amount,category,date,name,newBalance,previousBalance,reference,timeDiff,dayOfWeek
7,N/A,N/A,N/A,560,567,N/A,4,2
7,N/A,N/A,N/A,553,560,N/A,9,1
29,N/A,N/A,N/A,524,553,N/A,14,6
25,N/A,N/A,N/A,499,524,N/A,18,4
8,N/A,N/A,N/A,491,499,N/A,22,2
31,N/A,N/A,N/A,460,491,N/A,26,6
49,N/A,N/A,N/A,411,460,N/A,31,5
7,N/A,N/A,N/A,404,411,N/A,34,2
9,N/A,N/A,N/A,395,404,N/A,40,2
8,N/A,N/A,N/A,387,395,N/A,45,1
36,N/A,N/A,N/A,351,387,N/A,49,5
8,N/A,N/A,N/A,343,351,N/A,53,3
10,N/A,N/A,N/A,333,343,N/A,59,3
32,N/A,N/A,N/A,301,333,N/A,62,6
27,N/A,N/A,N/A,274,301,N/A,67,5
48,N/A,N/A,N/A,226,274,N/A,73,5
9,N/A,N/A,N/A,217,226,N/A,77,3
6,N/A,N/A,N/A,211,217,N/A,81,1
25,N/A,N/A,N/A,186,211,N/A,84,4
20,N/A,N/A,N/A,166,186,N/A,90,4
27,N/A,N/A,N/A,139,166,N/A,96,4
6,N/A,N/A,N/A,133,139,N/A,99,1
23,N/A,N/A,N/A,110,133,N/A,102,4
9,N/A,N/A,N/A,101,110,N/A,106,2
11,N/A,N/A,N/A,90,101,N/A,112,2
8,N/A,N/A,N/A,82,90,N/A,118,2
36,N/A,N/A,N/A,46,82,N/A,121,5
8,N/A,N/A,N/A,38,46,N/A,124,2
47,N/A,N/A,N/A,-9,38,N/A,127,5
23,N/A,N/A,N/A,518,541,N/A,3,4
9,N/A,N/A,N/A,509,518,N/A,8,3
42,N/A,N/A,N/A,467,509,N/A,11,6
21,N/A,N/A,N/A,446,467,N/A,15,4
7,N/A,N/A,N/A,439,446,N/A,20,3
8,N/A,N/A,N/A,431,439,N/A,24,1
23,N/A,N/A,N/A,408,431,N/A,27,4
9,N/A,N/A,N/A,399,408,N/A,30,1
14,N/A,N/A,N/A,385,399,N/A,33,4
25,N/A,N/A,N/A,360,385,N/A,39,4
7,N/A,N/A,N/A,353,360,N/A,43,2
45,N/A,N/A,N/A,308,353,N/A,46,5
16,N/A,N/A,N/A,292,308,N/A,51,4
7,N/A,N/A,N/A,285,292,N/A,55,2
6,N/A,N/A,N/A,279,285,N/A,60,1
7,N/A,N/A,N/A,272,279,N/A,66,1
25,N/A,N/A,N/A,247,272,N/A,70,5
16,N/A,N/A,N/A,231,247,N/A,75,4
11,N/A,N/A,N/A,220,231,N/A,80,3
8,N/A,N/A,N/A,212,220,N/A,85,2
7,N/A,N/A,N/A,205,212,N/A,91,2
9,N/A,N/A,N/A,196,205,N/A,97,2
11,N/A,N/A,N/A,185,196,N/A,103,2
10,N/A,N/A,N/A,175,185,N/A,109,2
7,N/A,N/A,N/A,168,175,N/A,115,2
9,N/A,N/A,N/A,159,168,N/A,120,1
8,N/A,N/A,N/A,151,159,N/A,126,1
20,N/A,N/A,N/A,131,151,N/A,129,4
24,N/A,N/A,N/A,107,131,N/A,135,4
26,N/A,N/A,N/A,81,107,N/A,141,4
8,N/A,N/A,N/A,1517,1525,N/A,5,1
35,N/A,N/A,N/A,1482,1517,N/A,9,5
9,N/A,N/A,N/A,1473,1482,N/A,12,2
9,N/A,N/A,N/A,1464,1473,N/A,17,1
24,N/A,N/A,N/A,1440,1464,N/A,20,4
12,N/A,N/A,N/A,1428,1440,N/A,26,4
11,N/A,N/A,N/A,1417,1428,N/A,31,3
9,N/A,N/A,N/A,1408,1417,N/A,36,2
35,N/A,N/A,N/A,1373,1408,N/A,39,5
27,N/A,N/A,N/A,1346,1373,N/A,44,4
21,N/A,N/A,N/A,1325,1346,N/A,50,4
5,N/A,N/A,N/A,1320,1325,N/A,53,1
48,N/A,N/A,N/A,1272,1320,N/A,57,5
17,N/A,N/A,N/A,1255,1272,N/A,62,4
7,N/A,N/A,N/A,1248,1255,N/A,65,1
31,N/A,N/A,N/A,1217,1248,N/A,69,5
10,N/A,N/A,N/A,1207,1217,N/A,72,2
28,N/A,N/A,N/A,1179,1207,N/A,76,6
36,N/A,N/A,N/A,1143,1179,N/A,81,5
7,N/A,N/A,N/A,1136,1143,N/A,85,3
10,N/A,N/A,N/A,1126,1136,N/A,91,3
45,N/A,N/A,N/A,1081,1126,N/A,94,6
24,N/A,N/A,N/A,1057,1081,N/A,98,4
11,N/A,N/A,N/A,1046,1057,N/A,103,3
11,N/A,N/A,N/A,1035,1046,N/A,108,2
35,N/A,N/A,N/A,1000,1035,N/A,111,5
32,N/A,N/A,N/A,968,1000,N/A,117,5
9,N/A,N/A,N/A,959,968,N/A,121,3
7,N/A,N/A,N/A,952,959,N/A,125,1
5,N/A,N/A,N/A,947,952,N/A,131,1
7,N/A,N/A,N/A,764,771,N/A,6,2
42,N/A,N/A,N/A,722,764,N/A,10,6
5,N/A,N/A,N/A,717,722,N/A,16,0
9,N/A,N/A,N/A,708,717,N/A,19,3
36,N/A,N/A,N/A,672,708,N/A,22,6
8,N/A,N/A,N/A,664,672,N/A,28,0
35,N/A,N/A,N/A,629,664,N/A,34,6
43,N/A,N/A,N/A,586,629,N/A,39,5
37,N/A,N/A,N/A,549,586,N/A,45,5
35,N/A,N/A,N/A,514,549,N/A,51,5
11,N/A,N/A,N/A,503,514,N/A,54,2
38,N/A,N/A,N/A,465,503,N/A,58,6
9,N/A,N/A,N/A,456,465,N/A,61,3
28,N/A,N/A,N/A,428,456,N/A,64,6
5,N/A,N/A,N/A,423,428,N/A,70,0
49,N/A,N/A,N/A,374,423,N/A,76,6
20,N/A,N/A,N/A,354,374,N/A,80,4
11,N/A,N/A,N/A,343,354,N/A,85,3
7,N/A,N/A,N/A,336,343,N/A,90,2
40,N/A,N/A,N/A,296,336,N/A,94,6
19,N/A,N/A,N/A,277,296,N/A,98,4
7,N/A,N/A,N/A,270,277,N/A,103,3
7,N/A,N/A,N/A,263,270,N/A,109,3
7,N/A,N/A,N/A,256,263,N/A,113,1
36,N/A,N/A,N/A,220,256,N/A,117,5
41,N/A,N/A,N/A,179,220,N/A,123,5
9,N/A,N/A,N/A,170,179,N/A,127,3
27,N/A,N/A,N/A,143,170,N/A,130,6
11,N/A,N/A,N/A,132,143,N/A,134,4
8,N/A,N/A,N/A,124,132,N/A,138,2
24,N/A,N/A,N/A,858,882,N/A,3,4
11,N/A,N/A,N/A,847,858,N/A,7,2
11,N/A,N/A,N/A,836,847,N/A,13,2
48,N/A,N/A,N/A,788,836,N/A,17,6
41,N/A,N/A,N/A,747,788,N/A,22,5
21,N/A,N/A,N/A,726,747,N/A,27,4
8,N/A,N/A,N/A,718,726,N/A,30,1
7,N/A,N/A,N/A,711,718,N/A,36,1
48,N/A,N/A,N/A,663,711,N/A,40,5
28,N/A,N/A,N/A,635,663,N/A,46,5
8,N/A,N/A,N/A,627,635,N/A,50,3
6,N/A,N/A,N/A,621,627,N/A,54,1
38,N/A,N/A,N/A,583,621,N/A,58,5
8,N/A,N/A,N/A,575,583,N/A,62,3
8,N/A,N/A,N/A,567,575,N/A,68,3
6,N/A,N/A,N/A,561,567,N/A,72,1
25,N/A,N/A,N/A,536,561,N/A,76,5
21,N/A,N/A,N/A,515,536,N/A,81,4
26,N/A,N/A,N/A,489,515,N/A,87,4
8,N/A,N/A,N/A,481,489,N/A,91,2
43,N/A,N/A,N/A,438,481,N/A,94,5
46,N/A,N/A,N/A,392,438,N/A,100,5
11,N/A,N/A,N/A,381,392,N/A,104,3
8,N/A,N/A,N/A,373,381,N/A,110,3
47,N/A,N/A,N/A,326,373,N/A,113,6
21,N/A,N/A,N/A,305,326,N/A,117,4
10,N/A,N/A,N/A,295,305,N/A,121,2
39,N/A,N/A,N/A,256,295,N/A,125,6
10,N/A,N/A,N/A,246,256,N/A,128,3
5,N/A,N/A,N/A,241,246,N/A,132,1
8,N/A,N/A,N/A,1252,1260,N/A,5,2
40,N/A,N/A,N/A,1212,1252,N/A,9,6
11,N/A,N/A,N/A,1201,1212,N/A,13,4
15,N/A,N/A,N/A,1186,1201,N/A,19,4
6,N/A,N/A,N/A,1180,1186,N/A,22,1
26,N/A,N/A,N/A,1154,1180,N/A,27,6
40,N/A,N/A,N/A,1114,1154,N/A,32,5
41,N/A,N/A,N/A,1073,1114,N/A,38,5
45,N/A,N/A,N/A,1028,1073,N/A,44,5
11,N/A,N/A,N/A,1017,1028,N/A,48,3
6,N/A,N/A,N/A,1011,1017,N/A,52,1
44,N/A,N/A,N/A,967,1011,N/A,57,6
10,N/A,N/A,N/A,957,967,N/A,60,3
42,N/A,N/A,N/A,915,957,N/A,63,6
45,N/A,N/A,N/A,870,915,N/A,68,5
8,N/A,N/A,N/A,862,870,N/A,71,2
7,N/A,N/A,N/A,855,862,N/A,77,2
9,N/A,N/A,N/A,846,855,N/A,83,2
25,N/A,N/A,N/A,821,846,N/A,87,6
6,N/A,N/A,N/A,815,821,N/A,93,0
39,N/A,N/A,N/A,776,815,N/A,99,6
7,N/A,N/A,N/A,769,776,N/A,102,3
33,N/A,N/A,N/A,736,769,N/A,105,6
13,N/A,N/A,N/A,723,736,N/A,109,4
10,N/A,N/A,N/A,713,723,N/A,114,3
10,N/A,N/A,N/A,703,713,N/A,120,3
6,N/A,N/A,N/A,697,703,N/A,124,1
20,N/A,N/A,N/A,677,697,N/A,127,4
7,N/A,N/A,N/A,670,677,N/A,131,2
30,N/A,N/A,N/A,640,670,N/A,134,5
6,N/A,N/A,N/A,1076,1082,N/A,3,1
40,N/A,N/A,N/A,1036,1076,N/A,8,6
21,N/A,N/A,N/A,1015,1036,N/A,12,4
10,N/A,N/A,N/A,1005,1015,N/A,18,4
10,N/A,N/A,N/A,995,1005,N/A,22,2
36,N/A,N/A,N/A,959,995,N/A,26,6
9,N/A,N/A,N/A,950,959,N/A,29,3
9,N/A,N/A,N/A,941,950,N/A,34,2
8,N/A,N/A,N/A,933,941,N/A,39,1
35,N/A,N/A,N/A,898,933,N/A,44,6
7,N/A,N/A,N/A,891,898,N/A,50,0
8,N/A,N/A,N/A,883,891,N/A,53,3
41,N/A,N/A,N/A,842,883,N/A,56,6
6,N/A,N/A,N/A,836,842,N/A,62,0
41,N/A,N/A,N/A,795,836,N/A,68,6
21,N/A,N/A,N/A,774,795,N/A,72,4
9,N/A,N/A,N/A,765,774,N/A,77,3
9,N/A,N/A,N/A,756,765,N/A,82,2
7,N/A,N/A,N/A,749,756,N/A,87,1
43,N/A,N/A,N/A,706,749,N/A,91,5
11,N/A,N/A,N/A,695,706,N/A,95,3
7,N/A,N/A,N/A,688,695,N/A,99,1
25,N/A,N/A,N/A,663,688,N/A,102,4
5,N/A,N/A,N/A,658,663,N/A,105,1
30,N/A,N/A,N/A,628,658,N/A,110,6
6,N/A,N/A,N/A,622,628,N/A,116,0
11,N/A,N/A,N/A,611,622,N/A,119,3
5,N/A,N/A,N/A,606,611,N/A,123,1
31,N/A,N/A,N/A,575,606,N/A,128,6
44,N/A,N/A,N/A,531,575,N/A,133,5
20,N/A,N/A,N/A,1084,1104,N/A,3,4
8,N/A,N/A,N/A,1076,1084,N/A,7,2
37,N/A,N/A,N/A,1039,1076,N/A,11,6
7,N/A,N/A,N/A,1032,1039,N/A,14,3
10,N/A,N/A,N/A,1022,1032,N/A,20,3
39,N/A,N/A,N/A,983,1022,N/A,23,6
8,N/A,N/A,N/A,975,983,N/A,29,0
28,N/A,N/A,N/A,947,975,N/A,34,5
36,N/A,N/A,N/A,911,947,N/A,40,5
9,N/A,N/A,N/A,902,911,N/A,44,3
10,N/A,N/A,N/A,892,902,N/A,49,2
11,N/A,N/A,N/A,881,892,N/A,55,2
37,N/A,N/A,N/A,844,881,N/A,58,5
10,N/A,N/A,N/A,834,844,N/A,62,3
11,N/A,N/A,N/A,823,834,N/A,67,2
11,N/A,N/A,N/A,812,823,N/A,73,2
6,N/A,N/A,N/A,806,812,N/A,78,1
6,N/A,N/A,N/A,800,806,N/A,84,1
7,N/A,N/A,N/A,793,800,N/A,90,1
8,N/A,N/A,N/A,785,793,N/A,96,1
30,N/A,N/A,N/A,755,785,N/A,101,6
23,N/A,N/A,N/A,732,755,N/A,105,4
15,N/A,N/A,N/A,717,732,N/A,111,4
9,N/A,N/A,N/A,708,717,N/A,116,3
34,N/A,N/A,N/A,674,708,N/A,119,6
9,N/A,N/A,N/A,665,674,N/A,122,3
43,N/A,N/A,N/A,622,665,N/A,125,6
10,N/A,N/A,N/A,612,622,N/A,128,3
11,N/A,N/A,N/A,601,612,N/A,134,3
7,N/A,N/A,N/A,594,601,N/A,138,1
11,N/A,N/A,N/A,1496,1507,N/A,5,2
7,N/A,N/A,N/A,1489,1496,N/A,11,2
39,N/A,N/A,N/A,1450,1489,N/A,14,5
9,N/A,N/A,N/A,1441,1450,N/A,17,2
37,N/A,N/A,N/A,1404,1441,N/A,21,6
45,N/A,N/A,N/A,1359,1404,N/A,26,5
28,N/A,N/A,N/A,1331,1359,N/A,31,4
7,N/A,N/A,N/A,1324,1331,N/A,35,2
5,N/A,N/A,N/A,1319,1324,N/A,40,1
36,N/A,N/A,N/A,1283,1319,N/A,45,6
11,N/A,N/A,N/A,1272,1283,N/A,49,4
21,N/A,N/A,N/A,1251,1272,N/A,55,4
9,N/A,N/A,N/A,1242,1251,N/A,58,1
5,N/A,N/A,N/A,1237,1242,N/A,64,1
5,N/A,N/A,N/A,1232,1237,N/A,70,1
27,N/A,N/A,N/A,1205,1232,N/A,74,5
26,N/A,N/A,N/A,1179,1205,N/A,79,4
21,N/A,N/A,N/A,1158,1179,N/A,85,4
20,N/A,N/A,N/A,1138,1158,N/A,91,4
6,N/A,N/A,N/A,1132,1138,N/A,94,1
22,N/A,N/A,N/A,1110,1132,N/A,97,4
21,N/A,N/A,N/A,1089,1110,N/A,103,4
7,N/A,N/A,N/A,1082,1089,N/A,108,3
26,N/A,N/A,N/A,1056,1082,N/A,111,6
33,N/A,N/A,N/A,1023,1056,N/A,116,5
8,N/A,N/A,N/A,1015,1023,N/A,120,3
10,N/A,N/A,N/A,1005,1015,N/A,126,3
9,N/A,N/A,N/A,996,1005,N/A,130,1
36,N/A,N/A,N/A,960,996,N/A,134,5
8,N/A,N/A,N/A,952,960,N/A,137,2
6,N/A,N/A,N/A,545,551,N/A,4,1
8,N/A,N/A,N/A,537,545,N/A,10,1
27,N/A,N/A,N/A,510,537,N/A,13,4
7,N/A,N/A,N/A,503,510,N/A,18,3
36,N/A,N/A,N/A,467,503,N/A,21,6
6,N/A,N/A,N/A,461,467,N/A,27,0
49,N/A,N/A,N/A,412,461,N/A,33,6
10,N/A,N/A,N/A,402,412,N/A,37,4
14,N/A,N/A,N/A,388,402,N/A,43,4
11,N/A,N/A,N/A,377,388,N/A,48,3
8,N/A,N/A,N/A,369,377,N/A,53,2
26,N/A,N/A,N/A,343,369,N/A,56,5
7,N/A,N/A,N/A,336,343,N/A,59,2
40,N/A,N/A,N/A,296,336,N/A,62,5
11,N/A,N/A,N/A,285,296,N/A,66,3
27,N/A,N/A,N/A,258,285,N/A,69,6
7,N/A,N/A,N/A,251,258,N/A,75,0
25,N/A,N/A,N/A,226,251,N/A,80,5
9,N/A,N/A,N/A,217,226,N/A,84,3
5,N/A,N/A,N/A,212,217,N/A,88,1
47,N/A,N/A,N/A,165,212,N/A,92,5
10,N/A,N/A,N/A,155,165,N/A,96,3
9,N/A,N/A,N/A,146,155,N/A,102,3
5,N/A,N/A,N/A,141,146,N/A,106,1
32,N/A,N/A,N/A,109,141,N/A,110,5
11,N/A,N/A,N/A,98,109,N/A,114,3
49,N/A,N/A,N/A,49,98,N/A,117,6
9,N/A,N/A,N/A,40,49,N/A,123,0
25,N/A,N/A,N/A,15,40,N/A,128,5
20,N/A,N/A,N/A,-5,15,N/A,133,4
16,N/A,N/A,N/A,877,893,N/A,3,4
26,N/A,N/A,N/A,851,877,N/A,9,4
7,N/A,N/A,N/A,844,851,N/A,12,1
36,N/A,N/A,N/A,808,844,N/A,17,6
11,N/A,N/A,N/A,797,808,N/A,20,3
8,N/A,N/A,N/A,789,797,N/A,24,1
24,N/A,N/A,N/A,765,789,N/A,27,4
8,N/A,N/A,N/A,757,765,N/A,32,3
10,N/A,N/A,N/A,747,757,N/A,37,2
7,N/A,N/A,N/A,740,747,N/A,43,2
9,N/A,N/A,N/A,731,740,N/A,49,2
45,N/A,N/A,N/A,686,731,N/A,53,6
8,N/A,N/A,N/A,678,686,N/A,56,3
39,N/A,N/A,N/A,639,678,N/A,59,6
6,N/A,N/A,N/A,633,639,N/A,65,0
49,N/A,N/A,N/A,584,633,N/A,71,6
8,N/A,N/A,N/A,576,584,N/A,77,0
24,N/A,N/A,N/A,552,576,N/A,81,4
18,N/A,N/A,N/A,534,552,N/A,87,4
14,N/A,N/A,N/A,520,534,N/A,93,4
20,N/A,N/A,N/A,500,520,N/A,99,4
11,N/A,N/A,N/A,489,500,N/A,103,2
7,N/A,N/A,N/A,482,489,N/A,108,1
48,N/A,N/A,N/A,434,482,N/A,113,6
42,N/A,N/A,N/A,392,434,N/A,118,5
11,N/A,N/A,N/A,381,392,N/A,121,2
25,N/A,N/A,N/A,356,381,N/A,124,5
7,N/A,N/A,N/A,349,356,N/A,127,2
44,N/A,N/A,N/A,305,349,N/A,130,5
48,N/A,N/A,N/A,257,305,N/A,136,5
10,N/A,N/A,N/A,1875,1885,N/A,5,4
14,N/A,N/A,N/A,1861,1875,N/A,11,4
10,N/A,N/A,N/A,1851,1861,N/A,17,4
9,N/A,N/A,N/A,1842,1851,N/A,21,2
49,N/A,N/A,N/A,1793,1842,N/A,24,5
32,N/A,N/A,N/A,1761,1793,N/A,30,5
11,N/A,N/A,N/A,1750,1761,N/A,34,3
7,N/A,N/A,N/A,1743,1750,N/A,39,2
7,N/A,N/A,N/A,1736,1743,N/A,45,2
7,N/A,N/A,N/A,1729,1736,N/A,50,1
8,N/A,N/A,N/A,1721,1729,N/A,56,1
49,N/A,N/A,N/A,1672,1721,N/A,61,6
8,N/A,N/A,N/A,1664,1672,N/A,64,3
25,N/A,N/A,N/A,1639,1664,N/A,67,6
49,N/A,N/A,N/A,1590,1639,N/A,72,5
48,N/A,N/A,N/A,1542,1590,N/A,78,5
14,N/A,N/A,N/A,1528,1542,N/A,83,4
7,N/A,N/A,N/A,1521,1528,N/A,86,1
28,N/A,N/A,N/A,1493,1521,N/A,91,6
45,N/A,N/A,N/A,1448,1493,N/A,96,5
29,N/A,N/A,N/A,1419,1448,N/A,102,5
9,N/A,N/A,N/A,1410,1419,N/A,106,3
10,N/A,N/A,N/A,1400,1410,N/A,112,3
5,N/A,N/A,N/A,1395,1400,N/A,116,1
9,N/A,N/A,N/A,1386,1395,N/A,122,1
27,N/A,N/A,N/A,1359,1386,N/A,127,6
7,N/A,N/A,N/A,1352,1359,N/A,130,3
11,N/A,N/A,N/A,1341,1352,N/A,136,3
7,N/A,N/A,N/A,1334,1341,N/A,142,3
11,N/A,N/A,N/A,1323,1334,N/A,147,2
37,N/A,N/A,N/A,1153,1190,N/A,4,6
11,N/A,N/A,N/A,1142,1153,N/A,8,4
6,N/A,N/A,N/A,1136,1142,N/A,11,1
36,N/A,N/A,N/A,1100,1136,N/A,15,5
42,N/A,N/A,N/A,1058,1100,N/A,21,5
10,N/A,N/A,N/A,1048,1058,N/A,25,3
8,N/A,N/A,N/A,1040,1048,N/A,29,1
41,N/A,N/A,N/A,999,1040,N/A,34,6
46,N/A,N/A,N/A,953,999,N/A,39,5
43,N/A,N/A,N/A,910,953,N/A,45,5
11,N/A,N/A,N/A,899,910,N/A,49,3
5,N/A,N/A,N/A,894,899,N/A,53,1
9,N/A,N/A,N/A,885,894,N/A,59,1
46,N/A,N/A,N/A,839,885,N/A,64,6
7,N/A,N/A,N/A,832,839,N/A,67,3
25,N/A,N/A,N/A,807,832,N/A,70,6
37,N/A,N/A,N/A,770,807,N/A,75,5
11,N/A,N/A,N/A,759,770,N/A,79,3
8,N/A,N/A,N/A,751,759,N/A,84,2
5,N/A,N/A,N/A,746,751,N/A,89,1
5,N/A,N/A,N/A,741,746,N/A,95,1
45,N/A,N/A,N/A,696,741,N/A,100,6
27,N/A,N/A,N/A,669,696,N/A,105,5
8,N/A,N/A,N/A,661,669,N/A,108,2
6,N/A,N/A,N/A,655,661,N/A,113,1
48,N/A,N/A,N/A,607,655,N/A,117,5
10,N/A,N/A,N/A,597,607,N/A,121,3
28,N/A,N/A,N/A,569,597,N/A,124,6
9,N/A,N/A,N/A,560,569,N/A,130,0
48,N/A,N/A,N/A,512,560,N/A,135,5
9,N/A,N/A,N/A,1502,1511,N/A,6,3
6,N/A,N/A,N/A,1496,1502,N/A,10,1
7,N/A,N/A,N/A,1489,1496,N/A,16,1
28,N/A,N/A,N/A,1461,1489,N/A,19,4
15,N/A,N/A,N/A,1446,1461,N/A,25,4
11,N/A,N/A,N/A,1435,1446,N/A,29,2
47,N/A,N/A,N/A,1388,1435,N/A,32,5
7,N/A,N/A,N/A,1381,1388,N/A,36,3
8,N/A,N/A,N/A,1373,1381,N/A,41,2
9,N/A,N/A,N/A,1364,1373,N/A,46,1
8,N/A,N/A,N/A,1356,1364,N/A,52,1
48,N/A,N/A,N/A,1308,1356,N/A,56,5
11,N/A,N/A,N/A,1297,1308,N/A,60,3
49,N/A,N/A,N/A,1248,1297,N/A,63,6
43,N/A,N/A,N/A,1205,1248,N/A,68,5
8,N/A,N/A,N/A,1197,1205,N/A,72,3
9,N/A,N/A,N/A,1188,1197,N/A,78,3
8,N/A,N/A,N/A,1180,1188,N/A,82,1
23,N/A,N/A,N/A,1157,1180,N/A,85,4
7,N/A,N/A,N/A,1150,1157,N/A,89,2
10,N/A,N/A,N/A,1140,1150,N/A,95,2
41,N/A,N/A,N/A,1099,1140,N/A,99,6
10,N/A,N/A,N/A,1089,1099,N/A,102,3
28,N/A,N/A,N/A,1061,1089,N/A,105,6
30,N/A,N/A,N/A,1031,1061,N/A,110,5
8,N/A,N/A,N/A,1023,1031,N/A,114,3
41,N/A,N/A,N/A,982,1023,N/A,117,6
6,N/A,N/A,N/A,976,982,N/A,123,0
30,N/A,N/A,N/A,946,976,N/A,128,5
8,N/A,N/A,N/A,938,946,N/A,132,3
6,N/A,N/A,N/A,1698,1704,N/A,3,1
42,N/A,N/A,N/A,1656,1698,N/A,8,6
11,N/A,N/A,N/A,1645,1656,N/A,11,3
44,N/A,N/A,N/A,1601,1645,N/A,14,6
18,N/A,N/A,N/A,1583,1601,N/A,18,4
11,N/A,N/A,N/A,1572,1583,N/A,24,4
26,N/A,N/A,N/A,1546,1572,N/A,30,4
8,N/A,N/A,N/A,1538,1546,N/A,35,3
11,N/A,N/A,N/A,1527,1538,N/A,40,2
27,N/A,N/A,N/A,1500,1527,N/A,43,5
11,N/A,N/A,N/A,1489,1500,N/A,46,2
5,N/A,N/A,N/A,1484,1489,N/A,51,1
18,N/A,N/A,N/A,1466,1484,N/A,54,4
6,N/A,N/A,N/A,1460,1466,N/A,57,1
14,N/A,N/A,N/A,1446,1460,N/A,60,4
21,N/A,N/A,N/A,1425,1446,N/A,66,4
28,N/A,N/A,N/A,1397,1425,N/A,72,4
10,N/A,N/A,N/A,1387,1397,N/A,78,4
7,N/A,N/A,N/A,1380,1387,N/A,83,3
11,N/A,N/A,N/A,1369,1380,N/A,89,3
27,N/A,N/A,N/A,1342,1369,N/A,92,6
11,N/A,N/A,N/A,1331,1342,N/A,95,3
11,N/A,N/A,N/A,1320,1331,N/A,101,3
11,N/A,N/A,N/A,1309,1320,N/A,107,3
35,N/A,N/A,N/A,1274,1309,N/A,110,6
9,N/A,N/A,N/A,1265,1274,N/A,116,0
11,N/A,N/A,N/A,1254,1265,N/A,119,3
7,N/A,N/A,N/A,1247,1254,N/A,125,3
30,N/A,N/A,N/A,1217,1247,N/A,128,6
49,N/A,N/A,N/A,1168,1217,N/A,133,5
28,N/A,N/A,N/A,1645,1673,N/A,6,6
47,N/A,N/A,N/A,1598,1645,N/A,11,5
9,N/A,N/A,N/A,1589,1598,N/A,15,3
7,N/A,N/A,N/A,1582,1589,N/A,21,3
7,N/A,N/A,N/A,1575,1582,N/A,26,2
8,N/A,N/A,N/A,1567,1575,N/A,32,2
42,N/A,N/A,N/A,1525,1567,N/A,36,6
20,N/A,N/A,N/A,1505,1525,N/A,40,4
7,N/A,N/A,N/A,1498,1505,N/A,43,1
28,N/A,N/A,N/A,1470,1498,N/A,48,6
22,N/A,N/A,N/A,1448,1470,N/A,52,4
7,N/A,N/A,N/A,1441,1448,N/A,57,3
7,N/A,N/A,N/A,1434,1441,N/A,61,1
6,N/A,N/A,N/A,1428,1434,N/A,67,1
26,N/A,N/A,N/A,1402,1428,N/A,71,5
26,N/A,N/A,N/A,1376,1402,N/A,77,5
25,N/A,N/A,N/A,1351,1376,N/A,83,5
7,N/A,N/A,N/A,1344,1351,N/A,86,2
41,N/A,N/A,N/A,1303,1344,N/A,89,5
16,N/A,N/A,N/A,1287,1303,N/A,94,4
14,N/A,N/A,N/A,1273,1287,N/A,100,4
9,N/A,N/A,N/A,1264,1273,N/A,105,3
8,N/A,N/A,N/A,1256,1264,N/A,110,2
9,N/A,N/A,N/A,1247,1256,N/A,116,2
7,N/A,N/A,N/A,1240,1247,N/A,122,2
31,N/A,N/A,N/A,1209,1240,N/A,125,5
23,N/A,N/A,N/A,1186,1209,N/A,130,4
10,N/A,N/A,N/A,1176,1186,N/A,135,3
7,N/A,N/A,N/A,1169,1176,N/A,139,1
14,N/A,N/A,N/A,1155,1169,N/A,142,4
10,N/A,N/A,N/A,551,561,N/A,6,3
9,N/A,N/A,N/A,542,551,N/A,10,1
31,N/A,N/A,N/A,511,542,N/A,15,6
32,N/A,N/A,N/A,479,511,N/A,20,5
11,N/A,N/A,N/A,468,479,N/A,24,3
7,N/A,N/A,N/A,461,468,N/A,29,2
11,N/A,N/A,N/A,450,461,N/A,35,2
31,N/A,N/A,N/A,419,450,N/A,39,6
5,N/A,N/A,N/A,414,419,N/A,45,0
35,N/A,N/A,N/A,379,414,N/A,50,5
10,N/A,N/A,N/A,369,379,N/A,53,2
43,N/A,N/A,N/A,326,369,N/A,57,6
11,N/A,N/A,N/A,315,326,N/A,61,4
11,N/A,N/A,N/A,304,315,N/A,65,2
33,N/A,N/A,N/A,271,304,N/A,69,6
42,N/A,N/A,N/A,229,271,N/A,74,5
8,N/A,N/A,N/A,221,229,N/A,78,3
7,N/A,N/A,N/A,214,221,N/A,83,2
11,N/A,N/A,N/A,203,214,N/A,89,2
35,N/A,N/A,N/A,168,203,N/A,93,6
6,N/A,N/A,N/A,162,168,N/A,99,0
9,N/A,N/A,N/A,153,162,N/A,102,3
9,N/A,N/A,N/A,144,153,N/A,106,1
8,N/A,N/A,N/A,136,144,N/A,112,1
8,N/A,N/A,N/A,128,136,N/A,118,1
28,N/A,N/A,N/A,100,128,N/A,123,6
44,N/A,N/A,N/A,56,100,N/A,128,5
12,N/A,N/A,N/A,44,56,N/A,133,4
18,N/A,N/A,N/A,26,44,N/A,139,4
11,N/A,N/A,N/A,15,26,N/A,144,3
12,N/A,N/A,N/A,747,759,N/A,3,4
20,N/A,N/A,N/A,727,747,N/A,9,4
25,N/A,N/A,N/A,702,727,N/A,15,4
19,N/A,N/A,N/A,683,702,N/A,21,4
8,N/A,N/A,N/A,675,683,N/A,24,1
25,N/A,N/A,N/A,650,675,N/A,27,4
19,N/A,N/A,N/A,631,650,N/A,33,4
7,N/A,N/A,N/A,624,631,N/A,38,3
29,N/A,N/A,N/A,595,624,N/A,41,6
31,N/A,N/A,N/A,564,595,N/A,46,5
10,N/A,N/A,N/A,554,564,N/A,49,2
30,N/A,N/A,N/A,524,554,N/A,53,6
8,N/A,N/A,N/A,516,524,N/A,56,3
7,N/A,N/A,N/A,509,516,N/A,60,1
49,N/A,N/A,N/A,460,509,N/A,65,6
26,N/A,N/A,N/A,434,460,N/A,69,4
26,N/A,N/A,N/A,408,434,N/A,75,4
21,N/A,N/A,N/A,387,408,N/A,81,4
9,N/A,N/A,N/A,378,387,N/A,84,1
39,N/A,N/A,N/A,339,378,N/A,88,5
10,N/A,N/A,N/A,329,339,N/A,91,2
48,N/A,N/A,N/A,281,329,N/A,94,5
39,N/A,N/A,N/A,242,281,N/A,100,5
19,N/A,N/A,N/A,223,242,N/A,105,4
8,N/A,N/A,N/A,215,223,N/A,108,1
38,N/A,N/A,N/A,177,215,N/A,113,6
25,N/A,N/A,N/A,152,177,N/A,117,4
9,N/A,N/A,N/A,143,152,N/A,122,3
46,N/A,N/A,N/A,97,143,N/A,125,6
9,N/A,N/A,N/A,88,97,N/A,128,3
9,N/A,N/A,N/A,1681,1690,N/A,5,3
8,N/A,N/A,N/A,1673,1681,N/A,9,1
11,N/A,N/A,N/A,1662,1673,N/A,12,4
9,N/A,N/A,N/A,1653,1662,N/A,16,2
33,N/A,N/A,N/A,1620,1653,N/A,20,6
11,N/A,N/A,N/A,1609,1620,N/A,24,4
5,N/A,N/A,N/A,1604,1609,N/A,27,1
38,N/A,N/A,N/A,1566,1604,N/A,32,6
5,N/A,N/A,N/A,1561,1566,N/A,38,0
11,N/A,N/A,N/A,1550,1561,N/A,41,3
11,N/A,N/A,N/A,1539,1550,N/A,46,2
37,N/A,N/A,N/A,1502,1539,N/A,49,5
7,N/A,N/A,N/A,1495,1502,N/A,53,3
8,N/A,N/A,N/A,1487,1495,N/A,59,3
10,N/A,N/A,N/A,1477,1487,N/A,64,2
8,N/A,N/A,N/A,1469,1477,N/A,69,1
30,N/A,N/A,N/A,1439,1469,N/A,73,5
8,N/A,N/A,N/A,1431,1439,N/A,76,2
5,N/A,N/A,N/A,1426,1431,N/A,81,1
14,N/A,N/A,N/A,1412,1426,N/A,84,4
12,N/A,N/A,N/A,1400,1412,N/A,90,4
24,N/A,N/A,N/A,1376,1400,N/A,96,4
8,N/A,N/A,N/A,1368,1376,N/A,99,1
28,N/A,N/A,N/A,1340,1368,N/A,104,6
9,N/A,N/A,N/A,1331,1340,N/A,110,0
40,N/A,N/A,N/A,1291,1331,N/A,116,6
46,N/A,N/A,N/A,1245,1291,N/A,121,5
43,N/A,N/A,N/A,1202,1245,N/A,127,5
37,N/A,N/A,N/A,1165,1202,N/A,133,5
11,N/A,N/A,N/A,1154,1165,N/A,137,3
7,N/A,N/A,N/A,1194,1201,N/A,6,1
40,N/A,N/A,N/A,1154,1194,N/A,11,6
8,N/A,N/A,N/A,1146,1154,N/A,17,0
42,N/A,N/A,N/A,1104,1146,N/A,22,5
37,N/A,N/A,N/A,1067,1104,N/A,28,5
11,N/A,N/A,N/A,1056,1067,N/A,31,2
7,N/A,N/A,N/A,1049,1056,N/A,36,1
17,N/A,N/A,N/A,1032,1049,N/A,39,4
10,N/A,N/A,N/A,1022,1032,N/A,45,4
7,N/A,N/A,N/A,1015,1022,N/A,49,2
5,N/A,N/A,N/A,1010,1015,N/A,54,1
26,N/A,N/A,N/A,984,1010,N/A,57,4
5,N/A,N/A,N/A,979,984,N/A,60,1
26,N/A,N/A,N/A,953,979,N/A,65,6
24,N/A,N/A,N/A,929,953,N/A,69,4
22,N/A,N/A,N/A,907,929,N/A,75,4
11,N/A,N/A,N/A,896,907,N/A,80,3
11,N/A,N/A,N/A,885,896,N/A,85,2
8,N/A,N/A,N/A,877,885,N/A,91,2
31,N/A,N/A,N/A,846,877,N/A,95,6
28,N/A,N/A,N/A,818,846,N/A,99,4
10,N/A,N/A,N/A,808,818,N/A,103,2
30,N/A,N/A,N/A,778,808,N/A,107,6
9,N/A,N/A,N/A,769,778,N/A,110,3
9,N/A,N/A,N/A,760,769,N/A,116,3
11,N/A,N/A,N/A,749,760,N/A,121,2
41,N/A,N/A,N/A,708,749,N/A,125,6
9,N/A,N/A,N/A,699,708,N/A,128,3
31,N/A,N/A,N/A,668,699,N/A,131,6
37,N/A,N/A,N/A,631,668,N/A,136,5
33,N/A,N/A,N/A,1278,1311,N/A,3,5
9,N/A,N/A,N/A,1269,1278,N/A,7,3
48,N/A,N/A,N/A,1221,1269,N/A,10,6
23,N/A,N/A,N/A,1198,1221,N/A,14,4
5,N/A,N/A,N/A,1193,1198,N/A,17,1
27,N/A,N/A,N/A,1166,1193,N/A,22,6
9,N/A,N/A,N/A,1157,1166,N/A,28,0
33,N/A,N/A,N/A,1124,1157,N/A,34,6
31,N/A,N/A,N/A,1093,1124,N/A,39,5
7,N/A,N/A,N/A,1086,1093,N/A,42,2
34,N/A,N/A,N/A,1052,1086,N/A,46,6
9,N/A,N/A,N/A,1043,1052,N/A,49,3
9,N/A,N/A,N/A,1034,1043,N/A,54,2
7,N/A,N/A,N/A,1027,1034,N/A,59,1
8,N/A,N/A,N/A,1019,1027,N/A,65,1
33,N/A,N/A,N/A,986,1019,N/A,69,5
20,N/A,N/A,N/A,966,986,N/A,74,4
7,N/A,N/A,N/A,959,966,N/A,77,1
25,N/A,N/A,N/A,934,959,N/A,81,5
8,N/A,N/A,N/A,926,934,N/A,84,2
8,N/A,N/A,N/A,918,926,N/A,90,2
7,N/A,N/A,N/A,911,918,N/A,96,2
7,N/A,N/A,N/A,904,911,N/A,101,1
45,N/A,N/A,N/A,859,904,N/A,106,6
37,N/A,N/A,N/A,822,859,N/A,111,5
40,N/A,N/A,N/A,782,822,N/A,117,5
35,N/A,N/A,N/A,747,782,N/A,123,5
33,N/A,N/A,N/A,714,747,N/A,129,5
8,N/A,N/A,N/A,706,714,N/A,133,3
7,N/A,N/A,N/A,699,706,N/A,138,2
7,N/A,N/A,N/A,1441,1448,N/A,5,1
7,N/A,N/A,N/A,1434,1441,N/A,11,1
44,N/A,N/A,N/A,1390,1434,N/A,15,5
28,N/A,N/A,N/A,1362,1390,N/A,21,5
40,N/A,N/A,N/A,1322,1362,N/A,27,5
13,N/A,N/A,N/A,1309,1322,N/A,32,4
9,N/A,N/A,N/A,1300,1309,N/A,37,3
7,N/A,N/A,N/A,1293,1300,N/A,43,3
48,N/A,N/A,N/A,1245,1293,N/A,46,6
8,N/A,N/A,N/A,1237,1245,N/A,49,3
9,N/A,N/A,N/A,1228,1237,N/A,55,3
9,N/A,N/A,N/A,1219,1228,N/A,59,1
28,N/A,N/A,N/A,1191,1219,N/A,62,4
11,N/A,N/A,N/A,1180,1191,N/A,66,2
38,N/A,N/A,N/A,1142,1180,N/A,70,6
8,N/A,N/A,N/A,1134,1142,N/A,73,3
8,N/A,N/A,N/A,1126,1134,N/A,78,2
28,N/A,N/A,N/A,1098,1126,N/A,82,6
10,N/A,N/A,N/A,1088,1098,N/A,85,3
11,N/A,N/A,N/A,1077,1088,N/A,91,3
8,N/A,N/A,N/A,1069,1077,N/A,96,2
11,N/A,N/A,N/A,1058,1069,N/A,102,2
7,N/A,N/A,N/A,1051,1058,N/A,107,1
8,N/A,N/A,N/A,1043,1051,N/A,113,1
27,N/A,N/A,N/A,1016,1043,N/A,118,6
29,N/A,N/A,N/A,987,1016,N/A,123,5
26,N/A,N/A,N/A,961,987,N/A,128,4
8,N/A,N/A,N/A,953,961,N/A,131,1
47,N/A,N/A,N/A,906,953,N/A,135,5
29,N/A,N/A,N/A,877,906,N/A,140,4
10,N/A,N/A,N/A,489,499,N/A,3,4
27,N/A,N/A,N/A,462,489,N/A,9,4
7,N/A,N/A,N/A,455,462,N/A,14,3
36,N/A,N/A,N/A,419,455,N/A,17,6
16,N/A,N/A,N/A,403,419,N/A,21,4
19,N/A,N/A,N/A,384,403,N/A,27,4
8,N/A,N/A,N/A,376,384,N/A,32,3
10,N/A,N/A,N/A,366,376,N/A,37,2
41,N/A,N/A,N/A,325,366,N/A,41,6
48,N/A,N/A,N/A,277,325,N/A,46,5
7,N/A,N/A,N/A,270,277,N/A,50,3
9,N/A,N/A,N/A,261,270,N/A,56,3
5,N/A,N/A,N/A,256,261,N/A,60,1
48,N/A,N/A,N/A,208,256,N/A,64,5
7,N/A,N/A,N/A,201,208,N/A,67,2
5,N/A,N/A,N/A,196,201,N/A,72,1
24,N/A,N/A,N/A,172,196,N/A,75,4
7,N/A,N/A,N/A,165,172,N/A,78,1
10,N/A,N/A,N/A,155,165,N/A,81,4
9,N/A,N/A,N/A,146,155,N/A,86,3
7,N/A,N/A,N/A,139,146,N/A,91,2
39,N/A,N/A,N/A,100,139,N/A,95,6
6,N/A,N/A,N/A,94,100,N/A,101,0
10,N/A,N/A,N/A,84,94,N/A,104,3
8,N/A,N/A,N/A,76,84,N/A,110,3
6,N/A,N/A,N/A,70,76,N/A,114,1
37,N/A,N/A,N/A,33,70,N/A,119,6
5,N/A,N/A,N/A,28,33,N/A,125,0
24,N/A,N/A,N/A,4,28,N/A,129,4
7,N/A,N/A,N/A,-3,4,N/A,134,3
33,N/A,N/A,N/A,1105,1138,N/A,5,5
7,N/A,N/A,N/A,1098,1105,N/A,9,3
43,N/A,N/A,N/A,1055,1098,N/A,12,6
25,N/A,N/A,N/A,1030,1055,N/A,16,4
10,N/A,N/A,N/A,1020,1030,N/A,20,2
43,N/A,N/A,N/A,977,1020,N/A,23,5
11,N/A,N/A,N/A,966,977,N/A,26,2
42,N/A,N/A,N/A,924,966,N/A,29,5
9,N/A,N/A,N/A,915,924,N/A,33,3
31,N/A,N/A,N/A,884,915,N/A,36,6
10,N/A,N/A,N/A,874,884,N/A,39,3
10,N/A,N/A,N/A,864,874,N/A,45,3
11,N/A,N/A,N/A,853,864,N/A,50,2
9,N/A,N/A,N/A,844,853,N/A,56,2
42,N/A,N/A,N/A,802,844,N/A,59,5
20,N/A,N/A,N/A,782,802,N/A,64,4
9,N/A,N/A,N/A,773,782,N/A,67,1
27,N/A,N/A,N/A,746,773,N/A,72,6
46,N/A,N/A,N/A,700,746,N/A,77,5
10,N/A,N/A,N/A,690,700,N/A,81,3
8,N/A,N/A,N/A,682,690,N/A,85,1
38,N/A,N/A,N/A,644,682,N/A,89,5
47,N/A,N/A,N/A,597,644,N/A,95,5
9,N/A,N/A,N/A,588,597,N/A,98,2
6,N/A,N/A,N/A,582,588,N/A,103,1
6,N/A,N/A,N/A,576,582,N/A,109,1
43,N/A,N/A,N/A,533,576,N/A,114,6
5,N/A,N/A,N/A,528,533,N/A,120,0
33,N/A,N/A,N/A,495,528,N/A,126,6
9,N/A,N/A,N/A,486,495,N/A,132,0
20,N/A,N/A,N/A,1746,1766,N/A,6,4
8,N/A,N/A,N/A,1738,1746,N/A,9,1
43,N/A,N/A,N/A,1695,1738,N/A,14,6
28,N/A,N/A,N/A,1667,1695,N/A,19,5
15,N/A,N/A,N/A,1652,1667,N/A,24,4
9,N/A,N/A,N/A,1643,1652,N/A,27,1
9,N/A,N/A,N/A,1634,1643,N/A,33,1
21,N/A,N/A,N/A,1613,1634,N/A,36,4
12,N/A,N/A,N/A,1601,1613,N/A,42,4
5,N/A,N/A,N/A,1596,1601,N/A,45,1
11,N/A,N/A,N/A,1585,1596,N/A,48,4
6,N/A,N/A,N/A,1579,1585,N/A,51,1
29,N/A,N/A,N/A,1550,1579,N/A,55,5
31,N/A,N/A,N/A,1519,1550,N/A,61,5
7,N/A,N/A,N/A,1512,1519,N/A,65,3
7,N/A,N/A,N/A,1505,1512,N/A,70,2
25,N/A,N/A,N/A,1480,1505,N/A,74,6
42,N/A,N/A,N/A,1438,1480,N/A,79,5
26,N/A,N/A,N/A,1412,1438,N/A,84,4
9,N/A,N/A,N/A,1403,1412,N/A,87,1
26,N/A,N/A,N/A,1377,1403,N/A,91,5
38,N/A,N/A,N/A,1339,1377,N/A,97,5
27,N/A,N/A,N/A,1312,1339,N/A,103,5
18,N/A,N/A,N/A,1294,1312,N/A,108,4
8,N/A,N/A,N/A,1286,1294,N/A,111,1
20,N/A,N/A,N/A,1266,1286,N/A,114,4
9,N/A,N/A,N/A,1257,1266,N/A,117,1
5,N/A,N/A,N/A,1252,1257,N/A,123,1
6,N/A,N/A,N/A,1246,1252,N/A,129,1
8,N/A,N/A,N/A,1238,1246,N/A,135,1
41,N/A,N/A,N/A,1687,1728,N/A,3,6
20,N/A,N/A,N/A,1667,1687,N/A,7,4
17,N/A,N/A,N/A,1650,1667,N/A,13,4
6,N/A,N/A,N/A,1644,1650,N/A,16,1
14,N/A,N/A,N/A,1630,1644,N/A,19,4
11,N/A,N/A,N/A,1619,1630,N/A,25,4
14,N/A,N/A,N/A,1605,1619,N/A,31,4
10,N/A,N/A,N/A,1595,1605,N/A,35,2
49,N/A,N/A,N/A,1546,1595,N/A,38,5
11,N/A,N/A,N/A,1535,1546,N/A,42,3
8,N/A,N/A,N/A,1527,1535,N/A,47,2
37,N/A,N/A,N/A,1490,1527,N/A,51,6
10,N/A,N/A,N/A,1480,1490,N/A,54,3
10,N/A,N/A,N/A,1470,1480,N/A,60,3
9,N/A,N/A,N/A,1461,1470,N/A,64,1
25,N/A,N/A,N/A,1436,1461,N/A,67,4
10,N/A,N/A,N/A,1426,1436,N/A,71,2
34,N/A,N/A,N/A,1392,1426,N/A,74,5
7,N/A,N/A,N/A,1385,1392,N/A,77,2
40,N/A,N/A,N/A,1345,1385,N/A,80,5
19,N/A,N/A,N/A,1326,1345,N/A,85,4
5,N/A,N/A,N/A,1321,1326,N/A,88,1
39,N/A,N/A,N/A,1282,1321,N/A,93,6
34,N/A,N/A,N/A,1248,1282,N/A,98,5
11,N/A,N/A,N/A,1237,1248,N/A,102,3
8,N/A,N/A,N/A,1229,1237,N/A,106,1
20,N/A,N/A,N/A,1209,1229,N/A,109,4
11,N/A,N/A,N/A,1198,1209,N/A,114,3
8,N/A,N/A,N/A,1190,1198,N/A,119,2
47,N/A,N/A,N/A,1143,1190,N/A,123,6
11,N/A,N/A,N/A,1293,1304,N/A,4,2
10,N/A,N/A,N/A,1283,1293,N/A,10,2
25,N/A,N/A,N/A,1258,1283,N/A,14,6
8,N/A,N/A,N/A,1250,1258,N/A,17,3
10,N/A,N/A,N/A,1240,1250,N/A,23,3
7,N/A,N/A,N/A,1233,1240,N/A,28,2
28,N/A,N/A,N/A,1205,1233,N/A,32,6
7,N/A,N/A,N/A,1198,1205,N/A,38,0
11,N/A,N/A,N/A,1187,1198,N/A,42,4
9,N/A,N/A,N/A,1178,1187,N/A,46,2
48,N/A,N/A,N/A,1130,1178,N/A,50,6
39,N/A,N/A,N/A,1091,1130,N/A,55,5
7,N/A,N/A,N/A,1084,1091,N/A,58,2
29,N/A,N/A,N/A,1055,1084,N/A,61,5
10,N/A,N/A,N/A,1045,1055,N/A,64,2
27,N/A,N/A,N/A,1018,1045,N/A,67,5
7,N/A,N/A,N/A,1011,1018,N/A,71,3
8,N/A,N/A,N/A,1003,1011,N/A,76,2
44,N/A,N/A,N/A,959,1003,N/A,79,5
17,N/A,N/A,N/A,942,959,N/A,84,4
7,N/A,N/A,N/A,935,942,N/A,89,3
8,N/A,N/A,N/A,927,935,N/A,95,3
8,N/A,N/A,N/A,919,927,N/A,100,2
36,N/A,N/A,N/A,883,919,N/A,104,6
29,N/A,N/A,N/A,854,883,N/A,108,4
7,N/A,N/A,N/A,847,854,N/A,112,2
11,N/A,N/A,N/A,836,847,N/A,118,2
6,N/A,N/A,N/A,830,836,N/A,123,1
26,N/A,N/A,N/A,804,830,N/A,128,6
9,N/A,N/A,N/A,795,804,N/A,131,3
13,N/A,N/A,N/A,1047,1060,N/A,5,4
8,N/A,N/A,N/A,1039,1047,N/A,9,2
10,N/A,N/A,N/A,1029,1039,N/A,15,2
10,N/A,N/A,N/A,1019,1029,N/A,21,2
43,N/A,N/A,N/A,976,1019,N/A,24,5
28,N/A,N/A,N/A,948,976,N/A,29,4
9,N/A,N/A,N/A,939,948,N/A,34,3
8,N/A,N/A,N/A,931,939,N/A,38,1
44,N/A,N/A,N/A,887,931,N/A,42,5
9,N/A,N/A,N/A,878,887,N/A,46,3
10,N/A,N/A,N/A,868,878,N/A,52,3
8,N/A,N/A,N/A,860,868,N/A,57,2
9,N/A,N/A,N/A,851,860,N/A,63,2
7,N/A,N/A,N/A,844,851,N/A,68,1
47,N/A,N/A,N/A,797,844,N/A,73,6
31,N/A,N/A,N/A,766,797,N/A,78,5
11,N/A,N/A,N/A,755,766,N/A,81,2
5,N/A,N/A,N/A,750,755,N/A,86,1
39,N/A,N/A,N/A,711,750,N/A,90,5
16,N/A,N/A,N/A,695,711,N/A,95,4
7,N/A,N/A,N/A,688,695,N/A,98,1
41,N/A,N/A,N/A,647,688,N/A,103,6
8,N/A,N/A,N/A,639,647,N/A,109,0
11,N/A,N/A,N/A,628,639,N/A,112,3
10,N/A,N/A,N/A,618,628,N/A,118,3
11,N/A,N/A,N/A,607,618,N/A,124,3
35,N/A,N/A,N/A,572,607,N/A,127,6
9,N/A,N/A,N/A,563,572,N/A,133,0
39,N/A,N/A,N/A,524,563,N/A,139,6
10,N/A,N/A,N/A,514,524,N/A,142,3
11,N/A,N/A,N/A,349,360,N/A,6,2
34,N/A,N/A,N/A,315,349,N/A,10,6
8,N/A,N/A,N/A,307,315,N/A,16,0
8,N/A,N/A,N/A,299,307,N/A,19,3
9,N/A,N/A,N/A,290,299,N/A,24,2
42,N/A,N/A,N/A,248,290,N/A,27,5
10,N/A,N/A,N/A,238,248,N/A,30,2
41,N/A,N/A,N/A,197,238,N/A,34,6
30,N/A,N/A,N/A,167,197,N/A,39,5
9,N/A,N/A,N/A,158,167,N/A,43,3
35,N/A,N/A,N/A,123,158,N/A,46,6
8,N/A,N/A,N/A,115,123,N/A,52,0
7,N/A,N/A,N/A,108,115,N/A,55,3
7,N/A,N/A,N/A,101,108,N/A,60,2
10,N/A,N/A,N/A,91,101,N/A,66,2
8,N/A,N/A,N/A,83,91,N/A,72,2
35,N/A,N/A,N/A,48,83,N/A,75,5
33,N/A,N/A,N/A,15,48,N/A,81,5
8,N/A,N/A,N/A,7,15,N/A,85,3
5,N/A,N/A,N/A,2,7,N/A,89,1
29,N/A,N/A,N/A,-27,2,N/A,94,6
37,N/A,N/A,N/A,398,435,N/A,6,5
26,N/A,N/A,N/A,372,398,N/A,11,4
24,N/A,N/A,N/A,348,372,N/A,17,4
7,N/A,N/A,N/A,341,348,N/A,22,3
10,N/A,N/A,N/A,331,341,N/A,28,3
6,N/A,N/A,N/A,325,331,N/A,32,1
21,N/A,N/A,N/A,304,325,N/A,35,4
11,N/A,N/A,N/A,293,304,N/A,40,3
10,N/A,N/A,N/A,283,293,N/A,45,2
9,N/A,N/A,N/A,274,283,N/A,50,1
30,N/A,N/A,N/A,244,274,N/A,55,6
42,N/A,N/A,N/A,202,244,N/A,60,5
10,N/A,N/A,N/A,192,202,N/A,64,3
28,N/A,N/A,N/A,164,192,N/A,67,6
12,N/A,N/A,N/A,152,164,N/A,71,4
7,N/A,N/A,N/A,145,152,N/A,75,2
5,N/A,N/A,N/A,140,145,N/A,80,1
7,N/A,N/A,N/A,133,140,N/A,86,1
9,N/A,N/A,N/A,124,133,N/A,92,1
27,N/A,N/A,N/A,97,124,N/A,95,4
7,N/A,N/A,N/A,90,97,N/A,99,2
47,N/A,N/A,N/A,43,90,N/A,103,6
9,N/A,N/A,N/A,34,43,N/A,109,0
24,N/A,N/A,N/A,10,34,N/A,113,4
5,N/A,N/A,N/A,5,10,N/A,116,1
45,N/A,N/A,N/A,-40,5,N/A,121,6
20,N/A,N/A,N/A,586,606,N/A,6,4
10,N/A,N/A,N/A,576,586,N/A,10,2
10,N/A,N/A,N/A,566,576,N/A,16,2
7,N/A,N/A,N/A,559,566,N/A,21,1
14,N/A,N/A,N/A,545,559,N/A,24,4
24,N/A,N/A,N/A,521,545,N/A,30,4
11,N/A,N/A,N/A,510,521,N/A,35,3
7,N/A,N/A,N/A,503,510,N/A,40,2
25,N/A,N/A,N/A,478,503,N/A,43,5
11,N/A,N/A,N/A,467,478,N/A,46,2
8,N/A,N/A,N/A,459,467,N/A,51,1
19,N/A,N/A,N/A,440,459,N/A,54,4
9,N/A,N/A,N/A,431,440,N/A,58,2
46,N/A,N/A,N/A,385,431,N/A,61,5
8,N/A,N/A,N/A,377,385,N/A,65,3
11,N/A,N/A,N/A,366,377,N/A,70,2
48,N/A,N/A,N/A,318,366,N/A,74,6
34,N/A,N/A,N/A,284,318,N/A,79,5
28,N/A,N/A,N/A,256,284,N/A,85,5
21,N/A,N/A,N/A,235,256,N/A,90,4
7,N/A,N/A,N/A,228,235,N/A,95,3
41,N/A,N/A,N/A,187,228,N/A,98,6
6,N/A,N/A,N/A,181,187,N/A,104,0
48,N/A,N/A,N/A,133,181,N/A,109,5
7,N/A,N/A,N/A,126,133,N/A,112,2
5,N/A,N/A,N/A,121,126,N/A,117,1
9,N/A,N/A,N/A,112,121,N/A,123,1
6,N/A,N/A,N/A,106,112,N/A,129,1
41,N/A,N/A,N/A,65,106,N/A,133,5
8,N/A,N/A,N/A,57,65,N/A,137,3
6,N/A,N/A,N/A,1675,1681,N/A,5,1
43,N/A,N/A,N/A,1632,1675,N/A,10,6
17,N/A,N/A,N/A,1615,1632,N/A,14,4
8,N/A,N/A,N/A,1607,1615,N/A,18,2
9,N/A,N/A,N/A,1598,1607,N/A,24,2
33,N/A,N/A,N/A,1565,1598,N/A,28,6
25,N/A,N/A,N/A,1540,1565,N/A,32,4
8,N/A,N/A,N/A,1532,1540,N/A,37,3
8,N/A,N/A,N/A,1524,1532,N/A,42,2
38,N/A,N/A,N/A,1486,1524,N/A,45,5
12,N/A,N/A,N/A,1474,1486,N/A,50,4
9,N/A,N/A,N/A,1465,1474,N/A,53,1
27,N/A,N/A,N/A,1438,1465,N/A,58,6
9,N/A,N/A,N/A,1429,1438,N/A,61,3
10,N/A,N/A,N/A,1419,1429,N/A,67,3
6,N/A,N/A,N/A,1413,1419,N/A,71,1
46,N/A,N/A,N/A,1367,1413,N/A,76,6
30,N/A,N/A,N/A,1337,1367,N/A,81,5
47,N/A,N/A,N/A,1290,1337,N/A,87,5
9,N/A,N/A,N/A,1281,1290,N/A,91,3
9,N/A,N/A,N/A,1272,1281,N/A,95,1
6,N/A,N/A,N/A,1266,1272,N/A,101,1
33,N/A,N/A,N/A,1233,1266,N/A,105,5
47,N/A,N/A,N/A,1186,1233,N/A,111,5
32,N/A,N/A,N/A,1154,1186,N/A,117,5
32,N/A,N/A,N/A,1122,1154,N/A,123,5
8,N/A,N/A,N/A,1114,1122,N/A,127,3
8,N/A,N/A,N/A,1106,1114,N/A,133,3
27,N/A,N/A,N/A,1079,1106,N/A,136,6
6,N/A,N/A,N/A,1073,1079,N/A,142,0
9,N/A,N/A,N/A,1174,1183,N/A,6,3
9,N/A,N/A,N/A,1165,1174,N/A,11,2
26,N/A,N/A,N/A,1139,1165,N/A,15,6
48,N/A,N/A,N/A,1091,1139,N/A,20,5
25,N/A,N/A,N/A,1066,1091,N/A,26,5
10,N/A,N/A,N/A,1056,1066,N/A,30,3
9,N/A,N/A,N/A,1047,1056,N/A,36,3
7,N/A,N/A,N/A,1040,1047,N/A,40,1
37,N/A,N/A,N/A,1003,1040,N/A,45,6
21,N/A,N/A,N/A,982,1003,N/A,49,4
12,N/A,N/A,N/A,970,982,N/A,55,4
6,N/A,N/A,N/A,964,970,N/A,58,1
31,N/A,N/A,N/A,933,964,N/A,63,6
9,N/A,N/A,N/A,924,933,N/A,69,0
10,N/A,N/A,N/A,914,924,N/A,72,3
8,N/A,N/A,N/A,906,914,N/A,76,1
5,N/A,N/A,N/A,901,906,N/A,82,1
21,N/A,N/A,N/A,880,901,N/A,85,4
10,N/A,N/A,N/A,870,880,N/A,90,3
9,N/A,N/A,N/A,861,870,N/A,94,1
16,N/A,N/A,N/A,845,861,N/A,97,4
7,N/A,N/A,N/A,838,845,N/A,100,1
6,N/A,N/A,N/A,832,838,N/A,106,1
29,N/A,N/A,N/A,803,832,N/A,111,6
11,N/A,N/A,N/A,792,803,N/A,114,3
11,N/A,N/A,N/A,781,792,N/A,119,2
10,N/A,N/A,N/A,771,781,N/A,125,2
32,N/A,N/A,N/A,739,771,N/A,129,6
9,N/A,N/A,N/A,730,739,N/A,135,0
16,N/A,N/A,N/A,714,730,N/A,139,4
39,N/A,N/A,N/A,1138,1177,N/A,5,5
11,N/A,N/A,N/A,1127,1138,N/A,8,2
29,N/A,N/A,N/A,1098,1127,N/A,11,5
15,N/A,N/A,N/A,1083,1098,N/A,16,4
7,N/A,N/A,N/A,1076,1083,N/A,21,3
8,N/A,N/A,N/A,1068,1076,N/A,26,2
11,N/A,N/A,N/A,1057,1068,N/A,32,2
28,N/A,N/A,N/A,1029,1057,N/A,36,6
14,N/A,N/A,N/A,1015,1029,N/A,40,4
8,N/A,N/A,N/A,1007,1015,N/A,44,2
49,N/A,N/A,N/A,958,1007,N/A,48,6
8,N/A,N/A,N/A,950,958,N/A,51,3
8,N/A,N/A,N/A,942,950,N/A,56,2
11,N/A,N/A,N/A,931,942,N/A,62,2
9,N/A,N/A,N/A,922,931,N/A,68,2
33,N/A,N/A,N/A,889,922,N/A,71,5
9,N/A,N/A,N/A,880,889,N/A,75,3
36,N/A,N/A,N/A,844,880,N/A,78,6
25,N/A,N/A,N/A,819,844,N/A,83,5
7,N/A,N/A,N/A,812,819,N/A,87,3
8,N/A,N/A,N/A,804,812,N/A,93,3
7,N/A,N/A,N/A,797,804,N/A,97,1
37,N/A,N/A,N/A,760,797,N/A,102,6
7,N/A,N/A,N/A,753,760,N/A,105,3
9,N/A,N/A,N/A,744,753,N/A,111,3
34,N/A,N/A,N/A,710,744,N/A,114,6
7,N/A,N/A,N/A,703,710,N/A,117,3
8,N/A,N/A,N/A,695,703,N/A,123,3
8,N/A,N/A,N/A,687,695,N/A,128,2
5,N/A,N/A,N/A,682,687,N/A,133,1
26,N/A,N/A,N/A,1048,1074,N/A,5,5
15,N/A,N/A,N/A,1033,1048,N/A,10,4
8,N/A,N/A,N/A,1025,1033,N/A,15,3
7,N/A,N/A,N/A,1018,1025,N/A,19,1
18,N/A,N/A,N/A,1000,1018,N/A,22,4
7,N/A,N/A,N/A,993,1000,N/A,27,3
10,N/A,N/A,N/A,983,993,N/A,33,3
44,N/A,N/A,N/A,939,983,N/A,36,6
27,N/A,N/A,N/A,912,939,N/A,41,5
15,N/A,N/A,N/A,897,912,N/A,46,4
9,N/A,N/A,N/A,888,897,N/A,51,3
10,N/A,N/A,N/A,878,888,N/A,56,2
30,N/A,N/A,N/A,848,878,N/A,59,5
27,N/A,N/A,N/A,821,848,N/A,65,5
28,N/A,N/A,N/A,793,821,N/A,71,5
7,N/A,N/A,N/A,786,793,N/A,75,3
39,N/A,N/A,N/A,747,786,N/A,78,6
14,N/A,N/A,N/A,733,747,N/A,82,4
9,N/A,N/A,N/A,724,733,N/A,86,2
48,N/A,N/A,N/A,676,724,N/A,89,5
40,N/A,N/A,N/A,636,676,N/A,95,5
8,N/A,N/A,N/A,628,636,N/A,98,2
9,N/A,N/A,N/A,619,628,N/A,103,1
37,N/A,N/A,N/A,582,619,N/A,108,6
9,N/A,N/A,N/A,573,582,N/A,114,0
49,N/A,N/A,N/A,524,573,N/A,119,5
35,N/A,N/A,N/A,489,524,N/A,125,5
10,N/A,N/A,N/A,479,489,N/A,129,3
8,N/A,N/A,N/A,471,479,N/A,133,1
34,N/A,N/A,N/A,437,471,N/A,138,6
26,N/A,N/A,N/A,1834,1860,N/A,6,4
25,N/A,N/A,N/A,1809,1834,N/A,12,4
9,N/A,N/A,N/A,1800,1809,N/A,17,3
36,N/A,N/A,N/A,1764,1800,N/A,20,6
7,N/A,N/A,N/A,1757,1764,N/A,23,3
9,N/A,N/A,N/A,1748,1757,N/A,27,1
15,N/A,N/A,N/A,1733,1748,N/A,30,4
9,N/A,N/A,N/A,1724,1733,N/A,34,2
7,N/A,N/A,N/A,1717,1724,N/A,39,1
7,N/A,N/A,N/A,1710,1717,N/A,45,1
26,N/A,N/A,N/A,1684,1710,N/A,48,4
9,N/A,N/A,N/A,1675,1684,N/A,51,1
25,N/A,N/A,N/A,1650,1675,N/A,56,6
40,N/A,N/A,N/A,1610,1650,N/A,61,5
10,N/A,N/A,N/A,1600,1610,N/A,66,4
9,N/A,N/A,N/A,1591,1600,N/A,69,1
35,N/A,N/A,N/A,1556,1591,N/A,74,6
9,N/A,N/A,N/A,1547,1556,N/A,80,0
12,N/A,N/A,N/A,1535,1547,N/A,84,4
8,N/A,N/A,N/A,1527,1535,N/A,89,3
7,N/A,N/A,N/A,1520,1527,N/A,95,3
26,N/A,N/A,N/A,1494,1520,N/A,98,6
11,N/A,N/A,N/A,1483,1494,N/A,101,3
5,N/A,N/A,N/A,1478,1483,N/A,105,1
46,N/A,N/A,N/A,1432,1478,N/A,109,5
40,N/A,N/A,N/A,1392,1432,N/A,115,5
48,N/A,N/A,N/A,1344,1392,N/A,121,5
27,N/A,N/A,N/A,1317,1344,N/A,127,5
12,N/A,N/A,N/A,1305,1317,N/A,132,4
6,N/A,N/A,N/A,1299,1305,N/A,135,1
9,N/A,N/A,N/A,1046,1055,N/A,5,2
26,N/A,N/A,N/A,1020,1046,N/A,9,6
40,N/A,N/A,N/A,980,1020,N/A,14,5
23,N/A,N/A,N/A,957,980,N/A,19,4
8,N/A,N/A,N/A,949,957,N/A,23,2
39,N/A,N/A,N/A,910,949,N/A,27,6
21,N/A,N/A,N/A,889,910,N/A,31,4
11,N/A,N/A,N/A,878,889,N/A,37,4
11,N/A,N/A,N/A,867,878,N/A,43,4
8,N/A,N/A,N/A,859,867,N/A,48,3
45,N/A,N/A,N/A,814,859,N/A,51,6
26,N/A,N/A,N/A,788,814,N/A,55,4
5,N/A,N/A,N/A,783,788,N/A,58,1
35,N/A,N/A,N/A,748,783,N/A,62,5
11,N/A,N/A,N/A,737,748,N/A,66,3
8,N/A,N/A,N/A,729,737,N/A,71,2
8,N/A,N/A,N/A,721,729,N/A,76,1
23,N/A,N/A,N/A,698,721,N/A,79,4
7,N/A,N/A,N/A,691,698,N/A,84,3
26,N/A,N/A,N/A,665,691,N/A,87,6
45,N/A,N/A,N/A,620,665,N/A,92,5
34,N/A,N/A,N/A,586,620,N/A,98,5
7,N/A,N/A,N/A,579,586,N/A,102,3
9,N/A,N/A,N/A,570,579,N/A,106,1
30,N/A,N/A,N/A,540,570,N/A,111,6
8,N/A,N/A,N/A,532,540,N/A,114,3
7,N/A,N/A,N/A,525,532,N/A,118,1
33,N/A,N/A,N/A,492,525,N/A,122,5
7,N/A,N/A,N/A,485,492,N/A,126,3
10,N/A,N/A,N/A,475,485,N/A,131,2
10,N/A,N/A,N/A,1089,1099,N/A,6,4
14,N/A,N/A,N/A,1075,1089,N/A,12,4
8,N/A,N/A,N/A,1067,1075,N/A,15,1
6,N/A,N/A,N/A,1061,1067,N/A,21,1
26,N/A,N/A,N/A,1035,1061,N/A,24,4
10,N/A,N/A,N/A,1025,1035,N/A,30,4
10,N/A,N/A,N/A,1015,1025,N/A,34,2
8,N/A,N/A,N/A,1007,1015,N/A,39,1
29,N/A,N/A,N/A,978,1007,N/A,42,4
10,N/A,N/A,N/A,968,978,N/A,47,3
7,N/A,N/A,N/A,961,968,N/A,53,3
48,N/A,N/A,N/A,913,961,N/A,56,6
11,N/A,N/A,N/A,902,913,N/A,59,3
10,N/A,N/A,N/A,892,902,N/A,65,3
10,N/A,N/A,N/A,882,892,N/A,71,3
7,N/A,N/A,N/A,875,882,N/A,76,2
8,N/A,N/A,N/A,867,875,N/A,82,2
7,N/A,N/A,N/A,860,867,N/A,87,1
25,N/A,N/A,N/A,835,860,N/A,92,6
37,N/A,N/A,N/A,798,835,N/A,97,5
7,N/A,N/A,N/A,791,798,N/A,100,2
48,N/A,N/A,N/A,743,791,N/A,103,5
33,N/A,N/A,N/A,710,743,N/A,109,5
48,N/A,N/A,N/A,662,710,N/A,115,5
17,N/A,N/A,N/A,645,662,N/A,120,4
9,N/A,N/A,N/A,636,645,N/A,125,3
7,N/A,N/A,N/A,629,636,N/A,129,1
10,N/A,N/A,N/A,619,629,N/A,132,4
11,N/A,N/A,N/A,608,619,N/A,137,3
11,N/A,N/A,N/A,597,608,N/A,142,2
8,N/A,N/A,N/A,1145,1153,N/A,6,1
49,N/A,N/A,N/A,1096,1145,N/A,11,6
8,N/A,N/A,N/A,1088,1096,N/A,14,3
48,N/A,N/A,N/A,1040,1088,N/A,17,6
26,N/A,N/A,N/A,1014,1040,N/A,21,4
9,N/A,N/A,N/A,1005,1014,N/A,26,3
7,N/A,N/A,N/A,998,1005,N/A,30,1
32,N/A,N/A,N/A,966,998,N/A,35,6
45,N/A,N/A,N/A,921,966,N/A,40,5
38,N/A,N/A,N/A,883,921,N/A,46,5
44,N/A,N/A,N/A,839,883,N/A,52,5
48,N/A,N/A,N/A,791,839,N/A,58,5
10,N/A,N/A,N/A,781,791,N/A,61,2
27,N/A,N/A,N/A,754,781,N/A,65,6
39,N/A,N/A,N/A,715,754,N/A,70,5
41,N/A,N/A,N/A,674,715,N/A,76,5
9,N/A,N/A,N/A,665,674,N/A,80,3
5,N/A,N/A,N/A,660,665,N/A,84,1
40,N/A,N/A,N/A,620,660,N/A,88,5
10,N/A,N/A,N/A,610,620,N/A,91,2
30,N/A,N/A,N/A,580,610,N/A,95,6
9,N/A,N/A,N/A,571,580,N/A,101,0
23,N/A,N/A,N/A,548,571,N/A,105,4
8,N/A,N/A,N/A,540,548,N/A,108,1
34,N/A,N/A,N/A,506,540,N/A,113,6
45,N/A,N/A,N/A,461,506,N/A,118,5
26,N/A,N/A,N/A,435,461,N/A,123,4
10,N/A,N/A,N/A,425,435,N/A,128,3
9,N/A,N/A,N/A,416,425,N/A,134,3
10,N/A,N/A,N/A,406,416,N/A,139,2
47,N/A,N/A,N/A,1557,1604,N/A,3,5
24,N/A,N/A,N/A,1533,1557,N/A,8,4
9,N/A,N/A,N/A,1524,1533,N/A,11,1
26,N/A,N/A,N/A,1498,1524,N/A,15,5
11,N/A,N/A,N/A,1487,1498,N/A,18,2
5,N/A,N/A,N/A,1482,1487,N/A,23,1
26,N/A,N/A,N/A,1456,1482,N/A,26,4
5,N/A,N/A,N/A,1451,1456,N/A,29,1
14,N/A,N/A,N/A,1437,1451,N/A,32,4
5,N/A,N/A,N/A,1432,1437,N/A,35,1
21,N/A,N/A,N/A,1411,1432,N/A,38,4
8,N/A,N/A,N/A,1403,1411,N/A,41,1
9,N/A,N/A,N/A,1394,1403,N/A,47,1
5,N/A,N/A,N/A,1389,1394,N/A,53,1
15,N/A,N/A,N/A,1374,1389,N/A,56,4
9,N/A,N/A,N/A,1365,1374,N/A,61,3
7,N/A,N/A,N/A,1358,1365,N/A,67,3
8,N/A,N/A,N/A,1350,1358,N/A,73,3
45,N/A,N/A,N/A,1305,1350,N/A,76,6
9,N/A,N/A,N/A,1296,1305,N/A,82,0
41,N/A,N/A,N/A,1255,1296,N/A,87,5
8,N/A,N/A,N/A,1247,1255,N/A,90,2
29,N/A,N/A,N/A,1218,1247,N/A,94,6
11,N/A,N/A,N/A,1207,1218,N/A,97,3
9,N/A,N/A,N/A,1198,1207,N/A,102,2
37,N/A,N/A,N/A,1161,1198,N/A,105,5
44,N/A,N/A,N/A,1117,1161,N/A,111,5
10,N/A,N/A,N/A,1107,1117,N/A,114,2
8,N/A,N/A,N/A,1099,1107,N/A,120,2
7,N/A,N/A,N/A,1092,1099,N/A,125,1
11,N/A,N/A,N/A,811,822,N/A,6,2
27,N/A,N/A,N/A,784,811,N/A,10,6
11,N/A,N/A,N/A,773,784,N/A,13,3
8,N/A,N/A,N/A,765,773,N/A,18,2
49,N/A,N/A,N/A,716,765,N/A,22,6
9,N/A,N/A,N/A,707,716,N/A,25,3
9,N/A,N/A,N/A,698,707,N/A,29,1
7,N/A,N/A,N/A,691,698,N/A,35,1
41,N/A,N/A,N/A,650,691,N/A,40,6
11,N/A,N/A,N/A,639,650,N/A,43,3
10,N/A,N/A,N/A,629,639,N/A,49,3
35,N/A,N/A,N/A,594,629,N/A,52,6
7,N/A,N/A,N/A,587,594,N/A,58,0
46,N/A,N/A,N/A,541,587,N/A,64,6
10,N/A,N/A,N/A,531,541,N/A,67,3
7,N/A,N/A,N/A,524,531,N/A,72,2
34,N/A,N/A,N/A,490,524,N/A,76,6
7,N/A,N/A,N/A,483,490,N/A,82,0
40,N/A,N/A,N/A,443,483,N/A,88,6
33,N/A,N/A,N/A,410,443,N/A,93,5
26,N/A,N/A,N/A,384,410,N/A,98,4
7,N/A,N/A,N/A,377,384,N/A,102,2
42,N/A,N/A,N/A,335,377,N/A,105,5
13,N/A,N/A,N/A,322,335,N/A,110,4
8,N/A,N/A,N/A,314,322,N/A,115,3
8,N/A,N/A,N/A,306,314,N/A,119,1
49,N/A,N/A,N/A,257,306,N/A,123,5
11,N/A,N/A,N/A,246,257,N/A,128,4
9,N/A,N/A,N/A,237,246,N/A,132,2
6,N/A,N/A,N/A,231,237,N/A,137,1
10,N/A,N/A,N/A,1057,1067,N/A,3,2
35,N/A,N/A,N/A,1022,1057,N/A,7,6
5,N/A,N/A,N/A,1017,1022,N/A,13,0
36,N/A,N/A,N/A,981,1017,N/A,18,5
48,N/A,N/A,N/A,933,981,N/A,24,5
18,N/A,N/A,N/A,915,933,N/A,29,4
8,N/A,N/A,N/A,907,915,N/A,33,2
32,N/A,N/A,N/A,875,907,N/A,36,5
11,N/A,N/A,N/A,864,875,N/A,39,2
30,N/A,N/A,N/A,834,864,N/A,43,6
11,N/A,N/A,N/A,823,834,N/A,46,3
47,N/A,N/A,N/A,776,823,N/A,49,6
8,N/A,N/A,N/A,768,776,N/A,55,0
11,N/A,N/A,N/A,757,768,N/A,58,3
10,N/A,N/A,N/A,747,757,N/A,63,2
9,N/A,N/A,N/A,738,747,N/A,68,1
8,N/A,N/A,N/A,730,738,N/A,74,1
8,N/A,N/A,N/A,722,730,N/A,80,1
35,N/A,N/A,N/A,687,722,N/A,85,6
42,N/A,N/A,N/A,645,687,N/A,90,5
27,N/A,N/A,N/A,618,645,N/A,95,4
24,N/A,N/A,N/A,594,618,N/A,101,4
16,N/A,N/A,N/A,578,594,N/A,107,4
6,N/A,N/A,N/A,572,578,N/A,110,1
7,N/A,N/A,N/A,565,572,N/A,116,1
6,N/A,N/A,N/A,559,565,N/A,122,1
7,N/A,N/A,N/A,552,559,N/A,128,1
26,N/A,N/A,N/A,526,552,N/A,133,6
7,N/A,N/A,N/A,519,526,N/A,136,3
9,N/A,N/A,N/A,510,519,N/A,142,3
11,N/A,N/A,N/A,1328,1339,N/A,6,2
9,N/A,N/A,N/A,1319,1328,N/A,12,2
46,N/A,N/A,N/A,1273,1319,N/A,15,5
40,N/A,N/A,N/A,1233,1273,N/A,21,5
7,N/A,N/A,N/A,1226,1233,N/A,25,3
7,N/A,N/A,N/A,1219,1226,N/A,29,1
26,N/A,N/A,N/A,1193,1219,N/A,33,5
49,N/A,N/A,N/A,1144,1193,N/A,39,5
9,N/A,N/A,N/A,1135,1144,N/A,43,3
27,N/A,N/A,N/A,1108,1135,N/A,46,6
31,N/A,N/A,N/A,1077,1108,N/A,51,5
8,N/A,N/A,N/A,1069,1077,N/A,55,3
6,N/A,N/A,N/A,1063,1069,N/A,59,1
8,N/A,N/A,N/A,1055,1063,N/A,65,1
31,N/A,N/A,N/A,1024,1055,N/A,70,6
6,N/A,N/A,N/A,1018,1024,N/A,76,0
9,N/A,N/A,N/A,1009,1018,N/A,79,3
8,N/A,N/A,N/A,1001,1009,N/A,83,1
15,N/A,N/A,N/A,986,1001,N/A,86,4
8,N/A,N/A,N/A,978,986,N/A,89,1
25,N/A,N/A,N/A,953,978,N/A,94,6
5,N/A,N/A,N/A,948,953,N/A,100,0
26,N/A,N/A,N/A,922,948,N/A,106,6
5,N/A,N/A,N/A,917,922,N/A,112,0
9,N/A,N/A,N/A,908,917,N/A,115,3
25,N/A,N/A,N/A,883,908,N/A,118,6
36,N/A,N/A,N/A,847,883,N/A,123,5
11,N/A,N/A,N/A,836,847,N/A,127,3
5,N/A,N/A,N/A,831,836,N/A,131,1
43,N/A,N/A,N/A,788,831,N/A,136,6
46,N/A,N/A,N/A,304,350,N/A,6,6
8,N/A,N/A,N/A,296,304,N/A,12,0
13,N/A,N/A,N/A,283,296,N/A,16,4
10,N/A,N/A,N/A,273,283,N/A,20,2
27,N/A,N/A,N/A,246,273,N/A,23,5
39,N/A,N/A,N/A,207,246,N/A,29,5
10,N/A,N/A,N/A,197,207,N/A,33,3
7,N/A,N/A,N/A,190,197,N/A,38,2
8,N/A,N/A,N/A,182,190,N/A,44,2
42,N/A,N/A,N/A,140,182,N/A,48,6
7,N/A,N/A,N/A,133,140,N/A,54,0
44,N/A,N/A,N/A,89,133,N/A,60,6
25,N/A,N/A,N/A,64,89,N/A,64,4
9,N/A,N/A,N/A,55,64,N/A,67,1
20,N/A,N/A,N/A,35,55,N/A,70,4
10,N/A,N/A,N/A,25,35,N/A,76,4
11,N/A,N/A,N/A,14,25,N/A,80,2
7,N/A,N/A,N/A,7,14,N/A,85,1
5,N/A,N/A,N/A,2,7,N/A,91,1
8,N/A,N/A,N/A,-6,2,N/A,97,1
48,N/A,N/A,N/A,1766,1814,N/A,3,6
11,N/A,N/A,N/A,1755,1766,N/A,6,3
10,N/A,N/A,N/A,1745,1755,N/A,11,2
10,N/A,N/A,N/A,1735,1745,N/A,17,2
28,N/A,N/A,N/A,1707,1735,N/A,20,5
21,N/A,N/A,N/A,1686,1707,N/A,25,4
28,N/A,N/A,N/A,1658,1686,N/A,31,4
7,N/A,N/A,N/A,1651,1658,N/A,36,3
9,N/A,N/A,N/A,1642,1651,N/A,42,3
8,N/A,N/A,N/A,1634,1642,N/A,47,2
9,N/A,N/A,N/A,1625,1634,N/A,52,1
45,N/A,N/A,N/A,1580,1625,N/A,56,5
28,N/A,N/A,N/A,1552,1580,N/A,61,4
8,N/A,N/A,N/A,1544,1552,N/A,64,1
29,N/A,N/A,N/A,1515,1544,N/A,67,4
23,N/A,N/A,N/A,1492,1515,N/A,73,4
8,N/A,N/A,N/A,1484,1492,N/A,77,2
46,N/A,N/A,N/A,1438,1484,N/A,81,6
28,N/A,N/A,N/A,1410,1438,N/A,86,5
22,N/A,N/A,N/A,1388,1410,N/A,91,4
11,N/A,N/A,N/A,1377,1388,N/A,95,2
42,N/A,N/A,N/A,1335,1377,N/A,99,6
6,N/A,N/A,N/A,1329,1335,N/A,105,0
29,N/A,N/A,N/A,1300,1329,N/A,111,6
10,N/A,N/A,N/A,1290,1300,N/A,114,3
34,N/A,N/A,N/A,1256,1290,N/A,117,6
19,N/A,N/A,N/A,1237,1256,N/A,121,4
10,N/A,N/A,N/A,1227,1237,N/A,125,2
9,N/A,N/A,N/A,1218,1227,N/A,130,1
8,N/A,N/A,N/A,1210,1218,N/A,136,1
37,N/A,N/A,N/A,1113,1150,N/A,4,5
47,N/A,N/A,N/A,1066,1113,N/A,10,5
10,N/A,N/A,N/A,1056,1066,N/A,15,4
9,N/A,N/A,N/A,1047,1056,N/A,18,1
37,N/A,N/A,N/A,1010,1047,N/A,22,5
11,N/A,N/A,N/A,999,1010,N/A,25,2
7,N/A,N/A,N/A,992,999,N/A,30,1
8,N/A,N/A,N/A,984,992,N/A,36,1
49,N/A,N/A,N/A,935,984,N/A,40,5
17,N/A,N/A,N/A,918,935,N/A,45,4
19,N/A,N/A,N/A,899,918,N/A,51,4
6,N/A,N/A,N/A,893,899,N/A,54,1
9,N/A,N/A,N/A,884,893,N/A,60,1
9,N/A,N/A,N/A,875,884,N/A,66,1
7,N/A,N/A,N/A,868,875,N/A,72,1
33,N/A,N/A,N/A,835,868,N/A,77,6
5,N/A,N/A,N/A,830,835,N/A,83,0
7,N/A,N/A,N/A,823,830,N/A,86,3
44,N/A,N/A,N/A,779,823,N/A,89,6
44,N/A,N/A,N/A,735,779,N/A,94,5
8,N/A,N/A,N/A,727,735,N/A,97,2
9,N/A,N/A,N/A,718,727,N/A,102,1
25,N/A,N/A,N/A,693,718,N/A,105,4
25,N/A,N/A,N/A,668,693,N/A,111,4
29,N/A,N/A,N/A,639,668,N/A,117,4
11,N/A,N/A,N/A,628,639,N/A,123,4
10,N/A,N/A,N/A,618,628,N/A,128,3
7,N/A,N/A,N/A,611,618,N/A,134,3
7,N/A,N/A,N/A,604,611,N/A,139,2
26,N/A,N/A,N/A,578,604,N/A,142,5
8,N/A,N/A,N/A,975,983,N/A,6,3
5,N/A,N/A,N/A,970,975,N/A,10,1
33,N/A,N/A,N/A,937,970,N/A,14,5
8,N/A,N/A,N/A,929,937,N/A,17,2
6,N/A,N/A,N/A,923,929,N/A,22,1
9,N/A,N/A,N/A,914,923,N/A,28,1
29,N/A,N/A,N/A,885,914,N/A,32,5
9,N/A,N/A,N/A,876,885,N/A,35,2
47,N/A,N/A,N/A,829,876,N/A,39,6
10,N/A,N/A,N/A,819,829,N/A,42,3
26,N/A,N/A,N/A,793,819,N/A,45,6
11,N/A,N/A,N/A,782,793,N/A,49,4
25,N/A,N/A,N/A,757,782,N/A,55,4
17,N/A,N/A,N/A,740,757,N/A,61,4
18,N/A,N/A,N/A,722,740,N/A,67,4
25,N/A,N/A,N/A,697,722,N/A,73,4
20,N/A,N/A,N/A,677,697,N/A,79,4
13,N/A,N/A,N/A,664,677,N/A,85,4
10,N/A,N/A,N/A,654,664,N/A,89,2
31,N/A,N/A,N/A,623,654,N/A,93,6
26,N/A,N/A,N/A,597,623,N/A,97,4
9,N/A,N/A,N/A,588,597,N/A,100,1
28,N/A,N/A,N/A,560,588,N/A,105,6
5,N/A,N/A,N/A,555,560,N/A,111,0
10,N/A,N/A,N/A,545,555,N/A,114,3
48,N/A,N/A,N/A,497,545,N/A,117,6
26,N/A,N/A,N/A,471,497,N/A,122,5
9,N/A,N/A,N/A,462,471,N/A,125,2
29,N/A,N/A,N/A,433,462,N/A,129,6
7,N/A,N/A,N/A,426,433,N/A,135,0
9,N/A,N/A,N/A,968,977,N/A,5,2
7,N/A,N/A,N/A,961,968,N/A,11,2
10,N/A,N/A,N/A,951,961,N/A,17,2
45,N/A,N/A,N/A,906,951,N/A,20,5
25,N/A,N/A,N/A,881,906,N/A,25,4
7,N/A,N/A,N/A,874,881,N/A,28,1
20,N/A,N/A,N/A,854,874,N/A,31,4
19,N/A,N/A,N/A,835,854,N/A,37,4
12,N/A,N/A,N/A,823,835,N/A,43,4
9,N/A,N/A,N/A,814,823,N/A,48,3
29,N/A,N/A,N/A,785,814,N/A,51,6
24,N/A,N/A,N/A,761,785,N/A,55,4
17,N/A,N/A,N/A,744,761,N/A,61,4
7,N/A,N/A,N/A,737,744,N/A,64,1
7,N/A,N/A,N/A,730,737,N/A,70,1
22,N/A,N/A,N/A,708,730,N/A,73,4
15,N/A,N/A,N/A,693,708,N/A,79,4
6,N/A,N/A,N/A,687,693,N/A,82,1
5,N/A,N/A,N/A,682,687,N/A,88,1
45,N/A,N/A,N/A,637,682,N/A,92,5
10,N/A,N/A,N/A,627,637,N/A,95,2
31,N/A,N/A,N/A,596,627,N/A,99,6
6,N/A,N/A,N/A,590,596,N/A,105,0
40,N/A,N/A,N/A,550,590,N/A,111,6
14,N/A,N/A,N/A,536,550,N/A,115,4
7,N/A,N/A,N/A,529,536,N/A,120,3
8,N/A,N/A,N/A,521,529,N/A,124,1
5,N/A,N/A,N/A,516,521,N/A,130,1
28,N/A,N/A,N/A,488,516,N/A,133,4
5,N/A,N/A,N/A,483,488,N/A,136,1
39,N/A,N/A,N/A,295,334,N/A,5,5
11,N/A,N/A,N/A,284,295,N/A,9,3
41,N/A,N/A,N/A,243,284,N/A,12,6
8,N/A,N/A,N/A,235,243,N/A,15,3
6,N/A,N/A,N/A,229,235,N/A,19,1
8,N/A,N/A,N/A,221,229,N/A,25,1
41,N/A,N/A,N/A,180,221,N/A,30,6
6,N/A,N/A,N/A,174,180,N/A,36,0
25,N/A,N/A,N/A,149,174,N/A,40,4
8,N/A,N/A,N/A,141,149,N/A,45,3
11,N/A,N/A,N/A,130,141,N/A,51,3
8,N/A,N/A,N/A,122,130,N/A,57,3
7,N/A,N/A,N/A,115,122,N/A,61,1
46,N/A,N/A,N/A,69,115,N/A,66,6
9,N/A,N/A,N/A,60,69,N/A,69,3
11,N/A,N/A,N/A,49,60,N/A,74,2
5,N/A,N/A,N/A,44,49,N/A,79,1
34,N/A,N/A,N/A,10,44,N/A,84,6
11,N/A,N/A,N/A,-1,10,N/A,87,3
11,N/A,N/A,N/A,402,413,N/A,3,2
43,N/A,N/A,N/A,359,402,N/A,7,6
27,N/A,N/A,N/A,332,359,N/A,11,4
15,N/A,N/A,N/A,317,332,N/A,17,4
15,N/A,N/A,N/A,302,317,N/A,23,4
11,N/A,N/A,N/A,291,302,N/A,28,3
32,N/A,N/A,N/A,259,291,N/A,31,6
11,N/A,N/A,N/A,248,259,N/A,35,4
5,N/A,N/A,N/A,243,248,N/A,38,1
29,N/A,N/A,N/A,214,243,N/A,42,5
7,N/A,N/A,N/A,207,214,N/A,45,2
42,N/A,N/A,N/A,165,207,N/A,48,5
39,N/A,N/A,N/A,126,165,N/A,54,5
7,N/A,N/A,N/A,119,126,N/A,57,2
35,N/A,N/A,N/A,84,119,N/A,60,5
8,N/A,N/A,N/A,76,84,N/A,64,3
29,N/A,N/A,N/A,47,76,N/A,67,6
22,N/A,N/A,N/A,25,47,N/A,71,4
15,N/A,N/A,N/A,10,25,N/A,77,4
7,N/A,N/A,N/A,3,10,N/A,81,2
7,N/A,N/A,N/A,-4,3,N/A,86,1
10,N/A,N/A,N/A,1262,1272,N/A,6,3
11,N/A,N/A,N/A,1251,1262,N/A,12,3
29,N/A,N/A,N/A,1222,1251,N/A,15,6
7,N/A,N/A,N/A,1215,1222,N/A,21,0
26,N/A,N/A,N/A,1189,1215,N/A,26,5
11,N/A,N/A,N/A,1178,1189,N/A,29,2
49,N/A,N/A,N/A,1129,1178,N/A,32,5
10,N/A,N/A,N/A,1119,1129,N/A,35,2
27,N/A,N/A,N/A,1092,1119,N/A,39,6
9,N/A,N/A,N/A,1083,1092,N/A,45,0
42,N/A,N/A,N/A,1041,1083,N/A,51,6
5,N/A,N/A,N/A,1036,1041,N/A,57,0
7,N/A,N/A,N/A,1029,1036,N/A,60,3
44,N/A,N/A,N/A,985,1029,N/A,63,6
8,N/A,N/A,N/A,977,985,N/A,69,0
39,N/A,N/A,N/A,938,977,N/A,75,6
10,N/A,N/A,N/A,928,938,N/A,78,3
33,N/A,N/A,N/A,895,928,N/A,81,6
8,N/A,N/A,N/A,887,895,N/A,87,0
20,N/A,N/A,N/A,867,887,N/A,91,4
9,N/A,N/A,N/A,858,867,N/A,95,2
9,N/A,N/A,N/A,849,858,N/A,101,2
25,N/A,N/A,N/A,824,849,N/A,104,5
37,N/A,N/A,N/A,787,824,N/A,110,5
8,N/A,N/A,N/A,779,787,N/A,114,3
39,N/A,N/A,N/A,740,779,N/A,117,6
9,N/A,N/A,N/A,731,740,N/A,123,0
37,N/A,N/A,N/A,694,731,N/A,128,5
10,N/A,N/A,N/A,684,694,N/A,132,3
9,N/A,N/A,N/A,675,684,N/A,138,3
19,N/A,N/A,N/A,1745,1764,N/A,4,4
7,N/A,N/A,N/A,1738,1745,N/A,7,1
21,N/A,N/A,N/A,1717,1738,N/A,10,4
27,N/A,N/A,N/A,1690,1717,N/A,16,4
11,N/A,N/A,N/A,1679,1690,N/A,21,3
10,N/A,N/A,N/A,1669,1679,N/A,27,3
5,N/A,N/A,N/A,1664,1669,N/A,31,1
18,N/A,N/A,N/A,1646,1664,N/A,34,4
26,N/A,N/A,N/A,1620,1646,N/A,40,4
8,N/A,N/A,N/A,1612,1620,N/A,45,3
33,N/A,N/A,N/A,1579,1612,N/A,48,6
23,N/A,N/A,N/A,1556,1579,N/A,52,4
22,N/A,N/A,N/A,1534,1556,N/A,58,4
19,N/A,N/A,N/A,1515,1534,N/A,64,4
14,N/A,N/A,N/A,1501,1515,N/A,70,4
11,N/A,N/A,N/A,1490,1501,N/A,74,2
7,N/A,N/A,N/A,1483,1490,N/A,80,2
7,N/A,N/A,N/A,1476,1483,N/A,86,2
8,N/A,N/A,N/A,1468,1476,N/A,92,2
9,N/A,N/A,N/A,1459,1468,N/A,98,2
9,N/A,N/A,N/A,1450,1459,N/A,104,2
9,N/A,N/A,N/A,1441,1450,N/A,110,2
8,N/A,N/A,N/A,1433,1441,N/A,116,2
34,N/A,N/A,N/A,1399,1433,N/A,120,6
36,N/A,N/A,N/A,1363,1399,N/A,125,5
24,N/A,N/A,N/A,1339,1363,N/A,130,4
8,N/A,N/A,N/A,1331,1339,N/A,133,1
21,N/A,N/A,N/A,1310,1331,N/A,136,4
8,N/A,N/A,N/A,1302,1310,N/A,139,1
10,N/A,N/A,N/A,1292,1302,N/A,142,4
9,N/A,N/A,N/A,889,898,N/A,6,1
20,N/A,N/A,N/A,869,889,N/A,9,4
22,N/A,N/A,N/A,847,869,N/A,15,4
9,N/A,N/A,N/A,838,847,N/A,19,2
8,N/A,N/A,N/A,830,838,N/A,24,1
35,N/A,N/A,N/A,795,830,N/A,28,5
9,N/A,N/A,N/A,786,795,N/A,31,2
26,N/A,N/A,N/A,760,786,N/A,35,6
19,N/A,N/A,N/A,741,760,N/A,39,4
7,N/A,N/A,N/A,734,741,N/A,44,3
9,N/A,N/A,N/A,725,734,N/A,48,1
26,N/A,N/A,N/A,699,725,N/A,51,4
7,N/A,N/A,N/A,692,699,N/A,54,1
28,N/A,N/A,N/A,664,692,N/A,58,5
8,N/A,N/A,N/A,656,664,N/A,62,3
7,N/A,N/A,N/A,649,656,N/A,67,2
7,N/A,N/A,N/A,642,649,N/A,73,2
7,N/A,N/A,N/A,635,642,N/A,79,2
6,N/A,N/A,N/A,629,635,N/A,84,1
5,N/A,N/A,N/A,624,629,N/A,90,1
9,N/A,N/A,N/A,615,624,N/A,96,1
18,N/A,N/A,N/A,597,615,N/A,99,4
7,N/A,N/A,N/A,590,597,N/A,104,3
41,N/A,N/A,N/A,549,590,N/A,107,6
8,N/A,N/A,N/A,541,549,N/A,110,3
10,N/A,N/A,N/A,531,541,N/A,116,3
8,N/A,N/A,N/A,523,531,N/A,121,2
8,N/A,N/A,N/A,515,523,N/A,127,2
32,N/A,N/A,N/A,483,515,N/A,130,5
11,N/A,N/A,N/A,472,483,N/A,134,3
7,N/A,N/A,N/A,685,692,N/A,6,1
45,N/A,N/A,N/A,640,685,N/A,10,5
10,N/A,N/A,N/A,630,640,N/A,13,2
11,N/A,N/A,N/A,619,630,N/A,19,2
38,N/A,N/A,N/A,581,619,N/A,23,6
7,N/A,N/A,N/A,574,581,N/A,29,0
7,N/A,N/A,N/A,567,574,N/A,32,3
9,N/A,N/A,N/A,558,567,N/A,36,1
38,N/A,N/A,N/A,520,558,N/A,40,5
9,N/A,N/A,N/A,511,520,N/A,43,2
8,N/A,N/A,N/A,503,511,N/A,49,2
30,N/A,N/A,N/A,473,503,N/A,53,6
8,N/A,N/A,N/A,465,473,N/A,56,3
9,N/A,N/A,N/A,456,465,N/A,62,3
7,N/A,N/A,N/A,449,456,N/A,67,2
9,N/A,N/A,N/A,440,449,N/A,72,1
23,N/A,N/A,N/A,417,440,N/A,75,4
12,N/A,N/A,N/A,405,417,N/A,81,4
27,N/A,N/A,N/A,378,405,N/A,87,4
7,N/A,N/A,N/A,371,378,N/A,92,3
25,N/A,N/A,N/A,346,371,N/A,95,6
6,N/A,N/A,N/A,340,346,N/A,101,0
14,N/A,N/A,N/A,326,340,N/A,105,4
7,N/A,N/A,N/A,319,326,N/A,110,3
7,N/A,N/A,N/A,312,319,N/A,114,1
32,N/A,N/A,N/A,280,312,N/A,118,5
21,N/A,N/A,N/A,259,280,N/A,123,4
8,N/A,N/A,N/A,251,259,N/A,127,2
10,N/A,N/A,N/A,241,251,N/A,133,2
33,N/A,N/A,N/A,208,241,N/A,136,5
10,N/A,N/A,N/A,1798,1808,N/A,3,3
7,N/A,N/A,N/A,1791,1798,N/A,8,2
35,N/A,N/A,N/A,1756,1791,N/A,11,5
10,N/A,N/A,N/A,1746,1756,N/A,15,3
9,N/A,N/A,N/A,1737,1746,N/A,19,1
46,N/A,N/A,N/A,1691,1737,N/A,23,5
16,N/A,N/A,N/A,1675,1691,N/A,28,4
20,N/A,N/A,N/A,1655,1675,N/A,34,4
26,N/A,N/A,N/A,1629,1655,N/A,40,4
10,N/A,N/A,N/A,1619,1629,N/A,44,2
33,N/A,N/A,N/A,1586,1619,N/A,48,6
7,N/A,N/A,N/A,1579,1586,N/A,51,3
8,N/A,N/A,N/A,1571,1579,N/A,56,2
27,N/A,N/A,N/A,1544,1571,N/A,60,6
9,N/A,N/A,N/A,1535,1544,N/A,63,3
11,N/A,N/A,N/A,1524,1535,N/A,69,3
7,N/A,N/A,N/A,1517,1524,N/A,74,2
29,N/A,N/A,N/A,1488,1517,N/A,78,6
30,N/A,N/A,N/A,1458,1488,N/A,83,5
8,N/A,N/A,N/A,1450,1458,N/A,87,3
10,N/A,N/A,N/A,1440,1450,N/A,93,3
6,N/A,N/A,N/A,1434,1440,N/A,97,1
19,N/A,N/A,N/A,1415,1434,N/A,100,4
8,N/A,N/A,N/A,1407,1415,N/A,103,1
7,N/A,N/A,N/A,1400,1407,N/A,109,1
5,N/A,N/A,N/A,1395,1400,N/A,115,1
46,N/A,N/A,N/A,1349,1395,N/A,120,6
11,N/A,N/A,N/A,1338,1349,N/A,123,3
8,N/A,N/A,N/A,1330,1338,N/A,128,2
48,N/A,N/A,N/A,1282,1330,N/A,132,6
8,N/A,N/A,N/A,1063,1071,N/A,5,3
7,N/A,N/A,N/A,1056,1063,N/A,10,2
9,N/A,N/A,N/A,1047,1056,N/A,15,1
46,N/A,N/A,N/A,1001,1047,N/A,19,5
23,N/A,N/A,N/A,978,1001,N/A,24,4
21,N/A,N/A,N/A,957,978,N/A,30,4
11,N/A,N/A,N/A,946,957,N/A,34,2
9,N/A,N/A,N/A,937,946,N/A,39,1
7,N/A,N/A,N/A,930,937,N/A,45,1
19,N/A,N/A,N/A,911,930,N/A,48,4
8,N/A,N/A,N/A,903,911,N/A,51,1
27,N/A,N/A,N/A,876,903,N/A,54,4
5,N/A,N/A,N/A,871,876,N/A,57,1
36,N/A,N/A,N/A,835,871,N/A,61,5
10,N/A,N/A,N/A,825,835,N/A,66,4
9,N/A,N/A,N/A,816,825,N/A,69,1
42,N/A,N/A,N/A,774,816,N/A,74,6
5,N/A,N/A,N/A,769,774,N/A,80,0
8,N/A,N/A,N/A,761,769,N/A,83,3
9,N/A,N/A,N/A,752,761,N/A,89,3
7,N/A,N/A,N/A,745,752,N/A,93,1
27,N/A,N/A,N/A,718,745,N/A,97,5
10,N/A,N/A,N/A,708,718,N/A,100,2
10,N/A,N/A,N/A,698,708,N/A,106,2
5,N/A,N/A,N/A,693,698,N/A,111,1
13,N/A,N/A,N/A,680,693,N/A,114,4
22,N/A,N/A,N/A,658,680,N/A,120,4
8,N/A,N/A,N/A,650,658,N/A,125,3
36,N/A,N/A,N/A,614,650,N/A,128,6
23,N/A,N/A,N/A,591,614,N/A,132,4
30,N/A,N/A,N/A,1533,1563,N/A,3,5
7,N/A,N/A,N/A,1526,1533,N/A,6,2
47,N/A,N/A,N/A,1479,1526,N/A,9,5
28,N/A,N/A,N/A,1451,1479,N/A,14,4
7,N/A,N/A,N/A,1444,1451,N/A,18,2
49,N/A,N/A,N/A,1395,1444,N/A,21,5
13,N/A,N/A,N/A,1382,1395,N/A,26,4
8,N/A,N/A,N/A,1374,1382,N/A,31,3
25,N/A,N/A,N/A,1349,1374,N/A,34,6
40,N/A,N/A,N/A,1309,1349,N/A,39,5
8,N/A,N/A,N/A,1301,1309,N/A,43,3
33,N/A,N/A,N/A,1268,1301,N/A,46,6
41,N/A,N/A,N/A,1227,1268,N/A,51,5
9,N/A,N/A,N/A,1218,1227,N/A,55,3
7,N/A,N/A,N/A,1211,1218,N/A,60,2
8,N/A,N/A,N/A,1203,1211,N/A,66,2
7,N/A,N/A,N/A,1196,1203,N/A,71,1
6,N/A,N/A,N/A,1190,1196,N/A,77,1
33,N/A,N/A,N/A,1157,1190,N/A,81,5
11,N/A,N/A,N/A,1146,1157,N/A,85,3
48,N/A,N/A,N/A,1098,1146,N/A,88,6
24,N/A,N/A,N/A,1074,1098,N/A,92,4
10,N/A,N/A,N/A,1064,1074,N/A,97,3
36,N/A,N/A,N/A,1028,1064,N/A,100,6
6,N/A,N/A,N/A,1022,1028,N/A,106,0
41,N/A,N/A,N/A,981,1022,N/A,111,5
11,N/A,N/A,N/A,970,981,N/A,114,2
29,N/A,N/A,N/A,941,970,N/A,117,5
10,N/A,N/A,N/A,931,941,N/A,121,3
7,N/A,N/A,N/A,924,931,N/A,127,3
8,N/A,N/A,N/A,1675,1683,N/A,3,2
8,N/A,N/A,N/A,1667,1675,N/A,9,2
8,N/A,N/A,N/A,1659,1667,N/A,15,2
32,N/A,N/A,N/A,1627,1659,N/A,18,5
8,N/A,N/A,N/A,1619,1627,N/A,22,3
9,N/A,N/A,N/A,1610,1619,N/A,26,1
25,N/A,N/A,N/A,1585,1610,N/A,29,4
7,N/A,N/A,N/A,1578,1585,N/A,33,2
9,N/A,N/A,N/A,1569,1578,N/A,38,1
36,N/A,N/A,N/A,1533,1569,N/A,43,6
23,N/A,N/A,N/A,1510,1533,N/A,47,4
6,N/A,N/A,N/A,1504,1510,N/A,50,1
27,N/A,N/A,N/A,1477,1504,N/A,54,5
10,N/A,N/A,N/A,1467,1477,N/A,58,3
9,N/A,N/A,N/A,1458,1467,N/A,62,1
27,N/A,N/A,N/A,1431,1458,N/A,65,4
27,N/A,N/A,N/A,1404,1431,N/A,71,4
10,N/A,N/A,N/A,1394,1404,N/A,76,3
43,N/A,N/A,N/A,1351,1394,N/A,79,6
44,N/A,N/A,N/A,1307,1351,N/A,84,5
8,N/A,N/A,N/A,1299,1307,N/A,88,3
9,N/A,N/A,N/A,1290,1299,N/A,94,3
25,N/A,N/A,N/A,1265,1290,N/A,97,6
5,N/A,N/A,N/A,1260,1265,N/A,103,0
10,N/A,N/A,N/A,1250,1260,N/A,106,3
7,N/A,N/A,N/A,1243,1250,N/A,112,3
7,N/A,N/A,N/A,1236,1243,N/A,116,1
15,N/A,N/A,N/A,1221,1236,N/A,119,4
22,N/A,N/A,N/A,1199,1221,N/A,125,4
11,N/A,N/A,N/A,1188,1199,N/A,131,4
10,N/A,N/A,N/A,1552,1562,N/A,4,2
40,N/A,N/A,N/A,1512,1552,N/A,8,6
10,N/A,N/A,N/A,1502,1512,N/A,11,3
8,N/A,N/A,N/A,1494,1502,N/A,15,1
34,N/A,N/A,N/A,1460,1494,N/A,20,6
5,N/A,N/A,N/A,1455,1460,N/A,26,0
16,N/A,N/A,N/A,1439,1455,N/A,30,4
11,N/A,N/A,N/A,1428,1439,N/A,36,4
8,N/A,N/A,N/A,1420,1428,N/A,41,3
7,N/A,N/A,N/A,1413,1420,N/A,47,3
8,N/A,N/A,N/A,1405,1413,N/A,51,1
31,N/A,N/A,N/A,1374,1405,N/A,55,5
8,N/A,N/A,N/A,1366,1374,N/A,58,2
34,N/A,N/A,N/A,1332,1366,N/A,62,6
41,N/A,N/A,N/A,1291,1332,N/A,67,5
23,N/A,N/A,N/A,1268,1291,N/A,72,4
10,N/A,N/A,N/A,1258,1268,N/A,77,3
11,N/A,N/A,N/A,1247,1258,N/A,83,3
11,N/A,N/A,N/A,1236,1247,N/A,88,2
7,N/A,N/A,N/A,1229,1236,N/A,94,2
46,N/A,N/A,N/A,1183,1229,N/A,97,5
8,N/A,N/A,N/A,1175,1183,N/A,100,2
11,N/A,N/A,N/A,1164,1175,N/A,106,2
44,N/A,N/A,N/A,1120,1164,N/A,109,5
46,N/A,N/A,N/A,1074,1120,N/A,115,5
11,N/A,N/A,N/A,1063,1074,N/A,119,3
7,N/A,N/A,N/A,1056,1063,N/A,124,2
7,N/A,N/A,N/A,1049,1056,N/A,130,2
9,N/A,N/A,N/A,1040,1049,N/A,135,1
6,N/A,N/A,N/A,1034,1040,N/A,141,1
7,N/A,N/A,N/A,1921,1928,N/A,3,3
26,N/A,N/A,N/A,1895,1921,N/A,6,6
11,N/A,N/A,N/A,1884,1895,N/A,9,3
37,N/A,N/A,N/A,1847,1884,N/A,12,6
31,N/A,N/A,N/A,1816,1847,N/A,17,5
10,N/A,N/A,N/A,1806,1816,N/A,21,3
49,N/A,N/A,N/A,1757,1806,N/A,24,6
8,N/A,N/A,N/A,1749,1757,N/A,27,3
9,N/A,N/A,N/A,1740,1749,N/A,32,2
7,N/A,N/A,N/A,1733,1740,N/A,37,1
31,N/A,N/A,N/A,1702,1733,N/A,41,5
18,N/A,N/A,N/A,1684,1702,N/A,46,4
10,N/A,N/A,N/A,1674,1684,N/A,51,3
7,N/A,N/A,N/A,1667,1674,N/A,56,2
49,N/A,N/A,N/A,1618,1667,N/A,59,5
7,N/A,N/A,N/A,1611,1618,N/A,62,2
9,N/A,N/A,N/A,1602,1611,N/A,67,1
42,N/A,N/A,N/A,1560,1602,N/A,71,5
7,N/A,N/A,N/A,1553,1560,N/A,75,3
10,N/A,N/A,N/A,1543,1553,N/A,80,2
9,N/A,N/A,N/A,1534,1543,N/A,85,1
40,N/A,N/A,N/A,1494,1534,N/A,89,5
12,N/A,N/A,N/A,1482,1494,N/A,94,4
7,N/A,N/A,N/A,1475,1482,N/A,97,1
16,N/A,N/A,N/A,1459,1475,N/A,100,4
7,N/A,N/A,N/A,1452,1459,N/A,104,2
36,N/A,N/A,N/A,1416,1452,N/A,108,6
25,N/A,N/A,N/A,1391,1416,N/A,113,5
10,N/A,N/A,N/A,1381,1391,N/A,117,3
39,N/A,N/A,N/A,1342,1381,N/A,120,6
31,N/A,N/A,N/A,560,591,N/A,3,6
12,N/A,N/A,N/A,548,560,N/A,7,4
27,N/A,N/A,N/A,521,548,N/A,13,4
9,N/A,N/A,N/A,512,521,N/A,17,2
45,N/A,N/A,N/A,467,512,N/A,21,6
6,N/A,N/A,N/A,461,467,N/A,27,0
34,N/A,N/A,N/A,427,461,N/A,33,6
7,N/A,N/A,N/A,420,427,N/A,39,0
7,N/A,N/A,N/A,413,420,N/A,42,3
37,N/A,N/A,N/A,376,413,N/A,45,6
28,N/A,N/A,N/A,348,376,N/A,50,5
48,N/A,N/A,N/A,300,348,N/A,56,5
10,N/A,N/A,N/A,290,300,N/A,59,2
43,N/A,N/A,N/A,247,290,N/A,63,6
35,N/A,N/A,N/A,212,247,N/A,68,5
9,N/A,N/A,N/A,203,212,N/A,72,3
11,N/A,N/A,N/A,192,203,N/A,77,2
6,N/A,N/A,N/A,186,192,N/A,82,1
32,N/A,N/A,N/A,154,186,N/A,86,5
10,N/A,N/A,N/A,144,154,N/A,90,3
7,N/A,N/A,N/A,137,144,N/A,96,3
34,N/A,N/A,N/A,103,137,N/A,99,6
34,N/A,N/A,N/A,69,103,N/A,104,5
10,N/A,N/A,N/A,59,69,N/A,107,2
37,N/A,N/A,N/A,22,59,N/A,110,5
8,N/A,N/A,N/A,14,22,N/A,113,2
9,N/A,N/A,N/A,5,14,N/A,118,1
36,N/A,N/A,N/A,-31,5,N/A,122,5
7,N/A,N/A,N/A,749,756,N/A,5,1
39,N/A,N/A,N/A,710,749,N/A,10,6
9,N/A,N/A,N/A,701,710,N/A,13,3
34,N/A,N/A,N/A,667,701,N/A,16,6
8,N/A,N/A,N/A,659,667,N/A,19,3
33,N/A,N/A,N/A,626,659,N/A,22,6
8,N/A,N/A,N/A,618,626,N/A,28,0
11,N/A,N/A,N/A,607,618,N/A,31,3
10,N/A,N/A,N/A,597,607,N/A,37,3
25,N/A,N/A,N/A,572,597,N/A,40,6
32,N/A,N/A,N/A,540,572,N/A,45,5
14,N/A,N/A,N/A,526,540,N/A,50,4
9,N/A,N/A,N/A,517,526,N/A,54,2
9,N/A,N/A,N/A,508,517,N/A,59,1
43,N/A,N/A,N/A,465,508,N/A,63,5
8,N/A,N/A,N/A,457,465,N/A,67,3
46,N/A,N/A,N/A,411,457,N/A,70,6
7,N/A,N/A,N/A,404,411,N/A,76,0
25,N/A,N/A,N/A,379,404,N/A,80,4
22,N/A,N/A,N/A,357,379,N/A,86,4
11,N/A,N/A,N/A,346,357,N/A,90,2
30,N/A,N/A,N/A,316,346,N/A,93,5
19,N/A,N/A,N/A,297,316,N/A,98,4
8,N/A,N/A,N/A,289,297,N/A,101,1
25,N/A,N/A,N/A,264,289,N/A,105,5
11,N/A,N/A,N/A,253,264,N/A,109,3
8,N/A,N/A,N/A,245,253,N/A,113,1
31,N/A,N/A,N/A,214,245,N/A,118,6
7,N/A,N/A,N/A,207,214,N/A,124,0
10,N/A,N/A,N/A,197,207,N/A,128,4
19,N/A,N/A,N/A,648,667,N/A,4,4
7,N/A,N/A,N/A,641,648,N/A,9,3
7,N/A,N/A,N/A,634,641,N/A,14,2
36,N/A,N/A,N/A,598,634,N/A,17,5
22,N/A,N/A,N/A,576,598,N/A,22,4
18,N/A,N/A,N/A,558,576,N/A,28,4
19,N/A,N/A,N/A,539,558,N/A,34,4
11,N/A,N/A,N/A,528,539,N/A,39,3
10,N/A,N/A,N/A,518,528,N/A,44,2
8,N/A,N/A,N/A,510,518,N/A,49,1
8,N/A,N/A,N/A,502,510,N/A,55,1
9,N/A,N/A,N/A,493,502,N/A,61,1
9,N/A,N/A,N/A,484,493,N/A,67,1
28,N/A,N/A,N/A,456,484,N/A,71,5
10,N/A,N/A,N/A,446,456,N/A,75,3
30,N/A,N/A,N/A,416,446,N/A,78,6
8,N/A,N/A,N/A,408,416,N/A,81,3
11,N/A,N/A,N/A,397,408,N/A,86,2
43,N/A,N/A,N/A,354,397,N/A,90,6
29,N/A,N/A,N/A,325,354,N/A,94,4
10,N/A,N/A,N/A,315,325,N/A,98,2
7,N/A,N/A,N/A,308,315,N/A,103,1
10,N/A,N/A,N/A,298,308,N/A,106,4
9,N/A,N/A,N/A,289,298,N/A,109,1
36,N/A,N/A,N/A,253,289,N/A,114,6
29,N/A,N/A,N/A,224,253,N/A,119,5
38,N/A,N/A,N/A,186,224,N/A,125,5
11,N/A,N/A,N/A,175,186,N/A,128,2
36,N/A,N/A,N/A,139,175,N/A,132,6
11,N/A,N/A,N/A,128,139,N/A,136,4
35,N/A,N/A,N/A,1659,1694,N/A,6,6
8,N/A,N/A,N/A,1651,1659,N/A,9,3
49,N/A,N/A,N/A,1602,1651,N/A,12,6
34,N/A,N/A,N/A,1568,1602,N/A,17,5
7,N/A,N/A,N/A,1561,1568,N/A,20,2
7,N/A,N/A,N/A,1554,1561,N/A,25,1
36,N/A,N/A,N/A,1518,1554,N/A,29,5
15,N/A,N/A,N/A,1503,1518,N/A,34,4
6,N/A,N/A,N/A,1497,1503,N/A,37,1
23,N/A,N/A,N/A,1474,1497,N/A,40,4
9,N/A,N/A,N/A,1465,1474,N/A,45,3
6,N/A,N/A,N/A,1459,1465,N/A,49,1
30,N/A,N/A,N/A,1429,1459,N/A,54,6
27,N/A,N/A,N/A,1402,1429,N/A,58,4
8,N/A,N/A,N/A,1394,1402,N/A,62,2
8,N/A,N/A,N/A,1386,1394,N/A,68,2
8,N/A,N/A,N/A,1378,1386,N/A,74,2
8,N/A,N/A,N/A,1370,1378,N/A,80,2
28,N/A,N/A,N/A,1342,1370,N/A,84,6
11,N/A,N/A,N/A,1331,1342,N/A,87,3
30,N/A,N/A,N/A,1301,1331,N/A,90,6
11,N/A,N/A,N/A,1290,1301,N/A,93,3
7,N/A,N/A,N/A,1283,1290,N/A,99,3
27,N/A,N/A,N/A,1256,1283,N/A,102,6
10,N/A,N/A,N/A,1246,1256,N/A,106,4
7,N/A,N/A,N/A,1239,1246,N/A,111,3
9,N/A,N/A,N/A,1230,1239,N/A,115,1
37,N/A,N/A,N/A,1193,1230,N/A,120,6
29,N/A,N/A,N/A,1164,1193,N/A,125,5
36,N/A,N/A,N/A,1128,1164,N/A,131,5
47,N/A,N/A,N/A,1015,1062,N/A,4,5
7,N/A,N/A,N/A,1008,1015,N/A,8,3
31,N/A,N/A,N/A,977,1008,N/A,11,6
8,N/A,N/A,N/A,969,977,N/A,14,3
47,N/A,N/A,N/A,922,969,N/A,17,6
19,N/A,N/A,N/A,903,922,N/A,21,4
9,N/A,N/A,N/A,894,903,N/A,24,1
28,N/A,N/A,N/A,866,894,N/A,29,6
7,N/A,N/A,N/A,859,866,N/A,35,0
45,N/A,N/A,N/A,814,859,N/A,40,5
28,N/A,N/A,N/A,786,814,N/A,45,4
5,N/A,N/A,N/A,781,786,N/A,48,1
32,N/A,N/A,N/A,749,781,N/A,53,6
10,N/A,N/A,N/A,739,749,N/A,56,3
33,N/A,N/A,N/A,706,739,N/A,59,6
24,N/A,N/A,N/A,682,706,N/A,63,4
20,N/A,N/A,N/A,662,682,N/A,69,4
11,N/A,N/A,N/A,651,662,N/A,74,3
5,N/A,N/A,N/A,646,651,N/A,78,1
18,N/A,N/A,N/A,628,646,N/A,81,4
10,N/A,N/A,N/A,618,628,N/A,85,2
11,N/A,N/A,N/A,607,618,N/A,91,2
44,N/A,N/A,N/A,563,607,N/A,94,5
9,N/A,N/A,N/A,554,563,N/A,97,2
5,N/A,N/A,N/A,549,554,N/A,102,1
18,N/A,N/A,N/A,531,549,N/A,105,4
15,N/A,N/A,N/A,516,531,N/A,111,4
28,N/A,N/A,N/A,488,516,N/A,117,4
19,N/A,N/A,N/A,469,488,N/A,123,4
27,N/A,N/A,N/A,442,469,N/A,129,4
11,N/A,N/A,N/A,588,599,N/A,4,2
45,N/A,N/A,N/A,543,588,N/A,7,5
16,N/A,N/A,N/A,527,543,N/A,12,4
9,N/A,N/A,N/A,518,527,N/A,17,3
9,N/A,N/A,N/A,509,518,N/A,23,3
27,N/A,N/A,N/A,482,509,N/A,26,6
11,N/A,N/A,N/A,471,482,N/A,29,3
25,N/A,N/A,N/A,446,471,N/A,32,6
39,N/A,N/A,N/A,407,446,N/A,37,5
39,N/A,N/A,N/A,368,407,N/A,43,5
10,N/A,N/A,N/A,358,368,N/A,46,2
8,N/A,N/A,N/A,350,358,N/A,52,2
6,N/A,N/A,N/A,344,350,N/A,57,1
10,N/A,N/A,N/A,334,344,N/A,60,4
7,N/A,N/A,N/A,327,334,N/A,63,1
26,N/A,N/A,N/A,301,327,N/A,67,5
43,N/A,N/A,N/A,258,301,N/A,73,5
10,N/A,N/A,N/A,248,258,N/A,76,2
7,N/A,N/A,N/A,241,248,N/A,82,2
8,N/A,N/A,N/A,233,241,N/A,87,1
35,N/A,N/A,N/A,198,233,N/A,91,5
11,N/A,N/A,N/A,187,198,N/A,96,4
11,N/A,N/A,N/A,176,187,N/A,100,2
5,N/A,N/A,N/A,171,176,N/A,105,1
42,N/A,N/A,N/A,129,171,N/A,109,5
9,N/A,N/A,N/A,120,129,N/A,112,2
9,N/A,N/A,N/A,111,120,N/A,117,1
34,N/A,N/A,N/A,77,111,N/A,121,5
8,N/A,N/A,N/A,69,77,N/A,124,2
27,N/A,N/A,N/A,42,69,N/A,128,6
22,N/A,N/A,N/A,1409,1431,N/A,6,4
7,N/A,N/A,N/A,1402,1409,N/A,10,2
35,N/A,N/A,N/A,1367,1402,N/A,14,6
24,N/A,N/A,N/A,1343,1367,N/A,18,4
11,N/A,N/A,N/A,1332,1343,N/A,23,3
11,N/A,N/A,N/A,1321,1332,N/A,28,2
7,N/A,N/A,N/A,1314,1321,N/A,34,2
42,N/A,N/A,N/A,1272,1314,N/A,37,5
39,N/A,N/A,N/A,1233,1272,N/A,43,5
9,N/A,N/A,N/A,1224,1233,N/A,46,2
44,N/A,N/A,N/A,1180,1224,N/A,49,5
11,N/A,N/A,N/A,1169,1180,N/A,53,3
11,N/A,N/A,N/A,1158,1169,N/A,59,3
29,N/A,N/A,N/A,1129,1158,N/A,62,6
5,N/A,N/A,N/A,1124,1129,N/A,68,0
21,N/A,N/A,N/A,1103,1124,N/A,72,4
8,N/A,N/A,N/A,1095,1103,N/A,77,3
9,N/A,N/A,N/A,1086,1095,N/A,82,2
26,N/A,N/A,N/A,1060,1086,N/A,85,5
14,N/A,N/A,N/A,1046,1060,N/A,90,4
8,N/A,N/A,N/A,1038,1046,N/A,93,1
43,N/A,N/A,N/A,995,1038,N/A,98,6
21,N/A,N/A,N/A,974,995,N/A,102,4
9,N/A,N/A,N/A,965,974,N/A,107,3
11,N/A,N/A,N/A,954,965,N/A,112,2
6,N/A,N/A,N/A,948,954,N/A,117,1
49,N/A,N/A,N/A,899,948,N/A,122,6
46,N/A,N/A,N/A,853,899,N/A,127,5
27,N/A,N/A,N/A,826,853,N/A,132,4
6,N/A,N/A,N/A,820,826,N/A,135,1
8,N/A,N/A,N/A,709,717,N/A,6,3
10,N/A,N/A,N/A,699,709,N/A,11,2
10,N/A,N/A,N/A,689,699,N/A,17,2
43,N/A,N/A,N/A,646,689,N/A,20,5
21,N/A,N/A,N/A,625,646,N/A,25,4
9,N/A,N/A,N/A,616,625,N/A,29,2
10,N/A,N/A,N/A,606,616,N/A,35,2
7,N/A,N/A,N/A,599,606,N/A,41,2
44,N/A,N/A,N/A,555,599,N/A,45,6
46,N/A,N/A,N/A,509,555,N/A,50,5
25,N/A,N/A,N/A,484,509,N/A,55,4
11,N/A,N/A,N/A,473,484,N/A,61,4
8,N/A,N/A,N/A,465,473,N/A,65,2
29,N/A,N/A,N/A,436,465,N/A,69,6
14,N/A,N/A,N/A,422,436,N/A,73,4
9,N/A,N/A,N/A,413,422,N/A,78,3
10,N/A,N/A,N/A,403,413,N/A,84,3
9,N/A,N/A,N/A,394,403,N/A,89,2
36,N/A,N/A,N/A,358,394,N/A,92,5
37,N/A,N/A,N/A,321,358,N/A,98,5
36,N/A,N/A,N/A,285,321,N/A,104,5
7,N/A,N/A,N/A,278,285,N/A,107,2
44,N/A,N/A,N/A,234,278,N/A,111,6
21,N/A,N/A,N/A,213,234,N/A,115,4
7,N/A,N/A,N/A,206,213,N/A,119,2
11,N/A,N/A,N/A,195,206,N/A,125,2
47,N/A,N/A,N/A,148,195,N/A,128,5
11,N/A,N/A,N/A,137,148,N/A,131,2
5,N/A,N/A,N/A,132,137,N/A,136,1
28,N/A,N/A,N/A,104,132,N/A,140,5
7,N/A,N/A,N/A,1722,1729,N/A,3,2
46,N/A,N/A,N/A,1676,1722,N/A,6,5
22,N/A,N/A,N/A,1654,1676,N/A,11,4
6,N/A,N/A,N/A,1648,1654,N/A,14,1
9,N/A,N/A,N/A,1639,1648,N/A,20,1
33,N/A,N/A,N/A,1606,1639,N/A,25,6
29,N/A,N/A,N/A,1577,1606,N/A,30,5
19,N/A,N/A,N/A,1558,1577,N/A,35,4
27,N/A,N/A,N/A,1531,1558,N/A,41,4
15,N/A,N/A,N/A,1516,1531,N/A,47,4
8,N/A,N/A,N/A,1508,1516,N/A,50,1
44,N/A,N/A,N/A,1464,1508,N/A,55,6
5,N/A,N/A,N/A,1459,1464,N/A,61,0
42,N/A,N/A,N/A,1417,1459,N/A,66,5
41,N/A,N/A,N/A,1376,1417,N/A,72,5
22,N/A,N/A,N/A,1354,1376,N/A,77,4
10,N/A,N/A,N/A,1344,1354,N/A,83,4
7,N/A,N/A,N/A,1337,1344,N/A,87,2
46,N/A,N/A,N/A,1291,1337,N/A,90,5
10,N/A,N/A,N/A,1281,1291,N/A,94,3
30,N/A,N/A,N/A,1251,1281,N/A,97,6
14,N/A,N/A,N/A,1237,1251,N/A,101,4
13,N/A,N/A,N/A,1224,1237,N/A,107,4
8,N/A,N/A,N/A,1216,1224,N/A,111,2
6,N/A,N/A,N/A,1210,1216,N/A,116,1
33,N/A,N/A,N/A,1177,1210,N/A,121,6
29,N/A,N/A,N/A,1148,1177,N/A,126,5
10,N/A,N/A,N/A,1138,1148,N/A,130,3
46,N/A,N/A,N/A,1092,1138,N/A,133,6
27,N/A,N/A,N/A,1065,1092,N/A,137,4
8,N/A,N/A,N/A,1159,1167,N/A,3,1
9,N/A,N/A,N/A,1150,1159,N/A,9,1
7,N/A,N/A,N/A,1143,1150,N/A,15,1
47,N/A,N/A,N/A,1096,1143,N/A,20,6
7,N/A,N/A,N/A,1089,1096,N/A,23,3
5,N/A,N/A,N/A,1084,1089,N/A,27,1
38,N/A,N/A,N/A,1046,1084,N/A,32,6
39,N/A,N/A,N/A,1007,1046,N/A,37,5
16,N/A,N/A,N/A,991,1007,N/A,42,4
9,N/A,N/A,N/A,982,991,N/A,47,3
9,N/A,N/A,N/A,973,982,N/A,53,3
8,N/A,N/A,N/A,965,973,N/A,57,1
11,N/A,N/A,N/A,954,965,N/A,60,4
8,N/A,N/A,N/A,946,954,N/A,65,3
8,N/A,N/A,N/A,938,946,N/A,69,1
9,N/A,N/A,N/A,929,938,N/A,75,1
28,N/A,N/A,N/A,901,929,N/A,80,6
9,N/A,N/A,N/A,892,901,N/A,83,3
11,N/A,N/A,N/A,881,892,N/A,88,2
5,N/A,N/A,N/A,876,881,N/A,93,1
37,N/A,N/A,N/A,839,876,N/A,98,6
9,N/A,N/A,N/A,830,839,N/A,101,3
10,N/A,N/A,N/A,820,830,N/A,106,2
8,N/A,N/A,N/A,812,820,N/A,111,1
9,N/A,N/A,N/A,803,812,N/A,117,1
40,N/A,N/A,N/A,763,803,N/A,122,6
9,N/A,N/A,N/A,754,763,N/A,125,3
7,N/A,N/A,N/A,747,754,N/A,130,2
39,N/A,N/A,N/A,708,747,N/A,133,5
24,N/A,N/A,N/A,684,708,N/A,138,4
13,N/A,N/A,N/A,451,464,N/A,5,4
7,N/A,N/A,N/A,444,451,N/A,8,1
21,N/A,N/A,N/A,423,444,N/A,11,4
29,N/A,N/A,N/A,394,423,N/A,17,4
10,N/A,N/A,N/A,384,394,N/A,21,2
29,N/A,N/A,N/A,355,384,N/A,24,5
10,N/A,N/A,N/A,345,355,N/A,28,3
5,N/A,N/A,N/A,340,345,N/A,32,1
29,N/A,N/A,N/A,311,340,N/A,36,5
28,N/A,N/A,N/A,283,311,N/A,42,5
23,N/A,N/A,N/A,260,283,N/A,47,4
26,N/A,N/A,N/A,234,260,N/A,53,4
7,N/A,N/A,N/A,227,234,N/A,57,2
31,N/A,N/A,N/A,196,227,N/A,61,6
38,N/A,N/A,N/A,158,196,N/A,66,5
22,N/A,N/A,N/A,136,158,N/A,71,4
6,N/A,N/A,N/A,130,136,N/A,74,1
34,N/A,N/A,N/A,96,130,N/A,78,5
43,N/A,N/A,N/A,53,96,N/A,84,5
22,N/A,N/A,N/A,31,53,N/A,89,4
11,N/A,N/A,N/A,20,31,N/A,95,4
6,N/A,N/A,N/A,14,20,N/A,98,1
26,N/A,N/A,N/A,-12,14,N/A,103,6
37,N/A,N/A,N/A,1199,1236,N/A,6,5
11,N/A,N/A,N/A,1188,1199,N/A,10,3
28,N/A,N/A,N/A,1160,1188,N/A,13,6
11,N/A,N/A,N/A,1149,1160,N/A,16,3
5,N/A,N/A,N/A,1144,1149,N/A,20,1
41,N/A,N/A,N/A,1103,1144,N/A,25,6
9,N/A,N/A,N/A,1094,1103,N/A,31,0
17,N/A,N/A,N/A,1077,1094,N/A,35,4
9,N/A,N/A,N/A,1068,1077,N/A,39,2
9,N/A,N/A,N/A,1059,1068,N/A,45,2
26,N/A,N/A,N/A,1033,1059,N/A,48,5
11,N/A,N/A,N/A,1022,1033,N/A,51,2
30,N/A,N/A,N/A,992,1022,N/A,55,6
8,N/A,N/A,N/A,984,992,N/A,58,3
6,N/A,N/A,N/A,978,984,N/A,62,1
41,N/A,N/A,N/A,937,978,N/A,66,5
9,N/A,N/A,N/A,928,937,N/A,69,2
32,N/A,N/A,N/A,896,928,N/A,72,5
17,N/A,N/A,N/A,879,896,N/A,77,4
18,N/A,N/A,N/A,861,879,N/A,83,4
7,N/A,N/A,N/A,854,861,N/A,87,2
31,N/A,N/A,N/A,823,854,N/A,91,6
17,N/A,N/A,N/A,806,823,N/A,95,4
7,N/A,N/A,N/A,799,806,N/A,100,3
7,N/A,N/A,N/A,792,799,N/A,105,2
49,N/A,N/A,N/A,743,792,N/A,109,6
47,N/A,N/A,N/A,696,743,N/A,114,5
8,N/A,N/A,N/A,688,696,N/A,117,2
42,N/A,N/A,N/A,646,688,N/A,121,6
9,N/A,N/A,N/A,637,646,N/A,127,0
25,N/A,N/A,N/A,367,392,N/A,3,6
9,N/A,N/A,N/A,358,367,N/A,6,3
7,N/A,N/A,N/A,351,358,N/A,10,1
20,N/A,N/A,N/A,331,351,N/A,13,4
28,N/A,N/A,N/A,303,331,N/A,19,4
8,N/A,N/A,N/A,295,303,N/A,23,2
8,N/A,N/A,N/A,287,295,N/A,28,1
9,N/A,N/A,N/A,278,287,N/A,34,1
7,N/A,N/A,N/A,271,278,N/A,40,1
45,N/A,N/A,N/A,226,271,N/A,45,6
13,N/A,N/A,N/A,213,226,N/A,49,4
14,N/A,N/A,N/A,199,213,N/A,55,4
9,N/A,N/A,N/A,190,199,N/A,60,3
7,N/A,N/A,N/A,183,190,N/A,66,3
10,N/A,N/A,N/A,173,183,N/A,72,3
7,N/A,N/A,N/A,166,173,N/A,76,1
25,N/A,N/A,N/A,141,166,N/A,80,5
40,N/A,N/A,N/A,101,141,N/A,86,5
42,N/A,N/A,N/A,59,101,N/A,92,5
32,N/A,N/A,N/A,27,59,N/A,98,5
7,N/A,N/A,N/A,20,27,N/A,102,3
7,N/A,N/A,N/A,13,20,N/A,106,1
9,N/A,N/A,N/A,4,13,N/A,112,1
37,N/A,N/A,N/A,-33,4,N/A,116,5
39,N/A,N/A,N/A,349,388,N/A,5,6
9,N/A,N/A,N/A,340,349,N/A,8,3
41,N/A,N/A,N/A,299,340,N/A,11,6
8,N/A,N/A,N/A,291,299,N/A,17,0
29,N/A,N/A,N/A,262,291,N/A,21,4
5,N/A,N/A,N/A,257,262,N/A,24,1
33,N/A,N/A,N/A,224,257,N/A,28,5
11,N/A,N/A,N/A,213,224,N/A,32,3
8,N/A,N/A,N/A,205,213,N/A,37,2
5,N/A,N/A,N/A,200,205,N/A,42,1
27,N/A,N/A,N/A,173,200,N/A,46,5
11,N/A,N/A,N/A,162,173,N/A,49,2
11,N/A,N/A,N/A,151,162,N/A,55,2
35,N/A,N/A,N/A,116,151,N/A,59,6
8,N/A,N/A,N/A,108,116,N/A,62,3
10,N/A,N/A,N/A,98,108,N/A,68,3
6,N/A,N/A,N/A,92,98,N/A,72,1
8,N/A,N/A,N/A,84,92,N/A,78,1
28,N/A,N/A,N/A,56,84,N/A,82,5
40,N/A,N/A,N/A,16,56,N/A,88,5
9,N/A,N/A,N/A,7,16,N/A,92,3
11,N/A,N/A,N/A,-4,7,N/A,97,2
6,N/A,N/A,N/A,1052,1058,N/A,5,1
32,N/A,N/A,N/A,1020,1052,N/A,10,6
22,N/A,N/A,N/A,998,1020,N/A,14,4
9,N/A,N/A,N/A,989,998,N/A,17,1
39,N/A,N/A,N/A,950,989,N/A,21,5
29,N/A,N/A,N/A,921,950,N/A,27,5
25,N/A,N/A,N/A,896,921,N/A,32,4
5,N/A,N/A,N/A,891,896,N/A,35,1
15,N/A,N/A,N/A,876,891,N/A,38,4
7,N/A,N/A,N/A,869,876,N/A,41,1
44,N/A,N/A,N/A,825,869,N/A,46,6
42,N/A,N/A,N/A,783,825,N/A,51,5
9,N/A,N/A,N/A,774,783,N/A,55,3
38,N/A,N/A,N/A,736,774,N/A,58,6
36,N/A,N/A,N/A,700,736,N/A,63,5
7,N/A,N/A,N/A,693,700,N/A,66,2
5,N/A,N/A,N/A,688,693,N/A,71,1
25,N/A,N/A,N/A,663,688,N/A,74,4
7,N/A,N/A,N/A,656,663,N/A,77,1
28,N/A,N/A,N/A,628,656,N/A,80,4
7,N/A,N/A,N/A,621,628,N/A,85,3
9,N/A,N/A,N/A,612,621,N/A,91,3
6,N/A,N/A,N/A,606,612,N/A,95,1
32,N/A,N/A,N/A,574,606,N/A,99,5
9,N/A,N/A,N/A,565,574,N/A,103,3
29,N/A,N/A,N/A,536,565,N/A,106,6
10,N/A,N/A,N/A,526,536,N/A,110,4
8,N/A,N/A,N/A,518,526,N/A,114,2
5,N/A,N/A,N/A,513,518,N/A,119,1
36,N/A,N/A,N/A,477,513,N/A,123,5
24,N/A,N/A,N/A,518,542,N/A,5,4
7,N/A,N/A,N/A,511,518,N/A,8,1
18,N/A,N/A,N/A,493,511,N/A,11,4
6,N/A,N/A,N/A,487,493,N/A,14,1
42,N/A,N/A,N/A,445,487,N/A,19,6
9,N/A,N/A,N/A,436,445,N/A,25,0
21,N/A,N/A,N/A,415,436,N/A,29,4
7,N/A,N/A,N/A,408,415,N/A,33,2
6,N/A,N/A,N/A,402,408,N/A,38,1
28,N/A,N/A,N/A,374,402,N/A,43,6
11,N/A,N/A,N/A,363,374,N/A,46,3
37,N/A,N/A,N/A,326,363,N/A,49,6
24,N/A,N/A,N/A,302,326,N/A,53,4
7,N/A,N/A,N/A,295,302,N/A,57,2
11,N/A,N/A,N/A,284,295,N/A,63,2
44,N/A,N/A,N/A,240,284,N/A,67,6
8,N/A,N/A,N/A,232,240,N/A,73,0
36,N/A,N/A,N/A,196,232,N/A,78,5
47,N/A,N/A,N/A,149,196,N/A,84,5
9,N/A,N/A,N/A,140,149,N/A,87,2
33,N/A,N/A,N/A,107,140,N/A,90,5
8,N/A,N/A,N/A,99,107,N/A,94,3
7,N/A,N/A,N/A,92,99,N/A,100,3
10,N/A,N/A,N/A,82,92,N/A,105,2
5,N/A,N/A,N/A,77,82,N/A,110,1
21,N/A,N/A,N/A,56,77,N/A,113,4
29,N/A,N/A,N/A,27,56,N/A,119,4
8,N/A,N/A,N/A,19,27,N/A,124,3
9,N/A,N/A,N/A,10,19,N/A,130,3
7,N/A,N/A,N/A,3,10,N/A,135,2
33,N/A,N/A,N/A,1726,1759,N/A,3,6
5,N/A,N/A,N/A,1721,1726,N/A,9,0
30,N/A,N/A,N/A,1691,1721,N/A,14,5
26,N/A,N/A,N/A,1665,1691,N/A,19,4
11,N/A,N/A,N/A,1654,1665,N/A,23,2
44,N/A,N/A,N/A,1610,1654,N/A,26,5
14,N/A,N/A,N/A,1596,1610,N/A,31,4
12,N/A,N/A,N/A,1584,1596,N/A,37,4
8,N/A,N/A,N/A,1576,1584,N/A,42,3
7,N/A,N/A,N/A,1569,1576,N/A,47,2
42,N/A,N/A,N/A,1527,1569,N/A,51,6
48,N/A,N/A,N/A,1479,1527,N/A,56,5
13,N/A,N/A,N/A,1466,1479,N/A,61,4
8,N/A,N/A,N/A,1458,1466,N/A,65,2
37,N/A,N/A,N/A,1421,1458,N/A,68,5
10,N/A,N/A,N/A,1411,1421,N/A,71,2
5,N/A,N/A,N/A,1406,1411,N/A,76,1
6,N/A,N/A,N/A,1400,1406,N/A,82,1
8,N/A,N/A,N/A,1392,1400,N/A,88,1
29,N/A,N/A,N/A,1363,1392,N/A,92,5
8,N/A,N/A,N/A,1355,1363,N/A,95,2
29,N/A,N/A,N/A,1326,1355,N/A,99,6
9,N/A,N/A,N/A,1317,1326,N/A,102,3
26,N/A,N/A,N/A,1291,1317,N/A,105,6
8,N/A,N/A,N/A,1283,1291,N/A,111,0
11,N/A,N/A,N/A,1272,1283,N/A,115,4
10,N/A,N/A,N/A,1262,1272,N/A,120,3
34,N/A,N/A,N/A,1228,1262,N/A,123,6
44,N/A,N/A,N/A,1184,1228,N/A,128,5
10,N/A,N/A,N/A,1174,1184,N/A,131,2
17,N/A,N/A,N/A,1931,1948,N/A,6,4
9,N/A,N/A,N/A,1922,1931,N/A,11,3
8,N/A,N/A,N/A,1914,1922,N/A,17,3
9,N/A,N/A,N/A,1905,1914,N/A,21,1
18,N/A,N/A,N/A,1887,1905,N/A,24,4
10,N/A,N/A,N/A,1877,1887,N/A,28,2
33,N/A,N/A,N/A,1844,1877,N/A,31,5
7,N/A,N/A,N/A,1837,1844,N/A,34,2
38,N/A,N/A,N/A,1799,1837,N/A,38,6
25,N/A,N/A,N/A,1774,1799,N/A,42,4
8,N/A,N/A,N/A,1766,1774,N/A,47,3
27,N/A,N/A,N/A,1739,1766,N/A,50,6
9,N/A,N/A,N/A,1730,1739,N/A,56,0
29,N/A,N/A,N/A,1701,1730,N/A,62,6
19,N/A,N/A,N/A,1682,1701,N/A,66,4
9,N/A,N/A,N/A,1673,1682,N/A,71,3
43,N/A,N/A,N/A,1630,1673,N/A,74,6
23,N/A,N/A,N/A,1607,1630,N/A,78,4
11,N/A,N/A,N/A,1596,1607,N/A,82,2
9,N/A,N/A,N/A,1587,1596,N/A,87,1
5,N/A,N/A,N/A,1582,1587,N/A,93,1
6,N/A,N/A,N/A,1576,1582,N/A,99,1
28,N/A,N/A,N/A,1548,1576,N/A,104,6
6,N/A,N/A,N/A,1542,1548,N/A,110,0
8,N/A,N/A,N/A,1534,1542,N/A,113,3
11,N/A,N/A,N/A,1523,1534,N/A,119,3
10,N/A,N/A,N/A,1513,1523,N/A,125,3
38,N/A,N/A,N/A,1475,1513,N/A,128,6
21,N/A,N/A,N/A,1454,1475,N/A,132,4
7,N/A,N/A,N/A,1447,1454,N/A,135,1
34,N/A,N/A,N/A,760,794,N/A,3,5
26,N/A,N/A,N/A,734,760,N/A,8,4
5,N/A,N/A,N/A,729,734,N/A,11,1
22,N/A,N/A,N/A,707,729,N/A,14,4
11,N/A,N/A,N/A,696,707,N/A,19,3
8,N/A,N/A,N/A,688,696,N/A,24,2
47,N/A,N/A,N/A,641,688,N/A,28,6
36,N/A,N/A,N/A,605,641,N/A,33,5
7,N/A,N/A,N/A,598,605,N/A,36,2
6,N/A,N/A,N/A,592,598,N/A,41,1
37,N/A,N/A,N/A,555,592,N/A,46,6
32,N/A,N/A,N/A,523,555,N/A,51,5
11,N/A,N/A,N/A,512,523,N/A,55,3
7,N/A,N/A,N/A,505,512,N/A,59,1
9,N/A,N/A,N/A,496,505,N/A,65,1
7,N/A,N/A,N/A,489,496,N/A,71,1
49,N/A,N/A,N/A,440,489,N/A,75,5
40,N/A,N/A,N/A,400,440,N/A,81,5
17,N/A,N/A,N/A,383,400,N/A,86,4
10,N/A,N/A,N/A,373,383,N/A,91,3
5,N/A,N/A,N/A,368,373,N/A,95,1
27,N/A,N/A,N/A,341,368,N/A,99,5
7,N/A,N/A,N/A,334,341,N/A,103,3
5,N/A,N/A,N/A,329,334,N/A,107,1
8,N/A,N/A,N/A,321,329,N/A,113,1
27,N/A,N/A,N/A,294,321,N/A,118,6
7,N/A,N/A,N/A,287,294,N/A,124,0
42,N/A,N/A,N/A,245,287,N/A,129,5
49,N/A,N/A,N/A,196,245,N/A,135,5
10,N/A,N/A,N/A,186,196,N/A,138,2
10,N/A,N/A,N/A,953,963,N/A,3,4
6,N/A,N/A,N/A,947,953,N/A,6,1
8,N/A,N/A,N/A,939,947,N/A,12,1
7,N/A,N/A,N/A,932,939,N/A,18,1
35,N/A,N/A,N/A,897,932,N/A,23,6
49,N/A,N/A,N/A,848,897,N/A,28,5
10,N/A,N/A,N/A,838,848,N/A,31,2
37,N/A,N/A,N/A,801,838,N/A,35,6
8,N/A,N/A,N/A,793,801,N/A,41,0
28,N/A,N/A,N/A,765,793,N/A,45,4
11,N/A,N/A,N/A,754,765,N/A,51,4
5,N/A,N/A,N/A,749,754,N/A,54,1
39,N/A,N/A,N/A,710,749,N/A,59,6
16,N/A,N/A,N/A,694,710,N/A,63,4
27,N/A,N/A,N/A,667,694,N/A,69,4
18,N/A,N/A,N/A,649,667,N/A,75,4
7,N/A,N/A,N/A,642,649,N/A,78,1
6,N/A,N/A,N/A,636,642,N/A,84,1
41,N/A,N/A,N/A,595,636,N/A,89,6
8,N/A,N/A,N/A,587,595,N/A,92,3
7,N/A,N/A,N/A,580,587,N/A,96,1
20,N/A,N/A,N/A,560,580,N/A,99,4
8,N/A,N/A,N/A,552,560,N/A,103,2
33,N/A,N/A,N/A,519,552,N/A,107,6
13,N/A,N/A,N/A,506,519,N/A,111,4
8,N/A,N/A,N/A,498,506,N/A,115,2
10,N/A,N/A,N/A,488,498,N/A,121,2
31,N/A,N/A,N/A,457,488,N/A,124,5
31,N/A,N/A,N/A,426,457,N/A,130,5
13,N/A,N/A,N/A,413,426,N/A,135,4
8,N/A,N/A,N/A,338,346,N/A,6,2
8,N/A,N/A,N/A,330,338,N/A,11,1
34,N/A,N/A,N/A,296,330,N/A,15,5
42,N/A,N/A,N/A,254,296,N/A,21,5
29,N/A,N/A,N/A,225,254,N/A,26,4
9,N/A,N/A,N/A,216,225,N/A,31,3
8,N/A,N/A,N/A,208,216,N/A,35,1
31,N/A,N/A,N/A,177,208,N/A,40,6
27,N/A,N/A,N/A,150,177,N/A,44,4
9,N/A,N/A,N/A,141,150,N/A,49,3
5,N/A,N/A,N/A,136,141,N/A,53,1
25,N/A,N/A,N/A,111,136,N/A,56,4
6,N/A,N/A,N/A,105,111,N/A,59,1
30,N/A,N/A,N/A,75,105,N/A,63,5
13,N/A,N/A,N/A,62,75,N/A,68,4
10,N/A,N/A,N/A,52,62,N/A,72,2
35,N/A,N/A,N/A,17,52,N/A,75,5
8,N/A,N/A,N/A,9,17,N/A,78,2
46,N/A,N/A,N/A,-37,9,N/A,82,6
8,N/A,N/A,N/A,862,870,N/A,5,1
27,N/A,N/A,N/A,835,862,N/A,10,6
5,N/A,N/A,N/A,830,835,N/A,16,0
7,N/A,N/A,N/A,823,830,N/A,19,3
37,N/A,N/A,N/A,786,823,N/A,22,6
32,N/A,N/A,N/A,754,786,N/A,27,5
11,N/A,N/A,N/A,743,754,N/A,30,2
7,N/A,N/A,N/A,736,743,N/A,35,1
31,N/A,N/A,N/A,705,736,N/A,40,6
9,N/A,N/A,N/A,696,705,N/A,46,0
12,N/A,N/A,N/A,684,696,N/A,50,4
9,N/A,N/A,N/A,675,684,N/A,54,2
7,N/A,N/A,N/A,668,675,N/A,59,1
6,N/A,N/A,N/A,662,668,N/A,65,1
7,N/A,N/A,N/A,655,662,N/A,71,1
9,N/A,N/A,N/A,646,655,N/A,77,1
16,N/A,N/A,N/A,630,646,N/A,80,4
10,N/A,N/A,N/A,620,630,N/A,85,3
30,N/A,N/A,N/A,590,620,N/A,88,6
11,N/A,N/A,N/A,579,590,N/A,91,3
7,N/A,N/A,N/A,572,579,N/A,97,3
8,N/A,N/A,N/A,564,572,N/A,103,3
47,N/A,N/A,N/A,517,564,N/A,106,6
31,N/A,N/A,N/A,486,517,N/A,111,5
24,N/A,N/A,N/A,462,486,N/A,116,4
5,N/A,N/A,N/A,457,462,N/A,119,1
48,N/A,N/A,N/A,409,457,N/A,123,5
37,N/A,N/A,N/A,372,409,N/A,129,5
7,N/A,N/A,N/A,365,372,N/A,132,2
7,N/A,N/A,N/A,358,365,N/A,137,1
48,N/A,N/A,N/A,1783,1831,N/A,6,5
8,N/A,N/A,N/A,1775,1783,N/A,9,2
6,N/A,N/A,N/A,1769,1775,N/A,14,1
26,N/A,N/A,N/A,1743,1769,N/A,19,6
21,N/A,N/A,N/A,1722,1743,N/A,23,4
5,N/A,N/A,N/A,1717,1722,N/A,26,1
14,N/A,N/A,N/A,1703,1717,N/A,29,4
12,N/A,N/A,N/A,1691,1703,N/A,35,4
9,N/A,N/A,N/A,1682,1691,N/A,40,3
10,N/A,N/A,N/A,1672,1682,N/A,45,2
29,N/A,N/A,N/A,1643,1672,N/A,48,5
37,N/A,N/A,N/A,1606,1643,N/A,54,5
16,N/A,N/A,N/A,1590,1606,N/A,59,4
15,N/A,N/A,N/A,1575,1590,N/A,65,4
21,N/A,N/A,N/A,1554,1575,N/A,71,4
12,N/A,N/A,N/A,1542,1554,N/A,77,4
11,N/A,N/A,N/A,1531,1542,N/A,81,2
36,N/A,N/A,N/A,1495,1531,N/A,85,6
47,N/A,N/A,N/A,1448,1495,N/A,90,5
7,N/A,N/A,N/A,1441,1448,N/A,94,3
11,N/A,N/A,N/A,1430,1441,N/A,100,3
27,N/A,N/A,N/A,1403,1430,N/A,103,6
20,N/A,N/A,N/A,1383,1403,N/A,107,4
25,N/A,N/A,N/A,1358,1383,N/A,113,4
7,N/A,N/A,N/A,1351,1358,N/A,117,2
8,N/A,N/A,N/A,1343,1351,N/A,122,1
41,N/A,N/A,N/A,1302,1343,N/A,127,6
9,N/A,N/A,N/A,1293,1302,N/A,130,3
7,N/A,N/A,N/A,1286,1293,N/A,135,2
8,N/A,N/A,N/A,1278,1286,N/A,140,1
22,N/A,N/A,N/A,759,781,N/A,6,4
22,N/A,N/A,N/A,737,759,N/A,12,4
9,N/A,N/A,N/A,728,737,N/A,17,3
7,N/A,N/A,N/A,721,728,N/A,23,3
7,N/A,N/A,N/A,714,721,N/A,27,1
31,N/A,N/A,N/A,683,714,N/A,32,6
9,N/A,N/A,N/A,674,683,N/A,35,3
7,N/A,N/A,N/A,667,674,N/A,41,3
6,N/A,N/A,N/A,661,667,N/A,45,1
16,N/A,N/A,N/A,645,661,N/A,48,4
11,N/A,N/A,N/A,634,645,N/A,53,3
9,N/A,N/A,N/A,625,634,N/A,58,2
47,N/A,N/A,N/A,578,625,N/A,61,5
11,N/A,N/A,N/A,567,578,N/A,65,3
46,N/A,N/A,N/A,521,567,N/A,68,6
38,N/A,N/A,N/A,483,521,N/A,73,5
8,N/A,N/A,N/A,475,483,N/A,77,3
39,N/A,N/A,N/A,436,475,N/A,80,6
11,N/A,N/A,N/A,425,436,N/A,83,3
8,N/A,N/A,N/A,417,425,N/A,88,2
28,N/A,N/A,N/A,389,417,N/A,91,5
40,N/A,N/A,N/A,349,389,N/A,97,5
15,N/A,N/A,N/A,334,349,N/A,102,4
15,N/A,N/A,N/A,319,334,N/A,108,4
7,N/A,N/A,N/A,312,319,N/A,112,2
36,N/A,N/A,N/A,276,312,N/A,116,6
31,N/A,N/A,N/A,245,276,N/A,121,5
16,N/A,N/A,N/A,229,245,N/A,126,4
9,N/A,N/A,N/A,220,229,N/A,131,3
5,N/A,N/A,N/A,215,220,N/A,135,1
45,N/A,N/A,N/A,1138,1183,N/A,4,6
47,N/A,N/A,N/A,1091,1138,N/A,9,5
10,N/A,N/A,N/A,1081,1091,N/A,14,4
8,N/A,N/A,N/A,1073,1081,N/A,19,3
7,N/A,N/A,N/A,1066,1073,N/A,24,2
5,N/A,N/A,N/A,1061,1066,N/A,29,1
17,N/A,N/A,N/A,1044,1061,N/A,32,4
11,N/A,N/A,N/A,1033,1044,N/A,37,3
9,N/A,N/A,N/A,1024,1033,N/A,41,1
24,N/A,N/A,N/A,1000,1024,N/A,44,4
7,N/A,N/A,N/A,993,1000,N/A,48,2
5,N/A,N/A,N/A,988,993,N/A,53,1
8,N/A,N/A,N/A,980,988,N/A,59,1
46,N/A,N/A,N/A,934,980,N/A,63,5
9,N/A,N/A,N/A,925,934,N/A,66,2
30,N/A,N/A,N/A,895,925,N/A,70,6
48,N/A,N/A,N/A,847,895,N/A,75,5
7,N/A,N/A,N/A,840,847,N/A,79,3
9,N/A,N/A,N/A,831,840,N/A,85,3
8,N/A,N/A,N/A,823,831,N/A,89,1
9,N/A,N/A,N/A,814,823,N/A,95,1
43,N/A,N/A,N/A,771,814,N/A,99,5
38,N/A,N/A,N/A,733,771,N/A,105,5
17,N/A,N/A,N/A,716,733,N/A,110,4
10,N/A,N/A,N/A,706,716,N/A,115,3
25,N/A,N/A,N/A,681,706,N/A,118,6
47,N/A,N/A,N/A,634,681,N/A,123,5
43,N/A,N/A,N/A,591,634,N/A,129,5
9,N/A,N/A,N/A,582,591,N/A,132,2
31,N/A,N/A,N/A,551,582,N/A,136,6
23,N/A,N/A,N/A,508,531,N/A,3,4
11,N/A,N/A,N/A,497,508,N/A,9,4
8,N/A,N/A,N/A,489,497,N/A,14,3
8,N/A,N/A,N/A,481,489,N/A,20,3
26,N/A,N/A,N/A,455,481,N/A,23,6
48,N/A,N/A,N/A,407,455,N/A,28,5
7,N/A,N/A,N/A,400,407,N/A,32,3
9,N/A,N/A,N/A,391,400,N/A,38,3
10,N/A,N/A,N/A,381,391,N/A,43,2
46,N/A,N/A,N/A,335,381,N/A,46,5
11,N/A,N/A,N/A,324,335,N/A,51,4
6,N/A,N/A,N/A,318,324,N/A,54,1
25,N/A,N/A,N/A,293,318,N/A,58,5
7,N/A,N/A,N/A,286,293,N/A,61,2
44,N/A,N/A,N/A,242,286,N/A,65,6
6,N/A,N/A,N/A,236,242,N/A,71,0
26,N/A,N/A,N/A,210,236,N/A,77,6
10,N/A,N/A,N/A,200,210,N/A,80,3
8,N/A,N/A,N/A,192,200,N/A,84,1
47,N/A,N/A,N/A,145,192,N/A,89,6
6,N/A,N/A,N/A,139,145,N/A,95,0
10,N/A,N/A,N/A,129,139,N/A,99,4
9,N/A,N/A,N/A,120,129,N/A,104,3
26,N/A,N/A,N/A,94,120,N/A,107,6
42,N/A,N/A,N/A,52,94,N/A,112,5
48,N/A,N/A,N/A,4,52,N/A,118,5
9,N/A,N/A,N/A,-5,4,N/A,121,2
42,N/A,N/A,N/A,332,374,N/A,5,6
32,N/A,N/A,N/A,300,332,N/A,10,5
7,N/A,N/A,N/A,293,300,N/A,13,2
41,N/A,N/A,N/A,252,293,N/A,17,6
13,N/A,N/A,N/A,239,252,N/A,21,4
8,N/A,N/A,N/A,231,239,N/A,24,1
28,N/A,N/A,N/A,203,231,N/A,27,4
10,N/A,N/A,N/A,193,203,N/A,32,3
48,N/A,N/A,N/A,145,193,N/A,35,6
18,N/A,N/A,N/A,127,145,N/A,39,4
6,N/A,N/A,N/A,121,127,N/A,42,1
28,N/A,N/A,N/A,93,121,N/A,46,5
30,N/A,N/A,N/A,63,93,N/A,52,5
9,N/A,N/A,N/A,54,63,N/A,56,3
8,N/A,N/A,N/A,46,54,N/A,61,2
49,N/A,N/A,N/A,-3,46,N/A,65,6
5,N/A,N/A,N/A,561,566,N/A,3,1
26,N/A,N/A,N/A,535,561,N/A,6,4
6,N/A,N/A,N/A,529,535,N/A,9,1
20,N/A,N/A,N/A,509,529,N/A,12,4
11,N/A,N/A,N/A,498,509,N/A,17,3
9,N/A,N/A,N/A,489,498,N/A,21,1
44,N/A,N/A,N/A,445,489,N/A,26,6
5,N/A,N/A,N/A,440,445,N/A,32,0
39,N/A,N/A,N/A,401,440,N/A,37,5
24,N/A,N/A,N/A,377,401,N/A,42,4
7,N/A,N/A,N/A,370,377,N/A,47,3
11,N/A,N/A,N/A,359,370,N/A,53,3
7,N/A,N/A,N/A,352,359,N/A,58,2
33,N/A,N/A,N/A,319,352,N/A,62,6
6,N/A,N/A,N/A,313,319,N/A,68,0
29,N/A,N/A,N/A,284,313,N/A,74,6
9,N/A,N/A,N/A,275,284,N/A,77,3
7,N/A,N/A,N/A,268,275,N/A,83,3
8,N/A,N/A,N/A,260,268,N/A,88,2
9,N/A,N/A,N/A,251,260,N/A,93,1
9,N/A,N/A,N/A,242,251,N/A,99,1
19,N/A,N/A,N/A,223,242,N/A,102,4
18,N/A,N/A,N/A,205,223,N/A,108,4
18,N/A,N/A,N/A,187,205,N/A,114,4
7,N/A,N/A,N/A,180,187,N/A,118,2
36,N/A,N/A,N/A,144,180,N/A,121,5
11,N/A,N/A,N/A,133,144,N/A,126,4
9,N/A,N/A,N/A,124,133,N/A,129,1
47,N/A,N/A,N/A,77,124,N/A,133,5
7,N/A,N/A,N/A,70,77,N/A,137,3
9,N/A,N/A,N/A,832,841,N/A,5,2
45,N/A,N/A,N/A,787,832,N/A,9,6
49,N/A,N/A,N/A,738,787,N/A,14,5
8,N/A,N/A,N/A,730,738,N/A,17,2
8,N/A,N/A,N/A,722,730,N/A,22,1
9,N/A,N/A,N/A,713,722,N/A,28,1
34,N/A,N/A,N/A,679,713,N/A,33,6
11,N/A,N/A,N/A,668,679,N/A,37,4
10,N/A,N/A,N/A,658,668,N/A,41,2
10,N/A,N/A,N/A,648,658,N/A,47,2
6,N/A,N/A,N/A,642,648,N/A,52,1
8,N/A,N/A,N/A,634,642,N/A,58,1
9,N/A,N/A,N/A,625,634,N/A,64,1
31,N/A,N/A,N/A,594,625,N/A,69,6
8,N/A,N/A,N/A,586,594,N/A,72,3
9,N/A,N/A,N/A,577,586,N/A,76,1
34,N/A,N/A,N/A,543,577,N/A,80,5
40,N/A,N/A,N/A,503,543,N/A,86,5
14,N/A,N/A,N/A,489,503,N/A,91,4
9,N/A,N/A,N/A,480,489,N/A,95,2
7,N/A,N/A,N/A,473,480,N/A,101,2
29,N/A,N/A,N/A,444,473,N/A,104,5
28,N/A,N/A,N/A,416,444,N/A,109,4
9,N/A,N/A,N/A,407,416,N/A,112,1
7,N/A,N/A,N/A,400,407,N/A,118,1
9,N/A,N/A,N/A,391,400,N/A,124,1
5,N/A,N/A,N/A,386,391,N/A,130,1
18,N/A,N/A,N/A,368,386,N/A,133,4
10,N/A,N/A,N/A,358,368,N/A,138,3
5,N/A,N/A,N/A,353,358,N/A,142,1
11,N/A,N/A,N/A,1591,1602,N/A,4,3
7,N/A,N/A,N/A,1584,1591,N/A,9,2
10,N/A,N/A,N/A,1574,1584,N/A,15,2
8,N/A,N/A,N/A,1566,1574,N/A,20,1
9,N/A,N/A,N/A,1557,1566,N/A,26,1
31,N/A,N/A,N/A,1526,1557,N/A,30,5
9,N/A,N/A,N/A,1517,1526,N/A,34,3
11,N/A,N/A,N/A,1506,1517,N/A,39,2
10,N/A,N/A,N/A,1496,1506,N/A,45,2
47,N/A,N/A,N/A,1449,1496,N/A,49,6
7,N/A,N/A,N/A,1442,1449,N/A,55,0
33,N/A,N/A,N/A,1409,1442,N/A,60,5
11,N/A,N/A,N/A,1398,1409,N/A,63,2
10,N/A,N/A,N/A,1388,1398,N/A,69,2
29,N/A,N/A,N/A,1359,1388,N/A,72,5
8,N/A,N/A,N/A,1351,1359,N/A,76,3
8,N/A,N/A,N/A,1343,1351,N/A,80,1
11,N/A,N/A,N/A,1332,1343,N/A,83,4
7,N/A,N/A,N/A,1325,1332,N/A,88,3
7,N/A,N/A,N/A,1318,1325,N/A,94,3
9,N/A,N/A,N/A,1309,1318,N/A,100,3
8,N/A,N/A,N/A,1301,1309,N/A,104,1
23,N/A,N/A,N/A,1278,1301,N/A,107,4
9,N/A,N/A,N/A,1269,1278,N/A,112,3
10,N/A,N/A,N/A,1259,1269,N/A,117,2
43,N/A,N/A,N/A,1216,1259,N/A,121,6
6,N/A,N/A,N/A,1210,1216,N/A,127,0
34,N/A,N/A,N/A,1176,1210,N/A,133,6
22,N/A,N/A,N/A,1154,1176,N/A,137,4
8,N/A,N/A,N/A,1146,1154,N/A,141,2
11,N/A,N/A,N/A,1135,1146,N/A,4,3
6,N/A,N/A,N/A,1129,1135,N/A,8,1
11,N/A,N/A,N/A,1118,1129,N/A,11,4
10,N/A,N/A,N/A,1108,1118,N/A,15,2
49,N/A,N/A,N/A,1059,1108,N/A,19,6
6,N/A,N/A,N/A,1053,1059,N/A,25,0
34,N/A,N/A,N/A,1019,1053,N/A,31,6
35,N/A,N/A,N/A,984,1019,N/A,36,5
18,N/A,N/A,N/A,966,984,N/A,41,4
9,N/A,N/A,N/A,957,966,N/A,45,2
9,N/A,N/A,N/A,948,957,N/A,51,2
5,N/A,N/A,N/A,943,948,N/A,56,1
6,N/A,N/A,N/A,937,943,N/A,62,1
42,N/A,N/A,N/A,895,937,N/A,67,6
28,N/A,N/A,N/A,867,895,N/A,71,4
19,N/A,N/A,N/A,848,867,N/A,77,4
8,N/A,N/A,N/A,840,848,N/A,81,2
33,N/A,N/A,N/A,807,840,N/A,85,6
9,N/A,N/A,N/A,798,807,N/A,91,0
8,N/A,N/A,N/A,790,798,N/A,94,3
8,N/A,N/A,N/A,782,790,N/A,98,1
9,N/A,N/A,N/A,773,782,N/A,104,1
22,N/A,N/A,N/A,751,773,N/A,107,4
8,N/A,N/A,N/A,743,751,N/A,111,2
7,N/A,N/A,N/A,736,743,N/A,116,1
21,N/A,N/A,N/A,715,736,N/A,119,4
7,N/A,N/A,N/A,708,715,N/A,122,1
7,N/A,N/A,N/A,701,708,N/A,128,1
29,N/A,N/A,N/A,672,701,N/A,133,6
6,N/A,N/A,N/A,666,672,N/A,139,0
11,N/A,N/A,N/A,1206,1217,N/A,6,2
7,N/A,N/A,N/A,1199,1206,N/A,12,2
6,N/A,N/A,N/A,1193,1199,N/A,17,1
9,N/A,N/A,N/A,1184,1193,N/A,23,1
26,N/A,N/A,N/A,1158,1184,N/A,26,4
11,N/A,N/A,N/A,1147,1158,N/A,30,2
6,N/A,N/A,N/A,1141,1147,N/A,35,1
7,N/A,N/A,N/A,1134,1141,N/A,41,1
7,N/A,N/A,N/A,1127,1134,N/A,47,1
25,N/A,N/A,N/A,1102,1127,N/A,50,4
11,N/A,N/A,N/A,1091,1102,N/A,56,4
11,N/A,N/A,N/A,1080,1091,N/A,60,2
30,N/A,N/A,N/A,1050,1080,N/A,64,6
16,N/A,N/A,N/A,1034,1050,N/A,68,4
7,N/A,N/A,N/A,1027,1034,N/A,71,1
34,N/A,N/A,N/A,993,1027,N/A,75,5
18,N/A,N/A,N/A,975,993,N/A,80,4
17,N/A,N/A,N/A,958,975,N/A,86,4
10,N/A,N/A,N/A,948,958,N/A,90,2
30,N/A,N/A,N/A,918,948,N/A,93,5
27,N/A,N/A,N/A,891,918,N/A,98,4
17,N/A,N/A,N/A,874,891,N/A,104,4
12,N/A,N/A,N/A,862,874,N/A,110,4
27,N/A,N/A,N/A,835,862,N/A,116,4
7,N/A,N/A,N/A,828,835,N/A,121,3
11,N/A,N/A,N/A,817,828,N/A,127,3
8,N/A,N/A,N/A,809,817,N/A,131,1
9,N/A,N/A,N/A,800,809,N/A,137,1
39,N/A,N/A,N/A,761,800,N/A,142,6
47,N/A,N/A,N/A,714,761,N/A,147,5
5,N/A,N/A,N/A,777,782,N/A,3,1
19,N/A,N/A,N/A,758,777,N/A,6,4
7,N/A,N/A,N/A,751,758,N/A,9,1
9,N/A,N/A,N/A,742,751,N/A,15,1
5,N/A,N/A,N/A,737,742,N/A,21,1
32,N/A,N/A,N/A,705,737,N/A,25,5
7,N/A,N/A,N/A,698,705,N/A,29,3
31,N/A,N/A,N/A,667,698,N/A,32,6
26,N/A,N/A,N/A,641,667,N/A,37,5
11,N/A,N/A,N/A,630,641,N/A,41,3
7,N/A,N/A,N/A,623,630,N/A,47,3
28,N/A,N/A,N/A,595,623,N/A,50,6
38,N/A,N/A,N/A,557,595,N/A,55,5
10,N/A,N/A,N/A,547,557,N/A,59,3
30,N/A,N/A,N/A,517,547,N/A,62,6
45,N/A,N/A,N/A,472,517,N/A,67,5
19,N/A,N/A,N/A,453,472,N/A,72,4
7,N/A,N/A,N/A,446,453,N/A,75,1
45,N/A,N/A,N/A,401,446,N/A,79,5
41,N/A,N/A,N/A,360,401,N/A,85,5
21,N/A,N/A,N/A,339,360,N/A,90,4
9,N/A,N/A,N/A,330,339,N/A,94,2
10,N/A,N/A,N/A,320,330,N/A,100,2
34,N/A,N/A,N/A,286,320,N/A,103,5
11,N/A,N/A,N/A,275,286,N/A,107,3
8,N/A,N/A,N/A,267,275,N/A,113,3
7,N/A,N/A,N/A,260,267,N/A,119,3
9,N/A,N/A,N/A,251,260,N/A,124,2
47,N/A,N/A,N/A,204,251,N/A,127,5
21,N/A,N/A,N/A,183,204,N/A,132,4
5,N/A,N/A,N/A,1434,1439,N/A,5,1
5,N/A,N/A,N/A,1429,1434,N/A,11,1
5,N/A,N/A,N/A,1424,1429,N/A,17,1
26,N/A,N/A,N/A,1398,1424,N/A,21,5
11,N/A,N/A,N/A,1387,1398,N/A,25,3
9,N/A,N/A,N/A,1378,1387,N/A,29,1
30,N/A,N/A,N/A,1348,1378,N/A,34,6
9,N/A,N/A,N/A,1339,1348,N/A,37,3
9,N/A,N/A,N/A,1330,1339,N/A,42,2
30,N/A,N/A,N/A,1300,1330,N/A,46,6
10,N/A,N/A,N/A,1290,1300,N/A,50,4
25,N/A,N/A,N/A,1265,1290,N/A,56,4
7,N/A,N/A,N/A,1258,1265,N/A,59,1
10,N/A,N/A,N/A,1248,1258,N/A,62,4
9,N/A,N/A,N/A,1239,1248,N/A,65,1
34,N/A,N/A,N/A,1205,1239,N/A,69,5
21,N/A,N/A,N/A,1184,1205,N/A,74,4
9,N/A,N/A,N/A,1175,1184,N/A,78,2
10,N/A,N/A,N/A,1165,1175,N/A,84,2
33,N/A,N/A,N/A,1132,1165,N/A,87,5
26,N/A,N/A,N/A,1106,1132,N/A,93,5
28,N/A,N/A,N/A,1078,1106,N/A,98,4
8,N/A,N/A,N/A,1070,1078,N/A,102,2
44,N/A,N/A,N/A,1026,1070,N/A,105,5
30,N/A,N/A,N/A,996,1026,N/A,111,5
10,N/A,N/A,N/A,986,996,N/A,114,2
32,N/A,N/A,N/A,954,986,N/A,118,6
10,N/A,N/A,N/A,944,954,N/A,121,3
7,N/A,N/A,N/A,937,944,N/A,125,1
26,N/A,N/A,N/A,911,937,N/A,130,6
29,N/A,N/A,N/A,1658,1687,N/A,6,5
14,N/A,N/A,N/A,1644,1658,N/A,11,4
7,N/A,N/A,N/A,1637,1644,N/A,16,3
11,N/A,N/A,N/A,1626,1637,N/A,22,3
5,N/A,N/A,N/A,1621,1626,N/A,26,1
25,N/A,N/A,N/A,1596,1621,N/A,31,6
33,N/A,N/A,N/A,1563,1596,N/A,36,5
17,N/A,N/A,N/A,1546,1563,N/A,41,4
6,N/A,N/A,N/A,1540,1546,N/A,44,1
11,N/A,N/A,N/A,1529,1540,N/A,47,4
7,N/A,N/A,N/A,1522,1529,N/A,51,2
11,N/A,N/A,N/A,1511,1522,N/A,57,2
41,N/A,N/A,N/A,1470,1511,N/A,61,6
39,N/A,N/A,N/A,1431,1470,N/A,66,5
14,N/A,N/A,N/A,1417,1431,N/A,71,4
18,N/A,N/A,N/A,1399,1417,N/A,77,4
9,N/A,N/A,N/A,1390,1399,N/A,82,3
7,N/A,N/A,N/A,1383,1390,N/A,87,2
9,N/A,N/A,N/A,1374,1383,N/A,93,2
6,N/A,N/A,N/A,1368,1374,N/A,98,1
39,N/A,N/A,N/A,1329,1368,N/A,102,5
21,N/A,N/A,N/A,1308,1329,N/A,107,4
7,N/A,N/A,N/A,1301,1308,N/A,111,2
48,N/A,N/A,N/A,1253,1301,N/A,114,5
11,N/A,N/A,N/A,1242,1253,N/A,119,4
9,N/A,N/A,N/A,1233,1242,N/A,122,1
5,N/A,N/A,N/A,1228,1233,N/A,128,1
34,N/A,N/A,N/A,1194,1228,N/A,132,5
43,N/A,N/A,N/A,1151,1194,N/A,138,5
9,N/A,N/A,N/A,1142,1151,N/A,142,3
27,N/A,N/A,N/A,1243,1270,N/A,3,6
11,N/A,N/A,N/A,1232,1243,N/A,6,3
32,N/A,N/A,N/A,1200,1232,N/A,9,6
15,N/A,N/A,N/A,1185,1200,N/A,13,4
22,N/A,N/A,N/A,1163,1185,N/A,19,4
9,N/A,N/A,N/A,1154,1163,N/A,24,3
34,N/A,N/A,N/A,1120,1154,N/A,27,6
9,N/A,N/A,N/A,1111,1120,N/A,33,0
10,N/A,N/A,N/A,1101,1111,N/A,36,3
8,N/A,N/A,N/A,1093,1101,N/A,41,2
9,N/A,N/A,N/A,1084,1093,N/A,47,2
11,N/A,N/A,N/A,1073,1084,N/A,53,2
7,N/A,N/A,N/A,1066,1073,N/A,59,2
11,N/A,N/A,N/A,1055,1066,N/A,65,2
6,N/A,N/A,N/A,1049,1055,N/A,70,1
8,N/A,N/A,N/A,1041,1049,N/A,76,1
26,N/A,N/A,N/A,1015,1041,N/A,79,4
11,N/A,N/A,N/A,1004,1015,N/A,84,3
36,N/A,N/A,N/A,968,1004,N/A,87,6
9,N/A,N/A,N/A,959,968,N/A,93,0
25,N/A,N/A,N/A,934,959,N/A,99,6
9,N/A,N/A,N/A,925,934,N/A,105,0
7,N/A,N/A,N/A,918,925,N/A,108,3
7,N/A,N/A,N/A,911,918,N/A,113,2
8,N/A,N/A,N/A,903,911,N/A,118,1
19,N/A,N/A,N/A,884,903,N/A,121,4
14,N/A,N/A,N/A,870,884,N/A,127,4
5,N/A,N/A,N/A,865,870,N/A,130,1
11,N/A,N/A,N/A,854,865,N/A,133,4
9,N/A,N/A,N/A,845,854,N/A,138,3
21,N/A,N/A,N/A,1070,1091,N/A,4,4
12,N/A,N/A,N/A,1058,1070,N/A,10,4
22,N/A,N/A,N/A,1036,1058,N/A,16,4
9,N/A,N/A,N/A,1027,1036,N/A,21,3
11,N/A,N/A,N/A,1016,1027,N/A,27,3
9,N/A,N/A,N/A,1007,1016,N/A,31,1
39,N/A,N/A,N/A,968,1007,N/A,36,6
31,N/A,N/A,N/A,937,968,N/A,41,5
9,N/A,N/A,N/A,928,937,N/A,44,2
10,N/A,N/A,N/A,918,928,N/A,50,2
27,N/A,N/A,N/A,891,918,N/A,54,6
9,N/A,N/A,N/A,882,891,N/A,60,0
14,N/A,N/A,N/A,868,882,N/A,64,4
9,N/A,N/A,N/A,859,868,N/A,69,3
43,N/A,N/A,N/A,816,859,N/A,72,6
29,N/A,N/A,N/A,787,816,N/A,77,5
17,N/A,N/A,N/A,770,787,N/A,82,4
7,N/A,N/A,N/A,763,770,N/A,85,1
9,N/A,N/A,N/A,754,763,N/A,91,1
26,N/A,N/A,N/A,728,754,N/A,96,6
11,N/A,N/A,N/A,717,728,N/A,99,3
10,N/A,N/A,N/A,707,717,N/A,104,2
35,N/A,N/A,N/A,672,707,N/A,107,5
48,N/A,N/A,N/A,624,672,N/A,113,5
19,N/A,N/A,N/A,605,624,N/A,118,4
11,N/A,N/A,N/A,594,605,N/A,123,3
5,N/A,N/A,N/A,589,594,N/A,127,1
28,N/A,N/A,N/A,561,589,N/A,130,4
29,N/A,N/A,N/A,532,561,N/A,136,4
27,N/A,N/A,N/A,505,532,N/A,142,4
34,N/A,N/A,N/A,333,367,N/A,3,5
35,N/A,N/A,N/A,298,333,N/A,9,5
38,N/A,N/A,N/A,260,298,N/A,15,5
9,N/A,N/A,N/A,251,260,N/A,18,2
44,N/A,N/A,N/A,207,251,N/A,22,6
39,N/A,N/A,N/A,168,207,N/A,27,5
46,N/A,N/A,N/A,122,168,N/A,33,5
11,N/A,N/A,N/A,111,122,N/A,37,3
10,N/A,N/A,N/A,101,111,N/A,42,2
7,N/A,N/A,N/A,94,101,N/A,47,1
40,N/A,N/A,N/A,54,94,N/A,51,5
38,N/A,N/A,N/A,16,54,N/A,57,5
40,N/A,N/A,N/A,-24,16,N/A,63,5
8,N/A,N/A,N/A,912,920,N/A,3,3
8,N/A,N/A,N/A,904,912,N/A,9,3
45,N/A,N/A,N/A,859,904,N/A,12,6
7,N/A,N/A,N/A,852,859,N/A,15,3
11,N/A,N/A,N/A,841,852,N/A,21,3
9,N/A,N/A,N/A,832,841,N/A,25,1
9,N/A,N/A,N/A,823,832,N/A,31,1
29,N/A,N/A,N/A,794,823,N/A,34,4
7,N/A,N/A,N/A,787,794,N/A,39,3
9,N/A,N/A,N/A,778,787,N/A,45,3
9,N/A,N/A,N/A,769,778,N/A,51,3
36,N/A,N/A,N/A,733,769,N/A,54,6
26,N/A,N/A,N/A,707,733,N/A,58,4
6,N/A,N/A,N/A,701,707,N/A,61,1
6,N/A,N/A,N/A,695,701,N/A,67,1
16,N/A,N/A,N/A,679,695,N/A,70,4
18,N/A,N/A,N/A,661,679,N/A,76,4
11,N/A,N/A,N/A,650,661,N/A,81,3
10,N/A,N/A,N/A,640,650,N/A,86,2
5,N/A,N/A,N/A,635,640,N/A,91,1
24,N/A,N/A,N/A,611,635,N/A,94,4
25,N/A,N/A,N/A,586,611,N/A,100,4
9,N/A,N/A,N/A,577,586,N/A,105,3
10,N/A,N/A,N/A,567,577,N/A,110,2
7,N/A,N/A,N/A,560,567,N/A,115,1
46,N/A,N/A,N/A,514,560,N/A,119,5
9,N/A,N/A,N/A,505,514,N/A,123,3
42,N/A,N/A,N/A,463,505,N/A,126,6
5,N/A,N/A,N/A,458,463,N/A,132,0
11,N/A,N/A,N/A,447,458,N/A,135,3
5,N/A,N/A,N/A,1754,1759,N/A,6,1
37,N/A,N/A,N/A,1717,1754,N/A,10,5
10,N/A,N/A,N/A,1707,1717,N/A,13,2
8,N/A,N/A,N/A,1699,1707,N/A,18,1
36,N/A,N/A,N/A,1663,1699,N/A,23,6
7,N/A,N/A,N/A,1656,1663,N/A,26,3
7,N/A,N/A,N/A,1649,1656,N/A,32,3
7,N/A,N/A,N/A,1642,1649,N/A,38,3
10,N/A,N/A,N/A,1632,1642,N/A,44,3
7,N/A,N/A,N/A,1625,1632,N/A,50,3
9,N/A,N/A,N/A,1616,1625,N/A,55,2
6,N/A,N/A,N/A,1610,1616,N/A,60,1
5,N/A,N/A,N/A,1605,1610,N/A,66,1
18,N/A,N/A,N/A,1587,1605,N/A,69,4
16,N/A,N/A,N/A,1571,1587,N/A,75,4
6,N/A,N/A,N/A,1565,1571,N/A,78,1
37,N/A,N/A,N/A,1528,1565,N/A,83,6
24,N/A,N/A,N/A,1504,1528,N/A,87,4
8,N/A,N/A,N/A,1496,1504,N/A,90,1
21,N/A,N/A,N/A,1475,1496,N/A,93,4
11,N/A,N/A,N/A,1464,1475,N/A,97,2
9,N/A,N/A,N/A,1455,1464,N/A,103,2
8,N/A,N/A,N/A,1447,1455,N/A,108,1
45,N/A,N/A,N/A,1402,1447,N/A,112,5
9,N/A,N/A,N/A,1393,1402,N/A,115,2
8,N/A,N/A,N/A,1385,1393,N/A,121,2
7,N/A,N/A,N/A,1378,1385,N/A,127,2
29,N/A,N/A,N/A,1349,1378,N/A,130,5
11,N/A,N/A,N/A,1338,1349,N/A,134,3
11,N/A,N/A,N/A,1327,1338,N/A,140,3
17,N/A,N/A,N/A,991,1008,N/A,4,4
7,N/A,N/A,N/A,984,991,N/A,8,2
35,N/A,N/A,N/A,949,984,N/A,12,6
39,N/A,N/A,N/A,910,949,N/A,17,5
8,N/A,N/A,N/A,902,910,N/A,21,3
7,N/A,N/A,N/A,895,902,N/A,25,1
27,N/A,N/A,N/A,868,895,N/A,28,4
7,N/A,N/A,N/A,861,868,N/A,32,2
25,N/A,N/A,N/A,836,861,N/A,36,6
7,N/A,N/A,N/A,829,836,N/A,42,0
13,N/A,N/A,N/A,816,829,N/A,46,4
9,N/A,N/A,N/A,807,816,N/A,49,1
41,N/A,N/A,N/A,766,807,N/A,54,6
25,N/A,N/A,N/A,741,766,N/A,58,4
9,N/A,N/A,N/A,732,741,N/A,62,2
8,N/A,N/A,N/A,724,732,N/A,67,1
6,N/A,N/A,N/A,718,724,N/A,73,1
25,N/A,N/A,N/A,693,718,N/A,77,5
34,N/A,N/A,N/A,659,693,N/A,83,5
43,N/A,N/A,N/A,616,659,N/A,89,5
8,N/A,N/A,N/A,608,616,N/A,92,2
48,N/A,N/A,N/A,560,608,N/A,95,5
7,N/A,N/A,N/A,553,560,N/A,99,3
7,N/A,N/A,N/A,546,553,N/A,103,1
26,N/A,N/A,N/A,520,546,N/A,107,5
9,N/A,N/A,N/A,511,520,N/A,111,3
41,N/A,N/A,N/A,470,511,N/A,114,6
5,N/A,N/A,N/A,465,470,N/A,120,0
35,N/A,N/A,N/A,430,465,N/A,125,5
36,N/A,N/A,N/A,394,430,N/A,131,5
11,N/A,N/A,N/A,1052,1063,N/A,5,2
49,N/A,N/A,N/A,1003,1052,N/A,8,5
7,N/A,N/A,N/A,996,1003,N/A,11,2
7,N/A,N/A,N/A,989,996,N/A,17,2
37,N/A,N/A,N/A,952,989,N/A,20,5
45,N/A,N/A,N/A,907,952,N/A,26,5
8,N/A,N/A,N/A,899,907,N/A,29,2
9,N/A,N/A,N/A,890,899,N/A,34,1
9,N/A,N/A,N/A,881,890,N/A,40,1
44,N/A,N/A,N/A,837,881,N/A,44,5
25,N/A,N/A,N/A,812,837,N/A,50,5
9,N/A,N/A,N/A,803,812,N/A,53,2
43,N/A,N/A,N/A,760,803,N/A,56,5
9,N/A,N/A,N/A,751,760,N/A,59,2
33,N/A,N/A,N/A,718,751,N/A,62,5
30,N/A,N/A,N/A,688,718,N/A,68,5
9,N/A,N/A,N/A,679,688,N/A,71,2
32,N/A,N/A,N/A,647,679,N/A,74,5
11,N/A,N/A,N/A,636,647,N/A,78,3
9,N/A,N/A,N/A,627,636,N/A,84,3
11,N/A,N/A,N/A,616,627,N/A,89,2
34,N/A,N/A,N/A,582,616,N/A,93,6
28,N/A,N/A,N/A,554,582,N/A,97,4
22,N/A,N/A,N/A,532,554,N/A,103,4
5,N/A,N/A,N/A,527,532,N/A,106,1
39,N/A,N/A,N/A,488,527,N/A,111,6
6,N/A,N/A,N/A,482,488,N/A,117,0
39,N/A,N/A,N/A,443,482,N/A,123,6
31,N/A,N/A,N/A,412,443,N/A,128,5
9,N/A,N/A,N/A,403,412,N/A,131,2
36,N/A,N/A,N/A,1203,1239,N/A,3,6
8,N/A,N/A,N/A,1195,1203,N/A,6,3
8,N/A,N/A,N/A,1187,1195,N/A,11,2
26,N/A,N/A,N/A,1161,1187,N/A,15,6
10,N/A,N/A,N/A,1151,1161,N/A,18,3
9,N/A,N/A,N/A,1142,1151,N/A,23,2
30,N/A,N/A,N/A,1112,1142,N/A,26,5
29,N/A,N/A,N/A,1083,1112,N/A,31,4
27,N/A,N/A,N/A,1056,1083,N/A,37,4
17,N/A,N/A,N/A,1039,1056,N/A,43,4
19,N/A,N/A,N/A,1020,1039,N/A,49,4
9,N/A,N/A,N/A,1011,1020,N/A,53,2
8,N/A,N/A,N/A,1003,1011,N/A,59,2
5,N/A,N/A,N/A,998,1003,N/A,64,1
35,N/A,N/A,N/A,963,998,N/A,69,6
14,N/A,N/A,N/A,949,963,N/A,73,4
7,N/A,N/A,N/A,942,949,N/A,76,1
49,N/A,N/A,N/A,893,942,N/A,81,6
16,N/A,N/A,N/A,877,893,N/A,85,4
7,N/A,N/A,N/A,870,877,N/A,88,1
5,N/A,N/A,N/A,865,870,N/A,94,1
10,N/A,N/A,N/A,855,865,N/A,97,4
11,N/A,N/A,N/A,844,855,N/A,103,4
11,N/A,N/A,N/A,833,844,N/A,108,3
25,N/A,N/A,N/A,808,833,N/A,111,6
40,N/A,N/A,N/A,768,808,N/A,116,5
10,N/A,N/A,N/A,758,768,N/A,120,3
7,N/A,N/A,N/A,751,758,N/A,125,2
27,N/A,N/A,N/A,724,751,N/A,129,6
28,N/A,N/A,N/A,696,724,N/A,134,5
46,N/A,N/A,N/A,947,993,N/A,5,6
23,N/A,N/A,N/A,924,947,N/A,9,4
10,N/A,N/A,N/A,914,924,N/A,13,2
36,N/A,N/A,N/A,878,914,N/A,17,6
13,N/A,N/A,N/A,865,878,N/A,21,4
9,N/A,N/A,N/A,856,865,N/A,25,2
33,N/A,N/A,N/A,823,856,N/A,28,5
25,N/A,N/A,N/A,798,823,N/A,33,4
23,N/A,N/A,N/A,775,798,N/A,39,4
12,N/A,N/A,N/A,763,775,N/A,45,4
9,N/A,N/A,N/A,754,763,N/A,48,1
5,N/A,N/A,N/A,749,754,N/A,54,1
39,N/A,N/A,N/A,710,749,N/A,59,6
9,N/A,N/A,N/A,701,710,N/A,62,3
7,N/A,N/A,N/A,694,701,N/A,68,3
39,N/A,N/A,N/A,655,694,N/A,71,6
46,N/A,N/A,N/A,609,655,N/A,76,5
33,N/A,N/A,N/A,576,609,N/A,82,5
9,N/A,N/A,N/A,567,576,N/A,86,3
26,N/A,N/A,N/A,541,567,N/A,89,6
9,N/A,N/A,N/A,532,541,N/A,92,3
11,N/A,N/A,N/A,521,532,N/A,97,2
7,N/A,N/A,N/A,514,521,N/A,103,2
41,N/A,N/A,N/A,473,514,N/A,106,5
7,N/A,N/A,N/A,466,473,N/A,109,2
40,N/A,N/A,N/A,426,466,N/A,113,6
5,N/A,N/A,N/A,421,426,N/A,119,0
10,N/A,N/A,N/A,411,421,N/A,122,3
9,N/A,N/A,N/A,402,411,N/A,127,2
7,N/A,N/A,N/A,395,402,N/A,132,1
17,N/A,N/A,N/A,462,479,N/A,4,4
19,N/A,N/A,N/A,443,462,N/A,10,4
7,N/A,N/A,N/A,436,443,N/A,15,3
45,N/A,N/A,N/A,391,436,N/A,18,6
19,N/A,N/A,N/A,372,391,N/A,22,4
7,N/A,N/A,N/A,365,372,N/A,27,3
8,N/A,N/A,N/A,357,365,N/A,33,3
6,N/A,N/A,N/A,351,357,N/A,37,1
12,N/A,N/A,N/A,339,351,N/A,40,4
9,N/A,N/A,N/A,330,339,N/A,44,2
34,N/A,N/A,N/A,296,330,N/A,48,6
6,N/A,N/A,N/A,290,296,N/A,54,0
8,N/A,N/A,N/A,282,290,N/A,57,3
11,N/A,N/A,N/A,271,282,N/A,62,2
7,N/A,N/A,N/A,264,271,N/A,68,2
5,N/A,N/A,N/A,259,264,N/A,73,1
36,N/A,N/A,N/A,223,259,N/A,77,5
41,N/A,N/A,N/A,182,223,N/A,83,5
17,N/A,N/A,N/A,165,182,N/A,88,4
18,N/A,N/A,N/A,147,165,N/A,94,4
8,N/A,N/A,N/A,139,147,N/A,97,1
6,N/A,N/A,N/A,133,139,N/A,103,1
18,N/A,N/A,N/A,115,133,N/A,106,4
6,N/A,N/A,N/A,109,115,N/A,109,1
6,N/A,N/A,N/A,103,109,N/A,115,1
33,N/A,N/A,N/A,70,103,N/A,119,5
40,N/A,N/A,N/A,30,70,N/A,125,5
11,N/A,N/A,N/A,19,30,N/A,129,3
30,N/A,N/A,N/A,-11,19,N/A,132,6
9,N/A,N/A,N/A,1863,1872,N/A,4,2
7,N/A,N/A,N/A,1856,1863,N/A,10,2
10,N/A,N/A,N/A,1846,1856,N/A,16,2
10,N/A,N/A,N/A,1836,1846,N/A,22,2
9,N/A,N/A,N/A,1827,1836,N/A,27,1
28,N/A,N/A,N/A,1799,1827,N/A,31,5
9,N/A,N/A,N/A,1790,1799,N/A,35,3
10,N/A,N/A,N/A,1780,1790,N/A,40,2
7,N/A,N/A,N/A,1773,1780,N/A,45,1
7,N/A,N/A,N/A,1766,1773,N/A,51,1
6,N/A,N/A,N/A,1760,1766,N/A,57,1
22,N/A,N/A,N/A,1738,1760,N/A,60,4
7,N/A,N/A,N/A,1731,1738,N/A,65,3
43,N/A,N/A,N/A,1688,1731,N/A,68,6
29,N/A,N/A,N/A,1659,1688,N/A,72,4
7,N/A,N/A,N/A,1652,1659,N/A,77,3
8,N/A,N/A,N/A,1644,1652,N/A,83,3
7,N/A,N/A,N/A,1637,1644,N/A,89,3
38,N/A,N/A,N/A,1599,1637,N/A,92,6
30,N/A,N/A,N/A,1569,1599,N/A,97,5
9,N/A,N/A,N/A,1560,1569,N/A,101,3
26,N/A,N/A,N/A,1534,1560,N/A,104,6
8,N/A,N/A,N/A,1526,1534,N/A,107,3
8,N/A,N/A,N/A,1518,1526,N/A,113,3
35,N/A,N/A,N/A,1483,1518,N/A,116,6
8,N/A,N/A,N/A,1475,1483,N/A,122,0
31,N/A,N/A,N/A,1444,1475,N/A,128,6
13,N/A,N/A,N/A,1431,1444,N/A,132,4
9,N/A,N/A,N/A,1422,1431,N/A,136,2
7,N/A,N/A,N/A,1415,1422,N/A,141,1
32,N/A,N/A,N/A,951,983,N/A,3,6
26,N/A,N/A,N/A,925,951,N/A,8,5
23,N/A,N/A,N/A,902,925,N/A,13,4
10,N/A,N/A,N/A,892,902,N/A,17,2
7,N/A,N/A,N/A,885,892,N/A,22,1
21,N/A,N/A,N/A,864,885,N/A,25,4
15,N/A,N/A,N/A,849,864,N/A,31,4
10,N/A,N/A,N/A,839,849,N/A,35,2
39,N/A,N/A,N/A,800,839,N/A,39,6
48,N/A,N/A,N/A,752,800,N/A,44,5
7,N/A,N/A,N/A,745,752,N/A,48,3
10,N/A,N/A,N/A,735,745,N/A,53,2
6,N/A,N/A,N/A,729,735,N/A,58,1
8,N/A,N/A,N/A,721,729,N/A,64,1
18,N/A,N/A,N/A,703,721,N/A,67,4
29,N/A,N/A,N/A,674,703,N/A,73,4
28,N/A,N/A,N/A,646,674,N/A,79,4
11,N/A,N/A,N/A,635,646,N/A,83,2
5,N/A,N/A,N/A,630,635,N/A,88,1
29,N/A,N/A,N/A,601,630,N/A,93,6
6,N/A,N/A,N/A,595,601,N/A,99,0
8,N/A,N/A,N/A,587,595,N/A,102,3
7,N/A,N/A,N/A,580,587,N/A,107,2
9,N/A,N/A,N/A,571,580,N/A,113,2
10,N/A,N/A,N/A,561,571,N/A,119,2
8,N/A,N/A,N/A,553,561,N/A,125,2
39,N/A,N/A,N/A,514,553,N/A,128,5
8,N/A,N/A,N/A,506,514,N/A,131,2
26,N/A,N/A,N/A,480,506,N/A,134,5
7,N/A,N/A,N/A,473,480,N/A,138,3
28,N/A,N/A,N/A,860,888,N/A,4,4
23,N/A,N/A,N/A,837,860,N/A,10,4
11,N/A,N/A,N/A,826,837,N/A,15,3
7,N/A,N/A,N/A,819,826,N/A,19,1
43,N/A,N/A,N/A,776,819,N/A,23,5
41,N/A,N/A,N/A,735,776,N/A,29,5
29,N/A,N/A,N/A,706,735,N/A,34,4
18,N/A,N/A,N/A,688,706,N/A,40,4
9,N/A,N/A,N/A,679,688,N/A,43,1
37,N/A,N/A,N/A,642,679,N/A,47,5
7,N/A,N/A,N/A,635,642,N/A,51,3
8,N/A,N/A,N/A,627,635,N/A,55,1
48,N/A,N/A,N/A,579,627,N/A,60,6
45,N/A,N/A,N/A,534,579,N/A,65,5
10,N/A,N/A,N/A,524,534,N/A,68,2
10,N/A,N/A,N/A,514,524,N/A,74,2
11,N/A,N/A,N/A,503,514,N/A,80,2
9,N/A,N/A,N/A,494,503,N/A,86,2
9,N/A,N/A,N/A,485,494,N/A,91,1
5,N/A,N/A,N/A,480,485,N/A,97,1
15,N/A,N/A,N/A,465,480,N/A,100,4
8,N/A,N/A,N/A,457,465,N/A,104,2
5,N/A,N/A,N/A,452,457,N/A,109,1
39,N/A,N/A,N/A,413,452,N/A,113,5
45,N/A,N/A,N/A,368,413,N/A,119,5
10,N/A,N/A,N/A,358,368,N/A,122,2
7,N/A,N/A,N/A,351,358,N/A,128,2
6,N/A,N/A,N/A,345,351,N/A,133,1
33,N/A,N/A,N/A,312,345,N/A,137,5
11,N/A,N/A,N/A,301,312,N/A,140,2
30,N/A,N/A,N/A,1153,1183,N/A,5,5
11,N/A,N/A,N/A,1142,1153,N/A,9,3
9,N/A,N/A,N/A,1133,1142,N/A,15,3
10,N/A,N/A,N/A,1123,1133,N/A,21,3
11,N/A,N/A,N/A,1112,1123,N/A,27,3
10,N/A,N/A,N/A,1102,1112,N/A,33,3
7,N/A,N/A,N/A,1095,1102,N/A,37,1
6,N/A,N/A,N/A,1089,1095,N/A,43,1
17,N/A,N/A,N/A,1072,1089,N/A,46,4
10,N/A,N/A,N/A,1062,1072,N/A,50,2
7,N/A,N/A,N/A,1055,1062,N/A,56,2
8,N/A,N/A,N/A,1047,1055,N/A,61,1
27,N/A,N/A,N/A,1020,1047,N/A,66,6
10,N/A,N/A,N/A,1010,1020,N/A,69,3
31,N/A,N/A,N/A,979,1010,N/A,72,6
25,N/A,N/A,N/A,954,979,N/A,76,4
6,N/A,N/A,N/A,948,954,N/A,79,1
16,N/A,N/A,N/A,932,948,N/A,82,4
22,N/A,N/A,N/A,910,932,N/A,88,4
12,N/A,N/A,N/A,898,910,N/A,94,4
25,N/A,N/A,N/A,873,898,N/A,100,4
8,N/A,N/A,N/A,865,873,N/A,103,1
31,N/A,N/A,N/A,834,865,N/A,107,5
15,N/A,N/A,N/A,819,834,N/A,112,4
11,N/A,N/A,N/A,808,819,N/A,117,3
8,N/A,N/A,N/A,800,808,N/A,121,1
27,N/A,N/A,N/A,773,800,N/A,124,4
10,N/A,N/A,N/A,763,773,N/A,130,4
9,N/A,N/A,N/A,754,763,N/A,134,2
5,N/A,N/A,N/A,749,754,N/A,139,1
8,N/A,N/A,N/A,1420,1428,N/A,6,1
17,N/A,N/A,N/A,1403,1420,N/A,9,4
16,N/A,N/A,N/A,1387,1403,N/A,15,4
16,N/A,N/A,N/A,1371,1387,N/A,21,4
11,N/A,N/A,N/A,1360,1371,N/A,26,3
10,N/A,N/A,N/A,1350,1360,N/A,31,2
43,N/A,N/A,N/A,1307,1350,N/A,35,6
6,N/A,N/A,N/A,1301,1307,N/A,41,0
16,N/A,N/A,N/A,1285,1301,N/A,45,4
7,N/A,N/A,N/A,1278,1285,N/A,48,1
5,N/A,N/A,N/A,1273,1278,N/A,54,1
8,N/A,N/A,N/A,1265,1273,N/A,60,1
25,N/A,N/A,N/A,1240,1265,N/A,63,4
11,N/A,N/A,N/A,1229,1240,N/A,69,4
9,N/A,N/A,N/A,1220,1229,N/A,72,1
25,N/A,N/A,N/A,1195,1220,N/A,77,6
20,N/A,N/A,N/A,1175,1195,N/A,81,4
7,N/A,N/A,N/A,1168,1175,N/A,86,3
11,N/A,N/A,N/A,1157,1168,N/A,91,2
49,N/A,N/A,N/A,1108,1157,N/A,95,6
14,N/A,N/A,N/A,1094,1108,N/A,99,4
7,N/A,N/A,N/A,1087,1094,N/A,104,3
11,N/A,N/A,N/A,1076,1087,N/A,109,2
48,N/A,N/A,N/A,1028,1076,N/A,113,6
7,N/A,N/A,N/A,1021,1028,N/A,119,0
7,N/A,N/A,N/A,1014,1021,N/A,122,3
8,N/A,N/A,N/A,1006,1014,N/A,127,2
8,N/A,N/A,N/A,998,1006,N/A,133,2
7,N/A,N/A,N/A,991,998,N/A,139,2
9,N/A,N/A,N/A,982,991,N/A,145,2
29,N/A,N/A,N/A,450,479,N/A,5,4
6,N/A,N/A,N/A,444,450,N/A,8,1
46,N/A,N/A,N/A,398,444,N/A,12,5
11,N/A,N/A,N/A,387,398,N/A,15,2
5,N/A,N/A,N/A,382,387,N/A,20,1
46,N/A,N/A,N/A,336,382,N/A,24,5
23,N/A,N/A,N/A,313,336,N/A,29,4
17,N/A,N/A,N/A,296,313,N/A,35,4
6,N/A,N/A,N/A,290,296,N/A,38,1
7,N/A,N/A,N/A,283,290,N/A,44,1
7,N/A,N/A,N/A,276,283,N/A,50,1
26,N/A,N/A,N/A,250,276,N/A,53,4
7,N/A,N/A,N/A,243,250,N/A,56,1
36,N/A,N/A,N/A,207,243,N/A,61,6
18,N/A,N/A,N/A,189,207,N/A,65,4
24,N/A,N/A,N/A,165,189,N/A,71,4
7,N/A,N/A,N/A,158,165,N/A,75,2
45,N/A,N/A,N/A,113,158,N/A,78,5
11,N/A,N/A,N/A,102,113,N/A,81,2
5,N/A,N/A,N/A,97,102,N/A,86,1
35,N/A,N/A,N/A,62,97,N/A,91,6
8,N/A,N/A,N/A,54,62,N/A,97,0
11,N/A,N/A,N/A,43,54,N/A,100,3
6,N/A,N/A,N/A,37,43,N/A,104,1
8,N/A,N/A,N/A,29,37,N/A,110,1
8,N/A,N/A,N/A,21,29,N/A,116,1
9,N/A,N/A,N/A,12,21,N/A,122,1
12,N/A,N/A,N/A,0,12,N/A,125,4
38,N/A,N/A,N/A,1829,1867,N/A,5,6
8,N/A,N/A,N/A,1821,1829,N/A,11,0
29,N/A,N/A,N/A,1792,1821,N/A,16,5
11,N/A,N/A,N/A,1781,1792,N/A,19,2
10,N/A,N/A,N/A,1771,1781,N/A,25,2
9,N/A,N/A,N/A,1762,1771,N/A,30,1
6,N/A,N/A,N/A,1756,1762,N/A,36,1
24,N/A,N/A,N/A,1732,1756,N/A,39,4
10,N/A,N/A,N/A,1722,1732,N/A,43,2
48,N/A,N/A,N/A,1674,1722,N/A,47,6
10,N/A,N/A,N/A,1664,1674,N/A,50,3
8,N/A,N/A,N/A,1656,1664,N/A,55,2
46,N/A,N/A,N/A,1610,1656,N/A,59,6
8,N/A,N/A,N/A,1602,1610,N/A,65,0
45,N/A,N/A,N/A,1557,1602,N/A,70,5
11,N/A,N/A,N/A,1546,1557,N/A,74,3
47,N/A,N/A,N/A,1499,1546,N/A,77,6
6,N/A,N/A,N/A,1493,1499,N/A,83,0
11,N/A,N/A,N/A,1482,1493,N/A,87,4
5,N/A,N/A,N/A,1477,1482,N/A,90,1
30,N/A,N/A,N/A,1447,1477,N/A,94,5
22,N/A,N/A,N/A,1425,1447,N/A,99,4
15,N/A,N/A,N/A,1410,1425,N/A,105,4
6,N/A,N/A,N/A,1404,1410,N/A,108,1
42,N/A,N/A,N/A,1362,1404,N/A,113,6
21,N/A,N/A,N/A,1341,1362,N/A,117,4
11,N/A,N/A,N/A,1330,1341,N/A,122,3
10,N/A,N/A,N/A,1320,1330,N/A,128,3
7,N/A,N/A,N/A,1313,1320,N/A,133,2
7,N/A,N/A,N/A,1306,1313,N/A,139,2
8,N/A,N/A,N/A,1430,1438,N/A,4,2
7,N/A,N/A,N/A,1423,1430,N/A,10,2
10,N/A,N/A,N/A,1413,1423,N/A,16,2
29,N/A,N/A,N/A,1384,1413,N/A,19,5
9,N/A,N/A,N/A,1375,1384,N/A,22,2
35,N/A,N/A,N/A,1340,1375,N/A,25,5
23,N/A,N/A,N/A,1317,1340,N/A,30,4
11,N/A,N/A,N/A,1306,1317,N/A,35,3
10,N/A,N/A,N/A,1296,1306,N/A,41,3
11,N/A,N/A,N/A,1285,1296,N/A,46,2
11,N/A,N/A,N/A,1274,1285,N/A,52,2
6,N/A,N/A,N/A,1268,1274,N/A,57,1
9,N/A,N/A,N/A,1259,1268,N/A,63,1
44,N/A,N/A,N/A,1215,1259,N/A,67,5
7,N/A,N/A,N/A,1208,1215,N/A,70,2
7,N/A,N/A,N/A,1201,1208,N/A,75,1
10,N/A,N/A,N/A,1191,1201,N/A,78,4
16,N/A,N/A,N/A,1175,1191,N/A,84,4
8,N/A,N/A,N/A,1167,1175,N/A,89,3
46,N/A,N/A,N/A,1121,1167,N/A,92,6
36,N/A,N/A,N/A,1085,1121,N/A,97,5
10,N/A,N/A,N/A,1075,1085,N/A,100,2
9,N/A,N/A,N/A,1066,1075,N/A,105,1
5,N/A,N/A,N/A,1061,1066,N/A,111,1
29,N/A,N/A,N/A,1032,1061,N/A,115,5
9,N/A,N/A,N/A,1023,1032,N/A,119,3
8,N/A,N/A,N/A,1015,1023,N/A,125,3
36,N/A,N/A,N/A,979,1015,N/A,128,6
19,N/A,N/A,N/A,960,979,N/A,132,4
8,N/A,N/A,N/A,952,960,N/A,137,3
35,N/A,N/A,N/A,1845,1880,N/A,3,5
7,N/A,N/A,N/A,1838,1845,N/A,6,2
38,N/A,N/A,N/A,1800,1838,N/A,10,6
10,N/A,N/A,N/A,1790,1800,N/A,13,3
6,N/A,N/A,N/A,1784,1790,N/A,17,1
19,N/A,N/A,N/A,1765,1784,N/A,20,4
17,N/A,N/A,N/A,1748,1765,N/A,26,4
5,N/A,N/A,N/A,1743,1748,N/A,29,1
47,N/A,N/A,N/A,1696,1743,N/A,33,5
21,N/A,N/A,N/A,1675,1696,N/A,38,4
10,N/A,N/A,N/A,1665,1675,N/A,44,4
8,N/A,N/A,N/A,1657,1665,N/A,47,1
38,N/A,N/A,N/A,1619,1657,N/A,52,6
9,N/A,N/A,N/A,1610,1619,N/A,55,3
10,N/A,N/A,N/A,1600,1610,N/A,60,2
9,N/A,N/A,N/A,1591,1600,N/A,66,2
9,N/A,N/A,N/A,1582,1591,N/A,72,2
8,N/A,N/A,N/A,1574,1582,N/A,78,2
41,N/A,N/A,N/A,1533,1574,N/A,81,5
45,N/A,N/A,N/A,1488,1533,N/A,87,5
42,N/A,N/A,N/A,1446,1488,N/A,93,5
40,N/A,N/A,N/A,1406,1446,N/A,99,5
9,N/A,N/A,N/A,1397,1406,N/A,102,2
26,N/A,N/A,N/A,1371,1397,N/A,106,6
6,N/A,N/A,N/A,1365,1371,N/A,112,0
8,N/A,N/A,N/A,1357,1365,N/A,115,3
7,N/A,N/A,N/A,1350,1357,N/A,121,3
9,N/A,N/A,N/A,1341,1350,N/A,126,2
9,N/A,N/A,N/A,1332,1341,N/A,131,1
18,N/A,N/A,N/A,1314,1332,N/A,134,4
26,N/A,N/A,N/A,374,400,N/A,5,4
9,N/A,N/A,N/A,365,374,N/A,10,3
11,N/A,N/A,N/A,354,365,N/A,15,2
6,N/A,N/A,N/A,348,354,N/A,20,1
6,N/A,N/A,N/A,342,348,N/A,26,1
14,N/A,N/A,N/A,328,342,N/A,29,4
7,N/A,N/A,N/A,321,328,N/A,33,2
5,N/A,N/A,N/A,316,321,N/A,38,1
43,N/A,N/A,N/A,273,316,N/A,43,6
28,N/A,N/A,N/A,245,273,N/A,48,5
31,N/A,N/A,N/A,214,245,N/A,54,5
11,N/A,N/A,N/A,203,214,N/A,59,4
9,N/A,N/A,N/A,194,203,N/A,64,3
7,N/A,N/A,N/A,187,194,N/A,68,1
30,N/A,N/A,N/A,157,187,N/A,72,5
11,N/A,N/A,N/A,146,157,N/A,76,3
7,N/A,N/A,N/A,139,146,N/A,81,2
49,N/A,N/A,N/A,90,139,N/A,84,5
21,N/A,N/A,N/A,69,90,N/A,89,4
5,N/A,N/A,N/A,64,69,N/A,92,1
32,N/A,N/A,N/A,32,64,N/A,97,6
12,N/A,N/A,N/A,20,32,N/A,101,4
16,N/A,N/A,N/A,4,20,N/A,107,4
25,N/A,N/A,N/A,-21,4,N/A,113,4
26,N/A,N/A,N/A,274,300,N/A,4,6
45,N/A,N/A,N/A,229,274,N/A,9,5
10,N/A,N/A,N/A,219,229,N/A,12,2
11,N/A,N/A,N/A,208,219,N/A,18,2
7,N/A,N/A,N/A,201,208,N/A,23,1
5,N/A,N/A,N/A,196,201,N/A,29,1
20,N/A,N/A,N/A,176,196,N/A,32,4
5,N/A,N/A,N/A,171,176,N/A,35,1
26,N/A,N/A,N/A,145,171,N/A,40,6
9,N/A,N/A,N/A,136,145,N/A,46,0
15,N/A,N/A,N/A,121,136,N/A,50,4
7,N/A,N/A,N/A,114,121,N/A,55,3
11,N/A,N/A,N/A,103,114,N/A,61,3
5,N/A,N/A,N/A,98,103,N/A,65,1
40,N/A,N/A,N/A,58,98,N/A,70,6
7,N/A,N/A,N/A,51,58,N/A,76,0
7,N/A,N/A,N/A,44,51,N/A,79,3
8,N/A,N/A,N/A,36,44,N/A,83,1
14,N/A,N/A,N/A,22,36,N/A,86,4
7,N/A,N/A,N/A,15,22,N/A,91,3
8,N/A,N/A,N/A,7,15,N/A,95,1
6,N/A,N/A,N/A,1,7,N/A,101,1
7,N/A,N/A,N/A,-6,1,N/A,107,1
5,N/A,N/A,N/A,829,834,N/A,6,1
24,N/A,N/A,N/A,805,829,N/A,9,4
11,N/A,N/A,N/A,794,805,N/A,13,2
43,N/A,N/A,N/A,751,794,N/A,17,6
6,N/A,N/A,N/A,745,751,N/A,23,0
34,N/A,N/A,N/A,711,745,N/A,28,5
10,N/A,N/A,N/A,701,711,N/A,32,3
7,N/A,N/A,N/A,694,701,N/A,38,3
8,N/A,N/A,N/A,686,694,N/A,44,3
30,N/A,N/A,N/A,656,686,N/A,47,6
5,N/A,N/A,N/A,651,656,N/A,53,0
25,N/A,N/A,N/A,626,651,N/A,58,5
7,N/A,N/A,N/A,619,626,N/A,61,2
10,N/A,N/A,N/A,609,619,N/A,67,2
9,N/A,N/A,N/A,600,609,N/A,73,2
8,N/A,N/A,N/A,592,600,N/A,79,2
32,N/A,N/A,N/A,560,592,N/A,82,5
36,N/A,N/A,N/A,524,560,N/A,88,5
36,N/A,N/A,N/A,488,524,N/A,94,5
21,N/A,N/A,N/A,467,488,N/A,99,4
9,N/A,N/A,N/A,458,467,N/A,104,3
9,N/A,N/A,N/A,449,458,N/A,109,2
43,N/A,N/A,N/A,406,449,N/A,113,6
22,N/A,N/A,N/A,384,406,N/A,117,4
5,N/A,N/A,N/A,379,384,N/A,120,1
42,N/A,N/A,N/A,337,379,N/A,124,5
18,N/A,N/A,N/A,319,337,N/A,129,4
10,N/A,N/A,N/A,309,319,N/A,134,3
10,N/A,N/A,N/A,299,309,N/A,140,3
8,N/A,N/A,N/A,291,299,N/A,145,2
47,N/A,N/A,N/A,912,959,N/A,3,6
8,N/A,N/A,N/A,904,912,N/A,6,3
38,N/A,N/A,N/A,866,904,N/A,9,6
48,N/A,N/A,N/A,818,866,N/A,14,5
39,N/A,N/A,N/A,779,818,N/A,20,5
9,N/A,N/A,N/A,770,779,N/A,23,2
47,N/A,N/A,N/A,723,770,N/A,27,6
8,N/A,N/A,N/A,715,723,N/A,30,3
32,N/A,N/A,N/A,683,715,N/A,33,6
15,N/A,N/A,N/A,668,683,N/A,37,4
5,N/A,N/A,N/A,663,668,N/A,40,1
29,N/A,N/A,N/A,634,663,N/A,44,5
26,N/A,N/A,N/A,608,634,N/A,49,4
7,N/A,N/A,N/A,601,608,N/A,54,3
47,N/A,N/A,N/A,554,601,N/A,57,6
25,N/A,N/A,N/A,529,554,N/A,61,4
11,N/A,N/A,N/A,518,529,N/A,66,3
7,N/A,N/A,N/A,511,518,N/A,71,2
30,N/A,N/A,N/A,481,511,N/A,75,6
8,N/A,N/A,N/A,473,481,N/A,78,3
10,N/A,N/A,N/A,463,473,N/A,84,3
32,N/A,N/A,N/A,431,463,N/A,87,6
47,N/A,N/A,N/A,384,431,N/A,92,5
10,N/A,N/A,N/A,374,384,N/A,97,4
8,N/A,N/A,N/A,366,374,N/A,100,1
41,N/A,N/A,N/A,325,366,N/A,105,6
7,N/A,N/A,N/A,318,325,N/A,111,0
47,N/A,N/A,N/A,271,318,N/A,117,6
25,N/A,N/A,N/A,246,271,N/A,122,5
32,N/A,N/A,N/A,214,246,N/A,128,5
8,N/A,N/A,N/A,1165,1173,N/A,3,3
8,N/A,N/A,N/A,1157,1165,N/A,8,2
5,N/A,N/A,N/A,1152,1157,N/A,13,1
6,N/A,N/A,N/A,1146,1152,N/A,19,1
32,N/A,N/A,N/A,1114,1146,N/A,23,5
38,N/A,N/A,N/A,1076,1114,N/A,29,5
25,N/A,N/A,N/A,1051,1076,N/A,34,4
10,N/A,N/A,N/A,1041,1051,N/A,39,3
8,N/A,N/A,N/A,1033,1041,N/A,45,3
8,N/A,N/A,N/A,1025,1033,N/A,50,2
9,N/A,N/A,N/A,1016,1025,N/A,56,2
9,N/A,N/A,N/A,1007,1016,N/A,62,2
9,N/A,N/A,N/A,998,1007,N/A,68,2
7,N/A,N/A,N/A,991,998,N/A,74,2
46,N/A,N/A,N/A,945,991,N/A,77,5
8,N/A,N/A,N/A,937,945,N/A,80,2
9,N/A,N/A,N/A,928,937,N/A,86,2
7,N/A,N/A,N/A,921,928,N/A,92,2
48,N/A,N/A,N/A,873,921,N/A,95,5
11,N/A,N/A,N/A,862,873,N/A,99,3
10,N/A,N/A,N/A,852,862,N/A,105,3
7,N/A,N/A,N/A,845,852,N/A,110,2
9,N/A,N/A,N/A,836,845,N/A,115,1
8,N/A,N/A,N/A,828,836,N/A,121,1
49,N/A,N/A,N/A,779,828,N/A,126,6
48,N/A,N/A,N/A,731,779,N/A,131,5
11,N/A,N/A,N/A,720,731,N/A,135,3
9,N/A,N/A,N/A,711,720,N/A,141,3
41,N/A,N/A,N/A,670,711,N/A,144,6
11,N/A,N/A,N/A,659,670,N/A,147,3
29,N/A,N/A,N/A,745,774,N/A,5,6
19,N/A,N/A,N/A,726,745,N/A,9,4
5,N/A,N/A,N/A,721,726,N/A,12,1
25,N/A,N/A,N/A,696,721,N/A,17,6
8,N/A,N/A,N/A,688,696,N/A,23,0
9,N/A,N/A,N/A,679,688,N/A,26,3
8,N/A,N/A,N/A,671,679,N/A,32,3
9,N/A,N/A,N/A,662,671,N/A,37,2
37,N/A,N/A,N/A,625,662,N/A,40,5
18,N/A,N/A,N/A,607,625,N/A,45,4
9,N/A,N/A,N/A,598,607,N/A,48,1
48,N/A,N/A,N/A,550,598,N/A,53,6
8,N/A,N/A,N/A,542,550,N/A,59,0
49,N/A,N/A,N/A,493,542,N/A,65,6
10,N/A,N/A,N/A,483,493,N/A,68,3
25,N/A,N/A,N/A,458,483,N/A,71,6
33,N/A,N/A,N/A,425,458,N/A,76,5
10,N/A,N/A,N/A,415,425,N/A,80,3
42,N/A,N/A,N/A,373,415,N/A,83,6
34,N/A,N/A,N/A,339,373,N/A,88,5
11,N/A,N/A,N/A,328,339,N/A,91,2
48,N/A,N/A,N/A,280,328,N/A,95,6
41,N/A,N/A,N/A,239,280,N/A,100,5
18,N/A,N/A,N/A,221,239,N/A,105,4
10,N/A,N/A,N/A,211,221,N/A,110,3
7,N/A,N/A,N/A,204,211,N/A,114,1
48,N/A,N/A,N/A,156,204,N/A,118,5
9,N/A,N/A,N/A,147,156,N/A,122,3
41,N/A,N/A,N/A,106,147,N/A,125,6
36,N/A,N/A,N/A,70,106,N/A,130,5
20,N/A,N/A,N/A,742,762,N/A,6,4
11,N/A,N/A,N/A,731,742,N/A,10,2
9,N/A,N/A,N/A,722,731,N/A,15,1
26,N/A,N/A,N/A,696,722,N/A,18,4
5,N/A,N/A,N/A,691,696,N/A,21,1
41,N/A,N/A,N/A,650,691,N/A,26,6
11,N/A,N/A,N/A,639,650,N/A,29,3
11,N/A,N/A,N/A,628,639,N/A,34,2
32,N/A,N/A,N/A,596,628,N/A,38,6
11,N/A,N/A,N/A,585,596,N/A,41,3
27,N/A,N/A,N/A,558,585,N/A,44,6
19,N/A,N/A,N/A,539,558,N/A,48,4
10,N/A,N/A,N/A,529,539,N/A,52,2
8,N/A,N/A,N/A,521,529,N/A,57,1
42,N/A,N/A,N/A,479,521,N/A,62,6
21,N/A,N/A,N/A,458,479,N/A,66,4
18,N/A,N/A,N/A,440,458,N/A,72,4
10,N/A,N/A,N/A,430,440,N/A,78,4
26,N/A,N/A,N/A,404,430,N/A,84,4
10,N/A,N/A,N/A,394,404,N/A,89,3
33,N/A,N/A,N/A,361,394,N/A,92,6
39,N/A,N/A,N/A,322,361,N/A,97,5
26,N/A,N/A,N/A,296,322,N/A,102,4
11,N/A,N/A,N/A,285,296,N/A,107,3
7,N/A,N/A,N/A,278,285,N/A,113,3
5,N/A,N/A,N/A,273,278,N/A,117,1
28,N/A,N/A,N/A,245,273,N/A,120,4
8,N/A,N/A,N/A,237,245,N/A,123,1
23,N/A,N/A,N/A,214,237,N/A,126,4
10,N/A,N/A,N/A,204,214,N/A,131,3
26,N/A,N/A,N/A,535,561,N/A,5,4
9,N/A,N/A,N/A,526,535,N/A,9,2
5,N/A,N/A,N/A,521,526,N/A,14,1
16,N/A,N/A,N/A,505,521,N/A,17,4
6,N/A,N/A,N/A,499,505,N/A,20,1
14,N/A,N/A,N/A,485,499,N/A,23,4
11,N/A,N/A,N/A,474,485,N/A,27,2
6,N/A,N/A,N/A,468,474,N/A,32,1
6,N/A,N/A,N/A,462,468,N/A,38,1
7,N/A,N/A,N/A,455,462,N/A,44,1
40,N/A,N/A,N/A,415,455,N/A,49,6
8,N/A,N/A,N/A,407,415,N/A,55,0
10,N/A,N/A,N/A,397,407,N/A,58,3
10,N/A,N/A,N/A,387,397,N/A,64,3
10,N/A,N/A,N/A,377,387,N/A,70,3
11,N/A,N/A,N/A,366,377,N/A,76,3
9,N/A,N/A,N/A,357,366,N/A,81,2
27,N/A,N/A,N/A,330,357,N/A,85,6
11,N/A,N/A,N/A,319,330,N/A,88,3
40,N/A,N/A,N/A,279,319,N/A,91,6
25,N/A,N/A,N/A,254,279,N/A,95,4
29,N/A,N/A,N/A,225,254,N/A,101,4
7,N/A,N/A,N/A,218,225,N/A,104,1
38,N/A,N/A,N/A,180,218,N/A,109,6
19,N/A,N/A,N/A,161,180,N/A,113,4
16,N/A,N/A,N/A,145,161,N/A,119,4
19,N/A,N/A,N/A,126,145,N/A,125,4
9,N/A,N/A,N/A,117,126,N/A,130,3
39,N/A,N/A,N/A,78,117,N/A,133,6
6,N/A,N/A,N/A,72,78,N/A,139,0
7,N/A,N/A,N/A,1795,1802,N/A,4,3
10,N/A,N/A,N/A,1785,1795,N/A,10,3
36,N/A,N/A,N/A,1749,1785,N/A,13,6
42,N/A,N/A,N/A,1707,1749,N/A,18,5
9,N/A,N/A,N/A,1698,1707,N/A,22,3
10,N/A,N/A,N/A,1688,1698,N/A,28,3
7,N/A,N/A,N/A,1681,1688,N/A,32,1
23,N/A,N/A,N/A,1658,1681,N/A,35,4
11,N/A,N/A,N/A,1647,1658,N/A,39,2
6,N/A,N/A,N/A,1641,1647,N/A,44,1
34,N/A,N/A,N/A,1607,1641,N/A,49,6
28,N/A,N/A,N/A,1579,1607,N/A,54,5
39,N/A,N/A,N/A,1540,1579,N/A,60,5
11,N/A,N/A,N/A,1529,1540,N/A,63,2
39,N/A,N/A,N/A,1490,1529,N/A,66,5
28,N/A,N/A,N/A,1462,1490,N/A,72,5
12,N/A,N/A,N/A,1450,1462,N/A,77,4
21,N/A,N/A,N/A,1429,1450,N/A,83,4
7,N/A,N/A,N/A,1422,1429,N/A,86,1
26,N/A,N/A,N/A,1396,1422,N/A,91,6
7,N/A,N/A,N/A,1389,1396,N/A,94,3
7,N/A,N/A,N/A,1382,1389,N/A,99,2
47,N/A,N/A,N/A,1335,1382,N/A,103,6
11,N/A,N/A,N/A,1324,1335,N/A,106,3
31,N/A,N/A,N/A,1293,1324,N/A,109,6
8,N/A,N/A,N/A,1285,1293,N/A,115,0
44,N/A,N/A,N/A,1241,1285,N/A,121,6
17,N/A,N/A,N/A,1224,1241,N/A,125,4
7,N/A,N/A,N/A,1217,1224,N/A,130,3
11,N/A,N/A,N/A,1206,1217,N/A,136,3
7,N/A,N/A,N/A,728,735,N/A,5,3
11,N/A,N/A,N/A,717,728,N/A,10,2
39,N/A,N/A,N/A,678,717,N/A,14,6
40,N/A,N/A,N/A,638,678,N/A,19,5
8,N/A,N/A,N/A,630,638,N/A,22,2
9,N/A,N/A,N/A,621,630,N/A,28,2
26,N/A,N/A,N/A,595,621,N/A,32,6
20,N/A,N/A,N/A,575,595,N/A,36,4
29,N/A,N/A,N/A,546,575,N/A,42,4
7,N/A,N/A,N/A,539,546,N/A,45,1
8,N/A,N/A,N/A,531,539,N/A,51,1
32,N/A,N/A,N/A,499,531,N/A,56,6
28,N/A,N/A,N/A,471,499,N/A,61,5
11,N/A,N/A,N/A,460,471,N/A,65,3
49,N/A,N/A,N/A,411,460,N/A,68,6
11,N/A,N/A,N/A,400,411,N/A,72,4
10,N/A,N/A,N/A,390,400,N/A,77,3
9,N/A,N/A,N/A,381,390,N/A,82,2
42,N/A,N/A,N/A,339,381,N/A,85,5
7,N/A,N/A,N/A,332,339,N/A,88,2
8,N/A,N/A,N/A,324,332,N/A,93,1
28,N/A,N/A,N/A,296,324,N/A,96,4
9,N/A,N/A,N/A,287,296,N/A,101,3
8,N/A,N/A,N/A,279,287,N/A,107,3
10,N/A,N/A,N/A,269,279,N/A,112,2
38,N/A,N/A,N/A,231,269,N/A,116,6
8,N/A,N/A,N/A,223,231,N/A,119,3
40,N/A,N/A,N/A,183,223,N/A,122,6
10,N/A,N/A,N/A,173,183,N/A,125,3
36,N/A,N/A,N/A,137,173,N/A,128,6
38,N/A,N/A,N/A,1176,1214,N/A,4,6
14,N/A,N/A,N/A,1162,1176,N/A,8,4
9,N/A,N/A,N/A,1153,1162,N/A,11,1
40,N/A,N/A,N/A,1113,1153,N/A,16,6
34,N/A,N/A,N/A,1079,1113,N/A,21,5
11,N/A,N/A,N/A,1068,1079,N/A,25,3
9,N/A,N/A,N/A,1059,1068,N/A,29,1
10,N/A,N/A,N/A,1049,1059,N/A,32,4
9,N/A,N/A,N/A,1040,1049,N/A,36,2
9,N/A,N/A,N/A,1031,1040,N/A,42,2
9,N/A,N/A,N/A,1022,1031,N/A,48,2
40,N/A,N/A,N/A,982,1022,N/A,52,6
10,N/A,N/A,N/A,972,982,N/A,55,3
9,N/A,N/A,N/A,963,972,N/A,61,3
30,N/A,N/A,N/A,933,963,N/A,64,6
10,N/A,N/A,N/A,923,933,N/A,67,3
9,N/A,N/A,N/A,914,923,N/A,71,1
39,N/A,N/A,N/A,875,914,N/A,75,5
46,N/A,N/A,N/A,829,875,N/A,81,5
48,N/A,N/A,N/A,781,829,N/A,87,5
45,N/A,N/A,N/A,736,781,N/A,93,5
8,N/A,N/A,N/A,728,736,N/A,97,3
40,N/A,N/A,N/A,688,728,N/A,100,6
11,N/A,N/A,N/A,677,688,N/A,104,4
5,N/A,N/A,N/A,672,677,N/A,107,1
21,N/A,N/A,N/A,651,672,N/A,110,4
8,N/A,N/A,N/A,643,651,N/A,115,3
8,N/A,N/A,N/A,635,643,N/A,119,1
9,N/A,N/A,N/A,626,635,N/A,125,1
48,N/A,N/A,N/A,578,626,N/A,129,5
45,N/A,N/A,N/A,503,548,N/A,5,6
6,N/A,N/A,N/A,497,503,N/A,11,0
43,N/A,N/A,N/A,454,497,N/A,16,5
10,N/A,N/A,N/A,444,454,N/A,20,3
11,N/A,N/A,N/A,433,444,N/A,25,2
35,N/A,N/A,N/A,398,433,N/A,28,5
8,N/A,N/A,N/A,390,398,N/A,32,3
47,N/A,N/A,N/A,343,390,N/A,35,6
7,N/A,N/A,N/A,336,343,N/A,41,0
8,N/A,N/A,N/A,328,336,N/A,44,3
8,N/A,N/A,N/A,320,328,N/A,50,3
7,N/A,N/A,N/A,313,320,N/A,55,2
32,N/A,N/A,N/A,281,313,N/A,59,6
17,N/A,N/A,N/A,264,281,N/A,63,4
5,N/A,N/A,N/A,259,264,N/A,66,1
32,N/A,N/A,N/A,227,259,N/A,70,5
35,N/A,N/A,N/A,192,227,N/A,76,5
7,N/A,N/A,N/A,185,192,N/A,80,3
8,N/A,N/A,N/A,177,185,N/A,86,3
10,N/A,N/A,N/A,167,177,N/A,91,2
49,N/A,N/A,N/A,118,167,N/A,95,6
5,N/A,N/A,N/A,113,118,N/A,101,0
33,N/A,N/A,N/A,80,113,N/A,107,6
43,N/A,N/A,N/A,37,80,N/A,112,5
7,N/A,N/A,N/A,30,37,N/A,116,3
7,N/A,N/A,N/A,23,30,N/A,120,1
7,N/A,N/A,N/A,16,23,N/A,126,1
19,N/A,N/A,N/A,-3,16,N/A,129,4
9,N/A,N/A,N/A,1623,1632,N/A,6,1
24,N/A,N/A,N/A,1599,1623,N/A,9,4
11,N/A,N/A,N/A,1588,1599,N/A,14,3
25,N/A,N/A,N/A,1563,1588,N/A,17,6
5,N/A,N/A,N/A,1558,1563,N/A,23,0
20,N/A,N/A,N/A,1538,1558,N/A,27,4
8,N/A,N/A,N/A,1530,1538,N/A,32,3
7,N/A,N/A,N/A,1523,1530,N/A,36,1
6,N/A,N/A,N/A,1517,1523,N/A,42,1
44,N/A,N/A,N/A,1473,1517,N/A,46,5
40,N/A,N/A,N/A,1433,1473,N/A,52,5
10,N/A,N/A,N/A,1423,1433,N/A,56,3
8,N/A,N/A,N/A,1415,1423,N/A,61,2
42,N/A,N/A,N/A,1373,1415,N/A,64,5
42,N/A,N/A,N/A,1331,1373,N/A,70,5
11,N/A,N/A,N/A,1320,1331,N/A,74,3
10,N/A,N/A,N/A,1310,1320,N/A,79,2
7,N/A,N/A,N/A,1303,1310,N/A,85,2
6,N/A,N/A,N/A,1297,1303,N/A,90,1
5,N/A,N/A,N/A,1292,1297,N/A,96,1
8,N/A,N/A,N/A,1284,1292,N/A,102,1
39,N/A,N/A,N/A,1245,1284,N/A,107,6
34,N/A,N/A,N/A,1211,1245,N/A,112,5
11,N/A,N/A,N/A,1200,1211,N/A,115,2
7,N/A,N/A,N/A,1193,1200,N/A,121,2
43,N/A,N/A,N/A,1150,1193,N/A,124,5
9,N/A,N/A,N/A,1141,1150,N/A,128,3
9,N/A,N/A,N/A,1132,1141,N/A,133,2
11,N/A,N/A,N/A,1121,1132,N/A,139,2
40,N/A,N/A,N/A,1081,1121,N/A,143,6
32,N/A,N/A,N/A,1908,1940,N/A,6,6
5,N/A,N/A,N/A,1903,1908,N/A,12,0
8,N/A,N/A,N/A,1895,1903,N/A,15,3
11,N/A,N/A,N/A,1884,1895,N/A,20,2
38,N/A,N/A,N/A,1846,1884,N/A,24,6
10,N/A,N/A,N/A,1836,1846,N/A,27,3
10,N/A,N/A,N/A,1826,1836,N/A,33,3
43,N/A,N/A,N/A,1783,1826,N/A,36,6
10,N/A,N/A,N/A,1773,1783,N/A,39,3
11,N/A,N/A,N/A,1762,1773,N/A,44,2
40,N/A,N/A,N/A,1722,1762,N/A,47,5
19,N/A,N/A,N/A,1703,1722,N/A,52,4
7,N/A,N/A,N/A,1696,1703,N/A,55,1
6,N/A,N/A,N/A,1690,1696,N/A,61,1
10,N/A,N/A,N/A,1680,1690,N/A,64,4
8,N/A,N/A,N/A,1672,1680,N/A,67,1
34,N/A,N/A,N/A,1638,1672,N/A,72,6
29,N/A,N/A,N/A,1609,1638,N/A,77,5
10,N/A,N/A,N/A,1599,1609,N/A,82,4
7,N/A,N/A,N/A,1592,1599,N/A,86,2
7,N/A,N/A,N/A,1585,1592,N/A,91,1
7,N/A,N/A,N/A,1578,1585,N/A,97,1
6,N/A,N/A,N/A,1572,1578,N/A,103,1
41,N/A,N/A,N/A,1531,1572,N/A,108,6
7,N/A,N/A,N/A,1524,1531,N/A,114,0
37,N/A,N/A,N/A,1487,1524,N/A,120,6
23,N/A,N/A,N/A,1464,1487,N/A,124,4
8,N/A,N/A,N/A,1456,1464,N/A,128,2
33,N/A,N/A,N/A,1423,1456,N/A,131,5
16,N/A,N/A,N/A,1407,1423,N/A,136,4
13,N/A,N/A,N/A,1114,1127,N/A,5,4
8,N/A,N/A,N/A,1106,1114,N/A,10,3
8,N/A,N/A,N/A,1098,1106,N/A,16,3
7,N/A,N/A,N/A,1091,1098,N/A,20,1
11,N/A,N/A,N/A,1080,1091,N/A,23,4
6,N/A,N/A,N/A,1074,1080,N/A,26,1
14,N/A,N/A,N/A,1060,1074,N/A,29,4
10,N/A,N/A,N/A,1050,1060,N/A,34,3
11,N/A,N/A,N/A,1039,1050,N/A,40,3
7,N/A,N/A,N/A,1032,1039,N/A,44,1
21,N/A,N/A,N/A,1011,1032,N/A,47,4
23,N/A,N/A,N/A,988,1011,N/A,53,4
7,N/A,N/A,N/A,981,988,N/A,57,2
48,N/A,N/A,N/A,933,981,N/A,61,6
47,N/A,N/A,N/A,886,933,N/A,66,5
37,N/A,N/A,N/A,849,886,N/A,72,5
36,N/A,N/A,N/A,813,849,N/A,78,5
9,N/A,N/A,N/A,804,813,N/A,82,3
10,N/A,N/A,N/A,794,804,N/A,88,3
9,N/A,N/A,N/A,785,794,N/A,93,2
7,N/A,N/A,N/A,778,785,N/A,99,2
5,N/A,N/A,N/A,773,778,N/A,104,1
9,N/A,N/A,N/A,764,773,N/A,110,1
28,N/A,N/A,N/A,736,764,N/A,113,4
10,N/A,N/A,N/A,726,736,N/A,117,2
10,N/A,N/A,N/A,716,726,N/A,123,2
42,N/A,N/A,N/A,674,716,N/A,127,6
45,N/A,N/A,N/A,629,674,N/A,132,5
7,N/A,N/A,N/A,622,629,N/A,135,2
36,N/A,N/A,N/A,586,622,N/A,138,5
9,N/A,N/A,N/A,1496,1505,N/A,4,2
40,N/A,N/A,N/A,1456,1496,N/A,7,5
45,N/A,N/A,N/A,1411,1456,N/A,13,5
13,N/A,N/A,N/A,1398,1411,N/A,18,4
9,N/A,N/A,N/A,1389,1398,N/A,23,3
9,N/A,N/A,N/A,1380,1389,N/A,27,1
25,N/A,N/A,N/A,1355,1380,N/A,30,4
7,N/A,N/A,N/A,1348,1355,N/A,34,2
8,N/A,N/A,N/A,1340,1348,N/A,39,1
12,N/A,N/A,N/A,1328,1340,N/A,42,4
5,N/A,N/A,N/A,1323,1328,N/A,45,1
19,N/A,N/A,N/A,1304,1323,N/A,48,4
9,N/A,N/A,N/A,1295,1304,N/A,53,3
7,N/A,N/A,N/A,1288,1295,N/A,57,1
26,N/A,N/A,N/A,1262,1288,N/A,61,5
9,N/A,N/A,N/A,1253,1262,N/A,65,3
26,N/A,N/A,N/A,1227,1253,N/A,68,6
8,N/A,N/A,N/A,1219,1227,N/A,71,3
8,N/A,N/A,N/A,1211,1219,N/A,75,1
41,N/A,N/A,N/A,1170,1211,N/A,80,6
27,N/A,N/A,N/A,1143,1170,N/A,84,4
8,N/A,N/A,N/A,1135,1143,N/A,88,2
10,N/A,N/A,N/A,1125,1135,N/A,94,2
45,N/A,N/A,N/A,1080,1125,N/A,97,5
8,N/A,N/A,N/A,1072,1080,N/A,101,3
8,N/A,N/A,N/A,1064,1072,N/A,105,1
15,N/A,N/A,N/A,1049,1064,N/A,108,4
9,N/A,N/A,N/A,1040,1049,N/A,113,3
9,N/A,N/A,N/A,1031,1040,N/A,119,3
7,N/A,N/A,N/A,1024,1031,N/A,124,2
14,N/A,N/A,N/A,1760,1774,N/A,4,4
28,N/A,N/A,N/A,1732,1760,N/A,10,4
9,N/A,N/A,N/A,1723,1732,N/A,15,3
5,N/A,N/A,N/A,1718,1723,N/A,19,1
14,N/A,N/A,N/A,1704,1718,N/A,22,4
7,N/A,N/A,N/A,1697,1704,N/A,26,2
7,N/A,N/A,N/A,1690,1697,N/A,32,2
10,N/A,N/A,N/A,1680,1690,N/A,38,2
42,N/A,N/A,N/A,1638,1680,N/A,42,6
11,N/A,N/A,N/A,1627,1638,N/A,45,3
7,N/A,N/A,N/A,1620,1627,N/A,51,3
10,N/A,N/A,N/A,1610,1620,N/A,56,2
5,N/A,N/A,N/A,1605,1610,N/A,61,1
16,N/A,N/A,N/A,1589,1605,N/A,64,4
5,N/A,N/A,N/A,1584,1589,N/A,67,1
23,N/A,N/A,N/A,1561,1584,N/A,70,4
5,N/A,N/A,N/A,1556,1561,N/A,73,1
36,N/A,N/A,N/A,1520,1556,N/A,78,6
7,N/A,N/A,N/A,1513,1520,N/A,81,3
8,N/A,N/A,N/A,1505,1513,N/A,85,1
35,N/A,N/A,N/A,1470,1505,N/A,90,6
21,N/A,N/A,N/A,1449,1470,N/A,94,4
11,N/A,N/A,N/A,1438,1449,N/A,98,2
48,N/A,N/A,N/A,1390,1438,N/A,101,5
9,N/A,N/A,N/A,1381,1390,N/A,104,2
9,N/A,N/A,N/A,1372,1381,N/A,110,2
10,N/A,N/A,N/A,1362,1372,N/A,116,2
7,N/A,N/A,N/A,1355,1362,N/A,121,1
18,N/A,N/A,N/A,1337,1355,N/A,124,4
11,N/A,N/A,N/A,1326,1337,N/A,129,3
9,N/A,N/A,N/A,1584,1593,N/A,3,3
42,N/A,N/A,N/A,1542,1584,N/A,6,6
12,N/A,N/A,N/A,1530,1542,N/A,10,4
9,N/A,N/A,N/A,1521,1530,N/A,14,2
36,N/A,N/A,N/A,1485,1521,N/A,17,5
11,N/A,N/A,N/A,1474,1485,N/A,21,3
7,N/A,N/A,N/A,1467,1474,N/A,26,2
30,N/A,N/A,N/A,1437,1467,N/A,29,5
11,N/A,N/A,N/A,1426,1437,N/A,33,3
7,N/A,N/A,N/A,1419,1426,N/A,37,1
25,N/A,N/A,N/A,1394,1419,N/A,41,5
7,N/A,N/A,N/A,1387,1394,N/A,44,2
11,N/A,N/A,N/A,1376,1387,N/A,50,2
43,N/A,N/A,N/A,1333,1376,N/A,53,5
11,N/A,N/A,N/A,1322,1333,N/A,57,3
5,N/A,N/A,N/A,1317,1322,N/A,61,1
38,N/A,N/A,N/A,1279,1317,N/A,66,6
25,N/A,N/A,N/A,1254,1279,N/A,70,4
23,N/A,N/A,N/A,1231,1254,N/A,76,4
8,N/A,N/A,N/A,1223,1231,N/A,81,3
9,N/A,N/A,N/A,1214,1223,N/A,87,3
6,N/A,N/A,N/A,1208,1214,N/A,91,1
27,N/A,N/A,N/A,1181,1208,N/A,94,4
6,N/A,N/A,N/A,1175,1181,N/A,97,1
25,N/A,N/A,N/A,1150,1175,N/A,102,6
43,N/A,N/A,N/A,1107,1150,N/A,107,5
10,N/A,N/A,N/A,1097,1107,N/A,110,2
31,N/A,N/A,N/A,1066,1097,N/A,113,5
11,N/A,N/A,N/A,1055,1066,N/A,117,3
46,N/A,N/A,N/A,1009,1055,N/A,120,6
11,N/A,N/A,N/A,1205,1216,N/A,5,4
10,N/A,N/A,N/A,1195,1205,N/A,10,3
7,N/A,N/A,N/A,1188,1195,N/A,14,1
10,N/A,N/A,N/A,1178,1188,N/A,17,4
17,N/A,N/A,N/A,1161,1178,N/A,23,4
7,N/A,N/A,N/A,1154,1161,N/A,26,1
48,N/A,N/A,N/A,1106,1154,N/A,31,6
14,N/A,N/A,N/A,1092,1106,N/A,35,4
7,N/A,N/A,N/A,1085,1092,N/A,39,2
10,N/A,N/A,N/A,1075,1085,N/A,45,2
7,N/A,N/A,N/A,1068,1075,N/A,50,1
21,N/A,N/A,N/A,1047,1068,N/A,53,4
11,N/A,N/A,N/A,1036,1047,N/A,57,2
11,N/A,N/A,N/A,1025,1036,N/A,63,2
46,N/A,N/A,N/A,979,1025,N/A,67,6
7,N/A,N/A,N/A,972,979,N/A,70,3
29,N/A,N/A,N/A,943,972,N/A,73,6
11,N/A,N/A,N/A,932,943,N/A,76,3
11,N/A,N/A,N/A,921,932,N/A,82,3
6,N/A,N/A,N/A,915,921,N/A,86,1
38,N/A,N/A,N/A,877,915,N/A,91,6
9,N/A,N/A,N/A,868,877,N/A,97,0
26,N/A,N/A,N/A,842,868,N/A,103,6
7,N/A,N/A,N/A,835,842,N/A,109,0
20,N/A,N/A,N/A,815,835,N/A,113,4
8,N/A,N/A,N/A,807,815,N/A,116,1
24,N/A,N/A,N/A,783,807,N/A,119,4
15,N/A,N/A,N/A,768,783,N/A,125,4
11,N/A,N/A,N/A,757,768,N/A,130,3
9,N/A,N/A,N/A,748,757,N/A,134,1
9,N/A,N/A,N/A,1572,1581,N/A,3,2
8,N/A,N/A,N/A,1564,1572,N/A,9,2
9,N/A,N/A,N/A,1555,1564,N/A,14,1
39,N/A,N/A,N/A,1516,1555,N/A,19,6
27,N/A,N/A,N/A,1489,1516,N/A,23,4
5,N/A,N/A,N/A,1484,1489,N/A,26,1
25,N/A,N/A,N/A,1459,1484,N/A,30,5
10,N/A,N/A,N/A,1449,1459,N/A,33,2
38,N/A,N/A,N/A,1411,1449,N/A,36,5
46,N/A,N/A,N/A,1365,1411,N/A,42,5
29,N/A,N/A,N/A,1336,1365,N/A,47,4
5,N/A,N/A,N/A,1331,1336,N/A,50,1
39,N/A,N/A,N/A,1292,1331,N/A,55,6
28,N/A,N/A,N/A,1264,1292,N/A,59,4
10,N/A,N/A,N/A,1254,1264,N/A,63,2
10,N/A,N/A,N/A,1244,1254,N/A,69,2
6,N/A,N/A,N/A,1238,1244,N/A,74,1
25,N/A,N/A,N/A,1213,1238,N/A,78,5
8,N/A,N/A,N/A,1205,1213,N/A,81,2
46,N/A,N/A,N/A,1159,1205,N/A,85,6
48,N/A,N/A,N/A,1111,1159,N/A,90,5
47,N/A,N/A,N/A,1064,1111,N/A,96,5
41,N/A,N/A,N/A,1023,1064,N/A,102,5
7,N/A,N/A,N/A,1016,1023,N/A,105,2
9,N/A,N/A,N/A,1007,1016,N/A,111,2
36,N/A,N/A,N/A,971,1007,N/A,115,6
6,N/A,N/A,N/A,965,971,N/A,121,0
32,N/A,N/A,N/A,933,965,N/A,126,5
12,N/A,N/A,N/A,921,933,N/A,131,4
24,N/A,N/A,N/A,897,921,N/A,137,4
8,N/A,N/A,N/A,1892,1900,N/A,3,2
7,N/A,N/A,N/A,1885,1892,N/A,9,2
5,N/A,N/A,N/A,1880,1885,N/A,14,1
28,N/A,N/A,N/A,1852,1880,N/A,19,6
9,N/A,N/A,N/A,1843,1852,N/A,25,0
16,N/A,N/A,N/A,1827,1843,N/A,29,4
7,N/A,N/A,N/A,1820,1827,N/A,32,1
44,N/A,N/A,N/A,1776,1820,N/A,37,6
7,N/A,N/A,N/A,1769,1776,N/A,40,3
48,N/A,N/A,N/A,1721,1769,N/A,43,6
28,N/A,N/A,N/A,1693,1721,N/A,47,4
25,N/A,N/A,N/A,1668,1693,N/A,53,4
14,N/A,N/A,N/A,1654,1668,N/A,59,4
8,N/A,N/A,N/A,1646,1654,N/A,63,2
7,N/A,N/A,N/A,1639,1646,N/A,68,1
27,N/A,N/A,N/A,1612,1639,N/A,72,5
7,N/A,N/A,N/A,1605,1612,N/A,75,2
25,N/A,N/A,N/A,1580,1605,N/A,78,5
15,N/A,N/A,N/A,1565,1580,N/A,83,4
8,N/A,N/A,N/A,1557,1565,N/A,86,1
41,N/A,N/A,N/A,1516,1557,N/A,90,5
13,N/A,N/A,N/A,1503,1516,N/A,95,4
10,N/A,N/A,N/A,1493,1503,N/A,100,3
7,N/A,N/A,N/A,1486,1493,N/A,106,3
33,N/A,N/A,N/A,1453,1486,N/A,109,6
29,N/A,N/A,N/A,1424,1453,N/A,114,5
46,N/A,N/A,N/A,1378,1424,N/A,120,5
11,N/A,N/A,N/A,1367,1378,N/A,124,3
7,N/A,N/A,N/A,1360,1367,N/A,130,3
28,N/A,N/A,N/A,1332,1360,N/A,133,6
10,N/A,N/A,N/A,1509,1519,N/A,5,2
26,N/A,N/A,N/A,1483,1509,N/A,9,6
9,N/A,N/A,N/A,1474,1483,N/A,15,0
28,N/A,N/A,N/A,1446,1474,N/A,20,5
8,N/A,N/A,N/A,1438,1446,N/A,24,3
29,N/A,N/A,N/A,1409,1438,N/A,27,6
26,N/A,N/A,N/A,1383,1409,N/A,32,5
20,N/A,N/A,N/A,1363,1383,N/A,37,4
7,N/A,N/A,N/A,1356,1363,N/A,42,3
11,N/A,N/A,N/A,1345,1356,N/A,47,2
32,N/A,N/A,N/A,1313,1345,N/A,50,5
11,N/A,N/A,N/A,1302,1313,N/A,55,4
11,N/A,N/A,N/A,1291,1302,N/A,59,2
32,N/A,N/A,N/A,1259,1291,N/A,62,5
12,N/A,N/A,N/A,1247,1259,N/A,67,4
13,N/A,N/A,N/A,1234,1247,N/A,73,4
11,N/A,N/A,N/A,1223,1234,N/A,78,3
8,N/A,N/A,N/A,1215,1223,N/A,84,3
49,N/A,N/A,N/A,1166,1215,N/A,87,6
30,N/A,N/A,N/A,1136,1166,N/A,92,5
46,N/A,N/A,N/A,1090,1136,N/A,98,5
37,N/A,N/A,N/A,1053,1090,N/A,104,5
11,N/A,N/A,N/A,1042,1053,N/A,107,2
32,N/A,N/A,N/A,1010,1042,N/A,111,6
37,N/A,N/A,N/A,973,1010,N/A,116,5
9,N/A,N/A,N/A,964,973,N/A,119,2
7,N/A,N/A,N/A,957,964,N/A,125,2
46,N/A,N/A,N/A,911,957,N/A,128,5
15,N/A,N/A,N/A,896,911,N/A,133,4
8,N/A,N/A,N/A,888,896,N/A,138,3
9,N/A,N/A,N/A,1909,1918,N/A,3,2
11,N/A,N/A,N/A,1898,1909,N/A,9,2
30,N/A,N/A,N/A,1868,1898,N/A,13,6
23,N/A,N/A,N/A,1845,1868,N/A,17,4
6,N/A,N/A,N/A,1839,1845,N/A,20,1
40,N/A,N/A,N/A,1799,1839,N/A,25,6
7,N/A,N/A,N/A,1792,1799,N/A,28,3
6,N/A,N/A,N/A,1786,1792,N/A,32,1
49,N/A,N/A,N/A,1737,1786,N/A,36,5
8,N/A,N/A,N/A,1729,1737,N/A,39,2
39,N/A,N/A,N/A,1690,1729,N/A,43,6
5,N/A,N/A,N/A,1685,1690,N/A,49,0
34,N/A,N/A,N/A,1651,1685,N/A,55,6
12,N/A,N/A,N/A,1639,1651,N/A,59,4
7,N/A,N/A,N/A,1632,1639,N/A,64,3
5,N/A,N/A,N/A,1627,1632,N/A,68,1
20,N/A,N/A,N/A,1607,1627,N/A,71,4
10,N/A,N/A,N/A,1597,1607,N/A,77,4
11,N/A,N/A,N/A,1586,1597,N/A,81,2
8,N/A,N/A,N/A,1578,1586,N/A,87,2
9,N/A,N/A,N/A,1569,1578,N/A,93,2
36,N/A,N/A,N/A,1533,1569,N/A,96,5
9,N/A,N/A,N/A,1524,1533,N/A,100,3
37,N/A,N/A,N/A,1487,1524,N/A,103,6
7,N/A,N/A,N/A,1480,1487,N/A,106,3
10,N/A,N/A,N/A,1470,1480,N/A,111,2
33,N/A,N/A,N/A,1437,1470,N/A,114,5
8,N/A,N/A,N/A,1429,1437,N/A,118,3
42,N/A,N/A,N/A,1387,1429,N/A,121,6
8,N/A,N/A,N/A,1379,1387,N/A,127,0
32,N/A,N/A,N/A,1029,1061,N/A,5,6
6,N/A,N/A,N/A,1023,1029,N/A,11,0
28,N/A,N/A,N/A,995,1023,N/A,15,4
8,N/A,N/A,N/A,987,995,N/A,20,3
37,N/A,N/A,N/A,950,987,N/A,23,6
7,N/A,N/A,N/A,943,950,N/A,26,3
37,N/A,N/A,N/A,906,943,N/A,29,6
28,N/A,N/A,N/A,878,906,N/A,34,5
9,N/A,N/A,N/A,869,878,N/A,38,3
43,N/A,N/A,N/A,826,869,N/A,41,6
11,N/A,N/A,N/A,815,826,N/A,44,3
7,N/A,N/A,N/A,808,815,N/A,48,1
6,N/A,N/A,N/A,802,808,N/A,54,1
29,N/A,N/A,N/A,773,802,N/A,58,5
11,N/A,N/A,N/A,762,773,N/A,61,2
45,N/A,N/A,N/A,717,762,N/A,64,5
11,N/A,N/A,N/A,706,717,N/A,68,3
49,N/A,N/A,N/A,657,706,N/A,71,6
5,N/A,N/A,N/A,652,657,N/A,77,0
10,N/A,N/A,N/A,642,652,N/A,80,3
7,N/A,N/A,N/A,635,642,N/A,84,1
23,N/A,N/A,N/A,612,635,N/A,87,4
12,N/A,N/A,N/A,600,612,N/A,93,4
10,N/A,N/A,N/A,590,600,N/A,97,2
48,N/A,N/A,N/A,542,590,N/A,100,5
7,N/A,N/A,N/A,535,542,N/A,103,2
48,N/A,N/A,N/A,487,535,N/A,107,6
22,N/A,N/A,N/A,465,487,N/A,111,4
11,N/A,N/A,N/A,454,465,N/A,117,4
10,N/A,N/A,N/A,444,454,N/A,121,2
28,N/A,N/A,N/A,1391,1419,N/A,5,4
7,N/A,N/A,N/A,1384,1391,N/A,9,2
8,N/A,N/A,N/A,1376,1384,N/A,15,2
28,N/A,N/A,N/A,1348,1376,N/A,19,6
22,N/A,N/A,N/A,1326,1348,N/A,23,4
14,N/A,N/A,N/A,1312,1326,N/A,29,4
9,N/A,N/A,N/A,1303,1312,N/A,33,2
47,N/A,N/A,N/A,1256,1303,N/A,36,5
11,N/A,N/A,N/A,1245,1256,N/A,39,2
7,N/A,N/A,N/A,1238,1245,N/A,44,1
13,N/A,N/A,N/A,1225,1238,N/A,47,4
10,N/A,N/A,N/A,1215,1225,N/A,51,2
25,N/A,N/A,N/A,1190,1215,N/A,54,5
24,N/A,N/A,N/A,1166,1190,N/A,59,4
8,N/A,N/A,N/A,1158,1166,N/A,62,1
47,N/A,N/A,N/A,1111,1158,N/A,67,6
14,N/A,N/A,N/A,1097,1111,N/A,71,4
19,N/A,N/A,N/A,1078,1097,N/A,77,4
25,N/A,N/A,N/A,1053,1078,N/A,83,4
13,N/A,N/A,N/A,1040,1053,N/A,89,4
20,N/A,N/A,N/A,1020,1040,N/A,95,4
10,N/A,N/A,N/A,1010,1020,N/A,100,3
10,N/A,N/A,N/A,1000,1010,N/A,105,2
5,N/A,N/A,N/A,995,1000,N/A,110,1
7,N/A,N/A,N/A,988,995,N/A,116,1
26,N/A,N/A,N/A,962,988,N/A,121,6
6,N/A,N/A,N/A,956,962,N/A,127,0
31,N/A,N/A,N/A,925,956,N/A,133,6
9,N/A,N/A,N/A,916,925,N/A,139,0
39,N/A,N/A,N/A,877,916,N/A,145,6
11,N/A,N/A,N/A,1321,1332,N/A,6,3
31,N/A,N/A,N/A,1290,1321,N/A,9,6
11,N/A,N/A,N/A,1279,1290,N/A,12,3
49,N/A,N/A,N/A,1230,1279,N/A,15,6
8,N/A,N/A,N/A,1222,1230,N/A,21,0
24,N/A,N/A,N/A,1198,1222,N/A,25,4
11,N/A,N/A,N/A,1187,1198,N/A,31,4
11,N/A,N/A,N/A,1176,1187,N/A,36,3
7,N/A,N/A,N/A,1169,1176,N/A,40,1
46,N/A,N/A,N/A,1123,1169,N/A,45,6
7,N/A,N/A,N/A,1116,1123,N/A,51,0
34,N/A,N/A,N/A,1082,1116,N/A,57,6
9,N/A,N/A,N/A,1073,1082,N/A,63,0
41,N/A,N/A,N/A,1032,1073,N/A,69,6
21,N/A,N/A,N/A,1011,1032,N/A,73,4
11,N/A,N/A,N/A,1000,1011,N/A,77,2
33,N/A,N/A,N/A,967,1000,N/A,81,6
7,N/A,N/A,N/A,960,967,N/A,87,0
37,N/A,N/A,N/A,923,960,N/A,93,6
6,N/A,N/A,N/A,917,923,N/A,99,0
11,N/A,N/A,N/A,906,917,N/A,103,4
7,N/A,N/A,N/A,899,906,N/A,108,3
40,N/A,N/A,N/A,859,899,N/A,111,6
9,N/A,N/A,N/A,850,859,N/A,117,0
38,N/A,N/A,N/A,812,850,N/A,123,6
33,N/A,N/A,N/A,779,812,N/A,128,5
11,N/A,N/A,N/A,768,779,N/A,132,3
10,N/A,N/A,N/A,758,768,N/A,137,2
38,N/A,N/A,N/A,720,758,N/A,141,6
10,N/A,N/A,N/A,710,720,N/A,144,3
14,N/A,N/A,N/A,466,480,N/A,3,4
28,N/A,N/A,N/A,438,466,N/A,9,4
21,N/A,N/A,N/A,417,438,N/A,15,4
22,N/A,N/A,N/A,395,417,N/A,21,4
6,N/A,N/A,N/A,389,395,N/A,24,1
22,N/A,N/A,N/A,367,389,N/A,27,4
6,N/A,N/A,N/A,361,367,N/A,30,1
31,N/A,N/A,N/A,330,361,N/A,34,5
7,N/A,N/A,N/A,323,330,N/A,38,3
9,N/A,N/A,N/A,314,323,N/A,43,2
29,N/A,N/A,N/A,285,314,N/A,46,5
34,N/A,N/A,N/A,251,285,N/A,52,5
26,N/A,N/A,N/A,225,251,N/A,58,5
26,N/A,N/A,N/A,199,225,N/A,64,5
41,N/A,N/A,N/A,158,199,N/A,70,5
19,N/A,N/A,N/A,139,158,N/A,75,4
10,N/A,N/A,N/A,129,139,N/A,79,2
9,N/A,N/A,N/A,120,129,N/A,84,1
46,N/A,N/A,N/A,74,120,N/A,88,5
24,N/A,N/A,N/A,50,74,N/A,93,4
7,N/A,N/A,N/A,43,50,N/A,98,3
7,N/A,N/A,N/A,36,43,N/A,104,3
9,N/A,N/A,N/A,27,36,N/A,110,3
25,N/A,N/A,N/A,2,27,N/A,113,6
9,N/A,N/A,N/A,-7,2,N/A,116,3
18,N/A,N/A,N/A,1827,1845,N/A,3,4
9,N/A,N/A,N/A,1818,1827,N/A,7,2
40,N/A,N/A,N/A,1778,1818,N/A,11,6
6,N/A,N/A,N/A,1772,1778,N/A,17,0
27,N/A,N/A,N/A,1745,1772,N/A,23,6
9,N/A,N/A,N/A,1736,1745,N/A,26,3
11,N/A,N/A,N/A,1725,1736,N/A,32,3
8,N/A,N/A,N/A,1717,1725,N/A,36,1
24,N/A,N/A,N/A,1693,1717,N/A,39,4
8,N/A,N/A,N/A,1685,1693,N/A,44,3
10,N/A,N/A,N/A,1675,1685,N/A,49,2
46,N/A,N/A,N/A,1629,1675,N/A,52,5
43,N/A,N/A,N/A,1586,1629,N/A,58,5
10,N/A,N/A,N/A,1576,1586,N/A,62,3
49,N/A,N/A,N/A,1527,1576,N/A,65,6
29,N/A,N/A,N/A,1498,1527,N/A,70,5
17,N/A,N/A,N/A,1481,1498,N/A,75,4
6,N/A,N/A,N/A,1475,1481,N/A,78,1
8,N/A,N/A,N/A,1467,1475,N/A,84,1
5,N/A,N/A,N/A,1462,1467,N/A,90,1
43,N/A,N/A,N/A,1419,1462,N/A,94,5
27,N/A,N/A,N/A,1392,1419,N/A,100,5
39,N/A,N/A,N/A,1353,1392,N/A,106,5
44,N/A,N/A,N/A,1309,1353,N/A,112,5
25,N/A,N/A,N/A,1284,1309,N/A,117,4
9,N/A,N/A,N/A,1275,1284,N/A,122,3
11,N/A,N/A,N/A,1264,1275,N/A,128,3
11,N/A,N/A,N/A,1253,1264,N/A,133,2
41,N/A,N/A,N/A,1212,1253,N/A,137,6
28,N/A,N/A,N/A,1184,1212,N/A,142,5
8,N/A,N/A,N/A,1898,1906,N/A,6,3
11,N/A,N/A,N/A,1887,1898,N/A,12,3
7,N/A,N/A,N/A,1880,1887,N/A,17,2
28,N/A,N/A,N/A,1852,1880,N/A,20,5
8,N/A,N/A,N/A,1844,1852,N/A,23,2
5,N/A,N/A,N/A,1839,1844,N/A,28,1
47,N/A,N/A,N/A,1792,1839,N/A,33,6
8,N/A,N/A,N/A,1784,1792,N/A,36,3
9,N/A,N/A,N/A,1775,1784,N/A,40,1
41,N/A,N/A,N/A,1734,1775,N/A,44,5
34,N/A,N/A,N/A,1700,1734,N/A,50,5
9,N/A,N/A,N/A,1691,1700,N/A,53,2
40,N/A,N/A,N/A,1651,1691,N/A,57,6
28,N/A,N/A,N/A,1623,1651,N/A,61,4
8,N/A,N/A,N/A,1615,1623,N/A,66,3
11,N/A,N/A,N/A,1604,1615,N/A,71,2
11,N/A,N/A,N/A,1593,1604,N/A,77,2
41,N/A,N/A,N/A,1552,1593,N/A,80,5
8,N/A,N/A,N/A,1544,1552,N/A,84,3
5,N/A,N/A,N/A,1539,1544,N/A,88,1
7,N/A,N/A,N/A,1532,1539,N/A,94,1
28,N/A,N/A,N/A,1504,1532,N/A,98,5
11,N/A,N/A,N/A,1493,1504,N/A,101,2
6,N/A,N/A,N/A,1487,1493,N/A,106,1
38,N/A,N/A,N/A,1449,1487,N/A,111,6
30,N/A,N/A,N/A,1419,1449,N/A,116,5
31,N/A,N/A,N/A,1388,1419,N/A,122,5
10,N/A,N/A,N/A,1378,1388,N/A,126,3
7,N/A,N/A,N/A,1371,1378,N/A,130,1
26,N/A,N/A,N/A,1345,1371,N/A,133,4
37,N/A,N/A,N/A,324,361,N/A,4,6
11,N/A,N/A,N/A,313,324,N/A,7,3
7,N/A,N/A,N/A,306,313,N/A,13,3
10,N/A,N/A,N/A,296,306,N/A,18,2
7,N/A,N/A,N/A,289,296,N/A,23,1
40,N/A,N/A,N/A,249,289,N/A,28,6
28,N/A,N/A,N/A,221,249,N/A,32,4
7,N/A,N/A,N/A,214,221,N/A,36,2
11,N/A,N/A,N/A,203,214,N/A,42,2
11,N/A,N/A,N/A,192,203,N/A,48,2
10,N/A,N/A,N/A,182,192,N/A,54,2
30,N/A,N/A,N/A,152,182,N/A,58,6
26,N/A,N/A,N/A,126,152,N/A,63,5
42,N/A,N/A,N/A,84,126,N/A,69,5
19,N/A,N/A,N/A,65,84,N/A,74,4
9,N/A,N/A,N/A,56,65,N/A,79,3
28,N/A,N/A,N/A,28,56,N/A,82,6
7,N/A,N/A,N/A,21,28,N/A,85,3
8,N/A,N/A,N/A,13,21,N/A,89,1
14,N/A,N/A,N/A,-1,13,N/A,92,4
26,N/A,N/A,N/A,439,465,N/A,5,5
7,N/A,N/A,N/A,432,439,N/A,9,3
8,N/A,N/A,N/A,424,432,N/A,15,3
11,N/A,N/A,N/A,413,424,N/A,21,3
45,N/A,N/A,N/A,368,413,N/A,24,6
9,N/A,N/A,N/A,359,368,N/A,30,0
26,N/A,N/A,N/A,333,359,N/A,36,6
6,N/A,N/A,N/A,327,333,N/A,42,0
44,N/A,N/A,N/A,283,327,N/A,48,6
8,N/A,N/A,N/A,275,283,N/A,54,0
18,N/A,N/A,N/A,257,275,N/A,58,4
11,N/A,N/A,N/A,246,257,N/A,62,2
9,N/A,N/A,N/A,237,246,N/A,67,1
48,N/A,N/A,N/A,189,237,N/A,71,5
9,N/A,N/A,N/A,180,189,N/A,75,3
5,N/A,N/A,N/A,175,180,N/A,79,1
6,N/A,N/A,N/A,169,175,N/A,85,1
20,N/A,N/A,N/A,149,169,N/A,88,4
7,N/A,N/A,N/A,142,149,N/A,92,2
39,N/A,N/A,N/A,103,142,N/A,95,5
19,N/A,N/A,N/A,84,103,N/A,100,4
8,N/A,N/A,N/A,76,84,N/A,105,3
27,N/A,N/A,N/A,49,76,N/A,108,6
18,N/A,N/A,N/A,31,49,N/A,112,4
7,N/A,N/A,N/A,24,31,N/A,116,2
35,N/A,N/A,N/A,-11,24,N/A,120,6
15,N/A,N/A,N/A,952,967,N/A,5,4
7,N/A,N/A,N/A,945,952,N/A,8,1
26,N/A,N/A,N/A,919,945,N/A,11,4
7,N/A,N/A,N/A,912,919,N/A,14,1
27,N/A,N/A,N/A,885,912,N/A,17,4
7,N/A,N/A,N/A,878,885,N/A,20,1
9,N/A,N/A,N/A,869,878,N/A,26,1
28,N/A,N/A,N/A,841,869,N/A,29,4
8,N/A,N/A,N/A,833,841,N/A,32,1
42,N/A,N/A,N/A,791,833,N/A,36,5
10,N/A,N/A,N/A,781,791,N/A,39,2
41,N/A,N/A,N/A,740,781,N/A,42,5
19,N/A,N/A,N/A,721,740,N/A,47,4
26,N/A,N/A,N/A,695,721,N/A,53,4
9,N/A,N/A,N/A,686,695,N/A,56,1
43,N/A,N/A,N/A,643,686,N/A,61,6
7,N/A,N/A,N/A,636,643,N/A,64,3
39,N/A,N/A,N/A,597,636,N/A,67,6
27,N/A,N/A,N/A,570,597,N/A,72,5
45,N/A,N/A,N/A,525,570,N/A,78,5
45,N/A,N/A,N/A,480,525,N/A,84,5
7,N/A,N/A,N/A,473,480,N/A,88,3
10,N/A,N/A,N/A,463,473,N/A,94,3
7,N/A,N/A,N/A,456,463,N/A,98,1
48,N/A,N/A,N/A,408,456,N/A,103,6
41,N/A,N/A,N/A,367,408,N/A,108,5
48,N/A,N/A,N/A,319,367,N/A,114,5
7,N/A,N/A,N/A,312,319,N/A,117,2
38,N/A,N/A,N/A,274,312,N/A,121,6
18,N/A,N/A,N/A,256,274,N/A,125,4
8,N/A,N/A,N/A,1139,1147,N/A,3,2
5,N/A,N/A,N/A,1134,1139,N/A,8,1
49,N/A,N/A,N/A,1085,1134,N/A,13,6
30,N/A,N/A,N/A,1055,1085,N/A,18,5
9,N/A,N/A,N/A,1046,1055,N/A,21,2
36,N/A,N/A,N/A,1010,1046,N/A,25,6
7,N/A,N/A,N/A,1003,1010,N/A,28,3
5,N/A,N/A,N/A,998,1003,N/A,32,1
26,N/A,N/A,N/A,972,998,N/A,35,4
8,N/A,N/A,N/A,964,972,N/A,40,3
11,N/A,N/A,N/A,953,964,N/A,45,2
39,N/A,N/A,N/A,914,953,N/A,48,5
9,N/A,N/A,N/A,905,914,N/A,52,3
11,N/A,N/A,N/A,894,905,N/A,58,3
39,N/A,N/A,N/A,855,894,N/A,61,6
8,N/A,N/A,N/A,847,855,N/A,64,3
8,N/A,N/A,N/A,839,847,N/A,69,2
5,N/A,N/A,N/A,834,839,N/A,74,1
33,N/A,N/A,N/A,801,834,N/A,78,5
38,N/A,N/A,N/A,763,801,N/A,84,5
8,N/A,N/A,N/A,755,763,N/A,88,3
7,N/A,N/A,N/A,748,755,N/A,92,1
42,N/A,N/A,N/A,706,748,N/A,96,5
8,N/A,N/A,N/A,698,706,N/A,100,3
7,N/A,N/A,N/A,691,698,N/A,106,3
10,N/A,N/A,N/A,681,691,N/A,112,3
7,N/A,N/A,N/A,674,681,N/A,117,2
26,N/A,N/A,N/A,648,674,N/A,120,5
10,N/A,N/A,N/A,638,648,N/A,123,2
5,N/A,N/A,N/A,633,638,N/A,128,1
27,N/A,N/A,N/A,1168,1195,N/A,3,4
9,N/A,N/A,N/A,1159,1168,N/A,7,2
11,N/A,N/A,N/A,1148,1159,N/A,13,2
41,N/A,N/A,N/A,1107,1148,N/A,16,5
39,N/A,N/A,N/A,1068,1107,N/A,22,5
26,N/A,N/A,N/A,1042,1068,N/A,28,5
10,N/A,N/A,N/A,1032,1042,N/A,32,3
10,N/A,N/A,N/A,1022,1032,N/A,37,2
33,N/A,N/A,N/A,989,1022,N/A,41,6
10,N/A,N/A,N/A,979,989,N/A,45,4
21,N/A,N/A,N/A,958,979,N/A,51,4
18,N/A,N/A,N/A,940,958,N/A,57,4
11,N/A,N/A,N/A,929,940,N/A,62,3
9,N/A,N/A,N/A,920,929,N/A,66,1
39,N/A,N/A,N/A,881,920,N/A,70,5
11,N/A,N/A,N/A,870,881,N/A,73,2
26,N/A,N/A,N/A,844,870,N/A,76,5
40,N/A,N/A,N/A,804,844,N/A,82,5
8,N/A,N/A,N/A,796,804,N/A,85,2
8,N/A,N/A,N/A,788,796,N/A,91,2
36,N/A,N/A,N/A,752,788,N/A,94,5
49,N/A,N/A,N/A,703,752,N/A,100,5
33,N/A,N/A,N/A,670,703,N/A,106,5
49,N/A,N/A,N/A,621,670,N/A,112,5
8,N/A,N/A,N/A,613,621,N/A,115,2
9,N/A,N/A,N/A,604,613,N/A,121,2
7,N/A,N/A,N/A,597,604,N/A,126,1
47,N/A,N/A,N/A,550,597,N/A,130,5
23,N/A,N/A,N/A,527,550,N/A,135,4
13,N/A,N/A,N/A,514,527,N/A,141,4
9,N/A,N/A,N/A,1962,1971,N/A,5,3
29,N/A,N/A,N/A,1933,1962,N/A,8,6
8,N/A,N/A,N/A,1925,1933,N/A,14,0
45,N/A,N/A,N/A,1880,1925,N/A,19,5
25,N/A,N/A,N/A,1855,1880,N/A,25,5
31,N/A,N/A,N/A,1824,1855,N/A,31,5
40,N/A,N/A,N/A,1784,1824,N/A,37,5
39,N/A,N/A,N/A,1745,1784,N/A,43,5
11,N/A,N/A,N/A,1734,1745,N/A,47,3
35,N/A,N/A,N/A,1699,1734,N/A,50,6
40,N/A,N/A,N/A,1659,1699,N/A,55,5
9,N/A,N/A,N/A,1650,1659,N/A,59,3
7,N/A,N/A,N/A,1643,1650,N/A,65,3
7,N/A,N/A,N/A,1636,1643,N/A,69,1
47,N/A,N/A,N/A,1589,1636,N/A,74,6
5,N/A,N/A,N/A,1584,1589,N/A,80,0
42,N/A,N/A,N/A,1542,1584,N/A,86,6
13,N/A,N/A,N/A,1529,1542,N/A,90,4
8,N/A,N/A,N/A,1521,1529,N/A,93,1
22,N/A,N/A,N/A,1499,1521,N/A,96,4
9,N/A,N/A,N/A,1490,1499,N/A,100,2
7,N/A,N/A,N/A,1483,1490,N/A,105,1
27,N/A,N/A,N/A,1456,1483,N/A,109,5
13,N/A,N/A,N/A,1443,1456,N/A,114,4
7,N/A,N/A,N/A,1436,1443,N/A,118,2
38,N/A,N/A,N/A,1398,1436,N/A,121,5
9,N/A,N/A,N/A,1389,1398,N/A,124,2
38,N/A,N/A,N/A,1351,1389,N/A,127,5
25,N/A,N/A,N/A,1326,1351,N/A,133,5
42,N/A,N/A,N/A,1284,1326,N/A,139,5
6,N/A,N/A,N/A,955,961,N/A,4,1
27,N/A,N/A,N/A,928,955,N/A,7,4
7,N/A,N/A,N/A,921,928,N/A,12,3
6,N/A,N/A,N/A,915,921,N/A,16,1
41,N/A,N/A,N/A,874,915,N/A,21,6
5,N/A,N/A,N/A,869,874,N/A,27,0
8,N/A,N/A,N/A,861,869,N/A,30,3
5,N/A,N/A,N/A,856,861,N/A,34,1
29,N/A,N/A,N/A,827,856,N/A,37,4
8,N/A,N/A,N/A,819,827,N/A,42,3
11,N/A,N/A,N/A,808,819,N/A,47,2
8,N/A,N/A,N/A,800,808,N/A,53,2
41,N/A,N/A,N/A,759,800,N/A,56,5
7,N/A,N/A,N/A,752,759,N/A,60,3
11,N/A,N/A,N/A,741,752,N/A,65,2
8,N/A,N/A,N/A,733,741,N/A,70,1
35,N/A,N/A,N/A,698,733,N/A,75,6
11,N/A,N/A,N/A,687,698,N/A,78,3
9,N/A,N/A,N/A,678,687,N/A,84,3
9,N/A,N/A,N/A,669,678,N/A,89,2
6,N/A,N/A,N/A,663,669,N/A,94,1
8,N/A,N/A,N/A,655,663,N/A,100,1
28,N/A,N/A,N/A,627,655,N/A,103,4
7,N/A,N/A,N/A,620,627,N/A,107,2
7,N/A,N/A,N/A,613,620,N/A,113,2
9,N/A,N/A,N/A,604,613,N/A,119,2
8,N/A,N/A,N/A,596,604,N/A,124,1
25,N/A,N/A,N/A,571,596,N/A,127,4
21,N/A,N/A,N/A,550,571,N/A,133,4
29,N/A,N/A,N/A,521,550,N/A,139,4
27,N/A,N/A,N/A,707,734,N/A,6,4
11,N/A,N/A,N/A,696,707,N/A,10,2
37,N/A,N/A,N/A,659,696,N/A,13,5
15,N/A,N/A,N/A,644,659,N/A,18,4
10,N/A,N/A,N/A,634,644,N/A,24,4
10,N/A,N/A,N/A,624,634,N/A,28,2
41,N/A,N/A,N/A,583,624,N/A,31,5
16,N/A,N/A,N/A,567,583,N/A,36,4
7,N/A,N/A,N/A,560,567,N/A,41,3
7,N/A,N/A,N/A,553,560,N/A,46,2
11,N/A,N/A,N/A,542,553,N/A,52,2
48,N/A,N/A,N/A,494,542,N/A,55,5
10,N/A,N/A,N/A,484,494,N/A,58,2
37,N/A,N/A,N/A,447,484,N/A,62,6
26,N/A,N/A,N/A,421,447,N/A,66,4
7,N/A,N/A,N/A,414,421,N/A,69,1
8,N/A,N/A,N/A,406,414,N/A,75,1
44,N/A,N/A,N/A,362,406,N/A,79,5
25,N/A,N/A,N/A,337,362,N/A,84,4
9,N/A,N/A,N/A,328,337,N/A,87,1
46,N/A,N/A,N/A,282,328,N/A,92,6
37,N/A,N/A,N/A,245,282,N/A,97,5
8,N/A,N/A,N/A,237,245,N/A,101,3
7,N/A,N/A,N/A,230,237,N/A,106,2
36,N/A,N/A,N/A,194,230,N/A,109,5
10,N/A,N/A,N/A,184,194,N/A,112,2
9,N/A,N/A,N/A,175,184,N/A,117,1
30,N/A,N/A,N/A,145,175,N/A,121,5
32,N/A,N/A,N/A,113,145,N/A,127,5
11,N/A,N/A,N/A,102,113,N/A,131,3
7,N/A,N/A,N/A,1800,1807,N/A,4,3
35,N/A,N/A,N/A,1765,1800,N/A,7,6
27,N/A,N/A,N/A,1738,1765,N/A,11,4
9,N/A,N/A,N/A,1729,1738,N/A,16,3
8,N/A,N/A,N/A,1721,1729,N/A,22,3
9,N/A,N/A,N/A,1712,1721,N/A,26,1
29,N/A,N/A,N/A,1683,1712,N/A,30,5
42,N/A,N/A,N/A,1641,1683,N/A,36,5
11,N/A,N/A,N/A,1630,1641,N/A,40,3
7,N/A,N/A,N/A,1623,1630,N/A,45,2
6,N/A,N/A,N/A,1617,1623,N/A,50,1
18,N/A,N/A,N/A,1599,1617,N/A,53,4
9,N/A,N/A,N/A,1590,1599,N/A,56,1
29,N/A,N/A,N/A,1561,1590,N/A,59,4
8,N/A,N/A,N/A,1553,1561,N/A,62,1
26,N/A,N/A,N/A,1527,1553,N/A,67,6
35,N/A,N/A,N/A,1492,1527,N/A,72,5
10,N/A,N/A,N/A,1482,1492,N/A,75,2
49,N/A,N/A,N/A,1433,1482,N/A,78,5
9,N/A,N/A,N/A,1424,1433,N/A,82,3
10,N/A,N/A,N/A,1414,1424,N/A,87,2
36,N/A,N/A,N/A,1378,1414,N/A,90,5
31,N/A,N/A,N/A,1347,1378,N/A,96,5
10,N/A,N/A,N/A,1337,1347,N/A,100,3
10,N/A,N/A,N/A,1327,1337,N/A,106,3
11,N/A,N/A,N/A,1316,1327,N/A,111,2
45,N/A,N/A,N/A,1271,1316,N/A,115,6
13,N/A,N/A,N/A,1258,1271,N/A,119,4
11,N/A,N/A,N/A,1247,1258,N/A,124,3
8,N/A,N/A,N/A,1239,1247,N/A,129,2
11,N/A,N/A,N/A,1599,1610,N/A,3,3
8,N/A,N/A,N/A,1591,1599,N/A,9,3
7,N/A,N/A,N/A,1584,1591,N/A,15,3
8,N/A,N/A,N/A,1576,1584,N/A,19,1
46,N/A,N/A,N/A,1530,1576,N/A,24,6
18,N/A,N/A,N/A,1512,1530,N/A,28,4
7,N/A,N/A,N/A,1505,1512,N/A,32,2
27,N/A,N/A,N/A,1478,1505,N/A,35,5
43,N/A,N/A,N/A,1435,1478,N/A,41,5
7,N/A,N/A,N/A,1428,1435,N/A,44,2
48,N/A,N/A,N/A,1380,1428,N/A,47,5
23,N/A,N/A,N/A,1357,1380,N/A,52,4
9,N/A,N/A,N/A,1348,1357,N/A,56,2
6,N/A,N/A,N/A,1342,1348,N/A,61,1
16,N/A,N/A,N/A,1326,1342,N/A,64,4
7,N/A,N/A,N/A,1319,1326,N/A,69,3
11,N/A,N/A,N/A,1308,1319,N/A,74,2
41,N/A,N/A,N/A,1267,1308,N/A,77,5
7,N/A,N/A,N/A,1260,1267,N/A,80,2
37,N/A,N/A,N/A,1223,1260,N/A,83,5
34,N/A,N/A,N/A,1189,1223,N/A,89,5
7,N/A,N/A,N/A,1182,1189,N/A,92,2
30,N/A,N/A,N/A,1152,1182,N/A,95,5
10,N/A,N/A,N/A,1142,1152,N/A,99,3
37,N/A,N/A,N/A,1105,1142,N/A,102,6
9,N/A,N/A,N/A,1096,1105,N/A,105,3
7,N/A,N/A,N/A,1089,1096,N/A,110,2
37,N/A,N/A,N/A,1052,1089,N/A,114,6
19,N/A,N/A,N/A,1033,1052,N/A,118,4
10,N/A,N/A,N/A,1023,1033,N/A,123,3
6,N/A,N/A,N/A,1627,1633,N/A,4,1
5,N/A,N/A,N/A,1622,1627,N/A,10,1
25,N/A,N/A,N/A,1597,1622,N/A,15,6
9,N/A,N/A,N/A,1588,1597,N/A,18,3
10,N/A,N/A,N/A,1578,1588,N/A,23,2
47,N/A,N/A,N/A,1531,1578,N/A,26,5
17,N/A,N/A,N/A,1514,1531,N/A,31,4
9,N/A,N/A,N/A,1505,1514,N/A,35,2
9,N/A,N/A,N/A,1496,1505,N/A,41,2
46,N/A,N/A,N/A,1450,1496,N/A,44,5
32,N/A,N/A,N/A,1418,1450,N/A,50,5
7,N/A,N/A,N/A,1411,1418,N/A,54,3
33,N/A,N/A,N/A,1378,1411,N/A,57,6
31,N/A,N/A,N/A,1347,1378,N/A,62,5
7,N/A,N/A,N/A,1340,1347,N/A,66,3
37,N/A,N/A,N/A,1303,1340,N/A,69,6
9,N/A,N/A,N/A,1294,1303,N/A,75,0
45,N/A,N/A,N/A,1249,1294,N/A,81,6
12,N/A,N/A,N/A,1237,1249,N/A,85,4
10,N/A,N/A,N/A,1227,1237,N/A,90,3
9,N/A,N/A,N/A,1218,1227,N/A,96,3
39,N/A,N/A,N/A,1179,1218,N/A,99,6
30,N/A,N/A,N/A,1149,1179,N/A,104,5
36,N/A,N/A,N/A,1113,1149,N/A,110,5
23,N/A,N/A,N/A,1090,1113,N/A,115,4
9,N/A,N/A,N/A,1081,1090,N/A,120,3
10,N/A,N/A,N/A,1071,1081,N/A,125,2
5,N/A,N/A,N/A,1066,1071,N/A,130,1
30,N/A,N/A,N/A,1036,1066,N/A,134,5
7,N/A,N/A,N/A,1029,1036,N/A,138,3
11,N/A,N/A,N/A,582,593,N/A,4,2
9,N/A,N/A,N/A,573,582,N/A,10,2
45,N/A,N/A,N/A,528,573,N/A,14,6
24,N/A,N/A,N/A,504,528,N/A,18,4
10,N/A,N/A,N/A,494,504,N/A,23,3
7,N/A,N/A,N/A,487,494,N/A,27,1
33,N/A,N/A,N/A,454,487,N/A,31,5
8,N/A,N/A,N/A,446,454,N/A,34,2
30,N/A,N/A,N/A,416,446,N/A,37,5
11,N/A,N/A,N/A,405,416,N/A,42,4
11,N/A,N/A,N/A,394,405,N/A,47,3
31,N/A,N/A,N/A,363,394,N/A,50,6
11,N/A,N/A,N/A,352,363,N/A,53,3
10,N/A,N/A,N/A,342,352,N/A,59,3
8,N/A,N/A,N/A,334,342,N/A,65,3
7,N/A,N/A,N/A,327,334,N/A,71,3
40,N/A,N/A,N/A,287,327,N/A,74,6
24,N/A,N/A,N/A,263,287,N/A,78,4
5,N/A,N/A,N/A,258,263,N/A,81,1
6,N/A,N/A,N/A,252,258,N/A,87,1
16,N/A,N/A,N/A,236,252,N/A,90,4
11,N/A,N/A,N/A,225,236,N/A,94,2
47,N/A,N/A,N/A,178,225,N/A,97,5
10,N/A,N/A,N/A,168,178,N/A,100,2
43,N/A,N/A,N/A,125,168,N/A,103,5
25,N/A,N/A,N/A,100,125,N/A,108,4
11,N/A,N/A,N/A,89,100,N/A,113,3
27,N/A,N/A,N/A,62,89,N/A,116,6
8,N/A,N/A,N/A,54,62,N/A,122,0
35,N/A,N/A,N/A,19,54,N/A,128,6
42,N/A,N/A,N/A,1701,1743,N/A,3,5
8,N/A,N/A,N/A,1693,1701,N/A,6,2
25,N/A,N/A,N/A,1668,1693,N/A,9,5
8,N/A,N/A,N/A,1660,1668,N/A,13,3
8,N/A,N/A,N/A,1652,1660,N/A,19,3
8,N/A,N/A,N/A,1644,1652,N/A,24,2
26,N/A,N/A,N/A,1618,1644,N/A,27,5
25,N/A,N/A,N/A,1593,1618,N/A,32,4
8,N/A,N/A,N/A,1585,1593,N/A,37,3
7,N/A,N/A,N/A,1578,1585,N/A,42,2
29,N/A,N/A,N/A,1549,1578,N/A,45,5
8,N/A,N/A,N/A,1541,1549,N/A,48,2
7,N/A,N/A,N/A,1534,1541,N/A,54,2
5,N/A,N/A,N/A,1529,1534,N/A,59,1
31,N/A,N/A,N/A,1498,1529,N/A,64,6
7,N/A,N/A,N/A,1491,1498,N/A,70,0
20,N/A,N/A,N/A,1471,1491,N/A,74,4
24,N/A,N/A,N/A,1447,1471,N/A,80,4
22,N/A,N/A,N/A,1425,1447,N/A,86,4
25,N/A,N/A,N/A,1400,1425,N/A,92,4
11,N/A,N/A,N/A,1389,1400,N/A,96,2
26,N/A,N/A,N/A,1363,1389,N/A,99,5
10,N/A,N/A,N/A,1353,1363,N/A,103,3
8,N/A,N/A,N/A,1345,1353,N/A,107,1
6,N/A,N/A,N/A,1339,1345,N/A,113,1
18,N/A,N/A,N/A,1321,1339,N/A,116,4
9,N/A,N/A,N/A,1312,1321,N/A,119,1
49,N/A,N/A,N/A,1263,1312,N/A,123,5
9,N/A,N/A,N/A,1254,1263,N/A,126,2
36,N/A,N/A,N/A,1218,1254,N/A,130,6
10,N/A,N/A,N/A,1762,1772,N/A,3,4
19,N/A,N/A,N/A,1743,1762,N/A,9,4
27,N/A,N/A,N/A,1716,1743,N/A,15,4
9,N/A,N/A,N/A,1707,1716,N/A,19,2
8,N/A,N/A,N/A,1699,1707,N/A,25,2
34,N/A,N/A,N/A,1665,1699,N/A,29,6
48,N/A,N/A,N/A,1617,1665,N/A,34,5
14,N/A,N/A,N/A,1603,1617,N/A,39,4
9,N/A,N/A,N/A,1594,1603,N/A,43,2
46,N/A,N/A,N/A,1548,1594,N/A,46,5
7,N/A,N/A,N/A,1541,1548,N/A,49,2
29,N/A,N/A,N/A,1512,1541,N/A,52,5
30,N/A,N/A,N/A,1482,1512,N/A,58,5
8,N/A,N/A,N/A,1474,1482,N/A,61,2
35,N/A,N/A,N/A,1439,1474,N/A,65,6
15,N/A,N/A,N/A,1424,1439,N/A,69,4
11,N/A,N/A,N/A,1413,1424,N/A,74,3
35,N/A,N/A,N/A,1378,1413,N/A,77,6
8,N/A,N/A,N/A,1370,1378,N/A,80,3
7,N/A,N/A,N/A,1363,1370,N/A,85,2
26,N/A,N/A,N/A,1337,1363,N/A,88,5
9,N/A,N/A,N/A,1328,1337,N/A,92,3
44,N/A,N/A,N/A,1284,1328,N/A,95,6
21,N/A,N/A,N/A,1263,1284,N/A,99,4
10,N/A,N/A,N/A,1253,1263,N/A,104,3
8,N/A,N/A,N/A,1245,1253,N/A,110,3
7,N/A,N/A,N/A,1238,1245,N/A,116,3
5,N/A,N/A,N/A,1233,1238,N/A,120,1
47,N/A,N/A,N/A,1186,1233,N/A,125,6
18,N/A,N/A,N/A,1168,1186,N/A,129,4
32,N/A,N/A,N/A,897,929,N/A,6,5
43,N/A,N/A,N/A,854,897,N/A,12,5
7,N/A,N/A,N/A,847,854,N/A,15,2
35,N/A,N/A,N/A,812,847,N/A,18,5
8,N/A,N/A,N/A,804,812,N/A,22,3
5,N/A,N/A,N/A,799,804,N/A,26,1
15,N/A,N/A,N/A,784,799,N/A,29,4
9,N/A,N/A,N/A,775,784,N/A,33,2
7,N/A,N/A,N/A,768,775,N/A,39,2
34,N/A,N/A,N/A,734,768,N/A,42,5
10,N/A,N/A,N/A,724,734,N/A,46,3
7,N/A,N/A,N/A,717,724,N/A,51,2
10,N/A,N/A,N/A,707,717,N/A,57,2
5,N/A,N/A,N/A,702,707,N/A,62,1
45,N/A,N/A,N/A,657,702,N/A,67,6
20,N/A,N/A,N/A,637,657,N/A,71,4
8,N/A,N/A,N/A,629,637,N/A,76,3
7,N/A,N/A,N/A,622,629,N/A,81,2
26,N/A,N/A,N/A,596,622,N/A,85,6
9,N/A,N/A,N/A,587,596,N/A,88,3
8,N/A,N/A,N/A,579,587,N/A,94,3
8,N/A,N/A,N/A,571,579,N/A,99,2
7,N/A,N/A,N/A,564,571,N/A,104,1
33,N/A,N/A,N/A,531,564,N/A,109,6
9,N/A,N/A,N/A,522,531,N/A,112,3
11,N/A,N/A,N/A,511,522,N/A,118,3
49,N/A,N/A,N/A,462,511,N/A,121,6
7,N/A,N/A,N/A,455,462,N/A,124,3
30,N/A,N/A,N/A,425,455,N/A,127,6
8,N/A,N/A,N/A,417,425,N/A,133,0
10,N/A,N/A,N/A,1591,1601,N/A,5,2
28,N/A,N/A,N/A,1563,1591,N/A,8,5
46,N/A,N/A,N/A,1517,1563,N/A,14,5
8,N/A,N/A,N/A,1509,1517,N/A,18,3
8,N/A,N/A,N/A,1501,1509,N/A,24,3
44,N/A,N/A,N/A,1457,1501,N/A,27,6
24,N/A,N/A,N/A,1433,1457,N/A,31,4
27,N/A,N/A,N/A,1406,1433,N/A,37,4
5,N/A,N/A,N/A,1401,1406,N/A,40,1
26,N/A,N/A,N/A,1375,1401,N/A,44,5
25,N/A,N/A,N/A,1350,1375,N/A,49,4
23,N/A,N/A,N/A,1327,1350,N/A,55,4
10,N/A,N/A,N/A,1317,1327,N/A,60,3
6,N/A,N/A,N/A,1311,1317,N/A,64,1
27,N/A,N/A,N/A,1284,1311,N/A,67,4
9,N/A,N/A,N/A,1275,1284,N/A,71,2
38,N/A,N/A,N/A,1237,1275,N/A,74,5
18,N/A,N/A,N/A,1219,1237,N/A,79,4
8,N/A,N/A,N/A,1211,1219,N/A,82,1
28,N/A,N/A,N/A,1183,1211,N/A,85,4
9,N/A,N/A,N/A,1174,1183,N/A,89,2
7,N/A,N/A,N/A,1167,1174,N/A,95,2
9,N/A,N/A,N/A,1158,1167,N/A,100,1
43,N/A,N/A,N/A,1115,1158,N/A,105,6
21,N/A,N/A,N/A,1094,1115,N/A,109,4
8,N/A,N/A,N/A,1086,1094,N/A,114,3
9,N/A,N/A,N/A,1077,1086,N/A,118,1
29,N/A,N/A,N/A,1048,1077,N/A,123,6
8,N/A,N/A,N/A,1040,1048,N/A,129,0
10,N/A,N/A,N/A,1030,1040,N/A,132,3
28,N/A,N/A,N/A,855,883,N/A,4,6
9,N/A,N/A,N/A,846,855,N/A,10,0
25,N/A,N/A,N/A,821,846,N/A,15,5
21,N/A,N/A,N/A,800,821,N/A,20,4
23,N/A,N/A,N/A,777,800,N/A,26,4
24,N/A,N/A,N/A,753,777,N/A,32,4
26,N/A,N/A,N/A,727,753,N/A,38,4
6,N/A,N/A,N/A,721,727,N/A,41,1
29,N/A,N/A,N/A,692,721,N/A,46,6
6,N/A,N/A,N/A,686,692,N/A,52,0
21,N/A,N/A,N/A,665,686,N/A,56,4
16,N/A,N/A,N/A,649,665,N/A,62,4
8,N/A,N/A,N/A,641,649,N/A,67,3
7,N/A,N/A,N/A,634,641,N/A,73,3
40,N/A,N/A,N/A,594,634,N/A,76,6
10,N/A,N/A,N/A,584,594,N/A,80,4
11,N/A,N/A,N/A,573,584,N/A,86,4
8,N/A,N/A,N/A,565,573,N/A,90,2
9,N/A,N/A,N/A,556,565,N/A,96,2
49,N/A,N/A,N/A,507,556,N/A,100,6
8,N/A,N/A,N/A,499,507,N/A,103,3
7,N/A,N/A,N/A,492,499,N/A,107,1
26,N/A,N/A,N/A,466,492,N/A,110,4
5,N/A,N/A,N/A,461,466,N/A,113,1
9,N/A,N/A,N/A,452,461,N/A,119,1
9,N/A,N/A,N/A,443,452,N/A,125,1
11,N/A,N/A,N/A,432,443,N/A,128,4
10,N/A,N/A,N/A,422,432,N/A,133,3
8,N/A,N/A,N/A,414,422,N/A,139,3
9,N/A,N/A,N/A,405,414,N/A,145,3
41,N/A,N/A,N/A,1557,1598,N/A,3,6
8,N/A,N/A,N/A,1549,1557,N/A,6,3
10,N/A,N/A,N/A,1539,1549,N/A,11,2
37,N/A,N/A,N/A,1502,1539,N/A,14,5
8,N/A,N/A,N/A,1494,1502,N/A,17,2
31,N/A,N/A,N/A,1463,1494,N/A,21,6
6,N/A,N/A,N/A,1457,1463,N/A,27,0
45,N/A,N/A,N/A,1412,1457,N/A,32,5
10,N/A,N/A,N/A,1402,1412,N/A,36,3
9,N/A,N/A,N/A,1393,1402,N/A,41,2
9,N/A,N/A,N/A,1384,1393,N/A,46,1
35,N/A,N/A,N/A,1349,1384,N/A,51,6
8,N/A,N/A,N/A,1341,1349,N/A,57,0
8,N/A,N/A,N/A,1333,1341,N/A,60,3
5,N/A,N/A,N/A,1328,1333,N/A,64,1
9,N/A,N/A,N/A,1319,1328,N/A,70,1
47,N/A,N/A,N/A,1272,1319,N/A,75,6
20,N/A,N/A,N/A,1252,1272,N/A,79,4
10,N/A,N/A,N/A,1242,1252,N/A,84,3
27,N/A,N/A,N/A,1215,1242,N/A,87,6
25,N/A,N/A,N/A,1190,1215,N/A,91,4
8,N/A,N/A,N/A,1182,1190,N/A,95,2
45,N/A,N/A,N/A,1137,1182,N/A,99,6
11,N/A,N/A,N/A,1126,1137,N/A,102,3
7,N/A,N/A,N/A,1119,1126,N/A,106,1
49,N/A,N/A,N/A,1070,1119,N/A,110,5
37,N/A,N/A,N/A,1033,1070,N/A,116,5
26,N/A,N/A,N/A,1007,1033,N/A,122,5
8,N/A,N/A,N/A,999,1007,N/A,125,2
30,N/A,N/A,N/A,969,999,N/A,128,5
9,N/A,N/A,N/A,1056,1065,N/A,3,1
29,N/A,N/A,N/A,1027,1056,N/A,7,5
14,N/A,N/A,N/A,1013,1027,N/A,12,4
7,N/A,N/A,N/A,1006,1013,N/A,17,3
7,N/A,N/A,N/A,999,1006,N/A,22,2
8,N/A,N/A,N/A,991,999,N/A,27,1
29,N/A,N/A,N/A,962,991,N/A,30,4
9,N/A,N/A,N/A,953,962,N/A,33,1
47,N/A,N/A,N/A,906,953,N/A,38,6
10,N/A,N/A,N/A,896,906,N/A,41,3
28,N/A,N/A,N/A,868,896,N/A,44,6
34,N/A,N/A,N/A,834,868,N/A,49,5
45,N/A,N/A,N/A,789,834,N/A,55,5
31,N/A,N/A,N/A,758,789,N/A,61,5
39,N/A,N/A,N/A,719,758,N/A,67,5
10,N/A,N/A,N/A,709,719,N/A,71,3
41,N/A,N/A,N/A,668,709,N/A,74,6
37,N/A,N/A,N/A,631,668,N/A,79,5
29,N/A,N/A,N/A,602,631,N/A,84,4
7,N/A,N/A,N/A,595,602,N/A,88,2
5,N/A,N/A,N/A,590,595,N/A,93,1
6,N/A,N/A,N/A,584,590,N/A,99,1
5,N/A,N/A,N/A,579,584,N/A,105,1
19,N/A,N/A,N/A,560,579,N/A,108,4
6,N/A,N/A,N/A,554,560,N/A,111,1
18,N/A,N/A,N/A,536,554,N/A,114,4
20,N/A,N/A,N/A,516,536,N/A,120,4
11,N/A,N/A,N/A,505,516,N/A,124,2
8,N/A,N/A,N/A,497,505,N/A,130,2
9,N/A,N/A,N/A,488,497,N/A,135,1
43,N/A,N/A,N/A,1439,1482,N/A,6,6
8,N/A,N/A,N/A,1431,1439,N/A,9,3
10,N/A,N/A,N/A,1421,1431,N/A,14,2
46,N/A,N/A,N/A,1375,1421,N/A,17,5
37,N/A,N/A,N/A,1338,1375,N/A,23,5
37,N/A,N/A,N/A,1301,1338,N/A,29,5
8,N/A,N/A,N/A,1293,1301,N/A,32,2
9,N/A,N/A,N/A,1284,1293,N/A,38,2
5,N/A,N/A,N/A,1279,1284,N/A,43,1
19,N/A,N/A,N/A,1260,1279,N/A,46,4
19,N/A,N/A,N/A,1241,1260,N/A,52,4
19,N/A,N/A,N/A,1222,1241,N/A,58,4
6,N/A,N/A,N/A,1216,1222,N/A,61,1
47,N/A,N/A,N/A,1169,1216,N/A,65,5
20,N/A,N/A,N/A,1149,1169,N/A,70,4
22,N/A,N/A,N/A,1127,1149,N/A,76,4
21,N/A,N/A,N/A,1106,1127,N/A,82,4
23,N/A,N/A,N/A,1083,1106,N/A,88,4
28,N/A,N/A,N/A,1055,1083,N/A,94,4
9,N/A,N/A,N/A,1046,1055,N/A,97,1
27,N/A,N/A,N/A,1019,1046,N/A,101,5
26,N/A,N/A,N/A,993,1019,N/A,106,4
25,N/A,N/A,N/A,968,993,N/A,112,4
10,N/A,N/A,N/A,958,968,N/A,116,2
48,N/A,N/A,N/A,910,958,N/A,119,5
11,N/A,N/A,N/A,899,910,N/A,122,2
32,N/A,N/A,N/A,867,899,N/A,126,6
8,N/A,N/A,N/A,859,867,N/A,132,0
15,N/A,N/A,N/A,844,859,N/A,136,4
11,N/A,N/A,N/A,833,844,N/A,141,3
28,N/A,N/A,N/A,962,990,N/A,3,5
17,N/A,N/A,N/A,945,962,N/A,8,4
29,N/A,N/A,N/A,916,945,N/A,14,4
6,N/A,N/A,N/A,910,916,N/A,17,1
9,N/A,N/A,N/A,901,910,N/A,23,1
5,N/A,N/A,N/A,896,901,N/A,29,1
41,N/A,N/A,N/A,855,896,N/A,33,5
10,N/A,N/A,N/A,845,855,N/A,37,3
9,N/A,N/A,N/A,836,845,N/A,41,1
28,N/A,N/A,N/A,808,836,N/A,45,5
10,N/A,N/A,N/A,798,808,N/A,48,2
11,N/A,N/A,N/A,787,798,N/A,54,2
28,N/A,N/A,N/A,759,787,N/A,58,6
37,N/A,N/A,N/A,722,759,N/A,63,5
43,N/A,N/A,N/A,679,722,N/A,69,5
7,N/A,N/A,N/A,672,679,N/A,73,3
6,N/A,N/A,N/A,666,672,N/A,77,1
48,N/A,N/A,N/A,618,666,N/A,81,5
37,N/A,N/A,N/A,581,618,N/A,87,5
41,N/A,N/A,N/A,540,581,N/A,93,5
25,N/A,N/A,N/A,515,540,N/A,98,4
9,N/A,N/A,N/A,506,515,N/A,102,2
27,N/A,N/A,N/A,479,506,N/A,106,6
22,N/A,N/A,N/A,457,479,N/A,110,4
9,N/A,N/A,N/A,448,457,N/A,113,1
5,N/A,N/A,N/A,443,448,N/A,119,1
20,N/A,N/A,N/A,423,443,N/A,122,4
10,N/A,N/A,N/A,413,423,N/A,126,2
27,N/A,N/A,N/A,386,413,N/A,130,6
11,N/A,N/A,N/A,375,386,N/A,133,3
29,N/A,N/A,N/A,1630,1659,N/A,6,4
13,N/A,N/A,N/A,1617,1630,N/A,12,4
9,N/A,N/A,N/A,1608,1617,N/A,17,3
9,N/A,N/A,N/A,1599,1608,N/A,23,3
10,N/A,N/A,N/A,1589,1599,N/A,28,2
47,N/A,N/A,N/A,1542,1589,N/A,32,6
7,N/A,N/A,N/A,1535,1542,N/A,38,0
26,N/A,N/A,N/A,1509,1535,N/A,44,6
35,N/A,N/A,N/A,1474,1509,N/A,49,5
10,N/A,N/A,N/A,1464,1474,N/A,54,4
5,N/A,N/A,N/A,1459,1464,N/A,57,1
41,N/A,N/A,N/A,1418,1459,N/A,61,5
15,N/A,N/A,N/A,1403,1418,N/A,66,4
10,N/A,N/A,N/A,1393,1403,N/A,70,2
8,N/A,N/A,N/A,1385,1393,N/A,76,2
8,N/A,N/A,N/A,1377,1385,N/A,82,2
47,N/A,N/A,N/A,1330,1377,N/A,86,6
10,N/A,N/A,N/A,1320,1330,N/A,89,3
36,N/A,N/A,N/A,1284,1320,N/A,92,6
22,N/A,N/A,N/A,1262,1284,N/A,96,4
5,N/A,N/A,N/A,1257,1262,N/A,99,1
12,N/A,N/A,N/A,1245,1257,N/A,102,4
8,N/A,N/A,N/A,1237,1245,N/A,106,2
5,N/A,N/A,N/A,1232,1237,N/A,111,1
16,N/A,N/A,N/A,1216,1232,N/A,114,4
9,N/A,N/A,N/A,1207,1216,N/A,119,3
5,N/A,N/A,N/A,1202,1207,N/A,123,1
39,N/A,N/A,N/A,1163,1202,N/A,127,5
8,N/A,N/A,N/A,1155,1163,N/A,130,2
9,N/A,N/A,N/A,1146,1155,N/A,136,2
48,N/A,N/A,N/A,1535,1583,N/A,5,5
14,N/A,N/A,N/A,1521,1535,N/A,10,4
5,N/A,N/A,N/A,1516,1521,N/A,13,1
5,N/A,N/A,N/A,1511,1516,N/A,19,1
29,N/A,N/A,N/A,1482,1511,N/A,24,6
38,N/A,N/A,N/A,1444,1482,N/A,29,5
7,N/A,N/A,N/A,1437,1444,N/A,33,3
42,N/A,N/A,N/A,1395,1437,N/A,36,6
6,N/A,N/A,N/A,1389,1395,N/A,42,0
26,N/A,N/A,N/A,1363,1389,N/A,46,4
8,N/A,N/A,N/A,1355,1363,N/A,49,1
38,N/A,N/A,N/A,1317,1355,N/A,54,6
7,N/A,N/A,N/A,1310,1317,N/A,57,3
10,N/A,N/A,N/A,1300,1310,N/A,62,2
7,N/A,N/A,N/A,1293,1300,N/A,67,1
35,N/A,N/A,N/A,1258,1293,N/A,71,5
42,N/A,N/A,N/A,1216,1258,N/A,77,5
11,N/A,N/A,N/A,1205,1216,N/A,80,2
6,N/A,N/A,N/A,1199,1205,N/A,85,1
44,N/A,N/A,N/A,1155,1199,N/A,89,5
7,N/A,N/A,N/A,1148,1155,N/A,93,3
7,N/A,N/A,N/A,1141,1148,N/A,98,2
41,N/A,N/A,N/A,1100,1141,N/A,101,5
7,N/A,N/A,N/A,1093,1100,N/A,105,3
45,N/A,N/A,N/A,1048,1093,N/A,108,6
8,N/A,N/A,N/A,1040,1048,N/A,111,3
8,N/A,N/A,N/A,1032,1040,N/A,115,1
28,N/A,N/A,N/A,1004,1032,N/A,119,5
7,N/A,N/A,N/A,997,1004,N/A,122,2
30,N/A,N/A,N/A,967,997,N/A,125,5
6,N/A,N/A,N/A,547,553,N/A,4,1
39,N/A,N/A,N/A,508,547,N/A,8,5
7,N/A,N/A,N/A,501,508,N/A,11,2
7,N/A,N/A,N/A,494,501,N/A,16,1
5,N/A,N/A,N/A,489,494,N/A,22,1
8,N/A,N/A,N/A,481,489,N/A,28,1
35,N/A,N/A,N/A,446,481,N/A,32,5
9,N/A,N/A,N/A,437,446,N/A,35,2
35,N/A,N/A,N/A,402,437,N/A,39,6
7,N/A,N/A,N/A,395,402,N/A,45,0
8,N/A,N/A,N/A,387,395,N/A,48,3
9,N/A,N/A,N/A,378,387,N/A,54,3
33,N/A,N/A,N/A,345,378,N/A,57,6
9,N/A,N/A,N/A,336,345,N/A,63,0
46,N/A,N/A,N/A,290,336,N/A,68,5
40,N/A,N/A,N/A,250,290,N/A,74,5
35,N/A,N/A,N/A,215,250,N/A,80,5
8,N/A,N/A,N/A,207,215,N/A,83,2
39,N/A,N/A,N/A,168,207,N/A,87,6
11,N/A,N/A,N/A,157,168,N/A,90,3
47,N/A,N/A,N/A,110,157,N/A,93,6
31,N/A,N/A,N/A,79,110,N/A,98,5
24,N/A,N/A,N/A,55,79,N/A,103,4
8,N/A,N/A,N/A,47,55,N/A,107,2
33,N/A,N/A,N/A,14,47,N/A,111,6
8,N/A,N/A,N/A,6,14,N/A,117,0
26,N/A,N/A,N/A,-20,6,N/A,122,5
18,N/A,N/A,N/A,1235,1253,N/A,6,4
9,N/A,N/A,N/A,1226,1235,N/A,11,3
28,N/A,N/A,N/A,1198,1226,N/A,14,6
24,N/A,N/A,N/A,1174,1198,N/A,18,4
16,N/A,N/A,N/A,1158,1174,N/A,24,4
10,N/A,N/A,N/A,1148,1158,N/A,30,4
9,N/A,N/A,N/A,1139,1148,N/A,35,3
7,N/A,N/A,N/A,1132,1139,N/A,40,2
8,N/A,N/A,N/A,1124,1132,N/A,45,1
43,N/A,N/A,N/A,1081,1124,N/A,49,5
11,N/A,N/A,N/A,1070,1081,N/A,54,4
10,N/A,N/A,N/A,1060,1070,N/A,59,3
9,N/A,N/A,N/A,1051,1060,N/A,65,3
9,N/A,N/A,N/A,1042,1051,N/A,71,3
9,N/A,N/A,N/A,1033,1042,N/A,77,3
9,N/A,N/A,N/A,1024,1033,N/A,83,3
10,N/A,N/A,N/A,1014,1024,N/A,89,3
9,N/A,N/A,N/A,1005,1014,N/A,94,2
42,N/A,N/A,N/A,963,1005,N/A,98,6
26,N/A,N/A,N/A,937,963,N/A,103,5
31,N/A,N/A,N/A,906,937,N/A,109,5
9,N/A,N/A,N/A,897,906,N/A,113,3
48,N/A,N/A,N/A,849,897,N/A,116,6
39,N/A,N/A,N/A,810,849,N/A,121,5
8,N/A,N/A,N/A,802,810,N/A,125,3
36,N/A,N/A,N/A,766,802,N/A,128,6
8,N/A,N/A,N/A,758,766,N/A,131,3
11,N/A,N/A,N/A,747,758,N/A,137,3
7,N/A,N/A,N/A,740,747,N/A,141,1
43,N/A,N/A,N/A,697,740,N/A,145,5
26,N/A,N/A,N/A,1876,1902,N/A,4,6
10,N/A,N/A,N/A,1866,1876,N/A,8,4
7,N/A,N/A,N/A,1859,1866,N/A,13,3
9,N/A,N/A,N/A,1850,1859,N/A,18,2
36,N/A,N/A,N/A,1814,1850,N/A,21,5
49,N/A,N/A,N/A,1765,1814,N/A,27,5
36,N/A,N/A,N/A,1729,1765,N/A,33,5
10,N/A,N/A,N/A,1719,1729,N/A,38,4
9,N/A,N/A,N/A,1710,1719,N/A,43,3
7,N/A,N/A,N/A,1703,1710,N/A,48,2
11,N/A,N/A,N/A,1692,1703,N/A,54,2
39,N/A,N/A,N/A,1653,1692,N/A,58,6
7,N/A,N/A,N/A,1646,1653,N/A,61,3
39,N/A,N/A,N/A,1607,1646,N/A,64,6
32,N/A,N/A,N/A,1575,1607,N/A,69,5
27,N/A,N/A,N/A,1548,1575,N/A,75,5
10,N/A,N/A,N/A,1538,1548,N/A,79,3
6,N/A,N/A,N/A,1532,1538,N/A,83,1
9,N/A,N/A,N/A,1523,1532,N/A,89,1
28,N/A,N/A,N/A,1495,1523,N/A,94,6
9,N/A,N/A,N/A,1486,1495,N/A,100,0
27,N/A,N/A,N/A,1459,1486,N/A,104,4
8,N/A,N/A,N/A,1451,1459,N/A,108,2
49,N/A,N/A,N/A,1402,1451,N/A,112,6
21,N/A,N/A,N/A,1381,1402,N/A,116,4
11,N/A,N/A,N/A,1370,1381,N/A,121,3
38,N/A,N/A,N/A,1332,1370,N/A,124,6
15,N/A,N/A,N/A,1317,1332,N/A,128,4
6,N/A,N/A,N/A,1311,1317,N/A,131,1
45,N/A,N/A,N/A,1266,1311,N/A,135,5
5,N/A,N/A,N/A,1189,1194,N/A,4,1
17,N/A,N/A,N/A,1172,1189,N/A,7,4
26,N/A,N/A,N/A,1146,1172,N/A,13,4
7,N/A,N/A,N/A,1139,1146,N/A,17,2
8,N/A,N/A,N/A,1131,1139,N/A,22,1
41,N/A,N/A,N/A,1090,1131,N/A,26,5
23,N/A,N/A,N/A,1067,1090,N/A,31,4
6,N/A,N/A,N/A,1061,1067,N/A,34,1
8,N/A,N/A,N/A,1053,1061,N/A,40,1
44,N/A,N/A,N/A,1009,1053,N/A,45,6
20,N/A,N/A,N/A,989,1009,N/A,49,4
9,N/A,N/A,N/A,980,989,N/A,52,1
5,N/A,N/A,N/A,975,980,N/A,58,1
9,N/A,N/A,N/A,966,975,N/A,64,1
21,N/A,N/A,N/A,945,966,N/A,67,4
24,N/A,N/A,N/A,921,945,N/A,73,4
7,N/A,N/A,N/A,914,921,N/A,77,2
9,N/A,N/A,N/A,905,914,N/A,82,1
37,N/A,N/A,N/A,868,905,N/A,86,5
25,N/A,N/A,N/A,843,868,N/A,91,4
10,N/A,N/A,N/A,833,843,N/A,95,2
37,N/A,N/A,N/A,796,833,N/A,98,5
18,N/A,N/A,N/A,778,796,N/A,103,4
9,N/A,N/A,N/A,769,778,N/A,108,3
11,N/A,N/A,N/A,758,769,N/A,113,2
9,N/A,N/A,N/A,749,758,N/A,119,2
36,N/A,N/A,N/A,713,749,N/A,122,5
41,N/A,N/A,N/A,672,713,N/A,128,5
11,N/A,N/A,N/A,661,672,N/A,132,3
31,N/A,N/A,N/A,630,661,N/A,135,6
26,N/A,N/A,N/A,1799,1825,N/A,3,4
7,N/A,N/A,N/A,1792,1799,N/A,7,2
34,N/A,N/A,N/A,1758,1792,N/A,10,5
8,N/A,N/A,N/A,1750,1758,N/A,13,2
8,N/A,N/A,N/A,1742,1750,N/A,18,1
27,N/A,N/A,N/A,1715,1742,N/A,23,6
9,N/A,N/A,N/A,1706,1715,N/A,29,0
13,N/A,N/A,N/A,1693,1706,N/A,33,4
29,N/A,N/A,N/A,1664,1693,N/A,39,4
9,N/A,N/A,N/A,1655,1664,N/A,44,3
9,N/A,N/A,N/A,1646,1655,N/A,48,1
9,N/A,N/A,N/A,1637,1646,N/A,54,1
7,N/A,N/A,N/A,1630,1637,N/A,60,1
43,N/A,N/A,N/A,1587,1630,N/A,64,5
32,N/A,N/A,N/A,1555,1587,N/A,70,5
9,N/A,N/A,N/A,1546,1555,N/A,74,3
38,N/A,N/A,N/A,1508,1546,N/A,77,6
8,N/A,N/A,N/A,1500,1508,N/A,80,3
7,N/A,N/A,N/A,1493,1500,N/A,85,2
31,N/A,N/A,N/A,1462,1493,N/A,88,5
9,N/A,N/A,N/A,1453,1462,N/A,92,3
11,N/A,N/A,N/A,1442,1453,N/A,97,2
33,N/A,N/A,N/A,1409,1442,N/A,101,6
28,N/A,N/A,N/A,1381,1409,N/A,106,5
7,N/A,N/A,N/A,1374,1381,N/A,109,2
39,N/A,N/A,N/A,1335,1374,N/A,112,5
10,N/A,N/A,N/A,1325,1335,N/A,116,3
10,N/A,N/A,N/A,1315,1325,N/A,122,3
45,N/A,N/A,N/A,1270,1315,N/A,125,6
9,N/A,N/A,N/A,1261,1270,N/A,131,0
8,N/A,N/A,N/A,964,972,N/A,6,3
7,N/A,N/A,N/A,957,964,N/A,12,3
7,N/A,N/A,N/A,950,957,N/A,16,1
39,N/A,N/A,N/A,911,950,N/A,20,5
8,N/A,N/A,N/A,903,911,N/A,23,2
9,N/A,N/A,N/A,894,903,N/A,29,2
32,N/A,N/A,N/A,862,894,N/A,32,5
29,N/A,N/A,N/A,833,862,N/A,37,4
7,N/A,N/A,N/A,826,833,N/A,42,3
9,N/A,N/A,N/A,817,826,N/A,47,2
45,N/A,N/A,N/A,772,817,N/A,51,6
13,N/A,N/A,N/A,759,772,N/A,55,4
8,N/A,N/A,N/A,751,759,N/A,60,3
6,N/A,N/A,N/A,745,751,N/A,64,1
8,N/A,N/A,N/A,737,745,N/A,70,1
26,N/A,N/A,N/A,711,737,N/A,74,5
9,N/A,N/A,N/A,702,711,N/A,78,3
9,N/A,N/A,N/A,693,702,N/A,82,1
22,N/A,N/A,N/A,671,693,N/A,85,4
10,N/A,N/A,N/A,661,671,N/A,91,4
27,N/A,N/A,N/A,634,661,N/A,97,4
9,N/A,N/A,N/A,625,634,N/A,102,3
5,N/A,N/A,N/A,620,625,N/A,106,1
33,N/A,N/A,N/A,587,620,N/A,110,5
9,N/A,N/A,N/A,578,587,N/A,113,2
10,N/A,N/A,N/A,568,578,N/A,119,2
34,N/A,N/A,N/A,534,568,N/A,123,6
9,N/A,N/A,N/A,525,534,N/A,126,3
9,N/A,N/A,N/A,516,525,N/A,130,1
25,N/A,N/A,N/A,491,516,N/A,135,6
32,N/A,N/A,N/A,731,763,N/A,4,6
7,N/A,N/A,N/A,724,731,N/A,10,0
43,N/A,N/A,N/A,681,724,N/A,16,6
5,N/A,N/A,N/A,676,681,N/A,22,0
29,N/A,N/A,N/A,647,676,N/A,26,4
6,N/A,N/A,N/A,641,647,N/A,29,1
8,N/A,N/A,N/A,633,641,N/A,35,1
34,N/A,N/A,N/A,599,633,N/A,39,5
20,N/A,N/A,N/A,579,599,N/A,44,4
5,N/A,N/A,N/A,574,579,N/A,47,1
48,N/A,N/A,N/A,526,574,N/A,51,5
7,N/A,N/A,N/A,519,526,N/A,55,3
8,N/A,N/A,N/A,511,519,N/A,59,1
43,N/A,N/A,N/A,468,511,N/A,64,6
26,N/A,N/A,N/A,442,468,N/A,68,4
8,N/A,N/A,N/A,434,442,N/A,73,3
6,N/A,N/A,N/A,428,434,N/A,77,1
7,N/A,N/A,N/A,421,428,N/A,83,1
48,N/A,N/A,N/A,373,421,N/A,88,6
29,N/A,N/A,N/A,344,373,N/A,92,4
9,N/A,N/A,N/A,335,344,N/A,95,1
8,N/A,N/A,N/A,327,335,N/A,101,1
42,N/A,N/A,N/A,285,327,N/A,105,5
22,N/A,N/A,N/A,263,285,N/A,110,4
17,N/A,N/A,N/A,246,263,N/A,116,4
28,N/A,N/A,N/A,218,246,N/A,122,4
15,N/A,N/A,N/A,203,218,N/A,128,4
16,N/A,N/A,N/A,187,203,N/A,134,4
8,N/A,N/A,N/A,179,187,N/A,139,3
11,N/A,N/A,N/A,168,179,N/A,144,2
46,N/A,N/A,N/A,538,584,N/A,6,6
9,N/A,N/A,N/A,529,538,N/A,9,3
42,N/A,N/A,N/A,487,529,N/A,12,6
36,N/A,N/A,N/A,451,487,N/A,17,5
8,N/A,N/A,N/A,443,451,N/A,21,3
8,N/A,N/A,N/A,435,443,N/A,25,1
46,N/A,N/A,N/A,389,435,N/A,30,6
21,N/A,N/A,N/A,368,389,N/A,34,4
7,N/A,N/A,N/A,361,368,N/A,37,1
34,N/A,N/A,N/A,327,361,N/A,41,5
40,N/A,N/A,N/A,287,327,N/A,47,5
12,N/A,N/A,N/A,275,287,N/A,52,4
10,N/A,N/A,N/A,265,275,N/A,57,3
9,N/A,N/A,N/A,256,265,N/A,62,2
38,N/A,N/A,N/A,218,256,N/A,66,6
25,N/A,N/A,N/A,193,218,N/A,71,5
7,N/A,N/A,N/A,186,193,N/A,75,3
8,N/A,N/A,N/A,178,186,N/A,79,1
9,N/A,N/A,N/A,169,178,N/A,85,1
5,N/A,N/A,N/A,164,169,N/A,91,1
9,N/A,N/A,N/A,155,164,N/A,97,1
5,N/A,N/A,N/A,150,155,N/A,103,1
11,N/A,N/A,N/A,139,150,N/A,106,4
21,N/A,N/A,N/A,118,139,N/A,112,4
8,N/A,N/A,N/A,110,118,N/A,116,2
46,N/A,N/A,N/A,64,110,N/A,119,5
34,N/A,N/A,N/A,30,64,N/A,125,5
9,N/A,N/A,N/A,21,30,N/A,129,3
7,N/A,N/A,N/A,14,21,N/A,135,3
30,N/A,N/A,N/A,-16,14,N/A,138,6
9,N/A,N/A,N/A,383,392,N/A,3,2
11,N/A,N/A,N/A,372,383,N/A,9,2
7,N/A,N/A,N/A,365,372,N/A,14,1
32,N/A,N/A,N/A,333,365,N/A,19,6
18,N/A,N/A,N/A,315,333,N/A,23,4
13,N/A,N/A,N/A,302,315,N/A,29,4
24,N/A,N/A,N/A,278,302,N/A,35,4
10,N/A,N/A,N/A,268,278,N/A,40,3
11,N/A,N/A,N/A,257,268,N/A,46,3
9,N/A,N/A,N/A,248,257,N/A,50,1
30,N/A,N/A,N/A,218,248,N/A,55,6
47,N/A,N/A,N/A,171,218,N/A,60,5
7,N/A,N/A,N/A,164,171,N/A,64,3
47,N/A,N/A,N/A,117,164,N/A,67,6
16,N/A,N/A,N/A,101,117,N/A,71,4
7,N/A,N/A,N/A,94,101,N/A,75,2
6,N/A,N/A,N/A,88,94,N/A,80,1
28,N/A,N/A,N/A,60,88,N/A,85,6
7,N/A,N/A,N/A,53,60,N/A,88,3
8,N/A,N/A,N/A,45,53,N/A,93,2
40,N/A,N/A,N/A,5,45,N/A,96,5
22,N/A,N/A,N/A,-17,5,N/A,101,4
28,N/A,N/A,N/A,618,646,N/A,4,6
10,N/A,N/A,N/A,608,618,N/A,7,3
31,N/A,N/A,N/A,577,608,N/A,10,6
11,N/A,N/A,N/A,566,577,N/A,13,3
8,N/A,N/A,N/A,558,566,N/A,17,1
39,N/A,N/A,N/A,519,558,N/A,21,5
40,N/A,N/A,N/A,479,519,N/A,27,5
7,N/A,N/A,N/A,472,479,N/A,31,3
7,N/A,N/A,N/A,465,472,N/A,37,3
45,N/A,N/A,N/A,420,465,N/A,40,6
21,N/A,N/A,N/A,399,420,N/A,44,4
7,N/A,N/A,N/A,392,399,N/A,48,2
25,N/A,N/A,N/A,367,392,N/A,52,6
28,N/A,N/A,N/A,339,367,N/A,56,4
8,N/A,N/A,N/A,331,339,N/A,59,1
33,N/A,N/A,N/A,298,331,N/A,63,5
7,N/A,N/A,N/A,291,298,N/A,66,2
49,N/A,N/A,N/A,242,291,N/A,69,5
7,N/A,N/A,N/A,235,242,N/A,73,3
6,N/A,N/A,N/A,229,235,N/A,77,1
7,N/A,N/A,N/A,222,229,N/A,83,1
28,N/A,N/A,N/A,194,222,N/A,87,5
11,N/A,N/A,N/A,183,194,N/A,91,3
10,N/A,N/A,N/A,173,183,N/A,96,2
9,N/A,N/A,N/A,164,173,N/A,102,2
34,N/A,N/A,N/A,130,164,N/A,105,5
34,N/A,N/A,N/A,96,130,N/A,111,5
8,N/A,N/A,N/A,88,96,N/A,114,2
8,N/A,N/A,N/A,80,88,N/A,119,1
9,N/A,N/A,N/A,71,80,N/A,125,1
7,N/A,N/A,N/A,1438,1445,N/A,6,1
9,N/A,N/A,N/A,1429,1438,N/A,12,1
7,N/A,N/A,N/A,1422,1429,N/A,18,1
18,N/A,N/A,N/A,1404,1422,N/A,21,4
11,N/A,N/A,N/A,1393,1404,N/A,26,3
8,N/A,N/A,N/A,1385,1393,N/A,32,3
7,N/A,N/A,N/A,1378,1385,N/A,37,2
7,N/A,N/A,N/A,1371,1378,N/A,43,2
44,N/A,N/A,N/A,1327,1371,N/A,46,5
11,N/A,N/A,N/A,1316,1327,N/A,50,3
8,N/A,N/A,N/A,1308,1316,N/A,55,2
32,N/A,N/A,N/A,1276,1308,N/A,59,6
8,N/A,N/A,N/A,1268,1276,N/A,65,0
43,N/A,N/A,N/A,1225,1268,N/A,70,5
34,N/A,N/A,N/A,1191,1225,N/A,76,5
34,N/A,N/A,N/A,1157,1191,N/A,82,5
35,N/A,N/A,N/A,1122,1157,N/A,88,5
12,N/A,N/A,N/A,1110,1122,N/A,93,4
8,N/A,N/A,N/A,1102,1110,N/A,98,3
7,N/A,N/A,N/A,1095,1102,N/A,104,3
11,N/A,N/A,N/A,1084,1095,N/A,109,2
9,N/A,N/A,N/A,1075,1084,N/A,115,2
8,N/A,N/A,N/A,1067,1075,N/A,120,1
39,N/A,N/A,N/A,1028,1067,N/A,124,5
10,N/A,N/A,N/A,1018,1028,N/A,128,3
7,N/A,N/A,N/A,1011,1018,N/A,134,3
9,N/A,N/A,N/A,1002,1011,N/A,138,1
29,N/A,N/A,N/A,973,1002,N/A,142,5
8,N/A,N/A,N/A,965,973,N/A,146,3
9,N/A,N/A,N/A,956,965,N/A,152,3
34,N/A,N/A,N/A,1081,1115,N/A,6,5
36,N/A,N/A,N/A,1045,1081,N/A,12,5
8,N/A,N/A,N/A,1037,1045,N/A,16,3
9,N/A,N/A,N/A,1028,1037,N/A,21,2
7,N/A,N/A,N/A,1021,1028,N/A,27,2
46,N/A,N/A,N/A,975,1021,N/A,30,5
11,N/A,N/A,N/A,964,975,N/A,33,2
9,N/A,N/A,N/A,955,964,N/A,39,2
7,N/A,N/A,N/A,948,955,N/A,44,1
11,N/A,N/A,N/A,937,948,N/A,47,4
10,N/A,N/A,N/A,927,937,N/A,52,3
47,N/A,N/A,N/A,880,927,N/A,55,6
20,N/A,N/A,N/A,860,880,N/A,59,4
22,N/A,N/A,N/A,838,860,N/A,65,4
11,N/A,N/A,N/A,827,838,N/A,69,2
29,N/A,N/A,N/A,798,827,N/A,72,5
10,N/A,N/A,N/A,788,798,N/A,76,3
11,N/A,N/A,N/A,777,788,N/A,81,2
32,N/A,N/A,N/A,745,777,N/A,85,6
46,N/A,N/A,N/A,699,745,N/A,90,5
31,N/A,N/A,N/A,668,699,N/A,96,5
11,N/A,N/A,N/A,657,668,N/A,99,2
7,N/A,N/A,N/A,650,657,N/A,105,2
8,N/A,N/A,N/A,642,650,N/A,111,2
44,N/A,N/A,N/A,598,642,N/A,115,6
6,N/A,N/A,N/A,592,598,N/A,121,0
39,N/A,N/A,N/A,553,592,N/A,127,6
12,N/A,N/A,N/A,541,553,N/A,131,4
19,N/A,N/A,N/A,522,541,N/A,137,4
10,N/A,N/A,N/A,512,522,N/A,141,2
8,N/A,N/A,N/A,544,552,N/A,5,2
10,N/A,N/A,N/A,534,544,N/A,11,2
28,N/A,N/A,N/A,506,534,N/A,15,6
13,N/A,N/A,N/A,493,506,N/A,19,4
9,N/A,N/A,N/A,484,493,N/A,24,3
7,N/A,N/A,N/A,477,484,N/A,28,1
44,N/A,N/A,N/A,433,477,N/A,32,5
18,N/A,N/A,N/A,415,433,N/A,37,4
7,N/A,N/A,N/A,408,415,N/A,40,1
38,N/A,N/A,N/A,370,408,N/A,45,6
10,N/A,N/A,N/A,360,370,N/A,48,3
10,N/A,N/A,N/A,350,360,N/A,53,2
48,N/A,N/A,N/A,302,350,N/A,57,6
8,N/A,N/A,N/A,294,302,N/A,63,0
23,N/A,N/A,N/A,271,294,N/A,67,4
29,N/A,N/A,N/A,242,271,N/A,73,4
9,N/A,N/A,N/A,233,242,N/A,78,3
9,N/A,N/A,N/A,224,233,N/A,82,1
40,N/A,N/A,N/A,184,224,N/A,86,5
29,N/A,N/A,N/A,155,184,N/A,91,4
29,N/A,N/A,N/A,126,155,N/A,97,4
10,N/A,N/A,N/A,116,126,N/A,102,3
8,N/A,N/A,N/A,108,116,N/A,107,2
37,N/A,N/A,N/A,71,108,N/A,110,5
7,N/A,N/A,N/A,64,71,N/A,113,2
37,N/A,N/A,N/A,27,64,N/A,116,5
7,N/A,N/A,N/A,20,27,N/A,120,3
9,N/A,N/A,N/A,11,20,N/A,126,3
8,N/A,N/A,N/A,3,11,N/A,131,2
9,N/A,N/A,N/A,-6,3,N/A,137,2
13,N/A,N/A,N/A,349,362,N/A,6,4
8,N/A,N/A,N/A,341,349,N/A,10,2
47,N/A,N/A,N/A,294,341,N/A,13,5
10,N/A,N/A,N/A,284,294,N/A,17,3
5,N/A,N/A,N/A,279,284,N/A,21,1
39,N/A,N/A,N/A,240,279,N/A,25,5
9,N/A,N/A,N/A,231,240,N/A,28,2
47,N/A,N/A,N/A,184,231,N/A,32,6
10,N/A,N/A,N/A,174,184,N/A,36,4
7,N/A,N/A,N/A,167,174,N/A,39,1
26,N/A,N/A,N/A,141,167,N/A,44,6
6,N/A,N/A,N/A,135,141,N/A,50,0
44,N/A,N/A,N/A,91,135,N/A,56,6
44,N/A,N/A,N/A,47,91,N/A,61,5
29,N/A,N/A,N/A,18,47,N/A,66,4
11,N/A,N/A,N/A,7,18,N/A,71,3
10,N/A,N/A,N/A,-3,7,N/A,77,3
37,N/A,N/A,N/A,323,360,N/A,4,6
41,N/A,N/A,N/A,282,323,N/A,9,5
7,N/A,N/A,N/A,275,282,N/A,13,3
9,N/A,N/A,N/A,266,275,N/A,17,1
37,N/A,N/A,N/A,229,266,N/A,22,6
35,N/A,N/A,N/A,194,229,N/A,27,5
34,N/A,N/A,N/A,160,194,N/A,33,5
18,N/A,N/A,N/A,142,160,N/A,38,4
9,N/A,N/A,N/A,133,142,N/A,42,2
43,N/A,N/A,N/A,90,133,N/A,45,5
35,N/A,N/A,N/A,55,90,N/A,51,5
25,N/A,N/A,N/A,30,55,N/A,56,4
8,N/A,N/A,N/A,22,30,N/A,61,3
11,N/A,N/A,N/A,11,22,N/A,66,2
9,N/A,N/A,N/A,2,11,N/A,71,1
37,N/A,N/A,N/A,-35,2,N/A,76,6
47,N/A,N/A,N/A,851,898,N/A,4,6
37,N/A,N/A,N/A,814,851,N/A,9,5
7,N/A,N/A,N/A,807,814,N/A,12,2
30,N/A,N/A,N/A,777,807,N/A,15,5
42,N/A,N/A,N/A,735,777,N/A,21,5
10,N/A,N/A,N/A,725,735,N/A,24,2
10,N/A,N/A,N/A,715,725,N/A,30,2
42,N/A,N/A,N/A,673,715,N/A,34,6
9,N/A,N/A,N/A,664,673,N/A,37,3
6,N/A,N/A,N/A,658,664,N/A,41,1
14,N/A,N/A,N/A,644,658,N/A,44,4
7,N/A,N/A,N/A,637,644,N/A,48,2
43,N/A,N/A,N/A,594,637,N/A,52,6
9,N/A,N/A,N/A,585,594,N/A,55,3
42,N/A,N/A,N/A,543,585,N/A,58,6
49,N/A,N/A,N/A,494,543,N/A,63,5
16,N/A,N/A,N/A,478,494,N/A,68,4
8,N/A,N/A,N/A,470,478,N/A,72,2
6,N/A,N/A,N/A,464,470,N/A,77,1
21,N/A,N/A,N/A,443,464,N/A,80,4
9,N/A,N/A,N/A,434,443,N/A,84,2
28,N/A,N/A,N/A,406,434,N/A,87,5
7,N/A,N/A,N/A,399,406,N/A,91,3
9,N/A,N/A,N/A,390,399,N/A,95,1
26,N/A,N/A,N/A,364,390,N/A,98,4
11,N/A,N/A,N/A,353,364,N/A,103,3
9,N/A,N/A,N/A,344,353,N/A,107,1
44,N/A,N/A,N/A,300,344,N/A,112,6
47,N/A,N/A,N/A,253,300,N/A,117,5
10,N/A,N/A,N/A,243,253,N/A,120,2
42,N/A,N/A,N/A,440,482,N/A,5,5
19,N/A,N/A,N/A,421,440,N/A,10,4
9,N/A,N/A,N/A,412,421,N/A,13,1
34,N/A,N/A,N/A,378,412,N/A,17,5
7,N/A,N/A,N/A,371,378,N/A,21,3
6,N/A,N/A,N/A,365,371,N/A,25,1
39,N/A,N/A,N/A,326,365,N/A,29,5
7,N/A,N/A,N/A,319,326,N/A,32,2
31,N/A,N/A,N/A,288,319,N/A,35,5
11,N/A,N/A,N/A,277,288,N/A,38,2
8,N/A,N/A,N/A,269,277,N/A,44,2
43,N/A,N/A,N/A,226,269,N/A,48,6
28,N/A,N/A,N/A,198,226,N/A,53,5
29,N/A,N/A,N/A,169,198,N/A,58,4
7,N/A,N/A,N/A,162,169,N/A,61,1
48,N/A,N/A,N/A,114,162,N/A,66,6
9,N/A,N/A,N/A,105,114,N/A,72,0
19,N/A,N/A,N/A,86,105,N/A,76,4
11,N/A,N/A,N/A,75,86,N/A,80,2
49,N/A,N/A,N/A,26,75,N/A,84,6
10,N/A,N/A,N/A,16,26,N/A,87,3
9,N/A,N/A,N/A,7,16,N/A,91,1
5,N/A,N/A,N/A,2,7,N/A,97,1
40,N/A,N/A,N/A,-38,2,N/A,101,5
10,N/A,N/A,N/A,1043,1053,N/A,5,3
8,N/A,N/A,N/A,1035,1043,N/A,11,3
9,N/A,N/A,N/A,1026,1035,N/A,15,1
36,N/A,N/A,N/A,990,1026,N/A,19,5
29,N/A,N/A,N/A,961,990,N/A,24,4
18,N/A,N/A,N/A,943,961,N/A,30,4
5,N/A,N/A,N/A,938,943,N/A,33,1
8,N/A,N/A,N/A,930,938,N/A,39,1
41,N/A,N/A,N/A,889,930,N/A,43,5
46,N/A,N/A,N/A,843,889,N/A,49,5
30,N/A,N/A,N/A,813,843,N/A,55,5
10,N/A,N/A,N/A,803,813,N/A,58,2
34,N/A,N/A,N/A,769,803,N/A,62,6
45,N/A,N/A,N/A,724,769,N/A,67,5
7,N/A,N/A,N/A,717,724,N/A,70,2
25,N/A,N/A,N/A,692,717,N/A,73,5
11,N/A,N/A,N/A,681,692,N/A,76,2
28,N/A,N/A,N/A,653,681,N/A,80,6
9,N/A,N/A,N/A,644,653,N/A,83,3
9,N/A,N/A,N/A,635,644,N/A,88,2
5,N/A,N/A,N/A,630,635,N/A,93,1
39,N/A,N/A,N/A,591,630,N/A,98,6
49,N/A,N/A,N/A,542,591,N/A,103,5
9,N/A,N/A,N/A,533,542,N/A,107,3
36,N/A,N/A,N/A,497,533,N/A,110,6
9,N/A,N/A,N/A,488,497,N/A,113,3
29,N/A,N/A,N/A,459,488,N/A,116,6
26,N/A,N/A,N/A,433,459,N/A,121,5
18,N/A,N/A,N/A,415,433,N/A,126,4
13,N/A,N/A,N/A,402,415,N/A,132,4
47,N/A,N/A,N/A,1061,1108,N/A,4,5
39,N/A,N/A,N/A,1022,1061,N/A,10,5
40,N/A,N/A,N/A,982,1022,N/A,16,5
7,N/A,N/A,N/A,975,982,N/A,19,2
45,N/A,N/A,N/A,930,975,N/A,22,5
10,N/A,N/A,N/A,920,930,N/A,25,2
6,N/A,N/A,N/A,914,920,N/A,30,1
6,N/A,N/A,N/A,908,914,N/A,36,1
33,N/A,N/A,N/A,875,908,N/A,41,6
11,N/A,N/A,N/A,864,875,N/A,44,3
8,N/A,N/A,N/A,856,864,N/A,48,1
9,N/A,N/A,N/A,847,856,N/A,54,1
38,N/A,N/A,N/A,809,847,N/A,59,6
48,N/A,N/A,N/A,761,809,N/A,64,5
11,N/A,N/A,N/A,750,761,N/A,68,3
11,N/A,N/A,N/A,739,750,N/A,74,3
9,N/A,N/A,N/A,730,739,N/A,78,1
23,N/A,N/A,N/A,707,730,N/A,81,4
19,N/A,N/A,N/A,688,707,N/A,87,4
11,N/A,N/A,N/A,677,688,N/A,92,3
5,N/A,N/A,N/A,672,677,N/A,96,1
5,N/A,N/A,N/A,667,672,N/A,102,1
43,N/A,N/A,N/A,624,667,N/A,106,5
46,N/A,N/A,N/A,578,624,N/A,112,5
11,N/A,N/A,N/A,567,578,N/A,115,2
30,N/A,N/A,N/A,537,567,N/A,118,5
38,N/A,N/A,N/A,499,537,N/A,124,5
8,N/A,N/A,N/A,491,499,N/A,127,2
8,N/A,N/A,N/A,483,491,N/A,132,1
45,N/A,N/A,N/A,438,483,N/A,136,5
48,N/A,N/A,N/A,941,989,N/A,3,6
27,N/A,N/A,N/A,914,941,N/A,7,4
26,N/A,N/A,N/A,888,914,N/A,13,4
8,N/A,N/A,N/A,880,888,N/A,16,1
26,N/A,N/A,N/A,854,880,N/A,19,4
9,N/A,N/A,N/A,845,854,N/A,24,3
9,N/A,N/A,N/A,836,845,N/A,29,2
48,N/A,N/A,N/A,788,836,N/A,32,5
16,N/A,N/A,N/A,772,788,N/A,37,4
10,N/A,N/A,N/A,762,772,N/A,41,2
8,N/A,N/A,N/A,754,762,N/A,47,2
10,N/A,N/A,N/A,744,754,N/A,53,2
9,N/A,N/A,N/A,735,744,N/A,58,1
35,N/A,N/A,N/A,700,735,N/A,62,5
19,N/A,N/A,N/A,681,700,N/A,67,4
6,N/A,N/A,N/A,675,681,N/A,70,1
9,N/A,N/A,N/A,666,675,N/A,76,1
45,N/A,N/A,N/A,621,666,N/A,80,5
10,N/A,N/A,N/A,611,621,N/A,84,3
8,N/A,N/A,N/A,603,611,N/A,88,1
9,N/A,N/A,N/A,594,603,N/A,94,1
7,N/A,N/A,N/A,587,594,N/A,100,1
46,N/A,N/A,N/A,541,587,N/A,104,5
42,N/A,N/A,N/A,499,541,N/A,110,5
8,N/A,N/A,N/A,491,499,N/A,114,3
8,N/A,N/A,N/A,483,491,N/A,119,2
11,N/A,N/A,N/A,472,483,N/A,125,2
10,N/A,N/A,N/A,462,472,N/A,131,2
32,N/A,N/A,N/A,430,462,N/A,134,5
26,N/A,N/A,N/A,404,430,N/A,140,5
28,N/A,N/A,N/A,589,617,N/A,3,4
6,N/A,N/A,N/A,583,589,N/A,6,1
42,N/A,N/A,N/A,541,583,N/A,11,6
32,N/A,N/A,N/A,509,541,N/A,16,5
9,N/A,N/A,N/A,500,509,N/A,19,2
28,N/A,N/A,N/A,472,500,N/A,22,5
8,N/A,N/A,N/A,464,472,N/A,25,2
7,N/A,N/A,N/A,457,464,N/A,30,1
29,N/A,N/A,N/A,428,457,N/A,34,5
11,N/A,N/A,N/A,417,428,N/A,38,3
10,N/A,N/A,N/A,407,417,N/A,44,3
8,N/A,N/A,N/A,399,407,N/A,48,1
15,N/A,N/A,N/A,384,399,N/A,51,4
6,N/A,N/A,N/A,378,384,N/A,54,1
9,N/A,N/A,N/A,369,378,N/A,60,1
26,N/A,N/A,N/A,343,369,N/A,64,5
24,N/A,N/A,N/A,319,343,N/A,69,4
6,N/A,N/A,N/A,313,319,N/A,72,1
7,N/A,N/A,N/A,306,313,N/A,78,1
36,N/A,N/A,N/A,270,306,N/A,83,6
27,N/A,N/A,N/A,243,270,N/A,88,5
10,N/A,N/A,N/A,233,243,N/A,92,3
7,N/A,N/A,N/A,226,233,N/A,97,2
36,N/A,N/A,N/A,190,226,N/A,100,5
11,N/A,N/A,N/A,179,190,N/A,103,2
6,N/A,N/A,N/A,173,179,N/A,108,1
6,N/A,N/A,N/A,167,173,N/A,114,1
49,N/A,N/A,N/A,118,167,N/A,118,5
29,N/A,N/A,N/A,89,118,N/A,124,5
10,N/A,N/A,N/A,79,89,N/A,128,3
8,N/A,N/A,N/A,489,497,N/A,4,3
9,N/A,N/A,N/A,480,489,N/A,9,2
42,N/A,N/A,N/A,438,480,N/A,12,5
7,N/A,N/A,N/A,431,438,N/A,15,2
9,N/A,N/A,N/A,422,431,N/A,20,1
27,N/A,N/A,N/A,395,422,N/A,24,5
10,N/A,N/A,N/A,385,395,N/A,28,3
11,N/A,N/A,N/A,374,385,N/A,33,2
7,N/A,N/A,N/A,367,374,N/A,38,1
20,N/A,N/A,N/A,347,367,N/A,41,4
11,N/A,N/A,N/A,336,347,N/A,45,2
11,N/A,N/A,N/A,325,336,N/A,51,2
8,N/A,N/A,N/A,317,325,N/A,56,1
48,N/A,N/A,N/A,269,317,N/A,60,5
9,N/A,N/A,N/A,260,269,N/A,64,3
11,N/A,N/A,N/A,249,260,N/A,70,3
9,N/A,N/A,N/A,240,249,N/A,76,3
6,N/A,N/A,N/A,234,240,N/A,80,1
11,N/A,N/A,N/A,223,234,N/A,83,4
7,N/A,N/A,N/A,216,223,N/A,86,1
26,N/A,N/A,N/A,190,216,N/A,90,5
38,N/A,N/A,N/A,152,190,N/A,96,5
41,N/A,N/A,N/A,111,152,N/A,102,5
11,N/A,N/A,N/A,100,111,N/A,105,2
33,N/A,N/A,N/A,67,100,N/A,108,5
14,N/A,N/A,N/A,53,67,N/A,113,4
8,N/A,N/A,N/A,45,53,N/A,118,3
38,N/A,N/A,N/A,7,45,N/A,121,6
7,N/A,N/A,N/A,0,7,N/A,124,3
23,N/A,N/A,N/A,1773,1796,N/A,5,4
11,N/A,N/A,N/A,1762,1773,N/A,9,2
41,N/A,N/A,N/A,1721,1762,N/A,13,6
42,N/A,N/A,N/A,1679,1721,N/A,18,5
26,N/A,N/A,N/A,1653,1679,N/A,23,4
9,N/A,N/A,N/A,1644,1653,N/A,26,1
39,N/A,N/A,N/A,1605,1644,N/A,30,5
13,N/A,N/A,N/A,1592,1605,N/A,35,4
7,N/A,N/A,N/A,1585,1592,N/A,38,1
18,N/A,N/A,N/A,1567,1585,N/A,41,4
8,N/A,N/A,N/A,1559,1567,N/A,44,1
28,N/A,N/A,N/A,1531,1559,N/A,49,6
7,N/A,N/A,N/A,1524,1531,N/A,52,3
7,N/A,N/A,N/A,1517,1524,N/A,56,1
34,N/A,N/A,N/A,1483,1517,N/A,61,6
5,N/A,N/A,N/A,1478,1483,N/A,67,0
45,N/A,N/A,N/A,1433,1478,N/A,73,6
9,N/A,N/A,N/A,1424,1433,N/A,76,3
30,N/A,N/A,N/A,1394,1424,N/A,79,6
13,N/A,N/A,N/A,1381,1394,N/A,83,4
11,N/A,N/A,N/A,1370,1381,N/A,88,3
45,N/A,N/A,N/A,1325,1370,N/A,91,6
20,N/A,N/A,N/A,1305,1325,N/A,95,4
11,N/A,N/A,N/A,1294,1305,N/A,100,3
45,N/A,N/A,N/A,1249,1294,N/A,103,6
6,N/A,N/A,N/A,1243,1249,N/A,109,0
42,N/A,N/A,N/A,1201,1243,N/A,114,5
23,N/A,N/A,N/A,1178,1201,N/A,119,4
6,N/A,N/A,N/A,1172,1178,N/A,122,1
39,N/A,N/A,N/A,1133,1172,N/A,127,6
30,N/A,N/A,N/A,780,810,N/A,4,5
20,N/A,N/A,N/A,760,780,N/A,9,4
18,N/A,N/A,N/A,742,760,N/A,15,4
9,N/A,N/A,N/A,733,742,N/A,20,3
10,N/A,N/A,N/A,723,733,N/A,25,2
47,N/A,N/A,N/A,676,723,N/A,28,5
27,N/A,N/A,N/A,649,676,N/A,33,4
11,N/A,N/A,N/A,638,649,N/A,38,3
9,N/A,N/A,N/A,629,638,N/A,43,2
39,N/A,N/A,N/A,590,629,N/A,46,5
34,N/A,N/A,N/A,556,590,N/A,52,5
35,N/A,N/A,N/A,521,556,N/A,58,5
49,N/A,N/A,N/A,472,521,N/A,64,5
8,N/A,N/A,N/A,464,472,N/A,68,3
8,N/A,N/A,N/A,456,464,N/A,72,1
48,N/A,N/A,N/A,408,456,N/A,76,5
11,N/A,N/A,N/A,397,408,N/A,80,3
8,N/A,N/A,N/A,389,397,N/A,86,3
27,N/A,N/A,N/A,362,389,N/A,89,6
11,N/A,N/A,N/A,351,362,N/A,93,4
8,N/A,N/A,N/A,343,351,N/A,96,1
25,N/A,N/A,N/A,318,343,N/A,99,4
8,N/A,N/A,N/A,310,318,N/A,103,2
7,N/A,N/A,N/A,303,310,N/A,108,1
44,N/A,N/A,N/A,259,303,N/A,112,5
22,N/A,N/A,N/A,237,259,N/A,117,4
9,N/A,N/A,N/A,228,237,N/A,122,3
9,N/A,N/A,N/A,219,228,N/A,128,3
8,N/A,N/A,N/A,211,219,N/A,132,1
22,N/A,N/A,N/A,189,211,N/A,135,4
14,N/A,N/A,N/A,343,357,N/A,5,4
8,N/A,N/A,N/A,335,343,N/A,9,2
42,N/A,N/A,N/A,293,335,N/A,12,5
25,N/A,N/A,N/A,268,293,N/A,18,5
42,N/A,N/A,N/A,226,268,N/A,24,5
29,N/A,N/A,N/A,197,226,N/A,30,5
10,N/A,N/A,N/A,187,197,N/A,33,2
37,N/A,N/A,N/A,150,187,N/A,36,5
10,N/A,N/A,N/A,140,150,N/A,41,4
9,N/A,N/A,N/A,131,140,N/A,44,1
43,N/A,N/A,N/A,88,131,N/A,49,6
41,N/A,N/A,N/A,47,88,N/A,54,5
25,N/A,N/A,N/A,22,47,N/A,59,4
26,N/A,N/A,N/A,-4,22,N/A,65,4
7,N/A,N/A,N/A,1900,1907,N/A,6,2
49,N/A,N/A,N/A,1851,1900,N/A,10,6
24,N/A,N/A,N/A,1827,1851,N/A,14,4
11,N/A,N/A,N/A,1816,1827,N/A,18,2
38,N/A,N/A,N/A,1778,1816,N/A,22,6
43,N/A,N/A,N/A,1735,1778,N/A,27,5
11,N/A,N/A,N/A,1724,1735,N/A,32,4
5,N/A,N/A,N/A,1719,1724,N/A,35,1
5,N/A,N/A,N/A,1714,1719,N/A,41,1
29,N/A,N/A,N/A,1685,1714,N/A,45,5
7,N/A,N/A,N/A,1678,1685,N/A,48,2
7,N/A,N/A,N/A,1671,1678,N/A,53,1
44,N/A,N/A,N/A,1627,1671,N/A,58,6
14,N/A,N/A,N/A,1613,1627,N/A,62,4
15,N/A,N/A,N/A,1598,1613,N/A,68,4
8,N/A,N/A,N/A,1590,1598,N/A,72,2
42,N/A,N/A,N/A,1548,1590,N/A,75,5
7,N/A,N/A,N/A,1541,1548,N/A,79,3
10,N/A,N/A,N/A,1531,1541,N/A,84,2
9,N/A,N/A,N/A,1522,1531,N/A,89,1
5,N/A,N/A,N/A,1517,1522,N/A,95,1
48,N/A,N/A,N/A,1469,1517,N/A,99,5
19,N/A,N/A,N/A,1450,1469,N/A,104,4
26,N/A,N/A,N/A,1424,1450,N/A,110,4
21,N/A,N/A,N/A,1403,1424,N/A,116,4
10,N/A,N/A,N/A,1393,1403,N/A,122,4
8,N/A,N/A,N/A,1385,1393,N/A,126,2
29,N/A,N/A,N/A,1356,1385,N/A,130,6
29,N/A,N/A,N/A,1327,1356,N/A,134,4
8,N/A,N/A,N/A,1319,1327,N/A,137,1
32,N/A,N/A,N/A,1349,1381,N/A,5,5
43,N/A,N/A,N/A,1306,1349,N/A,11,5
27,N/A,N/A,N/A,1279,1306,N/A,17,5
39,N/A,N/A,N/A,1240,1279,N/A,23,5
7,N/A,N/A,N/A,1233,1240,N/A,26,2
11,N/A,N/A,N/A,1222,1233,N/A,32,2
49,N/A,N/A,N/A,1173,1222,N/A,36,6
7,N/A,N/A,N/A,1166,1173,N/A,42,0
11,N/A,N/A,N/A,1155,1166,N/A,45,3
7,N/A,N/A,N/A,1148,1155,N/A,49,1
43,N/A,N/A,N/A,1105,1148,N/A,53,5
9,N/A,N/A,N/A,1096,1105,N/A,56,2
7,N/A,N/A,N/A,1089,1096,N/A,61,1
23,N/A,N/A,N/A,1066,1089,N/A,64,4
18,N/A,N/A,N/A,1048,1066,N/A,70,4
11,N/A,N/A,N/A,1037,1048,N/A,74,2
41,N/A,N/A,N/A,996,1037,N/A,77,5
11,N/A,N/A,N/A,985,996,N/A,81,3
9,N/A,N/A,N/A,976,985,N/A,85,1
7,N/A,N/A,N/A,969,976,N/A,91,1
29,N/A,N/A,N/A,940,969,N/A,95,5
11,N/A,N/A,N/A,929,940,N/A,99,3
11,N/A,N/A,N/A,918,929,N/A,104,2
35,N/A,N/A,N/A,883,918,N/A,108,6
6,N/A,N/A,N/A,877,883,N/A,114,0
42,N/A,N/A,N/A,835,877,N/A,120,6
10,N/A,N/A,N/A,825,835,N/A,123,3
10,N/A,N/A,N/A,815,825,N/A,129,3
5,N/A,N/A,N/A,810,815,N/A,133,1
33,N/A,N/A,N/A,777,810,N/A,137,5
10,N/A,N/A,N/A,877,887,N/A,3,2
40,N/A,N/A,N/A,837,877,N/A,6,5
44,N/A,N/A,N/A,793,837,N/A,12,5
14,N/A,N/A,N/A,779,793,N/A,17,4
7,N/A,N/A,N/A,772,779,N/A,20,1
5,N/A,N/A,N/A,767,772,N/A,26,1
39,N/A,N/A,N/A,728,767,N/A,31,6
11,N/A,N/A,N/A,717,728,N/A,34,3
11,N/A,N/A,N/A,706,717,N/A,40,3
26,N/A,N/A,N/A,680,706,N/A,43,6
38,N/A,N/A,N/A,642,680,N/A,48,5
27,N/A,N/A,N/A,615,642,N/A,53,4
19,N/A,N/A,N/A,596,615,N/A,59,4
9,N/A,N/A,N/A,587,596,N/A,64,3
28,N/A,N/A,N/A,559,587,N/A,67,6
11,N/A,N/A,N/A,548,559,N/A,70,3
11,N/A,N/A,N/A,537,548,N/A,76,3
37,N/A,N/A,N/A,500,537,N/A,79,6
10,N/A,N/A,N/A,490,500,N/A,82,3
30,N/A,N/A,N/A,460,490,N/A,85,6
32,N/A,N/A,N/A,428,460,N/A,90,5
9,N/A,N/A,N/A,419,428,N/A,94,3
9,N/A,N/A,N/A,410,419,N/A,98,1
27,N/A,N/A,N/A,383,410,N/A,102,5
39,N/A,N/A,N/A,344,383,N/A,108,5
9,N/A,N/A,N/A,335,344,N/A,112,3
9,N/A,N/A,N/A,326,335,N/A,117,2
5,N/A,N/A,N/A,321,326,N/A,122,1
25,N/A,N/A,N/A,296,321,N/A,127,6
7,N/A,N/A,N/A,289,296,N/A,130,3
9,N/A,N/A,N/A,1807,1816,N/A,6,3
9,N/A,N/A,N/A,1798,1807,N/A,11,2
44,N/A,N/A,N/A,1754,1798,N/A,15,6
9,N/A,N/A,N/A,1745,1754,N/A,21,0
28,N/A,N/A,N/A,1717,1745,N/A,25,4
6,N/A,N/A,N/A,1711,1717,N/A,28,1
40,N/A,N/A,N/A,1671,1711,N/A,33,6
9,N/A,N/A,N/A,1662,1671,N/A,39,0
25,N/A,N/A,N/A,1637,1662,N/A,45,6
5,N/A,N/A,N/A,1632,1637,N/A,51,0
28,N/A,N/A,N/A,1604,1632,N/A,56,5
29,N/A,N/A,N/A,1575,1604,N/A,62,5
12,N/A,N/A,N/A,1563,1575,N/A,67,4
5,N/A,N/A,N/A,1558,1563,N/A,70,1
6,N/A,N/A,N/A,1552,1558,N/A,76,1
46,N/A,N/A,N/A,1506,1552,N/A,81,6
9,N/A,N/A,N/A,1497,1506,N/A,87,0
39,N/A,N/A,N/A,1458,1497,N/A,92,5
34,N/A,N/A,N/A,1424,1458,N/A,98,5
46,N/A,N/A,N/A,1378,1424,N/A,104,5
25,N/A,N/A,N/A,1353,1378,N/A,109,4
7,N/A,N/A,N/A,1346,1353,N/A,114,3
9,N/A,N/A,N/A,1337,1346,N/A,120,3
44,N/A,N/A,N/A,1293,1337,N/A,123,6
6,N/A,N/A,N/A,1287,1293,N/A,129,0
45,N/A,N/A,N/A,1242,1287,N/A,135,6
9,N/A,N/A,N/A,1233,1242,N/A,141,0
8,N/A,N/A,N/A,1225,1233,N/A,144,3
10,N/A,N/A,N/A,1215,1225,N/A,150,3
11,N/A,N/A,N/A,1204,1215,N/A,155,2
5,N/A,N/A,N/A,1336,1341,N/A,5,1
5,N/A,N/A,N/A,1331,1336,N/A,11,1
48,N/A,N/A,N/A,1283,1331,N/A,15,5
10,N/A,N/A,N/A,1273,1283,N/A,19,3
10,N/A,N/A,N/A,1263,1273,N/A,24,2
49,N/A,N/A,N/A,1214,1263,N/A,27,5
39,N/A,N/A,N/A,1175,1214,N/A,33,5
11,N/A,N/A,N/A,1164,1175,N/A,36,2
48,N/A,N/A,N/A,1116,1164,N/A,39,5
9,N/A,N/A,N/A,1107,1116,N/A,42,2
9,N/A,N/A,N/A,1098,1107,N/A,47,1
38,N/A,N/A,N/A,1060,1098,N/A,51,5
29,N/A,N/A,N/A,1031,1060,N/A,56,4
10,N/A,N/A,N/A,1021,1031,N/A,60,2
27,N/A,N/A,N/A,994,1021,N/A,63,5
11,N/A,N/A,N/A,983,994,N/A,66,2
6,N/A,N/A,N/A,977,983,N/A,71,1
12,N/A,N/A,N/A,965,977,N/A,74,4
18,N/A,N/A,N/A,947,965,N/A,80,4
9,N/A,N/A,N/A,938,947,N/A,83,1
9,N/A,N/A,N/A,929,938,N/A,89,1
5,N/A,N/A,N/A,924,929,N/A,95,1
5,N/A,N/A,N/A,919,924,N/A,101,1
15,N/A,N/A,N/A,904,919,N/A,104,4
11,N/A,N/A,N/A,893,904,N/A,109,3
11,N/A,N/A,N/A,882,893,N/A,114,2
11,N/A,N/A,N/A,871,882,N/A,120,2
40,N/A,N/A,N/A,831,871,N/A,124,6
8,N/A,N/A,N/A,823,831,N/A,130,0
31,N/A,N/A,N/A,792,823,N/A,135,5
10,N/A,N/A,N/A,1580,1590,N/A,3,3
10,N/A,N/A,N/A,1570,1580,N/A,8,2
29,N/A,N/A,N/A,1541,1570,N/A,12,6
5,N/A,N/A,N/A,1536,1541,N/A,18,0
29,N/A,N/A,N/A,1507,1536,N/A,24,6
42,N/A,N/A,N/A,1465,1507,N/A,29,5
23,N/A,N/A,N/A,1442,1465,N/A,34,4
23,N/A,N/A,N/A,1419,1442,N/A,40,4
27,N/A,N/A,N/A,1392,1419,N/A,46,4
9,N/A,N/A,N/A,1383,1392,N/A,51,3
9,N/A,N/A,N/A,1374,1383,N/A,57,3
11,N/A,N/A,N/A,1363,1374,N/A,63,3
44,N/A,N/A,N/A,1319,1363,N/A,66,6
43,N/A,N/A,N/A,1276,1319,N/A,71,5
46,N/A,N/A,N/A,1230,1276,N/A,77,5
11,N/A,N/A,N/A,1219,1230,N/A,80,2
5,N/A,N/A,N/A,1214,1219,N/A,85,1
41,N/A,N/A,N/A,1173,1214,N/A,89,5
10,N/A,N/A,N/A,1163,1173,N/A,93,3
7,N/A,N/A,N/A,1156,1163,N/A,99,3
7,N/A,N/A,N/A,1149,1156,N/A,104,2
34,N/A,N/A,N/A,1115,1149,N/A,107,5
15,N/A,N/A,N/A,1100,1115,N/A,112,4
7,N/A,N/A,N/A,1093,1100,N/A,117,3
10,N/A,N/A,N/A,1083,1093,N/A,122,2
8,N/A,N/A,N/A,1075,1083,N/A,128,2
7,N/A,N/A,N/A,1068,1075,N/A,133,1
21,N/A,N/A,N/A,1047,1068,N/A,136,4
8,N/A,N/A,N/A,1039,1047,N/A,141,3
45,N/A,N/A,N/A,994,1039,N/A,144,6
9,N/A,N/A,N/A,894,903,N/A,6,3
49,N/A,N/A,N/A,845,894,N/A,9,6
9,N/A,N/A,N/A,836,845,N/A,15,0
31,N/A,N/A,N/A,805,836,N/A,20,5
12,N/A,N/A,N/A,793,805,N/A,25,4
8,N/A,N/A,N/A,785,793,N/A,30,3
9,N/A,N/A,N/A,776,785,N/A,34,1
12,N/A,N/A,N/A,764,776,N/A,37,4
9,N/A,N/A,N/A,755,764,N/A,42,3
11,N/A,N/A,N/A,744,755,N/A,48,3
9,N/A,N/A,N/A,735,744,N/A,53,2
11,N/A,N/A,N/A,724,735,N/A,59,2
9,N/A,N/A,N/A,715,724,N/A,64,1
47,N/A,N/A,N/A,668,715,N/A,68,5
8,N/A,N/A,N/A,660,668,N/A,72,3
11,N/A,N/A,N/A,649,660,N/A,78,3
7,N/A,N/A,N/A,642,649,N/A,84,3
7,N/A,N/A,N/A,635,642,N/A,90,3
7,N/A,N/A,N/A,628,635,N/A,95,2
35,N/A,N/A,N/A,593,628,N/A,98,5
9,N/A,N/A,N/A,584,593,N/A,102,3
11,N/A,N/A,N/A,573,584,N/A,107,2
48,N/A,N/A,N/A,525,573,N/A,110,5
25,N/A,N/A,N/A,500,525,N/A,115,4
9,N/A,N/A,N/A,491,500,N/A,118,1
26,N/A,N/A,N/A,465,491,N/A,123,6
26,N/A,N/A,N/A,439,465,N/A,128,5
41,N/A,N/A,N/A,398,439,N/A,134,5
28,N/A,N/A,N/A,370,398,N/A,139,4
8,N/A,N/A,N/A,362,370,N/A,144,3
35,N/A,N/A,N/A,1892,1927,N/A,4,6
7,N/A,N/A,N/A,1885,1892,N/A,7,3
33,N/A,N/A,N/A,1852,1885,N/A,10,6
5,N/A,N/A,N/A,1847,1852,N/A,16,0
8,N/A,N/A,N/A,1839,1847,N/A,19,3
11,N/A,N/A,N/A,1828,1839,N/A,25,3
8,N/A,N/A,N/A,1820,1828,N/A,31,3
10,N/A,N/A,N/A,1810,1820,N/A,36,2
7,N/A,N/A,N/A,1803,1810,N/A,42,2
8,N/A,N/A,N/A,1795,1803,N/A,47,1
16,N/A,N/A,N/A,1779,1795,N/A,50,4
7,N/A,N/A,N/A,1772,1779,N/A,55,3
8,N/A,N/A,N/A,1764,1772,N/A,61,3
9,N/A,N/A,N/A,1755,1764,N/A,65,1
9,N/A,N/A,N/A,1746,1755,N/A,71,1
49,N/A,N/A,N/A,1697,1746,N/A,75,5
20,N/A,N/A,N/A,1677,1697,N/A,80,4
10,N/A,N/A,N/A,1667,1677,N/A,84,2
37,N/A,N/A,N/A,1630,1667,N/A,88,6
32,N/A,N/A,N/A,1598,1630,N/A,93,5
7,N/A,N/A,N/A,1591,1598,N/A,97,3
7,N/A,N/A,N/A,1584,1591,N/A,102,2
9,N/A,N/A,N/A,1575,1584,N/A,108,2
49,N/A,N/A,N/A,1526,1575,N/A,111,5
10,N/A,N/A,N/A,1516,1526,N/A,115,3
6,N/A,N/A,N/A,1510,1516,N/A,119,1
26,N/A,N/A,N/A,1484,1510,N/A,122,4
18,N/A,N/A,N/A,1466,1484,N/A,128,4
11,N/A,N/A,N/A,1455,1466,N/A,133,3
9,N/A,N/A,N/A,1446,1455,N/A,139,3
13,N/A,N/A,N/A,1692,1705,N/A,5,4
7,N/A,N/A,N/A,1685,1692,N/A,10,3
29,N/A,N/A,N/A,1656,1685,N/A,13,6
26,N/A,N/A,N/A,1630,1656,N/A,18,5
10,N/A,N/A,N/A,1620,1630,N/A,21,2
5,N/A,N/A,N/A,1615,1620,N/A,26,1
27,N/A,N/A,N/A,1588,1615,N/A,30,5
29,N/A,N/A,N/A,1559,1588,N/A,35,4
8,N/A,N/A,N/A,1551,1559,N/A,38,1
40,N/A,N/A,N/A,1511,1551,N/A,42,5
7,N/A,N/A,N/A,1504,1511,N/A,46,3
8,N/A,N/A,N/A,1496,1504,N/A,51,2
8,N/A,N/A,N/A,1488,1496,N/A,56,1
20,N/A,N/A,N/A,1468,1488,N/A,59,4
19,N/A,N/A,N/A,1449,1468,N/A,65,4
12,N/A,N/A,N/A,1437,1449,N/A,71,4
8,N/A,N/A,N/A,1429,1437,N/A,76,3
7,N/A,N/A,N/A,1422,1429,N/A,80,1
7,N/A,N/A,N/A,1415,1422,N/A,86,1
8,N/A,N/A,N/A,1407,1415,N/A,92,1
45,N/A,N/A,N/A,1362,1407,N/A,96,5
10,N/A,N/A,N/A,1352,1362,N/A,101,4
14,N/A,N/A,N/A,1338,1352,N/A,107,4
7,N/A,N/A,N/A,1331,1338,N/A,112,3
38,N/A,N/A,N/A,1293,1331,N/A,115,6
11,N/A,N/A,N/A,1282,1293,N/A,118,3
10,N/A,N/A,N/A,1272,1282,N/A,124,3
44,N/A,N/A,N/A,1228,1272,N/A,127,6
6,N/A,N/A,N/A,1222,1228,N/A,133,0
25,N/A,N/A,N/A,1197,1222,N/A,139,6
8,N/A,N/A,N/A,864,872,N/A,5,3
10,N/A,N/A,N/A,854,864,N/A,11,3
11,N/A,N/A,N/A,843,854,N/A,16,2
8,N/A,N/A,N/A,835,843,N/A,22,2
9,N/A,N/A,N/A,826,835,N/A,27,1
7,N/A,N/A,N/A,819,826,N/A,33,1
46,N/A,N/A,N/A,773,819,N/A,38,6
10,N/A,N/A,N/A,763,773,N/A,41,3
7,N/A,N/A,N/A,756,763,N/A,46,2
5,N/A,N/A,N/A,751,756,N/A,51,1
6,N/A,N/A,N/A,745,751,N/A,57,1
44,N/A,N/A,N/A,701,745,N/A,62,6
29,N/A,N/A,N/A,672,701,N/A,66,4
9,N/A,N/A,N/A,663,672,N/A,70,2
29,N/A,N/A,N/A,634,663,N/A,74,6
23,N/A,N/A,N/A,611,634,N/A,78,4
14,N/A,N/A,N/A,597,611,N/A,84,4
8,N/A,N/A,N/A,589,597,N/A,88,2
37,N/A,N/A,N/A,552,589,N/A,91,5
33,N/A,N/A,N/A,519,552,N/A,97,5
8,N/A,N/A,N/A,511,519,N/A,101,3
11,N/A,N/A,N/A,500,511,N/A,107,3
8,N/A,N/A,N/A,492,500,N/A,111,1
19,N/A,N/A,N/A,473,492,N/A,114,4
11,N/A,N/A,N/A,462,473,N/A,118,2
8,N/A,N/A,N/A,454,462,N/A,123,1
41,N/A,N/A,N/A,413,454,N/A,128,6
8,N/A,N/A,N/A,405,413,N/A,131,3
7,N/A,N/A,N/A,398,405,N/A,135,1
8,N/A,N/A,N/A,390,398,N/A,141,1
13,N/A,N/A,N/A,1457,1470,N/A,3,4
9,N/A,N/A,N/A,1448,1457,N/A,7,2
30,N/A,N/A,N/A,1418,1448,N/A,11,6
10,N/A,N/A,N/A,1408,1418,N/A,15,4
8,N/A,N/A,N/A,1400,1408,N/A,18,1
6,N/A,N/A,N/A,1394,1400,N/A,24,1
27,N/A,N/A,N/A,1367,1394,N/A,28,5
10,N/A,N/A,N/A,1357,1367,N/A,31,2
9,N/A,N/A,N/A,1348,1357,N/A,37,2
10,N/A,N/A,N/A,1338,1348,N/A,43,2
27,N/A,N/A,N/A,1311,1338,N/A,46,5
44,N/A,N/A,N/A,1267,1311,N/A,52,5
41,N/A,N/A,N/A,1226,1267,N/A,58,5
28,N/A,N/A,N/A,1198,1226,N/A,64,5
9,N/A,N/A,N/A,1189,1198,N/A,67,2
7,N/A,N/A,N/A,1182,1189,N/A,73,2
25,N/A,N/A,N/A,1157,1182,N/A,77,6
5,N/A,N/A,N/A,1152,1157,N/A,83,0
8,N/A,N/A,N/A,1144,1152,N/A,86,3
7,N/A,N/A,N/A,1137,1144,N/A,91,2
5,N/A,N/A,N/A,1132,1137,N/A,96,1
18,N/A,N/A,N/A,1114,1132,N/A,99,4
7,N/A,N/A,N/A,1107,1114,N/A,102,1
7,N/A,N/A,N/A,1100,1107,N/A,108,1
13,N/A,N/A,N/A,1087,1100,N/A,111,4
9,N/A,N/A,N/A,1078,1087,N/A,115,2
32,N/A,N/A,N/A,1046,1078,N/A,119,6
28,N/A,N/A,N/A,1018,1046,N/A,123,4
19,N/A,N/A,N/A,999,1018,N/A,129,4
7,N/A,N/A,N/A,992,999,N/A,134,3
34,N/A,N/A,N/A,1552,1586,N/A,3,6
20,N/A,N/A,N/A,1532,1552,N/A,7,4
9,N/A,N/A,N/A,1523,1532,N/A,12,3
42,N/A,N/A,N/A,1481,1523,N/A,15,6
25,N/A,N/A,N/A,1456,1481,N/A,19,4
11,N/A,N/A,N/A,1445,1456,N/A,24,3
9,N/A,N/A,N/A,1436,1445,N/A,29,2
8,N/A,N/A,N/A,1428,1436,N/A,35,2
48,N/A,N/A,N/A,1380,1428,N/A,39,6
5,N/A,N/A,N/A,1375,1380,N/A,45,0
10,N/A,N/A,N/A,1365,1375,N/A,48,3
7,N/A,N/A,N/A,1358,1365,N/A,53,2
7,N/A,N/A,N/A,1351,1358,N/A,58,1
6,N/A,N/A,N/A,1345,1351,N/A,64,1
25,N/A,N/A,N/A,1320,1345,N/A,67,4
11,N/A,N/A,N/A,1309,1320,N/A,72,3
10,N/A,N/A,N/A,1299,1309,N/A,77,2
43,N/A,N/A,N/A,1256,1299,N/A,81,6
14,N/A,N/A,N/A,1242,1256,N/A,85,4
28,N/A,N/A,N/A,1214,1242,N/A,91,4
18,N/A,N/A,N/A,1196,1214,N/A,97,4
6,N/A,N/A,N/A,1190,1196,N/A,100,1
46,N/A,N/A,N/A,1144,1190,N/A,105,6
28,N/A,N/A,N/A,1116,1144,N/A,110,5
9,N/A,N/A,N/A,1107,1116,N/A,113,2
44,N/A,N/A,N/A,1063,1107,N/A,116,5
49,N/A,N/A,N/A,1014,1063,N/A,122,5
9,N/A,N/A,N/A,1005,1014,N/A,125,2
33,N/A,N/A,N/A,972,1005,N/A,129,6
10,N/A,N/A,N/A,962,972,N/A,132,3
10,N/A,N/A,N/A,341,351,N/A,6,3
37,N/A,N/A,N/A,304,341,N/A,9,6
7,N/A,N/A,N/A,297,304,N/A,12,3
32,N/A,N/A,N/A,265,297,N/A,15,6
27,N/A,N/A,N/A,238,265,N/A,20,5
23,N/A,N/A,N/A,215,238,N/A,25,4
8,N/A,N/A,N/A,207,215,N/A,28,1
28,N/A,N/A,N/A,179,207,N/A,32,5
7,N/A,N/A,N/A,172,179,N/A,36,3
28,N/A,N/A,N/A,144,172,N/A,39,6
7,N/A,N/A,N/A,137,144,N/A,45,0
23,N/A,N/A,N/A,114,137,N/A,49,4
7,N/A,N/A,N/A,107,114,N/A,54,3
31,N/A,N/A,N/A,76,107,N/A,57,6
25,N/A,N/A,N/A,51,76,N/A,61,4
9,N/A,N/A,N/A,42,51,N/A,66,3
8,N/A,N/A,N/A,34,42,N/A,71,2
45,N/A,N/A,N/A,-11,34,N/A,75,6
48,N/A,N/A,N/A,1148,1196,N/A,3,6
7,N/A,N/A,N/A,1141,1148,N/A,9,0
32,N/A,N/A,N/A,1109,1141,N/A,15,6
9,N/A,N/A,N/A,1100,1109,N/A,18,3
36,N/A,N/A,N/A,1064,1100,N/A,21,6
7,N/A,N/A,N/A,1057,1064,N/A,27,0
30,N/A,N/A,N/A,1027,1057,N/A,32,5
10,N/A,N/A,N/A,1017,1027,N/A,36,3
11,N/A,N/A,N/A,1006,1017,N/A,42,3
5,N/A,N/A,N/A,1001,1006,N/A,46,1
28,N/A,N/A,N/A,973,1001,N/A,50,5
8,N/A,N/A,N/A,965,973,N/A,54,3
7,N/A,N/A,N/A,958,965,N/A,60,3
8,N/A,N/A,N/A,950,958,N/A,66,3
44,N/A,N/A,N/A,906,950,N/A,69,6
16,N/A,N/A,N/A,890,906,N/A,73,4
11,N/A,N/A,N/A,879,890,N/A,78,3
9,N/A,N/A,N/A,870,879,N/A,84,3
6,N/A,N/A,N/A,864,870,N/A,88,1
29,N/A,N/A,N/A,835,864,N/A,93,6
10,N/A,N/A,N/A,825,835,N/A,96,3
8,N/A,N/A,N/A,817,825,N/A,101,2
11,N/A,N/A,N/A,806,817,N/A,107,2
39,N/A,N/A,N/A,767,806,N/A,111,6
34,N/A,N/A,N/A,733,767,N/A,116,5
9,N/A,N/A,N/A,724,733,N/A,120,3
45,N/A,N/A,N/A,679,724,N/A,123,6
7,N/A,N/A,N/A,672,679,N/A,129,0
8,N/A,N/A,N/A,664,672,N/A,132,3
37,N/A,N/A,N/A,627,664,N/A,135,6
11,N/A,N/A,N/A,751,762,N/A,5,3
8,N/A,N/A,N/A,743,751,N/A,11,3
7,N/A,N/A,N/A,736,743,N/A,16,2
47,N/A,N/A,N/A,689,736,N/A,20,6
8,N/A,N/A,N/A,681,689,N/A,26,0
33,N/A,N/A,N/A,648,681,N/A,31,5
10,N/A,N/A,N/A,638,648,N/A,34,2
38,N/A,N/A,N/A,600,638,N/A,38,6
29,N/A,N/A,N/A,571,600,N/A,43,5
10,N/A,N/A,N/A,561,571,N/A,46,2
45,N/A,N/A,N/A,516,561,N/A,49,5
9,N/A,N/A,N/A,507,516,N/A,52,2
40,N/A,N/A,N/A,467,507,N/A,55,5
43,N/A,N/A,N/A,424,467,N/A,61,5
26,N/A,N/A,N/A,398,424,N/A,66,4
7,N/A,N/A,N/A,391,398,N/A,70,2
40,N/A,N/A,N/A,351,391,N/A,74,6
5,N/A,N/A,N/A,346,351,N/A,80,0
26,N/A,N/A,N/A,320,346,N/A,84,4
8,N/A,N/A,N/A,312,320,N/A,87,1
9,N/A,N/A,N/A,303,312,N/A,93,1
9,N/A,N/A,N/A,294,303,N/A,99,1
47,N/A,N/A,N/A,247,294,N/A,103,5
8,N/A,N/A,N/A,239,247,N/A,106,2
11,N/A,N/A,N/A,228,239,N/A,112,2
9,N/A,N/A,N/A,219,228,N/A,118,2
8,N/A,N/A,N/A,211,219,N/A,123,1
44,N/A,N/A,N/A,167,211,N/A,127,5
8,N/A,N/A,N/A,159,167,N/A,131,3
41,N/A,N/A,N/A,118,159,N/A,134,6
7,N/A,N/A,N/A,806,813,N/A,6,1
45,N/A,N/A,N/A,761,806,N/A,10,5
10,N/A,N/A,N/A,751,761,N/A,15,4
8,N/A,N/A,N/A,743,751,N/A,18,1
9,N/A,N/A,N/A,734,743,N/A,24,1
31,N/A,N/A,N/A,703,734,N/A,28,5
10,N/A,N/A,N/A,693,703,N/A,31,2
6,N/A,N/A,N/A,687,693,N/A,36,1
7,N/A,N/A,N/A,680,687,N/A,42,1
40,N/A,N/A,N/A,640,680,N/A,47,6
45,N/A,N/A,N/A,595,640,N/A,52,5
11,N/A,N/A,N/A,584,595,N/A,56,3
25,N/A,N/A,N/A,559,584,N/A,59,6
28,N/A,N/A,N/A,531,559,N/A,63,4
16,N/A,N/A,N/A,515,531,N/A,69,4
13,N/A,N/A,N/A,502,515,N/A,75,4
10,N/A,N/A,N/A,492,502,N/A,79,2
29,N/A,N/A,N/A,463,492,N/A,82,5
9,N/A,N/A,N/A,454,463,N/A,86,3
9,N/A,N/A,N/A,445,454,N/A,91,2
31,N/A,N/A,N/A,414,445,N/A,94,5
7,N/A,N/A,N/A,407,414,N/A,97,2
5,N/A,N/A,N/A,402,407,N/A,102,1
8,N/A,N/A,N/A,394,402,N/A,108,1
39,N/A,N/A,N/A,355,394,N/A,112,5
11,N/A,N/A,N/A,344,355,N/A,116,3
44,N/A,N/A,N/A,300,344,N/A,119,6
27,N/A,N/A,N/A,273,300,N/A,123,4
8,N/A,N/A,N/A,265,273,N/A,126,1
33,N/A,N/A,N/A,232,265,N/A,130,5
5,N/A,N/A,N/A,449,454,N/A,4,1
6,N/A,N/A,N/A,443,449,N/A,10,1
5,N/A,N/A,N/A,438,443,N/A,16,1
13,N/A,N/A,N/A,425,438,N/A,19,4
10,N/A,N/A,N/A,415,425,N/A,24,3
7,N/A,N/A,N/A,408,415,N/A,29,2
8,N/A,N/A,N/A,400,408,N/A,34,1
25,N/A,N/A,N/A,375,400,N/A,39,6
9,N/A,N/A,N/A,366,375,N/A,45,0
43,N/A,N/A,N/A,323,366,N/A,51,6
41,N/A,N/A,N/A,282,323,N/A,56,5
7,N/A,N/A,N/A,275,282,N/A,59,2
33,N/A,N/A,N/A,242,275,N/A,63,6
48,N/A,N/A,N/A,194,242,N/A,68,5
10,N/A,N/A,N/A,184,194,N/A,71,2
9,N/A,N/A,N/A,175,184,N/A,76,1
26,N/A,N/A,N/A,149,175,N/A,80,5
9,N/A,N/A,N/A,140,149,N/A,83,2
6,N/A,N/A,N/A,134,140,N/A,88,1
26,N/A,N/A,N/A,108,134,N/A,91,4
13,N/A,N/A,N/A,95,108,N/A,97,4
20,N/A,N/A,N/A,75,95,N/A,103,4
8,N/A,N/A,N/A,67,75,N/A,108,3
26,N/A,N/A,N/A,41,67,N/A,111,6
9,N/A,N/A,N/A,32,41,N/A,114,3
8,N/A,N/A,N/A,24,32,N/A,118,1
38,N/A,N/A,N/A,-14,24,N/A,122,5
12,N/A,N/A,N/A,1933,1945,N/A,5,4
8,N/A,N/A,N/A,1925,1933,N/A,9,2
25,N/A,N/A,N/A,1900,1925,N/A,13,6
32,N/A,N/A,N/A,1868,1900,N/A,18,5
45,N/A,N/A,N/A,1823,1868,N/A,24,5
7,N/A,N/A,N/A,1816,1823,N/A,27,2
49,N/A,N/A,N/A,1767,1816,N/A,31,6
38,N/A,N/A,N/A,1729,1767,N/A,36,5
13,N/A,N/A,N/A,1716,1729,N/A,41,4
26,N/A,N/A,N/A,1690,1716,N/A,47,4
11,N/A,N/A,N/A,1679,1690,N/A,52,3
11,N/A,N/A,N/A,1668,1679,N/A,57,2
5,N/A,N/A,N/A,1663,1668,N/A,62,1
39,N/A,N/A,N/A,1624,1663,N/A,67,6
38,N/A,N/A,N/A,1586,1624,N/A,72,5
7,N/A,N/A,N/A,1579,1586,N/A,76,3
8,N/A,N/A,N/A,1571,1579,N/A,81,2
10,N/A,N/A,N/A,1561,1571,N/A,87,2
8,N/A,N/A,N/A,1553,1561,N/A,92,1
21,N/A,N/A,N/A,1532,1553,N/A,95,4
11,N/A,N/A,N/A,1521,1532,N/A,99,2
49,N/A,N/A,N/A,1472,1521,N/A,102,5
17,N/A,N/A,N/A,1455,1472,N/A,107,4
8,N/A,N/A,N/A,1447,1455,N/A,112,3
10,N/A,N/A,N/A,1437,1447,N/A,117,2
45,N/A,N/A,N/A,1392,1437,N/A,120,5
23,N/A,N/A,N/A,1369,1392,N/A,125,4
7,N/A,N/A,N/A,1362,1369,N/A,128,1
23,N/A,N/A,N/A,1339,1362,N/A,131,4
11,N/A,N/A,N/A,1328,1339,N/A,136,3
11,N/A,N/A,N/A,584,595,N/A,5,3
9,N/A,N/A,N/A,575,584,N/A,11,3
29,N/A,N/A,N/A,546,575,N/A,14,6
31,N/A,N/A,N/A,515,546,N/A,19,5
8,N/A,N/A,N/A,507,515,N/A,22,2
5,N/A,N/A,N/A,502,507,N/A,27,1
7,N/A,N/A,N/A,495,502,N/A,33,1
35,N/A,N/A,N/A,460,495,N/A,37,5
10,N/A,N/A,N/A,450,460,N/A,41,3
36,N/A,N/A,N/A,414,450,N/A,44,6
49,N/A,N/A,N/A,365,414,N/A,49,5
10,N/A,N/A,N/A,355,365,N/A,53,3
6,N/A,N/A,N/A,349,355,N/A,57,1
24,N/A,N/A,N/A,325,349,N/A,60,4
9,N/A,N/A,N/A,316,325,N/A,63,1
7,N/A,N/A,N/A,309,316,N/A,69,1
19,N/A,N/A,N/A,290,309,N/A,72,4
7,N/A,N/A,N/A,283,290,N/A,77,3
10,N/A,N/A,N/A,273,283,N/A,83,3
8,N/A,N/A,N/A,265,273,N/A,88,2
47,N/A,N/A,N/A,218,265,N/A,91,5
11,N/A,N/A,N/A,207,218,N/A,95,3
29,N/A,N/A,N/A,178,207,N/A,98,6
9,N/A,N/A,N/A,169,178,N/A,101,3
8,N/A,N/A,N/A,161,169,N/A,105,1
27,N/A,N/A,N/A,134,161,N/A,108,4
26,N/A,N/A,N/A,108,134,N/A,114,4
8,N/A,N/A,N/A,100,108,N/A,118,2
7,N/A,N/A,N/A,93,100,N/A,123,1
47,N/A,N/A,N/A,46,93,N/A,127,5
7,N/A,N/A,N/A,1467,1474,N/A,3,2
8,N/A,N/A,N/A,1459,1467,N/A,9,2
7,N/A,N/A,N/A,1452,1459,N/A,14,1
35,N/A,N/A,N/A,1417,1452,N/A,18,5
11,N/A,N/A,N/A,1406,1417,N/A,22,3
8,N/A,N/A,N/A,1398,1406,N/A,28,3
7,N/A,N/A,N/A,1391,1398,N/A,33,2
7,N/A,N/A,N/A,1384,1391,N/A,38,1
44,N/A,N/A,N/A,1340,1384,N/A,42,5
11,N/A,N/A,N/A,1329,1340,N/A,45,2
10,N/A,N/A,N/A,1319,1329,N/A,51,2
26,N/A,N/A,N/A,1293,1319,N/A,54,5
13,N/A,N/A,N/A,1280,1293,N/A,59,4
5,N/A,N/A,N/A,1275,1280,N/A,62,1
30,N/A,N/A,N/A,1245,1275,N/A,66,5
8,N/A,N/A,N/A,1237,1245,N/A,69,2
29,N/A,N/A,N/A,1208,1237,N/A,73,6
39,N/A,N/A,N/A,1169,1208,N/A,78,5
18,N/A,N/A,N/A,1151,1169,N/A,83,4
11,N/A,N/A,N/A,1140,1151,N/A,87,2
38,N/A,N/A,N/A,1102,1140,N/A,91,6
18,N/A,N/A,N/A,1084,1102,N/A,95,4
8,N/A,N/A,N/A,1076,1084,N/A,100,3
41,N/A,N/A,N/A,1035,1076,N/A,103,6
30,N/A,N/A,N/A,1005,1035,N/A,108,5
9,N/A,N/A,N/A,996,1005,N/A,111,2
8,N/A,N/A,N/A,988,996,N/A,116,1
38,N/A,N/A,N/A,950,988,N/A,121,6
6,N/A,N/A,N/A,944,950,N/A,127,0
22,N/A,N/A,N/A,922,944,N/A,131,4
36,N/A,N/A,N/A,1147,1183,N/A,6,6
28,N/A,N/A,N/A,1119,1147,N/A,11,5
21,N/A,N/A,N/A,1098,1119,N/A,16,4
9,N/A,N/A,N/A,1089,1098,N/A,21,3
49,N/A,N/A,N/A,1040,1089,N/A,24,6
27,N/A,N/A,N/A,1013,1040,N/A,28,4
8,N/A,N/A,N/A,1005,1013,N/A,32,2
36,N/A,N/A,N/A,969,1005,N/A,36,6
21,N/A,N/A,N/A,948,969,N/A,40,4
12,N/A,N/A,N/A,936,948,N/A,46,4
10,N/A,N/A,N/A,926,936,N/A,51,3
32,N/A,N/A,N/A,894,926,N/A,54,6
30,N/A,N/A,N/A,864,894,N/A,59,5
10,N/A,N/A,N/A,854,864,N/A,62,2
26,N/A,N/A,N/A,828,854,N/A,65,5
20,N/A,N/A,N/A,808,828,N/A,70,4
27,N/A,N/A,N/A,781,808,N/A,76,4
9,N/A,N/A,N/A,772,781,N/A,79,1
10,N/A,N/A,N/A,762,772,N/A,82,4
26,N/A,N/A,N/A,736,762,N/A,88,4
28,N/A,N/A,N/A,708,736,N/A,94,4
5,N/A,N/A,N/A,703,708,N/A,97,1
7,N/A,N/A,N/A,696,703,N/A,103,1
48,N/A,N/A,N/A,648,696,N/A,107,5
11,N/A,N/A,N/A,637,648,N/A,111,3
5,N/A,N/A,N/A,632,637,N/A,115,1
18,N/A,N/A,N/A,614,632,N/A,118,4
10,N/A,N/A,N/A,604,614,N/A,122,2
9,N/A,N/A,N/A,595,604,N/A,128,2
43,N/A,N/A,N/A,552,595,N/A,132,6
17,N/A,N/A,N/A,331,348,N/A,4,4
12,N/A,N/A,N/A,319,331,N/A,10,4
16,N/A,N/A,N/A,303,319,N/A,16,4
14,N/A,N/A,N/A,289,303,N/A,22,4
7,N/A,N/A,N/A,282,289,N/A,26,2
8,N/A,N/A,N/A,274,282,N/A,31,1
8,N/A,N/A,N/A,266,274,N/A,37,1
5,N/A,N/A,N/A,261,266,N/A,43,1
20,N/A,N/A,N/A,241,261,N/A,46,4
9,N/A,N/A,N/A,232,241,N/A,51,3
11,N/A,N/A,N/A,221,232,N/A,56,2
5,N/A,N/A,N/A,216,221,N/A,61,1
7,N/A,N/A,N/A,209,216,N/A,67,1
38,N/A,N/A,N/A,171,209,N/A,72,6
15,N/A,N/A,N/A,156,171,N/A,76,4
25,N/A,N/A,N/A,131,156,N/A,82,4
8,N/A,N/A,N/A,123,131,N/A,85,1
30,N/A,N/A,N/A,93,123,N/A,89,5
29,N/A,N/A,N/A,64,93,N/A,95,5
10,N/A,N/A,N/A,54,64,N/A,100,4
13,N/A,N/A,N/A,41,54,N/A,106,4
7,N/A,N/A,N/A,34,41,N/A,109,1
31,N/A,N/A,N/A,3,34,N/A,113,5
45,N/A,N/A,N/A,-42,3,N/A,119,5
5,N/A,N/A,N/A,991,996,N/A,6,1
7,N/A,N/A,N/A,984,991,N/A,12,1
30,N/A,N/A,N/A,954,984,N/A,17,6
5,N/A,N/A,N/A,949,954,N/A,23,0
49,N/A,N/A,N/A,900,949,N/A,28,5
7,N/A,N/A,N/A,893,900,N/A,31,2
35,N/A,N/A,N/A,858,893,N/A,35,6
5,N/A,N/A,N/A,853,858,N/A,41,0
24,N/A,N/A,N/A,829,853,N/A,45,4
11,N/A,N/A,N/A,818,829,N/A,49,2
5,N/A,N/A,N/A,813,818,N/A,54,1
45,N/A,N/A,N/A,768,813,N/A,59,6
30,N/A,N/A,N/A,738,768,N/A,64,5
7,N/A,N/A,N/A,731,738,N/A,67,2
7,N/A,N/A,N/A,724,731,N/A,73,2
46,N/A,N/A,N/A,678,724,N/A,77,6
34,N/A,N/A,N/A,644,678,N/A,82,5
8,N/A,N/A,N/A,636,644,N/A,86,3
27,N/A,N/A,N/A,609,636,N/A,89,6
36,N/A,N/A,N/A,573,609,N/A,94,5
33,N/A,N/A,N/A,540,573,N/A,100,5
11,N/A,N/A,N/A,529,540,N/A,104,3
9,N/A,N/A,N/A,520,529,N/A,109,2
8,N/A,N/A,N/A,512,520,N/A,114,1
48,N/A,N/A,N/A,464,512,N/A,119,6
5,N/A,N/A,N/A,459,464,N/A,125,0
7,N/A,N/A,N/A,452,459,N/A,128,3
10,N/A,N/A,N/A,442,452,N/A,133,2
28,N/A,N/A,N/A,414,442,N/A,136,5
8,N/A,N/A,N/A,406,414,N/A,140,3
9,N/A,N/A,N/A,1960,1969,N/A,6,1
8,N/A,N/A,N/A,1952,1960,N/A,12,1
26,N/A,N/A,N/A,1926,1952,N/A,17,6
28,N/A,N/A,N/A,1898,1926,N/A,22,5
11,N/A,N/A,N/A,1887,1898,N/A,26,3
7,N/A,N/A,N/A,1880,1887,N/A,30,1
19,N/A,N/A,N/A,1861,1880,N/A,33,4
18,N/A,N/A,N/A,1843,1861,N/A,39,4
6,N/A,N/A,N/A,1837,1843,N/A,42,1
15,N/A,N/A,N/A,1822,1837,N/A,45,4
8,N/A,N/A,N/A,1814,1822,N/A,48,1
5,N/A,N/A,N/A,1809,1814,N/A,54,1
8,N/A,N/A,N/A,1801,1809,N/A,60,1
13,N/A,N/A,N/A,1788,1801,N/A,63,4
8,N/A,N/A,N/A,1780,1788,N/A,68,3
6,N/A,N/A,N/A,1774,1780,N/A,72,1
28,N/A,N/A,N/A,1746,1774,N/A,77,6
24,N/A,N/A,N/A,1722,1746,N/A,81,4
9,N/A,N/A,N/A,1713,1722,N/A,84,1
35,N/A,N/A,N/A,1678,1713,N/A,89,6
11,N/A,N/A,N/A,1667,1678,N/A,92,3
44,N/A,N/A,N/A,1623,1667,N/A,95,6
8,N/A,N/A,N/A,1615,1623,N/A,101,0
21,N/A,N/A,N/A,1594,1615,N/A,105,4
10,N/A,N/A,N/A,1584,1594,N/A,110,3
8,N/A,N/A,N/A,1576,1584,N/A,114,1
26,N/A,N/A,N/A,1550,1576,N/A,119,6
7,N/A,N/A,N/A,1543,1550,N/A,125,0
22,N/A,N/A,N/A,1521,1543,N/A,129,4
8,N/A,N/A,N/A,1513,1521,N/A,132,1
11,N/A,N/A,N/A,565,576,N/A,6,2
7,N/A,N/A,N/A,558,565,N/A,12,2
5,N/A,N/A,N/A,553,558,N/A,17,1
29,N/A,N/A,N/A,524,553,N/A,22,6
10,N/A,N/A,N/A,514,524,N/A,25,3
9,N/A,N/A,N/A,505,514,N/A,30,2
5,N/A,N/A,N/A,500,505,N/A,35,1
39,N/A,N/A,N/A,461,500,N/A,39,5
34,N/A,N/A,N/A,427,461,N/A,45,5
25,N/A,N/A,N/A,402,427,N/A,51,5
28,N/A,N/A,N/A,374,402,N/A,56,4
7,N/A,N/A,N/A,367,374,N/A,61,3
42,N/A,N/A,N/A,325,367,N/A,64,6
29,N/A,N/A,N/A,296,325,N/A,69,5
17,N/A,N/A,N/A,279,296,N/A,74,4
7,N/A,N/A,N/A,272,279,N/A,78,2
9,N/A,N/A,N/A,263,272,N/A,84,2
45,N/A,N/A,N/A,218,263,N/A,88,6
7,N/A,N/A,N/A,211,218,N/A,91,3
10,N/A,N/A,N/A,201,211,N/A,97,3
42,N/A,N/A,N/A,159,201,N/A,100,6
9,N/A,N/A,N/A,150,159,N/A,103,3
10,N/A,N/A,N/A,140,150,N/A,109,3
7,N/A,N/A,N/A,133,140,N/A,115,3
9,N/A,N/A,N/A,124,133,N/A,121,3
48,N/A,N/A,N/A,76,124,N/A,124,6
9,N/A,N/A,N/A,67,76,N/A,127,3
11,N/A,N/A,N/A,56,67,N/A,133,3
25,N/A,N/A,N/A,31,56,N/A,136,6
49,N/A,N/A,N/A,-18,31,N/A,141,5
38,N/A,N/A,N/A,379,417,N/A,5,5
9,N/A,N/A,N/A,370,379,N/A,9,3
6,N/A,N/A,N/A,364,370,N/A,13,1
37,N/A,N/A,N/A,327,364,N/A,17,5
37,N/A,N/A,N/A,290,327,N/A,23,5
8,N/A,N/A,N/A,282,290,N/A,27,3
11,N/A,N/A,N/A,271,282,N/A,32,2
9,N/A,N/A,N/A,262,271,N/A,38,2
45,N/A,N/A,N/A,217,262,N/A,42,6
12,N/A,N/A,N/A,205,217,N/A,46,4
9,N/A,N/A,N/A,196,205,N/A,49,1
34,N/A,N/A,N/A,162,196,N/A,53,5
27,N/A,N/A,N/A,135,162,N/A,58,4
7,N/A,N/A,N/A,128,135,N/A,62,2
7,N/A,N/A,N/A,121,128,N/A,67,1
5,N/A,N/A,N/A,116,121,N/A,73,1
35,N/A,N/A,N/A,81,116,N/A,78,6
41,N/A,N/A,N/A,40,81,N/A,83,5
22,N/A,N/A,N/A,18,40,N/A,88,4
8,N/A,N/A,N/A,10,18,N/A,91,1
28,N/A,N/A,N/A,-18,10,N/A,96,6
9,N/A,N/A,N/A,1179,1188,N/A,3,2
6,N/A,N/A,N/A,1173,1179,N/A,8,1
44,N/A,N/A,N/A,1129,1173,N/A,12,5
21,N/A,N/A,N/A,1108,1129,N/A,17,4
11,N/A,N/A,N/A,1097,1108,N/A,22,3
6,N/A,N/A,N/A,1091,1097,N/A,26,1
17,N/A,N/A,N/A,1074,1091,N/A,29,4
7,N/A,N/A,N/A,1067,1074,N/A,33,2
38,N/A,N/A,N/A,1029,1067,N/A,37,6
23,N/A,N/A,N/A,1006,1029,N/A,41,4
10,N/A,N/A,N/A,996,1006,N/A,46,3
45,N/A,N/A,N/A,951,996,N/A,49,6
20,N/A,N/A,N/A,931,951,N/A,53,4
11,N/A,N/A,N/A,920,931,N/A,57,2
8,N/A,N/A,N/A,912,920,N/A,63,2
43,N/A,N/A,N/A,869,912,N/A,66,5
10,N/A,N/A,N/A,859,869,N/A,69,2
35,N/A,N/A,N/A,824,859,N/A,72,5
10,N/A,N/A,N/A,814,824,N/A,76,3
8,N/A,N/A,N/A,806,814,N/A,81,2
11,N/A,N/A,N/A,795,806,N/A,87,2
11,N/A,N/A,N/A,784,795,N/A,93,2
8,N/A,N/A,N/A,776,784,N/A,98,1
44,N/A,N/A,N/A,732,776,N/A,103,6
36,N/A,N/A,N/A,696,732,N/A,108,5
49,N/A,N/A,N/A,647,696,N/A,114,5
12,N/A,N/A,N/A,635,647,N/A,119,4
7,N/A,N/A,N/A,628,635,N/A,124,3
9,N/A,N/A,N/A,619,628,N/A,128,1
25,N/A,N/A,N/A,594,619,N/A,132,5
9,N/A,N/A,N/A,323,332,N/A,3,2
46,N/A,N/A,N/A,277,323,N/A,7,6
37,N/A,N/A,N/A,240,277,N/A,12,5
29,N/A,N/A,N/A,211,240,N/A,17,4
10,N/A,N/A,N/A,201,211,N/A,22,3
27,N/A,N/A,N/A,174,201,N/A,25,6
40,N/A,N/A,N/A,134,174,N/A,30,5
7,N/A,N/A,N/A,127,134,N/A,34,3
11,N/A,N/A,N/A,116,127,N/A,40,3
8,N/A,N/A,N/A,108,116,N/A,45,2
10,N/A,N/A,N/A,98,108,N/A,51,2
39,N/A,N/A,N/A,59,98,N/A,55,6
9,N/A,N/A,N/A,50,59,N/A,58,3
47,N/A,N/A,N/A,3,50,N/A,61,6
34,N/A,N/A,N/A,-31,3,N/A,66,5
5,N/A,N/A,N/A,1152,1157,N/A,4,1
41,N/A,N/A,N/A,1111,1152,N/A,8,5
25,N/A,N/A,N/A,1086,1111,N/A,14,5
10,N/A,N/A,N/A,1076,1086,N/A,17,2
11,N/A,N/A,N/A,1065,1076,N/A,23,2
47,N/A,N/A,N/A,1018,1065,N/A,26,5
13,N/A,N/A,N/A,1005,1018,N/A,31,4
5,N/A,N/A,N/A,1000,1005,N/A,34,1
22,N/A,N/A,N/A,978,1000,N/A,37,4
9,N/A,N/A,N/A,969,978,N/A,40,1
32,N/A,N/A,N/A,937,969,N/A,45,6
49,N/A,N/A,N/A,888,937,N/A,50,5
9,N/A,N/A,N/A,879,888,N/A,54,3
9,N/A,N/A,N/A,870,879,N/A,59,2
43,N/A,N/A,N/A,827,870,N/A,63,6
8,N/A,N/A,N/A,819,827,N/A,69,0
7,N/A,N/A,N/A,812,819,N/A,72,3
7,N/A,N/A,N/A,805,812,N/A,78,3
5,N/A,N/A,N/A,800,805,N/A,82,1
25,N/A,N/A,N/A,775,800,N/A,86,5
12,N/A,N/A,N/A,763,775,N/A,91,4
9,N/A,N/A,N/A,754,763,N/A,94,1
34,N/A,N/A,N/A,720,754,N/A,98,5
20,N/A,N/A,N/A,700,720,N/A,103,4
8,N/A,N/A,N/A,692,700,N/A,107,2
26,N/A,N/A,N/A,666,692,N/A,110,5
39,N/A,N/A,N/A,627,666,N/A,116,5
40,N/A,N/A,N/A,587,627,N/A,122,5
26,N/A,N/A,N/A,561,587,N/A,127,4
11,N/A,N/A,N/A,550,561,N/A,131,2
9,N/A,N/A,N/A,1484,1493,N/A,5,1
43,N/A,N/A,N/A,1441,1484,N/A,9,5
12,N/A,N/A,N/A,1429,1441,N/A,14,4
8,N/A,N/A,N/A,1421,1429,N/A,19,3
10,N/A,N/A,N/A,1411,1421,N/A,25,3
8,N/A,N/A,N/A,1403,1411,N/A,29,1
7,N/A,N/A,N/A,1396,1403,N/A,35,1
5,N/A,N/A,N/A,1391,1396,N/A,41,1
30,N/A,N/A,N/A,1361,1391,N/A,45,5
17,N/A,N/A,N/A,1344,1361,N/A,50,4
7,N/A,N/A,N/A,1337,1344,N/A,54,2
48,N/A,N/A,N/A,1289,1337,N/A,58,6
11,N/A,N/A,N/A,1278,1289,N/A,62,4
19,N/A,N/A,N/A,1259,1278,N/A,68,4
7,N/A,N/A,N/A,1252,1259,N/A,73,3
8,N/A,N/A,N/A,1244,1252,N/A,77,1
9,N/A,N/A,N/A,1235,1244,N/A,83,1
12,N/A,N/A,N/A,1223,1235,N/A,86,4
10,N/A,N/A,N/A,1213,1223,N/A,90,2
32,N/A,N/A,N/A,1181,1213,N/A,93,5
29,N/A,N/A,N/A,1152,1181,N/A,98,4
9,N/A,N/A,N/A,1143,1152,N/A,101,1
25,N/A,N/A,N/A,1118,1143,N/A,105,5
8,N/A,N/A,N/A,1110,1118,N/A,109,3
8,N/A,N/A,N/A,1102,1110,N/A,115,3
9,N/A,N/A,N/A,1093,1102,N/A,120,2
5,N/A,N/A,N/A,1088,1093,N/A,125,1
49,N/A,N/A,N/A,1039,1088,N/A,130,6
9,N/A,N/A,N/A,1030,1039,N/A,133,3
40,N/A,N/A,N/A,990,1030,N/A,136,6
44,N/A,N/A,N/A,1204,1248,N/A,5,6
17,N/A,N/A,N/A,1187,1204,N/A,9,4
10,N/A,N/A,N/A,1177,1187,N/A,15,4
9,N/A,N/A,N/A,1168,1177,N/A,20,3
48,N/A,N/A,N/A,1120,1168,N/A,23,6
9,N/A,N/A,N/A,1111,1120,N/A,29,0
23,N/A,N/A,N/A,1088,1111,N/A,33,4
10,N/A,N/A,N/A,1078,1088,N/A,37,2
8,N/A,N/A,N/A,1070,1078,N/A,42,1
23,N/A,N/A,N/A,1047,1070,N/A,45,4
7,N/A,N/A,N/A,1040,1047,N/A,50,3
9,N/A,N/A,N/A,1031,1040,N/A,55,2
25,N/A,N/A,N/A,1006,1031,N/A,59,6
10,N/A,N/A,N/A,996,1006,N/A,62,3
47,N/A,N/A,N/A,949,996,N/A,65,6
43,N/A,N/A,N/A,906,949,N/A,70,5
42,N/A,N/A,N/A,864,906,N/A,76,5
29,N/A,N/A,N/A,835,864,N/A,82,5
26,N/A,N/A,N/A,809,835,N/A,87,4
23,N/A,N/A,N/A,786,809,N/A,93,4
11,N/A,N/A,N/A,775,786,N/A,97,2
6,N/A,N/A,N/A,769,775,N/A,102,1
5,N/A,N/A,N/A,764,769,N/A,108,1
22,N/A,N/A,N/A,742,764,N/A,111,4
9,N/A,N/A,N/A,733,742,N/A,115,2
34,N/A,N/A,N/A,699,733,N/A,118,5
41,N/A,N/A,N/A,658,699,N/A,124,5
11,N/A,N/A,N/A,647,658,N/A,129,4
11,N/A,N/A,N/A,636,647,N/A,134,3
9,N/A,N/A,N/A,627,636,N/A,139,2
27,N/A,N/A,N/A,635,662,N/A,5,5
11,N/A,N/A,N/A,624,635,N/A,9,3
8,N/A,N/A,N/A,616,624,N/A,14,2
8,N/A,N/A,N/A,608,616,N/A,19,1
7,N/A,N/A,N/A,601,608,N/A,25,1
13,N/A,N/A,N/A,588,601,N/A,28,4
24,N/A,N/A,N/A,564,588,N/A,34,4
20,N/A,N/A,N/A,544,564,N/A,40,4
11,N/A,N/A,N/A,533,544,N/A,45,3
8,N/A,N/A,N/A,525,533,N/A,51,3
9,N/A,N/A,N/A,516,525,N/A,56,2
6,N/A,N/A,N/A,510,516,N/A,61,1
42,N/A,N/A,N/A,468,510,N/A,66,6
28,N/A,N/A,N/A,440,468,N/A,71,5
10,N/A,N/A,N/A,430,440,N/A,75,3
7,N/A,N/A,N/A,423,430,N/A,79,1
6,N/A,N/A,N/A,417,423,N/A,85,1
17,N/A,N/A,N/A,400,417,N/A,88,4
29,N/A,N/A,N/A,371,400,N/A,94,4
8,N/A,N/A,N/A,363,371,N/A,99,3
9,N/A,N/A,N/A,354,363,N/A,103,1
40,N/A,N/A,N/A,314,354,N/A,107,5
7,N/A,N/A,N/A,307,314,N/A,110,2
26,N/A,N/A,N/A,281,307,N/A,113,5
8,N/A,N/A,N/A,273,281,N/A,116,2
8,N/A,N/A,N/A,265,273,N/A,122,2
11,N/A,N/A,N/A,254,265,N/A,128,2
7,N/A,N/A,N/A,247,254,N/A,134,2
48,N/A,N/A,N/A,199,247,N/A,137,5
47,N/A,N/A,N/A,152,199,N/A,143,5
29,N/A,N/A,N/A,1608,1637,N/A,3,6
15,N/A,N/A,N/A,1593,1608,N/A,7,4
10,N/A,N/A,N/A,1583,1593,N/A,11,2
33,N/A,N/A,N/A,1550,1583,N/A,14,5
41,N/A,N/A,N/A,1509,1550,N/A,20,5
10,N/A,N/A,N/A,1499,1509,N/A,24,3
9,N/A,N/A,N/A,1490,1499,N/A,28,1
8,N/A,N/A,N/A,1482,1490,N/A,34,1
12,N/A,N/A,N/A,1470,1482,N/A,37,4
10,N/A,N/A,N/A,1460,1470,N/A,42,3
7,N/A,N/A,N/A,1453,1460,N/A,46,1
13,N/A,N/A,N/A,1440,1453,N/A,49,4
9,N/A,N/A,N/A,1431,1440,N/A,53,2
8,N/A,N/A,N/A,1423,1431,N/A,58,1
26,N/A,N/A,N/A,1397,1423,N/A,61,4
8,N/A,N/A,N/A,1389,1397,N/A,64,1
27,N/A,N/A,N/A,1362,1389,N/A,67,4
8,N/A,N/A,N/A,1354,1362,N/A,71,2
8,N/A,N/A,N/A,1346,1354,N/A,77,2
10,N/A,N/A,N/A,1336,1346,N/A,83,2
37,N/A,N/A,N/A,1299,1336,N/A,86,5
18,N/A,N/A,N/A,1281,1299,N/A,91,4
11,N/A,N/A,N/A,1270,1281,N/A,95,2
41,N/A,N/A,N/A,1229,1270,N/A,98,5
11,N/A,N/A,N/A,1218,1229,N/A,102,3
6,N/A,N/A,N/A,1212,1218,N/A,106,1
20,N/A,N/A,N/A,1192,1212,N/A,109,4
10,N/A,N/A,N/A,1182,1192,N/A,115,4
11,N/A,N/A,N/A,1171,1182,N/A,119,2
44,N/A,N/A,N/A,1127,1171,N/A,123,6
29,N/A,N/A,N/A,1483,1512,N/A,3,6
27,N/A,N/A,N/A,1456,1483,N/A,8,5
10,N/A,N/A,N/A,1446,1456,N/A,11,2
39,N/A,N/A,N/A,1407,1446,N/A,15,6
8,N/A,N/A,N/A,1399,1407,N/A,21,0
11,N/A,N/A,N/A,1388,1399,N/A,24,3
9,N/A,N/A,N/A,1379,1388,N/A,29,2
9,N/A,N/A,N/A,1370,1379,N/A,35,2
46,N/A,N/A,N/A,1324,1370,N/A,38,5
8,N/A,N/A,N/A,1316,1324,N/A,42,3
8,N/A,N/A,N/A,1308,1316,N/A,47,2
27,N/A,N/A,N/A,1281,1308,N/A,51,6
28,N/A,N/A,N/A,1253,1281,N/A,55,4
17,N/A,N/A,N/A,1236,1253,N/A,61,4
9,N/A,N/A,N/A,1227,1236,N/A,66,3
7,N/A,N/A,N/A,1220,1227,N/A,72,3
7,N/A,N/A,N/A,1213,1220,N/A,76,1
21,N/A,N/A,N/A,1192,1213,N/A,79,4
23,N/A,N/A,N/A,1169,1192,N/A,85,4
6,N/A,N/A,N/A,1163,1169,N/A,88,1
39,N/A,N/A,N/A,1124,1163,N/A,93,6
11,N/A,N/A,N/A,1113,1124,N/A,96,3
26,N/A,N/A,N/A,1087,1113,N/A,99,6
7,N/A,N/A,N/A,1080,1087,N/A,102,3
7,N/A,N/A,N/A,1073,1080,N/A,108,3
10,N/A,N/A,N/A,1063,1073,N/A,113,2
6,N/A,N/A,N/A,1057,1063,N/A,118,1
29,N/A,N/A,N/A,1028,1057,N/A,123,6
9,N/A,N/A,N/A,1019,1028,N/A,129,0
27,N/A,N/A,N/A,992,1019,N/A,135,6
10,N/A,N/A,N/A,668,678,N/A,4,3
11,N/A,N/A,N/A,657,668,N/A,9,2
11,N/A,N/A,N/A,646,657,N/A,15,2
7,N/A,N/A,N/A,639,646,N/A,20,1
7,N/A,N/A,N/A,632,639,N/A,26,1
7,N/A,N/A,N/A,625,632,N/A,32,1
27,N/A,N/A,N/A,598,625,N/A,36,5
18,N/A,N/A,N/A,580,598,N/A,41,4
25,N/A,N/A,N/A,555,580,N/A,47,4
11,N/A,N/A,N/A,544,555,N/A,52,3
11,N/A,N/A,N/A,533,544,N/A,58,3
11,N/A,N/A,N/A,522,533,N/A,63,2
30,N/A,N/A,N/A,492,522,N/A,66,5
14,N/A,N/A,N/A,478,492,N/A,71,4
7,N/A,N/A,N/A,471,478,N/A,76,3
7,N/A,N/A,N/A,464,471,N/A,81,2
9,N/A,N/A,N/A,455,464,N/A,86,1
25,N/A,N/A,N/A,430,455,N/A,89,4
8,N/A,N/A,N/A,422,430,N/A,93,2
38,N/A,N/A,N/A,384,422,N/A,97,6
11,N/A,N/A,N/A,373,384,N/A,101,4
7,N/A,N/A,N/A,366,373,N/A,105,2
33,N/A,N/A,N/A,333,366,N/A,109,6
9,N/A,N/A,N/A,324,333,N/A,112,3
36,N/A,N/A,N/A,288,324,N/A,115,6
8,N/A,N/A,N/A,280,288,N/A,118,3
25,N/A,N/A,N/A,255,280,N/A,121,6
8,N/A,N/A,N/A,247,255,N/A,124,3
6,N/A,N/A,N/A,241,247,N/A,128,1
39,N/A,N/A,N/A,202,241,N/A,132,5
5,N/A,N/A,N/A,1873,1878,N/A,6,1
24,N/A,N/A,N/A,1849,1873,N/A,9,4
19,N/A,N/A,N/A,1830,1849,N/A,15,4
14,N/A,N/A,N/A,1816,1830,N/A,21,4
11,N/A,N/A,N/A,1805,1816,N/A,25,2
31,N/A,N/A,N/A,1774,1805,N/A,29,6
9,N/A,N/A,N/A,1765,1774,N/A,32,3
7,N/A,N/A,N/A,1758,1765,N/A,36,1
33,N/A,N/A,N/A,1725,1758,N/A,41,6
9,N/A,N/A,N/A,1716,1725,N/A,44,3
8,N/A,N/A,N/A,1708,1716,N/A,49,2
45,N/A,N/A,N/A,1663,1708,N/A,52,5
7,N/A,N/A,N/A,1656,1663,N/A,56,3
10,N/A,N/A,N/A,1646,1656,N/A,62,3
10,N/A,N/A,N/A,1636,1646,N/A,67,2
45,N/A,N/A,N/A,1591,1636,N/A,70,5
9,N/A,N/A,N/A,1582,1591,N/A,73,2
9,N/A,N/A,N/A,1573,1582,N/A,78,1
13,N/A,N/A,N/A,1560,1573,N/A,81,4
15,N/A,N/A,N/A,1545,1560,N/A,87,4
26,N/A,N/A,N/A,1519,1545,N/A,93,4
24,N/A,N/A,N/A,1495,1519,N/A,99,4
8,N/A,N/A,N/A,1487,1495,N/A,104,3
9,N/A,N/A,N/A,1478,1487,N/A,109,2
8,N/A,N/A,N/A,1470,1478,N/A,115,2
42,N/A,N/A,N/A,1428,1470,N/A,119,6
8,N/A,N/A,N/A,1420,1428,N/A,122,3
27,N/A,N/A,N/A,1393,1420,N/A,125,6
22,N/A,N/A,N/A,1371,1393,N/A,129,4
5,N/A,N/A,N/A,1366,1371,N/A,132,1
8,N/A,N/A,N/A,1413,1421,N/A,5,2
41,N/A,N/A,N/A,1372,1413,N/A,9,6
8,N/A,N/A,N/A,1364,1372,N/A,15,0
15,N/A,N/A,N/A,1349,1364,N/A,19,4
8,N/A,N/A,N/A,1341,1349,N/A,23,2
6,N/A,N/A,N/A,1335,1341,N/A,28,1
26,N/A,N/A,N/A,1309,1335,N/A,33,6
45,N/A,N/A,N/A,1264,1309,N/A,38,5
25,N/A,N/A,N/A,1239,1264,N/A,44,5
11,N/A,N/A,N/A,1228,1239,N/A,47,2
5,N/A,N/A,N/A,1223,1228,N/A,52,1
43,N/A,N/A,N/A,1180,1223,N/A,56,5
11,N/A,N/A,N/A,1169,1180,N/A,60,3
31,N/A,N/A,N/A,1138,1169,N/A,63,6
8,N/A,N/A,N/A,1130,1138,N/A,66,3
40,N/A,N/A,N/A,1090,1130,N/A,69,6
25,N/A,N/A,N/A,1065,1090,N/A,73,4
9,N/A,N/A,N/A,1056,1065,N/A,76,1
36,N/A,N/A,N/A,1020,1056,N/A,80,5
13,N/A,N/A,N/A,1007,1020,N/A,85,4
10,N/A,N/A,N/A,997,1007,N/A,89,2
40,N/A,N/A,N/A,957,997,N/A,93,6
26,N/A,N/A,N/A,931,957,N/A,97,4
11,N/A,N/A,N/A,920,931,N/A,103,4
6,N/A,N/A,N/A,914,920,N/A,106,1
47,N/A,N/A,N/A,867,914,N/A,111,6
22,N/A,N/A,N/A,845,867,N/A,115,4
8,N/A,N/A,N/A,837,845,N/A,120,3
10,N/A,N/A,N/A,827,837,N/A,126,3
8,N/A,N/A,N/A,819,827,N/A,131,2
24,N/A,N/A,N/A,1111,1135,N/A,4,4
22,N/A,N/A,N/A,1089,1111,N/A,10,4
9,N/A,N/A,N/A,1080,1089,N/A,14,2
27,N/A,N/A,N/A,1053,1080,N/A,18,6
7,N/A,N/A,N/A,1046,1053,N/A,24,0
19,N/A,N/A,N/A,1027,1046,N/A,28,4
10,N/A,N/A,N/A,1017,1027,N/A,32,2
32,N/A,N/A,N/A,985,1017,N/A,36,6
28,N/A,N/A,N/A,957,985,N/A,41,5
27,N/A,N/A,N/A,930,957,N/A,46,4
10,N/A,N/A,N/A,920,930,N/A,50,2
11,N/A,N/A,N/A,909,920,N/A,56,2
30,N/A,N/A,N/A,879,909,N/A,60,6
22,N/A,N/A,N/A,857,879,N/A,64,4
5,N/A,N/A,N/A,852,857,N/A,67,1
9,N/A,N/A,N/A,843,852,N/A,73,1
9,N/A,N/A,N/A,834,843,N/A,79,1
42,N/A,N/A,N/A,792,834,N/A,84,6
40,N/A,N/A,N/A,752,792,N/A,89,5
7,N/A,N/A,N/A,745,752,N/A,93,3
8,N/A,N/A,N/A,737,745,N/A,97,1
32,N/A,N/A,N/A,705,737,N/A,101,5
10,N/A,N/A,N/A,695,705,N/A,104,2
45,N/A,N/A,N/A,650,695,N/A,108,6
9,N/A,N/A,N/A,641,650,N/A,111,3
42,N/A,N/A,N/A,599,641,N/A,114,6
16,N/A,N/A,N/A,583,599,N/A,118,4
7,N/A,N/A,N/A,576,583,N/A,122,2
39,N/A,N/A,N/A,537,576,N/A,126,6
10,N/A,N/A,N/A,527,537,N/A,129,3
11,N/A,N/A,N/A,1650,1661,N/A,4,2
28,N/A,N/A,N/A,1622,1650,N/A,8,6
10,N/A,N/A,N/A,1612,1622,N/A,12,4
10,N/A,N/A,N/A,1602,1612,N/A,16,2
44,N/A,N/A,N/A,1558,1602,N/A,20,6
9,N/A,N/A,N/A,1549,1558,N/A,23,3
8,N/A,N/A,N/A,1541,1549,N/A,28,2
32,N/A,N/A,N/A,1509,1541,N/A,31,5
9,N/A,N/A,N/A,1500,1509,N/A,34,2
39,N/A,N/A,N/A,1461,1500,N/A,37,5
44,N/A,N/A,N/A,1417,1461,N/A,43,5
10,N/A,N/A,N/A,1407,1417,N/A,47,3
7,N/A,N/A,N/A,1400,1407,N/A,51,1
9,N/A,N/A,N/A,1391,1400,N/A,57,1
8,N/A,N/A,N/A,1383,1391,N/A,63,1
39,N/A,N/A,N/A,1344,1383,N/A,68,6
6,N/A,N/A,N/A,1338,1344,N/A,74,0
25,N/A,N/A,N/A,1313,1338,N/A,78,4
24,N/A,N/A,N/A,1289,1313,N/A,84,4
26,N/A,N/A,N/A,1263,1289,N/A,90,4
10,N/A,N/A,N/A,1253,1263,N/A,95,3
5,N/A,N/A,N/A,1248,1253,N/A,99,1
39,N/A,N/A,N/A,1209,1248,N/A,104,6
7,N/A,N/A,N/A,1202,1209,N/A,110,0
8,N/A,N/A,N/A,1194,1202,N/A,113,3
6,N/A,N/A,N/A,1188,1194,N/A,117,1
34,N/A,N/A,N/A,1154,1188,N/A,121,5
9,N/A,N/A,N/A,1145,1154,N/A,125,3
7,N/A,N/A,N/A,1138,1145,N/A,130,2
32,N/A,N/A,N/A,1106,1138,N/A,133,5
33,N/A,N/A,N/A,890,923,N/A,6,6
7,N/A,N/A,N/A,883,890,N/A,9,3
8,N/A,N/A,N/A,875,883,N/A,13,1
39,N/A,N/A,N/A,836,875,N/A,17,5
46,N/A,N/A,N/A,790,836,N/A,23,5
8,N/A,N/A,N/A,782,790,N/A,26,2
5,N/A,N/A,N/A,777,782,N/A,31,1
7,N/A,N/A,N/A,770,777,N/A,37,1
27,N/A,N/A,N/A,743,770,N/A,41,5
14,N/A,N/A,N/A,729,743,N/A,46,4
17,N/A,N/A,N/A,712,729,N/A,52,4
9,N/A,N/A,N/A,703,712,N/A,57,3
11,N/A,N/A,N/A,692,703,N/A,62,2
41,N/A,N/A,N/A,651,692,N/A,65,5
45,N/A,N/A,N/A,606,651,N/A,71,5
17,N/A,N/A,N/A,589,606,N/A,76,4
11,N/A,N/A,N/A,578,589,N/A,82,4
28,N/A,N/A,N/A,550,578,N/A,88,4
7,N/A,N/A,N/A,543,550,N/A,92,2
30,N/A,N/A,N/A,513,543,N/A,96,6
30,N/A,N/A,N/A,483,513,N/A,101,5
10,N/A,N/A,N/A,473,483,N/A,105,3
10,N/A,N/A,N/A,463,473,N/A,110,2
48,N/A,N/A,N/A,415,463,N/A,114,6
9,N/A,N/A,N/A,406,415,N/A,117,3
11,N/A,N/A,N/A,395,406,N/A,122,2
8,N/A,N/A,N/A,387,395,N/A,127,1
9,N/A,N/A,N/A,378,387,N/A,133,1
28,N/A,N/A,N/A,350,378,N/A,138,6
10,N/A,N/A,N/A,340,350,N/A,141,3
28,N/A,N/A,N/A,1598,1626,N/A,3,4
8,N/A,N/A,N/A,1590,1598,N/A,8,3
10,N/A,N/A,N/A,1580,1590,N/A,14,3
6,N/A,N/A,N/A,1574,1580,N/A,18,1
8,N/A,N/A,N/A,1566,1574,N/A,24,1
36,N/A,N/A,N/A,1530,1566,N/A,28,5
33,N/A,N/A,N/A,1497,1530,N/A,34,5
11,N/A,N/A,N/A,1486,1497,N/A,38,3
7,N/A,N/A,N/A,1479,1486,N/A,42,1
27,N/A,N/A,N/A,1452,1479,N/A,46,5
29,N/A,N/A,N/A,1423,1452,N/A,52,5
10,N/A,N/A,N/A,1413,1423,N/A,55,2
10,N/A,N/A,N/A,1403,1413,N/A,61,2
25,N/A,N/A,N/A,1378,1403,N/A,65,6
9,N/A,N/A,N/A,1369,1378,N/A,68,3
8,N/A,N/A,N/A,1361,1369,N/A,74,3
41,N/A,N/A,N/A,1320,1361,N/A,77,6
7,N/A,N/A,N/A,1313,1320,N/A,80,3
9,N/A,N/A,N/A,1304,1313,N/A,86,3
11,N/A,N/A,N/A,1293,1304,N/A,91,2
46,N/A,N/A,N/A,1247,1293,N/A,94,5
44,N/A,N/A,N/A,1203,1247,N/A,100,5
43,N/A,N/A,N/A,1160,1203,N/A,106,5
9,N/A,N/A,N/A,1151,1160,N/A,109,2
30,N/A,N/A,N/A,1121,1151,N/A,112,5
23,N/A,N/A,N/A,1098,1121,N/A,117,4
10,N/A,N/A,N/A,1088,1098,N/A,121,2
7,N/A,N/A,N/A,1081,1088,N/A,127,2
46,N/A,N/A,N/A,1035,1081,N/A,130,5
24,N/A,N/A,N/A,1011,1035,N/A,135,4
5,N/A,N/A,N/A,1250,1255,N/A,3,1
37,N/A,N/A,N/A,1213,1250,N/A,7,5
27,N/A,N/A,N/A,1186,1213,N/A,12,4
8,N/A,N/A,N/A,1178,1186,N/A,15,1
44,N/A,N/A,N/A,1134,1178,N/A,19,5
25,N/A,N/A,N/A,1109,1134,N/A,24,4
8,N/A,N/A,N/A,1101,1109,N/A,28,2
7,N/A,N/A,N/A,1094,1101,N/A,34,2
5,N/A,N/A,N/A,1089,1094,N/A,39,1
8,N/A,N/A,N/A,1081,1089,N/A,45,1
24,N/A,N/A,N/A,1057,1081,N/A,48,4
5,N/A,N/A,N/A,1052,1057,N/A,51,1
5,N/A,N/A,N/A,1047,1052,N/A,57,1
5,N/A,N/A,N/A,1042,1047,N/A,63,1
36,N/A,N/A,N/A,1006,1042,N/A,67,5
10,N/A,N/A,N/A,996,1006,N/A,71,3
8,N/A,N/A,N/A,988,996,N/A,76,2
47,N/A,N/A,N/A,941,988,N/A,80,6
8,N/A,N/A,N/A,933,941,N/A,83,3
8,N/A,N/A,N/A,925,933,N/A,88,2
44,N/A,N/A,N/A,881,925,N/A,92,6
7,N/A,N/A,N/A,874,881,N/A,98,0
43,N/A,N/A,N/A,831,874,N/A,104,6
35,N/A,N/A,N/A,796,831,N/A,109,5
16,N/A,N/A,N/A,780,796,N/A,114,4
9,N/A,N/A,N/A,771,780,N/A,117,1
35,N/A,N/A,N/A,736,771,N/A,121,5
27,N/A,N/A,N/A,709,736,N/A,127,5
31,N/A,N/A,N/A,678,709,N/A,133,5
29,N/A,N/A,N/A,649,678,N/A,138,4
38,N/A,N/A,N/A,493,531,N/A,4,5
8,N/A,N/A,N/A,485,493,N/A,7,2
37,N/A,N/A,N/A,448,485,N/A,10,5
11,N/A,N/A,N/A,437,448,N/A,14,3
11,N/A,N/A,N/A,426,437,N/A,20,3
9,N/A,N/A,N/A,417,426,N/A,25,2
9,N/A,N/A,N/A,408,417,N/A,30,1
8,N/A,N/A,N/A,400,408,N/A,36,1
25,N/A,N/A,N/A,375,400,N/A,39,4
9,N/A,N/A,N/A,366,375,N/A,42,1
29,N/A,N/A,N/A,337,366,N/A,46,5
8,N/A,N/A,N/A,329,337,N/A,50,3
11,N/A,N/A,N/A,318,329,N/A,56,3
29,N/A,N/A,N/A,289,318,N/A,59,6
11,N/A,N/A,N/A,278,289,N/A,63,4
7,N/A,N/A,N/A,271,278,N/A,66,1
44,N/A,N/A,N/A,227,271,N/A,71,6
27,N/A,N/A,N/A,200,227,N/A,75,4
11,N/A,N/A,N/A,189,200,N/A,80,3
8,N/A,N/A,N/A,181,189,N/A,84,1
12,N/A,N/A,N/A,169,181,N/A,87,4
7,N/A,N/A,N/A,162,169,N/A,90,1
28,N/A,N/A,N/A,134,162,N/A,93,4
18,N/A,N/A,N/A,116,134,N/A,99,4
6,N/A,N/A,N/A,110,116,N/A,102,1
28,N/A,N/A,N/A,82,110,N/A,107,6
27,N/A,N/A,N/A,55,82,N/A,112,5
25,N/A,N/A,N/A,30,55,N/A,117,4
10,N/A,N/A,N/A,20,30,N/A,122,3
9,N/A,N/A,N/A,11,20,N/A,127,2
9,N/A,N/A,N/A,835,844,N/A,5,2
6,N/A,N/A,N/A,829,835,N/A,10,1
39,N/A,N/A,N/A,790,829,N/A,15,6
18,N/A,N/A,N/A,772,790,N/A,19,4
7,N/A,N/A,N/A,765,772,N/A,24,3
6,N/A,N/A,N/A,759,765,N/A,28,1
8,N/A,N/A,N/A,751,759,N/A,34,1
12,N/A,N/A,N/A,739,751,N/A,37,4
9,N/A,N/A,N/A,730,739,N/A,41,2
10,N/A,N/A,N/A,720,730,N/A,47,2
41,N/A,N/A,N/A,679,720,N/A,50,5
39,N/A,N/A,N/A,640,679,N/A,56,5
11,N/A,N/A,N/A,629,640,N/A,59,2
26,N/A,N/A,N/A,603,629,N/A,63,6
9,N/A,N/A,N/A,594,603,N/A,69,0
43,N/A,N/A,N/A,551,594,N/A,75,6
13,N/A,N/A,N/A,538,551,N/A,79,4
8,N/A,N/A,N/A,530,538,N/A,84,3
9,N/A,N/A,N/A,521,530,N/A,90,3
11,N/A,N/A,N/A,510,521,N/A,95,2
8,N/A,N/A,N/A,502,510,N/A,101,2
9,N/A,N/A,N/A,493,502,N/A,107,2
47,N/A,N/A,N/A,446,493,N/A,111,6
8,N/A,N/A,N/A,438,446,N/A,117,0
27,N/A,N/A,N/A,411,438,N/A,121,4
9,N/A,N/A,N/A,402,411,N/A,125,2
9,N/A,N/A,N/A,393,402,N/A,130,1
10,N/A,N/A,N/A,383,393,N/A,133,4
20,N/A,N/A,N/A,363,383,N/A,139,4
24,N/A,N/A,N/A,339,363,N/A,145,4
38,N/A,N/A,N/A,825,863,N/A,4,5
8,N/A,N/A,N/A,817,825,N/A,7,2
7,N/A,N/A,N/A,810,817,N/A,12,1
27,N/A,N/A,N/A,783,810,N/A,16,5
8,N/A,N/A,N/A,775,783,N/A,19,2
26,N/A,N/A,N/A,749,775,N/A,23,6
8,N/A,N/A,N/A,741,749,N/A,29,0
30,N/A,N/A,N/A,711,741,N/A,34,5
23,N/A,N/A,N/A,688,711,N/A,39,4
5,N/A,N/A,N/A,683,688,N/A,42,1
44,N/A,N/A,N/A,639,683,N/A,47,6
10,N/A,N/A,N/A,629,639,N/A,50,3
8,N/A,N/A,N/A,621,629,N/A,55,2
8,N/A,N/A,N/A,613,621,N/A,61,2
48,N/A,N/A,N/A,565,613,N/A,65,6
8,N/A,N/A,N/A,557,565,N/A,71,0
7,N/A,N/A,N/A,550,557,N/A,74,3
7,N/A,N/A,N/A,543,550,N/A,79,2
41,N/A,N/A,N/A,502,543,N/A,82,5
32,N/A,N/A,N/A,470,502,N/A,88,5
45,N/A,N/A,N/A,425,470,N/A,94,5
42,N/A,N/A,N/A,383,425,N/A,100,5
10,N/A,N/A,N/A,373,383,N/A,104,3
6,N/A,N/A,N/A,367,373,N/A,108,1
27,N/A,N/A,N/A,340,367,N/A,113,6
19,N/A,N/A,N/A,321,340,N/A,117,4
6,N/A,N/A,N/A,315,321,N/A,120,1
23,N/A,N/A,N/A,292,315,N/A,123,4
10,N/A,N/A,N/A,282,292,N/A,127,2
49,N/A,N/A,N/A,233,282,N/A,131,6
27,N/A,N/A,N/A,722,749,N/A,4,4
7,N/A,N/A,N/A,715,722,N/A,9,3
9,N/A,N/A,N/A,706,715,N/A,13,1
38,N/A,N/A,N/A,668,706,N/A,17,5
42,N/A,N/A,N/A,626,668,N/A,23,5
28,N/A,N/A,N/A,598,626,N/A,28,4
5,N/A,N/A,N/A,593,598,N/A,31,1
39,N/A,N/A,N/A,554,593,N/A,35,5
10,N/A,N/A,N/A,544,554,N/A,38,2
10,N/A,N/A,N/A,534,544,N/A,44,2
8,N/A,N/A,N/A,526,534,N/A,50,2
41,N/A,N/A,N/A,485,526,N/A,54,6
34,N/A,N/A,N/A,451,485,N/A,59,5
10,N/A,N/A,N/A,441,451,N/A,63,3
40,N/A,N/A,N/A,401,441,N/A,66,6
36,N/A,N/A,N/A,365,401,N/A,71,5
34,N/A,N/A,N/A,331,365,N/A,77,5
10,N/A,N/A,N/A,321,331,N/A,80,2
6,N/A,N/A,N/A,315,321,N/A,85,1
24,N/A,N/A,N/A,291,315,N/A,88,4
7,N/A,N/A,N/A,284,291,N/A,91,1
26,N/A,N/A,N/A,258,284,N/A,94,4
9,N/A,N/A,N/A,249,258,N/A,99,3
43,N/A,N/A,N/A,206,249,N/A,102,6
6,N/A,N/A,N/A,200,206,N/A,108,0
22,N/A,N/A,N/A,178,200,N/A,112,4
10,N/A,N/A,N/A,168,178,N/A,118,4
11,N/A,N/A,N/A,157,168,N/A,124,4
17,N/A,N/A,N/A,140,157,N/A,130,4
7,N/A,N/A,N/A,133,140,N/A,133,1
26,N/A,N/A,N/A,1692,1718,N/A,6,6
46,N/A,N/A,N/A,1646,1692,N/A,11,5
40,N/A,N/A,N/A,1606,1646,N/A,17,5
29,N/A,N/A,N/A,1577,1606,N/A,23,5
40,N/A,N/A,N/A,1537,1577,N/A,29,5
39,N/A,N/A,N/A,1498,1537,N/A,35,5
9,N/A,N/A,N/A,1489,1498,N/A,39,3
9,N/A,N/A,N/A,1480,1489,N/A,45,3
33,N/A,N/A,N/A,1447,1480,N/A,48,6
8,N/A,N/A,N/A,1439,1447,N/A,51,3
8,N/A,N/A,N/A,1431,1439,N/A,56,2
5,N/A,N/A,N/A,1426,1431,N/A,61,1
15,N/A,N/A,N/A,1411,1426,N/A,64,4
6,N/A,N/A,N/A,1405,1411,N/A,67,1
28,N/A,N/A,N/A,1377,1405,N/A,71,5
9,N/A,N/A,N/A,1368,1377,N/A,74,2
49,N/A,N/A,N/A,1319,1368,N/A,77,5
8,N/A,N/A,N/A,1311,1319,N/A,80,2
8,N/A,N/A,N/A,1303,1311,N/A,85,1
8,N/A,N/A,N/A,1295,1303,N/A,91,1
27,N/A,N/A,N/A,1268,1295,N/A,95,5
9,N/A,N/A,N/A,1259,1268,N/A,99,3
11,N/A,N/A,N/A,1248,1259,N/A,104,2
28,N/A,N/A,N/A,1220,1248,N/A,108,6
38,N/A,N/A,N/A,1182,1220,N/A,113,5
11,N/A,N/A,N/A,1171,1182,N/A,116,2
30,N/A,N/A,N/A,1141,1171,N/A,120,6
15,N/A,N/A,N/A,1126,1141,N/A,124,4
11,N/A,N/A,N/A,1115,1126,N/A,129,3
42,N/A,N/A,N/A,1073,1115,N/A,132,6
5,N/A,N/A,N/A,1560,1565,N/A,3,1
27,N/A,N/A,N/A,1533,1560,N/A,6,4
8,N/A,N/A,N/A,1525,1533,N/A,11,3
11,N/A,N/A,N/A,1514,1525,N/A,17,3
9,N/A,N/A,N/A,1505,1514,N/A,22,2
35,N/A,N/A,N/A,1470,1505,N/A,25,5
7,N/A,N/A,N/A,1463,1470,N/A,28,2
9,N/A,N/A,N/A,1454,1463,N/A,33,1
26,N/A,N/A,N/A,1428,1454,N/A,36,4
10,N/A,N/A,N/A,1418,1428,N/A,42,4
22,N/A,N/A,N/A,1396,1418,N/A,48,4
16,N/A,N/A,N/A,1380,1396,N/A,54,4
11,N/A,N/A,N/A,1369,1380,N/A,60,4
11,N/A,N/A,N/A,1358,1369,N/A,65,3
11,N/A,N/A,N/A,1347,1358,N/A,70,2
38,N/A,N/A,N/A,1309,1347,N/A,74,6
11,N/A,N/A,N/A,1298,1309,N/A,77,3
11,N/A,N/A,N/A,1287,1298,N/A,82,2
26,N/A,N/A,N/A,1261,1287,N/A,86,6
7,N/A,N/A,N/A,1254,1261,N/A,92,0
38,N/A,N/A,N/A,1216,1254,N/A,98,6
7,N/A,N/A,N/A,1209,1216,N/A,104,0
49,N/A,N/A,N/A,1160,1209,N/A,110,6
27,N/A,N/A,N/A,1133,1160,N/A,115,5
35,N/A,N/A,N/A,1098,1133,N/A,121,5
8,N/A,N/A,N/A,1090,1098,N/A,124,2
34,N/A,N/A,N/A,1056,1090,N/A,127,5
10,N/A,N/A,N/A,1046,1056,N/A,131,3
10,N/A,N/A,N/A,1036,1046,N/A,136,2
6,N/A,N/A,N/A,1030,1036,N/A,141,1
21,N/A,N/A,N/A,1010,1031,N/A,4,4
10,N/A,N/A,N/A,1000,1010,N/A,9,3
27,N/A,N/A,N/A,973,1000,N/A,12,6
9,N/A,N/A,N/A,964,973,N/A,18,0
7,N/A,N/A,N/A,957,964,N/A,21,3
11,N/A,N/A,N/A,946,957,N/A,26,2
7,N/A,N/A,N/A,939,946,N/A,32,2
7,N/A,N/A,N/A,932,939,N/A,37,1
33,N/A,N/A,N/A,899,932,N/A,41,5
35,N/A,N/A,N/A,864,899,N/A,47,5
7,N/A,N/A,N/A,857,864,N/A,50,2
9,N/A,N/A,N/A,848,857,N/A,56,2
36,N/A,N/A,N/A,812,848,N/A,60,6
9,N/A,N/A,N/A,803,812,N/A,63,3
11,N/A,N/A,N/A,792,803,N/A,69,3
8,N/A,N/A,N/A,784,792,N/A,73,1
27,N/A,N/A,N/A,757,784,N/A,76,4
10,N/A,N/A,N/A,747,757,N/A,81,3
9,N/A,N/A,N/A,738,747,N/A,85,1
20,N/A,N/A,N/A,718,738,N/A,88,4
7,N/A,N/A,N/A,711,718,N/A,91,1
20,N/A,N/A,N/A,691,711,N/A,94,4
25,N/A,N/A,N/A,666,691,N/A,100,4
7,N/A,N/A,N/A,659,666,N/A,103,1
22,N/A,N/A,N/A,637,659,N/A,106,4
7,N/A,N/A,N/A,630,637,N/A,109,1
7,N/A,N/A,N/A,623,630,N/A,115,1
12,N/A,N/A,N/A,611,623,N/A,118,4
6,N/A,N/A,N/A,605,611,N/A,121,1
36,N/A,N/A,N/A,569,605,N/A,125,5
34,N/A,N/A,N/A,1755,1789,N/A,3,5
7,N/A,N/A,N/A,1748,1755,N/A,7,3
42,N/A,N/A,N/A,1706,1748,N/A,10,6
19,N/A,N/A,N/A,1687,1706,N/A,14,4
8,N/A,N/A,N/A,1679,1687,N/A,18,2
5,N/A,N/A,N/A,1674,1679,N/A,23,1
47,N/A,N/A,N/A,1627,1674,N/A,28,6
8,N/A,N/A,N/A,1619,1627,N/A,34,0
42,N/A,N/A,N/A,1577,1619,N/A,40,6
47,N/A,N/A,N/A,1530,1577,N/A,45,5
26,N/A,N/A,N/A,1504,1530,N/A,51,5
13,N/A,N/A,N/A,1491,1504,N/A,56,4
10,N/A,N/A,N/A,1481,1491,N/A,60,2
9,N/A,N/A,N/A,1472,1481,N/A,65,1
17,N/A,N/A,N/A,1455,1472,N/A,68,4
20,N/A,N/A,N/A,1435,1455,N/A,74,4
9,N/A,N/A,N/A,1426,1435,N/A,79,3
7,N/A,N/A,N/A,1419,1426,N/A,83,1
5,N/A,N/A,N/A,1414,1419,N/A,89,1
19,N/A,N/A,N/A,1395,1414,N/A,92,4
25,N/A,N/A,N/A,1370,1395,N/A,98,4
11,N/A,N/A,N/A,1359,1370,N/A,102,2
11,N/A,N/A,N/A,1348,1359,N/A,108,2
37,N/A,N/A,N/A,1311,1348,N/A,112,6
10,N/A,N/A,N/A,1301,1311,N/A,115,3
8,N/A,N/A,N/A,1293,1301,N/A,120,2
8,N/A,N/A,N/A,1285,1293,N/A,125,1
12,N/A,N/A,N/A,1273,1285,N/A,128,4
5,N/A,N/A,N/A,1268,1273,N/A,131,1
36,N/A,N/A,N/A,1232,1268,N/A,136,6
49,N/A,N/A,N/A,709,758,N/A,6,6
38,N/A,N/A,N/A,671,709,N/A,11,5
41,N/A,N/A,N/A,630,671,N/A,17,5
38,N/A,N/A,N/A,592,630,N/A,23,5
8,N/A,N/A,N/A,584,592,N/A,26,2
8,N/A,N/A,N/A,576,584,N/A,32,2
7,N/A,N/A,N/A,569,576,N/A,38,2
47,N/A,N/A,N/A,522,569,N/A,41,5
47,N/A,N/A,N/A,475,522,N/A,47,5
12,N/A,N/A,N/A,463,475,N/A,52,4
8,N/A,N/A,N/A,455,463,N/A,57,3
38,N/A,N/A,N/A,417,455,N/A,60,6
26,N/A,N/A,N/A,391,417,N/A,64,4
9,N/A,N/A,N/A,382,391,N/A,67,1
48,N/A,N/A,N/A,334,382,N/A,71,5
7,N/A,N/A,N/A,327,334,N/A,75,3
10,N/A,N/A,N/A,317,327,N/A,80,2
38,N/A,N/A,N/A,279,317,N/A,83,5
41,N/A,N/A,N/A,238,279,N/A,89,5
11,N/A,N/A,N/A,227,238,N/A,93,3
29,N/A,N/A,N/A,198,227,N/A,96,6
8,N/A,N/A,N/A,190,198,N/A,102,0
9,N/A,N/A,N/A,181,190,N/A,105,3
9,N/A,N/A,N/A,172,181,N/A,111,3
7,N/A,N/A,N/A,165,172,N/A,117,3
6,N/A,N/A,N/A,159,165,N/A,121,1
7,N/A,N/A,N/A,152,159,N/A,127,1
8,N/A,N/A,N/A,144,152,N/A,133,1
6,N/A,N/A,N/A,138,144,N/A,139,1
27,N/A,N/A,N/A,111,138,N/A,142,4
29,N/A,N/A,N/A,1032,1061,N/A,6,6
8,N/A,N/A,N/A,1024,1032,N/A,9,3
7,N/A,N/A,N/A,1017,1024,N/A,14,2
49,N/A,N/A,N/A,968,1017,N/A,18,6
9,N/A,N/A,N/A,959,968,N/A,21,3
25,N/A,N/A,N/A,934,959,N/A,24,6
7,N/A,N/A,N/A,927,934,N/A,30,0
10,N/A,N/A,N/A,917,927,N/A,33,3
8,N/A,N/A,N/A,909,917,N/A,39,3
37,N/A,N/A,N/A,872,909,N/A,42,6
10,N/A,N/A,N/A,862,872,N/A,46,4
8,N/A,N/A,N/A,854,862,N/A,51,3
9,N/A,N/A,N/A,845,854,N/A,56,2
43,N/A,N/A,N/A,802,845,N/A,59,5
46,N/A,N/A,N/A,756,802,N/A,65,5
46,N/A,N/A,N/A,710,756,N/A,71,5
8,N/A,N/A,N/A,702,710,N/A,74,2
40,N/A,N/A,N/A,662,702,N/A,77,5
14,N/A,N/A,N/A,648,662,N/A,82,4
9,N/A,N/A,N/A,639,648,N/A,85,1
16,N/A,N/A,N/A,623,639,N/A,88,4
8,N/A,N/A,N/A,615,623,N/A,92,2
39,N/A,N/A,N/A,576,615,N/A,95,5
29,N/A,N/A,N/A,547,576,N/A,100,4
10,N/A,N/A,N/A,537,547,N/A,104,2
44,N/A,N/A,N/A,493,537,N/A,107,5
10,N/A,N/A,N/A,483,493,N/A,111,3
28,N/A,N/A,N/A,455,483,N/A,114,6
11,N/A,N/A,N/A,444,455,N/A,117,3
7,N/A,N/A,N/A,437,444,N/A,122,2
10,N/A,N/A,N/A,1438,1448,N/A,6,3
32,N/A,N/A,N/A,1406,1438,N/A,9,6
29,N/A,N/A,N/A,1377,1406,N/A,13,4
11,N/A,N/A,N/A,1366,1377,N/A,18,3
7,N/A,N/A,N/A,1359,1366,N/A,22,1
40,N/A,N/A,N/A,1319,1359,N/A,27,6
30,N/A,N/A,N/A,1289,1319,N/A,32,5
7,N/A,N/A,N/A,1282,1289,N/A,35,2
9,N/A,N/A,N/A,1273,1282,N/A,40,1
21,N/A,N/A,N/A,1252,1273,N/A,43,4
7,N/A,N/A,N/A,1245,1252,N/A,48,3
7,N/A,N/A,N/A,1238,1245,N/A,52,1
5,N/A,N/A,N/A,1233,1238,N/A,58,1
8,N/A,N/A,N/A,1225,1233,N/A,64,1
18,N/A,N/A,N/A,1207,1225,N/A,67,4
21,N/A,N/A,N/A,1186,1207,N/A,73,4
11,N/A,N/A,N/A,1175,1186,N/A,79,4
5,N/A,N/A,N/A,1170,1175,N/A,82,1
27,N/A,N/A,N/A,1143,1170,N/A,86,5
49,N/A,N/A,N/A,1094,1143,N/A,92,5
9,N/A,N/A,N/A,1085,1094,N/A,95,2
30,N/A,N/A,N/A,1055,1085,N/A,98,5
48,N/A,N/A,N/A,1007,1055,N/A,104,5
25,N/A,N/A,N/A,982,1007,N/A,109,4
5,N/A,N/A,N/A,977,982,N/A,112,1
42,N/A,N/A,N/A,935,977,N/A,116,5
10,N/A,N/A,N/A,925,935,N/A,119,2
38,N/A,N/A,N/A,887,925,N/A,123,6
11,N/A,N/A,N/A,876,887,N/A,126,3
10,N/A,N/A,N/A,866,876,N/A,131,2
8,N/A,N/A,N/A,876,884,N/A,6,1
5,N/A,N/A,N/A,871,876,N/A,12,1
8,N/A,N/A,N/A,863,871,N/A,18,1
10,N/A,N/A,N/A,853,863,N/A,21,4
26,N/A,N/A,N/A,827,853,N/A,27,4
18,N/A,N/A,N/A,809,827,N/A,33,4
5,N/A,N/A,N/A,804,809,N/A,36,1
5,N/A,N/A,N/A,799,804,N/A,42,1
8,N/A,N/A,N/A,791,799,N/A,48,1
45,N/A,N/A,N/A,746,791,N/A,52,5
10,N/A,N/A,N/A,736,746,N/A,56,3
47,N/A,N/A,N/A,689,736,N/A,59,6
19,N/A,N/A,N/A,670,689,N/A,63,4
9,N/A,N/A,N/A,661,670,N/A,67,2
38,N/A,N/A,N/A,623,661,N/A,70,5
45,N/A,N/A,N/A,578,623,N/A,76,5
11,N/A,N/A,N/A,567,578,N/A,79,2
7,N/A,N/A,N/A,560,567,N/A,84,1
28,N/A,N/A,N/A,532,560,N/A,87,4
11,N/A,N/A,N/A,521,532,N/A,92,3
9,N/A,N/A,N/A,512,521,N/A,97,2
7,N/A,N/A,N/A,505,512,N/A,103,2
11,N/A,N/A,N/A,494,505,N/A,109,2
35,N/A,N/A,N/A,459,494,N/A,112,5
14,N/A,N/A,N/A,445,459,N/A,117,4
10,N/A,N/A,N/A,435,445,N/A,121,2
40,N/A,N/A,N/A,395,435,N/A,124,5
21,N/A,N/A,N/A,374,395,N/A,129,4
6,N/A,N/A,N/A,368,374,N/A,132,1
22,N/A,N/A,N/A,346,368,N/A,135,4
8,N/A,N/A,N/A,668,676,N/A,5,3
9,N/A,N/A,N/A,659,668,N/A,10,2
32,N/A,N/A,N/A,627,659,N/A,14,6
22,N/A,N/A,N/A,605,627,N/A,18,4
26,N/A,N/A,N/A,579,605,N/A,24,4
7,N/A,N/A,N/A,572,579,N/A,27,1
6,N/A,N/A,N/A,566,572,N/A,33,1
44,N/A,N/A,N/A,522,566,N/A,37,5
26,N/A,N/A,N/A,496,522,N/A,43,5
42,N/A,N/A,N/A,454,496,N/A,49,5
28,N/A,N/A,N/A,426,454,N/A,55,5
11,N/A,N/A,N/A,415,426,N/A,59,3
8,N/A,N/A,N/A,407,415,N/A,64,2
9,N/A,N/A,N/A,398,407,N/A,69,1
6,N/A,N/A,N/A,392,398,N/A,75,1
7,N/A,N/A,N/A,385,392,N/A,81,1
9,N/A,N/A,N/A,376,385,N/A,87,1
14,N/A,N/A,N/A,362,376,N/A,90,4
7,N/A,N/A,N/A,355,362,N/A,93,1
23,N/A,N/A,N/A,332,355,N/A,96,4
7,N/A,N/A,N/A,325,332,N/A,100,2
28,N/A,N/A,N/A,297,325,N/A,104,6
11,N/A,N/A,N/A,286,297,N/A,107,3
11,N/A,N/A,N/A,275,286,N/A,113,3
8,N/A,N/A,N/A,267,275,N/A,119,3
6,N/A,N/A,N/A,261,267,N/A,123,1
8,N/A,N/A,N/A,253,261,N/A,129,1
34,N/A,N/A,N/A,219,253,N/A,133,5
8,N/A,N/A,N/A,211,219,N/A,137,3
8,N/A,N/A,N/A,203,211,N/A,142,2
15,N/A,N/A,N/A,1842,1857,N/A,3,4
7,N/A,N/A,N/A,1835,1842,N/A,7,2
10,N/A,N/A,N/A,1825,1835,N/A,13,2
8,N/A,N/A,N/A,1817,1825,N/A,18,1
46,N/A,N/A,N/A,1771,1817,N/A,22,5
14,N/A,N/A,N/A,1757,1771,N/A,27,4
7,N/A,N/A,N/A,1750,1757,N/A,31,2
10,N/A,N/A,N/A,1740,1750,N/A,37,2
38,N/A,N/A,N/A,1702,1740,N/A,41,6
9,N/A,N/A,N/A,1693,1702,N/A,44,3
8,N/A,N/A,N/A,1685,1693,N/A,48,1
43,N/A,N/A,N/A,1642,1685,N/A,53,6
29,N/A,N/A,N/A,1613,1642,N/A,57,4
5,N/A,N/A,N/A,1608,1613,N/A,60,1
34,N/A,N/A,N/A,1574,1608,N/A,65,6
6,N/A,N/A,N/A,1568,1574,N/A,71,0
9,N/A,N/A,N/A,1559,1568,N/A,74,3
5,N/A,N/A,N/A,1554,1559,N/A,78,1
41,N/A,N/A,N/A,1513,1554,N/A,83,6
29,N/A,N/A,N/A,1484,1513,N/A,87,4
12,N/A,N/A,N/A,1472,1484,N/A,93,4
7,N/A,N/A,N/A,1465,1472,N/A,97,2
8,N/A,N/A,N/A,1457,1465,N/A,102,1
10,N/A,N/A,N/A,1447,1457,N/A,105,4
9,N/A,N/A,N/A,1438,1447,N/A,110,3
6,N/A,N/A,N/A,1432,1438,N/A,114,1
15,N/A,N/A,N/A,1417,1432,N/A,117,4
8,N/A,N/A,N/A,1409,1417,N/A,120,1
28,N/A,N/A,N/A,1381,1409,N/A,124,5
7,N/A,N/A,N/A,1374,1381,N/A,127,2
47,N/A,N/A,N/A,688,735,N/A,6,6
25,N/A,N/A,N/A,663,688,N/A,11,5
9,N/A,N/A,N/A,654,663,N/A,15,3
7,N/A,N/A,N/A,647,654,N/A,19,1
8,N/A,N/A,N/A,639,647,N/A,25,1
15,N/A,N/A,N/A,624,639,N/A,28,4
25,N/A,N/A,N/A,599,624,N/A,34,4
17,N/A,N/A,N/A,582,599,N/A,40,4
18,N/A,N/A,N/A,564,582,N/A,46,4
9,N/A,N/A,N/A,555,564,N/A,49,1
27,N/A,N/A,N/A,528,555,N/A,53,5
12,N/A,N/A,N/A,516,528,N/A,58,4
25,N/A,N/A,N/A,491,516,N/A,64,4
9,N/A,N/A,N/A,482,491,N/A,69,3
6,N/A,N/A,N/A,476,482,N/A,73,1
47,N/A,N/A,N/A,429,476,N/A,77,5
29,N/A,N/A,N/A,400,429,N/A,83,5
9,N/A,N/A,N/A,391,400,N/A,87,3
48,N/A,N/A,N/A,343,391,N/A,90,6
9,N/A,N/A,N/A,334,343,N/A,93,3
9,N/A,N/A,N/A,325,334,N/A,97,1
15,N/A,N/A,N/A,310,325,N/A,100,4
5,N/A,N/A,N/A,305,310,N/A,103,1
16,N/A,N/A,N/A,289,305,N/A,106,4
7,N/A,N/A,N/A,282,289,N/A,109,1
30,N/A,N/A,N/A,252,282,N/A,114,6
9,N/A,N/A,N/A,243,252,N/A,120,0
17,N/A,N/A,N/A,226,243,N/A,124,4
8,N/A,N/A,N/A,218,226,N/A,128,2
48,N/A,N/A,N/A,170,218,N/A,132,6
41,N/A,N/A,N/A,1836,1877,N/A,6,5
41,N/A,N/A,N/A,1795,1836,N/A,12,5
8,N/A,N/A,N/A,1787,1795,N/A,15,2
38,N/A,N/A,N/A,1749,1787,N/A,18,5
9,N/A,N/A,N/A,1740,1749,N/A,21,2
39,N/A,N/A,N/A,1701,1740,N/A,25,6
11,N/A,N/A,N/A,1690,1701,N/A,29,4
10,N/A,N/A,N/A,1680,1690,N/A,34,3
39,N/A,N/A,N/A,1641,1680,N/A,37,6
10,N/A,N/A,N/A,1631,1641,N/A,40,3
11,N/A,N/A,N/A,1620,1631,N/A,45,2
33,N/A,N/A,N/A,1587,1620,N/A,49,6
10,N/A,N/A,N/A,1577,1587,N/A,52,3
42,N/A,N/A,N/A,1535,1577,N/A,55,6
18,N/A,N/A,N/A,1517,1535,N/A,59,4
19,N/A,N/A,N/A,1498,1517,N/A,65,4
9,N/A,N/A,N/A,1489,1498,N/A,69,2
8,N/A,N/A,N/A,1481,1489,N/A,75,2
37,N/A,N/A,N/A,1444,1481,N/A,79,6
26,N/A,N/A,N/A,1418,1444,N/A,83,4
10,N/A,N/A,N/A,1408,1418,N/A,88,3
35,N/A,N/A,N/A,1373,1408,N/A,91,6
15,N/A,N/A,N/A,1358,1373,N/A,95,4
7,N/A,N/A,N/A,1351,1358,N/A,99,2
41,N/A,N/A,N/A,1310,1351,N/A,103,6
33,N/A,N/A,N/A,1277,1310,N/A,108,5
8,N/A,N/A,N/A,1269,1277,N/A,111,2
6,N/A,N/A,N/A,1263,1269,N/A,116,1
32,N/A,N/A,N/A,1231,1263,N/A,121,6
28,N/A,N/A,N/A,1203,1231,N/A,125,4
33,N/A,N/A,N/A,1962,1995,N/A,3,5
30,N/A,N/A,N/A,1932,1962,N/A,9,5
8,N/A,N/A,N/A,1924,1932,N/A,12,2
10,N/A,N/A,N/A,1914,1924,N/A,18,2
11,N/A,N/A,N/A,1903,1914,N/A,24,2
11,N/A,N/A,N/A,1892,1903,N/A,30,2
9,N/A,N/A,N/A,1883,1892,N/A,36,2
9,N/A,N/A,N/A,1874,1883,N/A,42,2
10,N/A,N/A,N/A,1864,1874,N/A,48,2
37,N/A,N/A,N/A,1827,1864,N/A,51,5
31,N/A,N/A,N/A,1796,1827,N/A,57,5
10,N/A,N/A,N/A,1786,1796,N/A,60,2
41,N/A,N/A,N/A,1745,1786,N/A,63,5
9,N/A,N/A,N/A,1736,1745,N/A,67,3
26,N/A,N/A,N/A,1710,1736,N/A,70,6
6,N/A,N/A,N/A,1704,1710,N/A,76,0
49,N/A,N/A,N/A,1655,1704,N/A,82,6
27,N/A,N/A,N/A,1628,1655,N/A,87,5
20,N/A,N/A,N/A,1608,1628,N/A,92,4
9,N/A,N/A,N/A,1599,1608,N/A,97,3
10,N/A,N/A,N/A,1589,1599,N/A,103,3
7,N/A,N/A,N/A,1582,1589,N/A,108,2
7,N/A,N/A,N/A,1575,1582,N/A,113,1
24,N/A,N/A,N/A,1551,1575,N/A,116,4
18,N/A,N/A,N/A,1533,1551,N/A,122,4
10,N/A,N/A,N/A,1523,1533,N/A,126,2
47,N/A,N/A,N/A,1476,1523,N/A,130,6
7,N/A,N/A,N/A,1469,1476,N/A,136,0
8,N/A,N/A,N/A,1461,1469,N/A,139,3
25,N/A,N/A,N/A,1436,1461,N/A,142,6
7,N/A,N/A,N/A,448,455,N/A,6,1
38,N/A,N/A,N/A,410,448,N/A,11,6
13,N/A,N/A,N/A,397,410,N/A,15,4
11,N/A,N/A,N/A,386,397,N/A,19,2
41,N/A,N/A,N/A,345,386,N/A,22,5
27,N/A,N/A,N/A,318,345,N/A,27,4
7,N/A,N/A,N/A,311,318,N/A,30,1
38,N/A,N/A,N/A,273,311,N/A,34,5
27,N/A,N/A,N/A,246,273,N/A,39,4
7,N/A,N/A,N/A,239,246,N/A,44,3
10,N/A,N/A,N/A,229,239,N/A,50,3
7,N/A,N/A,N/A,222,229,N/A,56,3
10,N/A,N/A,N/A,212,222,N/A,61,2
8,N/A,N/A,N/A,204,212,N/A,67,2
10,N/A,N/A,N/A,194,204,N/A,73,2
32,N/A,N/A,N/A,162,194,N/A,77,6
7,N/A,N/A,N/A,155,162,N/A,83,0
32,N/A,N/A,N/A,123,155,N/A,88,5
8,N/A,N/A,N/A,115,123,N/A,92,3
7,N/A,N/A,N/A,108,115,N/A,96,1
9,N/A,N/A,N/A,99,108,N/A,102,1
7,N/A,N/A,N/A,92,99,N/A,108,1
39,N/A,N/A,N/A,53,92,N/A,112,5
26,N/A,N/A,N/A,27,53,N/A,117,4
7,N/A,N/A,N/A,20,27,N/A,122,3
11,N/A,N/A,N/A,9,20,N/A,128,3
7,N/A,N/A,N/A,2,9,N/A,132,1
8,N/A,N/A,N/A,-6,2,N/A,138,1
16,N/A,N/A,N/A,1081,1097,N/A,3,4
23,N/A,N/A,N/A,1058,1081,N/A,9,4
11,N/A,N/A,N/A,1047,1058,N/A,14,3
32,N/A,N/A,N/A,1015,1047,N/A,17,6
11,N/A,N/A,N/A,1004,1015,N/A,20,3
30,N/A,N/A,N/A,974,1004,N/A,23,6
46,N/A,N/A,N/A,928,974,N/A,28,5
20,N/A,N/A,N/A,908,928,N/A,33,4
11,N/A,N/A,N/A,897,908,N/A,38,3
25,N/A,N/A,N/A,872,897,N/A,41,6
7,N/A,N/A,N/A,865,872,N/A,47,0
41,N/A,N/A,N/A,824,865,N/A,52,5
10,N/A,N/A,N/A,814,824,N/A,56,3
11,N/A,N/A,N/A,803,814,N/A,61,2
45,N/A,N/A,N/A,758,803,N/A,65,6
35,N/A,N/A,N/A,723,758,N/A,70,5
38,N/A,N/A,N/A,685,723,N/A,76,5
20,N/A,N/A,N/A,665,685,N/A,81,4
11,N/A,N/A,N/A,654,665,N/A,86,3
32,N/A,N/A,N/A,622,654,N/A,89,6
9,N/A,N/A,N/A,613,622,N/A,95,0
9,N/A,N/A,N/A,604,613,N/A,98,3
5,N/A,N/A,N/A,599,604,N/A,102,1
5,N/A,N/A,N/A,594,599,N/A,108,1
33,N/A,N/A,N/A,561,594,N/A,113,6
10,N/A,N/A,N/A,551,561,N/A,116,3
37,N/A,N/A,N/A,514,551,N/A,119,6
25,N/A,N/A,N/A,489,514,N/A,124,5
30,N/A,N/A,N/A,459,489,N/A,130,5
12,N/A,N/A,N/A,447,459,N/A,135,4
41,N/A,N/A,N/A,1616,1657,N/A,4,5
8,N/A,N/A,N/A,1608,1616,N/A,7,2
7,N/A,N/A,N/A,1601,1608,N/A,13,2
7,N/A,N/A,N/A,1594,1601,N/A,19,2
31,N/A,N/A,N/A,1563,1594,N/A,22,5
9,N/A,N/A,N/A,1554,1563,N/A,26,3
9,N/A,N/A,N/A,1545,1554,N/A,30,1
8,N/A,N/A,N/A,1537,1545,N/A,36,1
27,N/A,N/A,N/A,1510,1537,N/A,39,4
9,N/A,N/A,N/A,1501,1510,N/A,43,2
48,N/A,N/A,N/A,1453,1501,N/A,46,5
10,N/A,N/A,N/A,1443,1453,N/A,50,3
7,N/A,N/A,N/A,1436,1443,N/A,56,3
10,N/A,N/A,N/A,1426,1436,N/A,62,3
9,N/A,N/A,N/A,1417,1426,N/A,67,2
35,N/A,N/A,N/A,1382,1417,N/A,71,6
22,N/A,N/A,N/A,1360,1382,N/A,75,4
25,N/A,N/A,N/A,1335,1360,N/A,81,4
11,N/A,N/A,N/A,1324,1335,N/A,85,2
27,N/A,N/A,N/A,1297,1324,N/A,89,6
6,N/A,N/A,N/A,1291,1297,N/A,95,0
21,N/A,N/A,N/A,1270,1291,N/A,99,4
11,N/A,N/A,N/A,1259,1270,N/A,104,3
7,N/A,N/A,N/A,1252,1259,N/A,108,1
33,N/A,N/A,N/A,1219,1252,N/A,112,5
10,N/A,N/A,N/A,1209,1219,N/A,117,4
11,N/A,N/A,N/A,1198,1209,N/A,123,4
7,N/A,N/A,N/A,1191,1198,N/A,127,2
46,N/A,N/A,N/A,1145,1191,N/A,130,5
9,N/A,N/A,N/A,1136,1145,N/A,134,3
31,N/A,N/A,N/A,1131,1162,N/A,4,6
7,N/A,N/A,N/A,1124,1131,N/A,10,0
38,N/A,N/A,N/A,1086,1124,N/A,16,6
14,N/A,N/A,N/A,1072,1086,N/A,20,4
5,N/A,N/A,N/A,1067,1072,N/A,23,1
5,N/A,N/A,N/A,1062,1067,N/A,29,1
13,N/A,N/A,N/A,1049,1062,N/A,32,4
11,N/A,N/A,N/A,1038,1049,N/A,36,2
32,N/A,N/A,N/A,1006,1038,N/A,39,5
9,N/A,N/A,N/A,997,1006,N/A,43,3
9,N/A,N/A,N/A,988,997,N/A,48,2
5,N/A,N/A,N/A,983,988,N/A,53,1
35,N/A,N/A,N/A,948,983,N/A,58,6
46,N/A,N/A,N/A,902,948,N/A,63,5
33,N/A,N/A,N/A,869,902,N/A,69,5
42,N/A,N/A,N/A,827,869,N/A,75,5
12,N/A,N/A,N/A,815,827,N/A,80,4
7,N/A,N/A,N/A,808,815,N/A,84,2
9,N/A,N/A,N/A,799,808,N/A,90,2
27,N/A,N/A,N/A,772,799,N/A,94,6
8,N/A,N/A,N/A,764,772,N/A,100,0
26,N/A,N/A,N/A,738,764,N/A,106,6
46,N/A,N/A,N/A,692,738,N/A,111,5
25,N/A,N/A,N/A,667,692,N/A,116,4
29,N/A,N/A,N/A,638,667,N/A,122,4
9,N/A,N/A,N/A,629,638,N/A,126,2
34,N/A,N/A,N/A,595,629,N/A,129,5
7,N/A,N/A,N/A,588,595,N/A,132,2
38,N/A,N/A,N/A,550,588,N/A,135,5
16,N/A,N/A,N/A,534,550,N/A,140,4
49,N/A,N/A,N/A,1672,1721,N/A,3,6
46,N/A,N/A,N/A,1626,1672,N/A,8,5
11,N/A,N/A,N/A,1615,1626,N/A,12,3
9,N/A,N/A,N/A,1606,1615,N/A,18,3
8,N/A,N/A,N/A,1598,1606,N/A,23,2
31,N/A,N/A,N/A,1567,1598,N/A,26,5
10,N/A,N/A,N/A,1557,1567,N/A,29,2
37,N/A,N/A,N/A,1520,1557,N/A,32,5
17,N/A,N/A,N/A,1503,1520,N/A,37,4
7,N/A,N/A,N/A,1496,1503,N/A,40,1
9,N/A,N/A,N/A,1487,1496,N/A,46,1
44,N/A,N/A,N/A,1443,1487,N/A,50,5
7,N/A,N/A,N/A,1436,1443,N/A,53,2
7,N/A,N/A,N/A,1429,1436,N/A,59,2
8,N/A,N/A,N/A,1421,1429,N/A,65,2
27,N/A,N/A,N/A,1394,1421,N/A,69,6
29,N/A,N/A,N/A,1365,1394,N/A,74,5
8,N/A,N/A,N/A,1357,1365,N/A,78,3
9,N/A,N/A,N/A,1348,1357,N/A,83,2
44,N/A,N/A,N/A,1304,1348,N/A,87,6
10,N/A,N/A,N/A,1294,1304,N/A,90,3
9,N/A,N/A,N/A,1285,1294,N/A,96,3
6,N/A,N/A,N/A,1279,1285,N/A,100,1
40,N/A,N/A,N/A,1239,1279,N/A,105,6
8,N/A,N/A,N/A,1231,1239,N/A,108,3
10,N/A,N/A,N/A,1221,1231,N/A,113,2
6,N/A,N/A,N/A,1215,1221,N/A,118,1
33,N/A,N/A,N/A,1182,1215,N/A,122,5
38,N/A,N/A,N/A,1144,1182,N/A,128,5
29,N/A,N/A,N/A,1115,1144,N/A,133,4
8,N/A,N/A,N/A,602,610,N/A,3,1
18,N/A,N/A,N/A,584,602,N/A,6,4
6,N/A,N/A,N/A,578,584,N/A,9,1
17,N/A,N/A,N/A,561,578,N/A,12,4
11,N/A,N/A,N/A,550,561,N/A,16,2
38,N/A,N/A,N/A,512,550,N/A,19,5
33,N/A,N/A,N/A,479,512,N/A,25,5
7,N/A,N/A,N/A,472,479,N/A,29,3
8,N/A,N/A,N/A,464,472,N/A,34,2
26,N/A,N/A,N/A,438,464,N/A,37,5
32,N/A,N/A,N/A,406,438,N/A,43,5
36,N/A,N/A,N/A,370,406,N/A,49,5
7,N/A,N/A,N/A,363,370,N/A,53,3
10,N/A,N/A,N/A,353,363,N/A,58,2
9,N/A,N/A,N/A,344,353,N/A,64,2
11,N/A,N/A,N/A,333,344,N/A,70,2
35,N/A,N/A,N/A,298,333,N/A,73,5
36,N/A,N/A,N/A,262,298,N/A,79,5
31,N/A,N/A,N/A,231,262,N/A,85,5
8,N/A,N/A,N/A,223,231,N/A,89,3
7,N/A,N/A,N/A,216,223,N/A,93,1
31,N/A,N/A,N/A,185,216,N/A,97,5
7,N/A,N/A,N/A,178,185,N/A,100,2
31,N/A,N/A,N/A,147,178,N/A,103,5
7,N/A,N/A,N/A,140,147,N/A,106,2
34,N/A,N/A,N/A,106,140,N/A,110,6
10,N/A,N/A,N/A,96,106,N/A,113,3
32,N/A,N/A,N/A,64,96,N/A,116,6
30,N/A,N/A,N/A,34,64,N/A,121,5
9,N/A,N/A,N/A,25,34,N/A,124,2
10,N/A,N/A,N/A,1132,1142,N/A,3,2
34,N/A,N/A,N/A,1098,1132,N/A,6,5
10,N/A,N/A,N/A,1088,1098,N/A,9,2
6,N/A,N/A,N/A,1082,1088,N/A,14,1
26,N/A,N/A,N/A,1056,1082,N/A,18,5
8,N/A,N/A,N/A,1048,1056,N/A,22,3
10,N/A,N/A,N/A,1038,1048,N/A,28,3
7,N/A,N/A,N/A,1031,1038,N/A,34,3
34,N/A,N/A,N/A,997,1031,N/A,37,6
24,N/A,N/A,N/A,973,997,N/A,41,4
6,N/A,N/A,N/A,967,973,N/A,44,1
27,N/A,N/A,N/A,940,967,N/A,47,4
6,N/A,N/A,N/A,934,940,N/A,50,1
44,N/A,N/A,N/A,890,934,N/A,54,5
11,N/A,N/A,N/A,879,890,N/A,58,3
7,N/A,N/A,N/A,872,879,N/A,62,1
47,N/A,N/A,N/A,825,872,N/A,66,5
7,N/A,N/A,N/A,818,825,N/A,70,3
9,N/A,N/A,N/A,809,818,N/A,75,2
41,N/A,N/A,N/A,768,809,N/A,79,6
12,N/A,N/A,N/A,756,768,N/A,83,4
9,N/A,N/A,N/A,747,756,N/A,87,2
7,N/A,N/A,N/A,740,747,N/A,93,2
9,N/A,N/A,N/A,731,740,N/A,99,2
9,N/A,N/A,N/A,722,731,N/A,104,1
38,N/A,N/A,N/A,684,722,N/A,108,5
10,N/A,N/A,N/A,674,684,N/A,111,2
42,N/A,N/A,N/A,632,674,N/A,114,5
10,N/A,N/A,N/A,622,632,N/A,118,3
8,N/A,N/A,N/A,614,622,N/A,124,3
25,N/A,N/A,N/A,1381,1406,N/A,6,6
35,N/A,N/A,N/A,1346,1381,N/A,11,5
39,N/A,N/A,N/A,1307,1346,N/A,17,5
7,N/A,N/A,N/A,1300,1307,N/A,20,2
10,N/A,N/A,N/A,1290,1300,N/A,26,2
7,N/A,N/A,N/A,1283,1290,N/A,31,1
16,N/A,N/A,N/A,1267,1283,N/A,34,4
8,N/A,N/A,N/A,1259,1267,N/A,38,2
32,N/A,N/A,N/A,1227,1259,N/A,41,5
44,N/A,N/A,N/A,1183,1227,N/A,47,5
10,N/A,N/A,N/A,1173,1183,N/A,52,4
9,N/A,N/A,N/A,1164,1173,N/A,57,3
9,N/A,N/A,N/A,1155,1164,N/A,62,2
36,N/A,N/A,N/A,1119,1155,N/A,65,5
11,N/A,N/A,N/A,1108,1119,N/A,69,3
39,N/A,N/A,N/A,1069,1108,N/A,72,6
30,N/A,N/A,N/A,1039,1069,N/A,77,5
14,N/A,N/A,N/A,1025,1039,N/A,82,4
24,N/A,N/A,N/A,1001,1025,N/A,88,4
9,N/A,N/A,N/A,992,1001,N/A,92,2
11,N/A,N/A,N/A,981,992,N/A,98,2
37,N/A,N/A,N/A,944,981,N/A,102,6
21,N/A,N/A,N/A,923,944,N/A,106,4
8,N/A,N/A,N/A,915,923,N/A,111,3
8,N/A,N/A,N/A,907,915,N/A,115,1
13,N/A,N/A,N/A,894,907,N/A,118,4
5,N/A,N/A,N/A,889,894,N/A,121,1
43,N/A,N/A,N/A,846,889,N/A,126,6
11,N/A,N/A,N/A,835,846,N/A,129,3
33,N/A,N/A,N/A,802,835,N/A,132,6
11,N/A,N/A,N/A,1191,1202,N/A,5,3
9,N/A,N/A,N/A,1182,1191,N/A,9,1
10,N/A,N/A,N/A,1172,1182,N/A,12,4
21,N/A,N/A,N/A,1151,1172,N/A,18,4
9,N/A,N/A,N/A,1142,1151,N/A,22,2
5,N/A,N/A,N/A,1137,1142,N/A,27,1
8,N/A,N/A,N/A,1129,1137,N/A,33,1
46,N/A,N/A,N/A,1083,1129,N/A,38,6
11,N/A,N/A,N/A,1072,1083,N/A,41,3
11,N/A,N/A,N/A,1061,1072,N/A,47,3
9,N/A,N/A,N/A,1052,1061,N/A,53,3
7,N/A,N/A,N/A,1045,1052,N/A,59,3
8,N/A,N/A,N/A,1037,1045,N/A,65,3
26,N/A,N/A,N/A,1011,1037,N/A,68,6
15,N/A,N/A,N/A,996,1011,N/A,72,4
29,N/A,N/A,N/A,967,996,N/A,78,4
13,N/A,N/A,N/A,954,967,N/A,84,4
9,N/A,N/A,N/A,945,954,N/A,89,3
46,N/A,N/A,N/A,899,945,N/A,92,6
10,N/A,N/A,N/A,889,899,N/A,95,3
35,N/A,N/A,N/A,854,889,N/A,98,6
11,N/A,N/A,N/A,843,854,N/A,101,3
7,N/A,N/A,N/A,836,843,N/A,105,1
7,N/A,N/A,N/A,829,836,N/A,111,1
25,N/A,N/A,N/A,804,829,N/A,116,6
9,N/A,N/A,N/A,795,804,N/A,122,0
39,N/A,N/A,N/A,756,795,N/A,128,6
10,N/A,N/A,N/A,746,756,N/A,132,4
9,N/A,N/A,N/A,737,746,N/A,137,3
11,N/A,N/A,N/A,726,737,N/A,143,3
46,N/A,N/A,N/A,749,795,N/A,5,6
30,N/A,N/A,N/A,719,749,N/A,10,5
48,N/A,N/A,N/A,671,719,N/A,16,5
11,N/A,N/A,N/A,660,671,N/A,19,2
49,N/A,N/A,N/A,611,660,N/A,23,6
20,N/A,N/A,N/A,591,611,N/A,27,4
16,N/A,N/A,N/A,575,591,N/A,33,4
11,N/A,N/A,N/A,564,575,N/A,38,3
7,N/A,N/A,N/A,557,564,N/A,43,2
45,N/A,N/A,N/A,512,557,N/A,46,5
46,N/A,N/A,N/A,466,512,N/A,52,5
28,N/A,N/A,N/A,438,466,N/A,57,4
7,N/A,N/A,N/A,431,438,N/A,60,1
13,N/A,N/A,N/A,418,431,N/A,63,4
11,N/A,N/A,N/A,407,418,N/A,67,2
9,N/A,N/A,N/A,398,407,N/A,72,1
33,N/A,N/A,N/A,365,398,N/A,76,5
11,N/A,N/A,N/A,354,365,N/A,79,2
25,N/A,N/A,N/A,329,354,N/A,83,6
22,N/A,N/A,N/A,307,329,N/A,87,4
8,N/A,N/A,N/A,299,307,N/A,91,2
35,N/A,N/A,N/A,264,299,N/A,94,5
7,N/A,N/A,N/A,257,264,N/A,97,2
46,N/A,N/A,N/A,211,257,N/A,101,6
43,N/A,N/A,N/A,168,211,N/A,106,5
34,N/A,N/A,N/A,134,168,N/A,112,5
11,N/A,N/A,N/A,123,134,N/A,116,3
9,N/A,N/A,N/A,114,123,N/A,122,3
7,N/A,N/A,N/A,107,114,N/A,126,1
47,N/A,N/A,N/A,60,107,N/A,130,5
7,N/A,N/A,N/A,1559,1566,N/A,4,2
7,N/A,N/A,N/A,1552,1559,N/A,9,1
20,N/A,N/A,N/A,1532,1552,N/A,12,4
10,N/A,N/A,N/A,1522,1532,N/A,16,2
8,N/A,N/A,N/A,1514,1522,N/A,21,1
48,N/A,N/A,N/A,1466,1514,N/A,25,5
27,N/A,N/A,N/A,1439,1466,N/A,30,4
7,N/A,N/A,N/A,1432,1439,N/A,34,2
7,N/A,N/A,N/A,1425,1432,N/A,39,1
16,N/A,N/A,N/A,1409,1425,N/A,42,4
6,N/A,N/A,N/A,1403,1409,N/A,45,1
31,N/A,N/A,N/A,1372,1403,N/A,49,5
8,N/A,N/A,N/A,1364,1372,N/A,52,2
36,N/A,N/A,N/A,1328,1364,N/A,55,5
27,N/A,N/A,N/A,1301,1328,N/A,61,5
10,N/A,N/A,N/A,1291,1301,N/A,64,2
8,N/A,N/A,N/A,1283,1291,N/A,70,2
32,N/A,N/A,N/A,1251,1283,N/A,73,5
9,N/A,N/A,N/A,1242,1251,N/A,76,2
8,N/A,N/A,N/A,1234,1242,N/A,82,2
7,N/A,N/A,N/A,1227,1234,N/A,87,1
47,N/A,N/A,N/A,1180,1227,N/A,92,6
26,N/A,N/A,N/A,1154,1180,N/A,97,5
8,N/A,N/A,N/A,1146,1154,N/A,101,3
8,N/A,N/A,N/A,1138,1146,N/A,105,1
5,N/A,N/A,N/A,1133,1138,N/A,111,1
5,N/A,N/A,N/A,1128,1133,N/A,117,1
47,N/A,N/A,N/A,1081,1128,N/A,121,5
22,N/A,N/A,N/A,1059,1081,N/A,126,4
19,N/A,N/A,N/A,1040,1059,N/A,132,4
48,N/A,N/A,N/A,411,459,N/A,4,6
28,N/A,N/A,N/A,383,411,N/A,9,5
11,N/A,N/A,N/A,372,383,N/A,12,2
45,N/A,N/A,N/A,327,372,N/A,16,6
11,N/A,N/A,N/A,316,327,N/A,19,3
45,N/A,N/A,N/A,271,316,N/A,22,6
5,N/A,N/A,N/A,266,271,N/A,28,0
32,N/A,N/A,N/A,234,266,N/A,34,6
11,N/A,N/A,N/A,223,234,N/A,37,3
9,N/A,N/A,N/A,214,223,N/A,42,2
5,N/A,N/A,N/A,209,214,N/A,47,1
34,N/A,N/A,N/A,175,209,N/A,52,6
7,N/A,N/A,N/A,168,175,N/A,55,3
10,N/A,N/A,N/A,158,168,N/A,60,2
6,N/A,N/A,N/A,152,158,N/A,65,1
31,N/A,N/A,N/A,121,152,N/A,69,5
18,N/A,N/A,N/A,103,121,N/A,74,4
10,N/A,N/A,N/A,93,103,N/A,78,2
42,N/A,N/A,N/A,51,93,N/A,81,5
11,N/A,N/A,N/A,40,51,N/A,85,3
7,N/A,N/A,N/A,33,40,N/A,89,1
43,N/A,N/A,N/A,-10,33,N/A,94,6
46,N/A,N/A,N/A,925,971,N/A,4,5
37,N/A,N/A,N/A,888,925,N/A,10,5
11,N/A,N/A,N/A,877,888,N/A,14,3
8,N/A,N/A,N/A,869,877,N/A,20,3
8,N/A,N/A,N/A,861,869,N/A,26,3
10,N/A,N/A,N/A,851,861,N/A,32,3
8,N/A,N/A,N/A,843,851,N/A,38,3
8,N/A,N/A,N/A,835,843,N/A,43,2
10,N/A,N/A,N/A,825,835,N/A,49,2
42,N/A,N/A,N/A,783,825,N/A,53,6
41,N/A,N/A,N/A,742,783,N/A,58,5
48,N/A,N/A,N/A,694,742,N/A,64,5
11,N/A,N/A,N/A,683,694,N/A,67,2
36,N/A,N/A,N/A,647,683,N/A,71,6
9,N/A,N/A,N/A,638,647,N/A,77,0
45,N/A,N/A,N/A,593,638,N/A,83,6
29,N/A,N/A,N/A,564,593,N/A,88,5
11,N/A,N/A,N/A,553,564,N/A,92,3
28,N/A,N/A,N/A,525,553,N/A,95,6
11,N/A,N/A,N/A,514,525,N/A,98,3
7,N/A,N/A,N/A,507,514,N/A,103,2
6,N/A,N/A,N/A,501,507,N/A,108,1
41,N/A,N/A,N/A,460,501,N/A,113,6
24,N/A,N/A,N/A,436,460,N/A,117,4
6,N/A,N/A,N/A,430,436,N/A,120,1
32,N/A,N/A,N/A,398,430,N/A,124,5
8,N/A,N/A,N/A,390,398,N/A,127,2
44,N/A,N/A,N/A,346,390,N/A,131,6
26,N/A,N/A,N/A,320,346,N/A,135,4
10,N/A,N/A,N/A,310,320,N/A,140,3
31,N/A,N/A,N/A,498,529,N/A,4,6
8,N/A,N/A,N/A,490,498,N/A,10,0
42,N/A,N/A,N/A,448,490,N/A,16,6
13,N/A,N/A,N/A,435,448,N/A,20,4
25,N/A,N/A,N/A,410,435,N/A,26,4
26,N/A,N/A,N/A,384,410,N/A,32,4
8,N/A,N/A,N/A,376,384,N/A,35,1
6,N/A,N/A,N/A,370,376,N/A,41,1
19,N/A,N/A,N/A,351,370,N/A,44,4
9,N/A,N/A,N/A,342,351,N/A,49,3
8,N/A,N/A,N/A,334,342,N/A,55,3
11,N/A,N/A,N/A,323,334,N/A,60,2
38,N/A,N/A,N/A,285,323,N/A,63,5
21,N/A,N/A,N/A,264,285,N/A,68,4
8,N/A,N/A,N/A,256,264,N/A,71,1
10,N/A,N/A,N/A,246,256,N/A,74,4
7,N/A,N/A,N/A,239,246,N/A,79,3
11,N/A,N/A,N/A,228,239,N/A,84,2
8,N/A,N/A,N/A,220,228,N/A,89,1
7,N/A,N/A,N/A,213,220,N/A,95,1
12,N/A,N/A,N/A,201,213,N/A,98,4
21,N/A,N/A,N/A,180,201,N/A,104,4
11,N/A,N/A,N/A,169,180,N/A,108,2
25,N/A,N/A,N/A,144,169,N/A,112,6
7,N/A,N/A,N/A,137,144,N/A,118,0
45,N/A,N/A,N/A,92,137,N/A,123,5
8,N/A,N/A,N/A,84,92,N/A,127,3
8,N/A,N/A,N/A,76,84,N/A,133,3
9,N/A,N/A,N/A,67,76,N/A,138,2
37,N/A,N/A,N/A,30,67,N/A,142,6
7,N/A,N/A,N/A,1847,1854,N/A,4,2
29,N/A,N/A,N/A,1818,1847,N/A,7,5
11,N/A,N/A,N/A,1807,1818,N/A,11,3
26,N/A,N/A,N/A,1781,1807,N/A,14,6
27,N/A,N/A,N/A,1754,1781,N/A,18,4
8,N/A,N/A,N/A,1746,1754,N/A,22,2
6,N/A,N/A,N/A,1740,1746,N/A,27,1
8,N/A,N/A,N/A,1732,1740,N/A,33,1
9,N/A,N/A,N/A,1723,1732,N/A,39,1
17,N/A,N/A,N/A,1706,1723,N/A,42,4
7,N/A,N/A,N/A,1699,1706,N/A,46,2
30,N/A,N/A,N/A,1669,1699,N/A,50,6
14,N/A,N/A,N/A,1655,1669,N/A,54,4
5,N/A,N/A,N/A,1650,1655,N/A,57,1
34,N/A,N/A,N/A,1616,1650,N/A,61,5
13,N/A,N/A,N/A,1603,1616,N/A,66,4
10,N/A,N/A,N/A,1593,1603,N/A,70,2
44,N/A,N/A,N/A,1549,1593,N/A,73,5
8,N/A,N/A,N/A,1541,1549,N/A,76,2
6,N/A,N/A,N/A,1535,1541,N/A,81,1
40,N/A,N/A,N/A,1495,1535,N/A,86,6
11,N/A,N/A,N/A,1484,1495,N/A,89,3
9,N/A,N/A,N/A,1475,1484,N/A,93,1
28,N/A,N/A,N/A,1447,1475,N/A,97,5
10,N/A,N/A,N/A,1437,1447,N/A,102,4
20,N/A,N/A,N/A,1417,1437,N/A,108,4
10,N/A,N/A,N/A,1407,1417,N/A,113,3
29,N/A,N/A,N/A,1378,1407,N/A,116,6
10,N/A,N/A,N/A,1368,1378,N/A,119,3
10,N/A,N/A,N/A,1358,1368,N/A,124,2
43,N/A,N/A,N/A,287,330,N/A,4,5
7,N/A,N/A,N/A,280,287,N/A,7,2
9,N/A,N/A,N/A,271,280,N/A,13,2
47,N/A,N/A,N/A,224,271,N/A,17,6
14,N/A,N/A,N/A,210,224,N/A,21,4
10,N/A,N/A,N/A,200,210,N/A,26,3
38,N/A,N/A,N/A,162,200,N/A,29,6
16,N/A,N/A,N/A,146,162,N/A,33,4
8,N/A,N/A,N/A,138,146,N/A,37,2
9,N/A,N/A,N/A,129,138,N/A,42,1
14,N/A,N/A,N/A,115,129,N/A,45,4
7,N/A,N/A,N/A,108,115,N/A,50,3
32,N/A,N/A,N/A,76,108,N/A,53,6
7,N/A,N/A,N/A,69,76,N/A,56,3
8,N/A,N/A,N/A,61,69,N/A,60,1
26,N/A,N/A,N/A,35,61,N/A,64,5
11,N/A,N/A,N/A,24,35,N/A,69,4
9,N/A,N/A,N/A,15,24,N/A,73,2
9,N/A,N/A,N/A,6,15,N/A,78,1
37,N/A,N/A,N/A,-31,6,N/A,83,6
26,N/A,N/A,N/A,1267,1293,N/A,3,4
6,N/A,N/A,N/A,1261,1267,N/A,6,1
7,N/A,N/A,N/A,1254,1261,N/A,12,1
46,N/A,N/A,N/A,1208,1254,N/A,17,6
15,N/A,N/A,N/A,1193,1208,N/A,21,4
10,N/A,N/A,N/A,1183,1193,N/A,26,3
34,N/A,N/A,N/A,1149,1183,N/A,29,6
9,N/A,N/A,N/A,1140,1149,N/A,35,0
11,N/A,N/A,N/A,1129,1140,N/A,39,4
11,N/A,N/A,N/A,1118,1129,N/A,44,3
5,N/A,N/A,N/A,1113,1118,N/A,48,1
43,N/A,N/A,N/A,1070,1113,N/A,52,5
10,N/A,N/A,N/A,1060,1070,N/A,57,4
7,N/A,N/A,N/A,1053,1060,N/A,61,2
36,N/A,N/A,N/A,1017,1053,N/A,65,6
35,N/A,N/A,N/A,982,1017,N/A,70,5
11,N/A,N/A,N/A,971,982,N/A,73,2
5,N/A,N/A,N/A,966,971,N/A,78,1
7,N/A,N/A,N/A,959,966,N/A,84,1
49,N/A,N/A,N/A,910,959,N/A,89,6
9,N/A,N/A,N/A,901,910,N/A,92,3
8,N/A,N/A,N/A,893,901,N/A,97,2
44,N/A,N/A,N/A,849,893,N/A,101,6
11,N/A,N/A,N/A,838,849,N/A,104,3
10,N/A,N/A,N/A,828,838,N/A,110,3
9,N/A,N/A,N/A,819,828,N/A,114,1
23,N/A,N/A,N/A,796,819,N/A,117,4
6,N/A,N/A,N/A,790,796,N/A,120,1
26,N/A,N/A,N/A,764,790,N/A,123,4
11,N/A,N/A,N/A,753,764,N/A,127,2
8,N/A,N/A,N/A,1271,1279,N/A,5,1
36,N/A,N/A,N/A,1235,1271,N/A,9,5
28,N/A,N/A,N/A,1207,1235,N/A,14,4
21,N/A,N/A,N/A,1186,1207,N/A,20,4
15,N/A,N/A,N/A,1171,1186,N/A,26,4
9,N/A,N/A,N/A,1162,1171,N/A,29,1
34,N/A,N/A,N/A,1128,1162,N/A,33,5
9,N/A,N/A,N/A,1119,1128,N/A,36,2
5,N/A,N/A,N/A,1114,1119,N/A,41,1
48,N/A,N/A,N/A,1066,1114,N/A,46,6
39,N/A,N/A,N/A,1027,1066,N/A,51,5
9,N/A,N/A,N/A,1018,1027,N/A,55,3
8,N/A,N/A,N/A,1010,1018,N/A,59,1
48,N/A,N/A,N/A,962,1010,N/A,63,5
10,N/A,N/A,N/A,952,962,N/A,66,2
7,N/A,N/A,N/A,945,952,N/A,72,2
6,N/A,N/A,N/A,939,945,N/A,77,1
6,N/A,N/A,N/A,933,939,N/A,83,1
8,N/A,N/A,N/A,925,933,N/A,89,1
40,N/A,N/A,N/A,885,925,N/A,93,5
19,N/A,N/A,N/A,866,885,N/A,98,4
21,N/A,N/A,N/A,845,866,N/A,104,4
9,N/A,N/A,N/A,836,845,N/A,108,2
36,N/A,N/A,N/A,800,836,N/A,111,5
10,N/A,N/A,N/A,790,800,N/A,114,2
11,N/A,N/A,N/A,779,790,N/A,120,2
6,N/A,N/A,N/A,773,779,N/A,125,1
28,N/A,N/A,N/A,745,773,N/A,130,6
28,N/A,N/A,N/A,717,745,N/A,134,4
11,N/A,N/A,N/A,706,717,N/A,139,3
19,N/A,N/A,N/A,1783,1802,N/A,3,4
13,N/A,N/A,N/A,1770,1783,N/A,9,4
9,N/A,N/A,N/A,1761,1770,N/A,13,2
6,N/A,N/A,N/A,1755,1761,N/A,18,1
6,N/A,N/A,N/A,1749,1755,N/A,24,1
39,N/A,N/A,N/A,1710,1749,N/A,28,5
9,N/A,N/A,N/A,1701,1710,N/A,32,3
11,N/A,N/A,N/A,1690,1701,N/A,37,2
43,N/A,N/A,N/A,1647,1690,N/A,40,5
13,N/A,N/A,N/A,1634,1647,N/A,45,4
9,N/A,N/A,N/A,1625,1634,N/A,49,2
45,N/A,N/A,N/A,1580,1625,N/A,53,6
6,N/A,N/A,N/A,1574,1580,N/A,59,0
42,N/A,N/A,N/A,1532,1574,N/A,65,6
26,N/A,N/A,N/A,1506,1532,N/A,69,4
10,N/A,N/A,N/A,1496,1506,N/A,73,2
38,N/A,N/A,N/A,1458,1496,N/A,76,5
27,N/A,N/A,N/A,1431,1458,N/A,81,4
20,N/A,N/A,N/A,1411,1431,N/A,87,4
13,N/A,N/A,N/A,1398,1411,N/A,93,4
5,N/A,N/A,N/A,1393,1398,N/A,96,1
29,N/A,N/A,N/A,1364,1393,N/A,100,5
9,N/A,N/A,N/A,1355,1364,N/A,104,3
41,N/A,N/A,N/A,1314,1355,N/A,107,6
5,N/A,N/A,N/A,1309,1314,N/A,113,0
35,N/A,N/A,N/A,1274,1309,N/A,119,6
27,N/A,N/A,N/A,1247,1274,N/A,124,5
9,N/A,N/A,N/A,1238,1247,N/A,128,3
43,N/A,N/A,N/A,1195,1238,N/A,131,6
7,N/A,N/A,N/A,1188,1195,N/A,137,0
45,N/A,N/A,N/A,1318,1363,N/A,6,6
17,N/A,N/A,N/A,1301,1318,N/A,10,4
7,N/A,N/A,N/A,1294,1301,N/A,14,2
49,N/A,N/A,N/A,1245,1294,N/A,18,6
45,N/A,N/A,N/A,1200,1245,N/A,23,5
31,N/A,N/A,N/A,1169,1200,N/A,29,5
11,N/A,N/A,N/A,1158,1169,N/A,33,3
9,N/A,N/A,N/A,1149,1158,N/A,37,1
46,N/A,N/A,N/A,1103,1149,N/A,41,5
23,N/A,N/A,N/A,1080,1103,N/A,46,4
20,N/A,N/A,N/A,1060,1080,N/A,52,4
11,N/A,N/A,N/A,1049,1060,N/A,56,2
47,N/A,N/A,N/A,1002,1049,N/A,60,6
36,N/A,N/A,N/A,966,1002,N/A,65,5
13,N/A,N/A,N/A,953,966,N/A,70,4
6,N/A,N/A,N/A,947,953,N/A,73,1
8,N/A,N/A,N/A,939,947,N/A,79,1
8,N/A,N/A,N/A,931,939,N/A,85,1
26,N/A,N/A,N/A,905,931,N/A,88,4
9,N/A,N/A,N/A,896,905,N/A,93,3
8,N/A,N/A,N/A,888,896,N/A,98,2
49,N/A,N/A,N/A,839,888,N/A,102,6
6,N/A,N/A,N/A,833,839,N/A,108,0
36,N/A,N/A,N/A,797,833,N/A,113,5
23,N/A,N/A,N/A,774,797,N/A,118,4
10,N/A,N/A,N/A,764,774,N/A,122,2
44,N/A,N/A,N/A,720,764,N/A,126,6
15,N/A,N/A,N/A,705,720,N/A,130,4
20,N/A,N/A,N/A,685,705,N/A,136,4
8,N/A,N/A,N/A,677,685,N/A,140,2
48,N/A,N/A,N/A,1144,1192,N/A,3,5
24,N/A,N/A,N/A,1120,1144,N/A,8,4
9,N/A,N/A,N/A,1111,1120,N/A,11,1
31,N/A,N/A,N/A,1080,1111,N/A,15,5
11,N/A,N/A,N/A,1069,1080,N/A,18,2
8,N/A,N/A,N/A,1061,1069,N/A,24,2
26,N/A,N/A,N/A,1035,1061,N/A,28,6
8,N/A,N/A,N/A,1027,1035,N/A,34,0
25,N/A,N/A,N/A,1002,1027,N/A,38,4
7,N/A,N/A,N/A,995,1002,N/A,43,3
10,N/A,N/A,N/A,985,995,N/A,48,2
37,N/A,N/A,N/A,948,985,N/A,51,5
11,N/A,N/A,N/A,937,948,N/A,55,3
44,N/A,N/A,N/A,893,937,N/A,58,6
17,N/A,N/A,N/A,876,893,N/A,62,4
23,N/A,N/A,N/A,853,876,N/A,68,4
28,N/A,N/A,N/A,825,853,N/A,74,4
7,N/A,N/A,N/A,818,825,N/A,79,3
9,N/A,N/A,N/A,809,818,N/A,83,1
44,N/A,N/A,N/A,765,809,N/A,88,6
10,N/A,N/A,N/A,755,765,N/A,91,3
11,N/A,N/A,N/A,744,755,N/A,97,3
5,N/A,N/A,N/A,739,744,N/A,101,1
9,N/A,N/A,N/A,730,739,N/A,107,1
5,N/A,N/A,N/A,725,730,N/A,113,1
33,N/A,N/A,N/A,692,725,N/A,118,6
11,N/A,N/A,N/A,681,692,N/A,121,3
7,N/A,N/A,N/A,674,681,N/A,125,1
39,N/A,N/A,N/A,635,674,N/A,129,5
7,N/A,N/A,N/A,628,635,N/A,132,2
23,N/A,N/A,N/A,723,746,N/A,6,4
7,N/A,N/A,N/A,716,723,N/A,10,2
29,N/A,N/A,N/A,687,716,N/A,14,6
8,N/A,N/A,N/A,679,687,N/A,17,3
11,N/A,N/A,N/A,668,679,N/A,22,2
32,N/A,N/A,N/A,636,668,N/A,25,5
11,N/A,N/A,N/A,625,636,N/A,28,2
25,N/A,N/A,N/A,600,625,N/A,32,6
29,N/A,N/A,N/A,571,600,N/A,36,4
9,N/A,N/A,N/A,562,571,N/A,41,3
8,N/A,N/A,N/A,554,562,N/A,46,2
8,N/A,N/A,N/A,546,554,N/A,52,2
8,N/A,N/A,N/A,538,546,N/A,57,1
5,N/A,N/A,N/A,533,538,N/A,63,1
9,N/A,N/A,N/A,524,533,N/A,69,1
17,N/A,N/A,N/A,507,524,N/A,72,4
21,N/A,N/A,N/A,486,507,N/A,78,4
10,N/A,N/A,N/A,476,486,N/A,84,4
8,N/A,N/A,N/A,468,476,N/A,88,2
47,N/A,N/A,N/A,421,468,N/A,91,5
35,N/A,N/A,N/A,386,421,N/A,97,5
25,N/A,N/A,N/A,361,386,N/A,102,4
9,N/A,N/A,N/A,352,361,N/A,107,3
7,N/A,N/A,N/A,345,352,N/A,113,3
28,N/A,N/A,N/A,317,345,N/A,116,6
8,N/A,N/A,N/A,309,317,N/A,122,0
19,N/A,N/A,N/A,290,309,N/A,126,4
9,N/A,N/A,N/A,281,290,N/A,129,1
45,N/A,N/A,N/A,236,281,N/A,134,6
28,N/A,N/A,N/A,208,236,N/A,138,4
12,N/A,N/A,N/A,1740,1752,N/A,4,4
8,N/A,N/A,N/A,1732,1740,N/A,8,2
40,N/A,N/A,N/A,1692,1732,N/A,11,5
16,N/A,N/A,N/A,1676,1692,N/A,16,4
9,N/A,N/A,N/A,1667,1676,N/A,21,3
10,N/A,N/A,N/A,1657,1667,N/A,26,2
25,N/A,N/A,N/A,1632,1657,N/A,30,6
14,N/A,N/A,N/A,1618,1632,N/A,34,4
29,N/A,N/A,N/A,1589,1618,N/A,40,4
10,N/A,N/A,N/A,1579,1589,N/A,44,2
8,N/A,N/A,N/A,1571,1579,N/A,50,2
8,N/A,N/A,N/A,1563,1571,N/A,56,2
8,N/A,N/A,N/A,1555,1563,N/A,62,2
42,N/A,N/A,N/A,1513,1555,N/A,66,6
11,N/A,N/A,N/A,1502,1513,N/A,69,3
10,N/A,N/A,N/A,1492,1502,N/A,75,3
6,N/A,N/A,N/A,1486,1492,N/A,79,1
6,N/A,N/A,N/A,1480,1486,N/A,85,1
20,N/A,N/A,N/A,1460,1480,N/A,88,4
5,N/A,N/A,N/A,1455,1460,N/A,91,1
46,N/A,N/A,N/A,1409,1455,N/A,96,6
6,N/A,N/A,N/A,1403,1409,N/A,102,0
16,N/A,N/A,N/A,1387,1403,N/A,106,4
7,N/A,N/A,N/A,1380,1387,N/A,110,2
5,N/A,N/A,N/A,1375,1380,N/A,115,1
46,N/A,N/A,N/A,1329,1375,N/A,120,6
38,N/A,N/A,N/A,1291,1329,N/A,125,5
8,N/A,N/A,N/A,1283,1291,N/A,129,3
11,N/A,N/A,N/A,1272,1283,N/A,135,3
5,N/A,N/A,N/A,1267,1272,N/A,139,1
5,N/A,N/A,N/A,793,798,N/A,6,1
24,N/A,N/A,N/A,769,793,N/A,9,4
8,N/A,N/A,N/A,761,769,N/A,14,3
9,N/A,N/A,N/A,752,761,N/A,18,1
40,N/A,N/A,N/A,712,752,N/A,22,5
35,N/A,N/A,N/A,677,712,N/A,28,5
48,N/A,N/A,N/A,629,677,N/A,34,5
10,N/A,N/A,N/A,619,629,N/A,38,3
10,N/A,N/A,N/A,609,619,N/A,44,3
45,N/A,N/A,N/A,564,609,N/A,47,6
10,N/A,N/A,N/A,554,564,N/A,50,3
33,N/A,N/A,N/A,521,554,N/A,53,6
9,N/A,N/A,N/A,512,521,N/A,59,0
7,N/A,N/A,N/A,505,512,N/A,62,3
11,N/A,N/A,N/A,494,505,N/A,67,2
44,N/A,N/A,N/A,450,494,N/A,70,5
41,N/A,N/A,N/A,409,450,N/A,76,5
11,N/A,N/A,N/A,398,409,N/A,79,2
6,N/A,N/A,N/A,392,398,N/A,84,1
35,N/A,N/A,N/A,357,392,N/A,89,6
7,N/A,N/A,N/A,350,357,N/A,92,3
11,N/A,N/A,N/A,339,350,N/A,98,3
7,N/A,N/A,N/A,332,339,N/A,103,2
9,N/A,N/A,N/A,323,332,N/A,109,2
48,N/A,N/A,N/A,275,323,N/A,113,6
9,N/A,N/A,N/A,266,275,N/A,116,3
9,N/A,N/A,N/A,257,266,N/A,120,1
26,N/A,N/A,N/A,231,257,N/A,125,6
8,N/A,N/A,N/A,223,231,N/A,131,0
42,N/A,N/A,N/A,181,223,N/A,136,5
24,N/A,N/A,N/A,624,648,N/A,5,4
17,N/A,N/A,N/A,607,624,N/A,11,4
8,N/A,N/A,N/A,599,607,N/A,15,2
9,N/A,N/A,N/A,590,599,N/A,20,1
8,N/A,N/A,N/A,582,590,N/A,26,1
23,N/A,N/A,N/A,559,582,N/A,29,4
11,N/A,N/A,N/A,548,559,N/A,34,3
10,N/A,N/A,N/A,538,548,N/A,40,3
11,N/A,N/A,N/A,527,538,N/A,46,3
7,N/A,N/A,N/A,520,527,N/A,50,1
45,N/A,N/A,N/A,475,520,N/A,55,6
8,N/A,N/A,N/A,467,475,N/A,61,0
28,N/A,N/A,N/A,439,467,N/A,67,6
7,N/A,N/A,N/A,432,439,N/A,70,3
28,N/A,N/A,N/A,404,432,N/A,73,6
42,N/A,N/A,N/A,362,404,N/A,78,5
46,N/A,N/A,N/A,316,362,N/A,84,5
7,N/A,N/A,N/A,309,316,N/A,87,2
7,N/A,N/A,N/A,302,309,N/A,93,2
47,N/A,N/A,N/A,255,302,N/A,97,6
8,N/A,N/A,N/A,247,255,N/A,103,0
23,N/A,N/A,N/A,224,247,N/A,107,4
11,N/A,N/A,N/A,213,224,N/A,112,3
11,N/A,N/A,N/A,202,213,N/A,117,2
5,N/A,N/A,N/A,197,202,N/A,122,1
25,N/A,N/A,N/A,172,197,N/A,126,5
11,N/A,N/A,N/A,161,172,N/A,129,2
38,N/A,N/A,N/A,123,161,N/A,133,6
12,N/A,N/A,N/A,111,123,N/A,137,4
11,N/A,N/A,N/A,100,111,N/A,141,2
27,N/A,N/A,N/A,430,457,N/A,3,5
9,N/A,N/A,N/A,421,430,N/A,6,2
7,N/A,N/A,N/A,414,421,N/A,12,2
7,N/A,N/A,N/A,407,414,N/A,18,2
8,N/A,N/A,N/A,399,407,N/A,23,1
29,N/A,N/A,N/A,370,399,N/A,28,6
6,N/A,N/A,N/A,364,370,N/A,34,0
12,N/A,N/A,N/A,352,364,N/A,38,4
5,N/A,N/A,N/A,347,352,N/A,41,1
37,N/A,N/A,N/A,310,347,N/A,45,5
7,N/A,N/A,N/A,303,310,N/A,48,2
42,N/A,N/A,N/A,261,303,N/A,52,6
15,N/A,N/A,N/A,246,261,N/A,56,4
16,N/A,N/A,N/A,230,246,N/A,62,4
7,N/A,N/A,N/A,223,230,N/A,65,1
36,N/A,N/A,N/A,187,223,N/A,70,6
37,N/A,N/A,N/A,150,187,N/A,75,5
10,N/A,N/A,N/A,140,150,N/A,78,2
6,N/A,N/A,N/A,134,140,N/A,83,1
9,N/A,N/A,N/A,125,134,N/A,89,1
28,N/A,N/A,N/A,97,125,N/A,93,5
42,N/A,N/A,N/A,55,97,N/A,99,5
7,N/A,N/A,N/A,48,55,N/A,102,2
40,N/A,N/A,N/A,8,48,N/A,105,5
9,N/A,N/A,N/A,-1,8,N/A,109,3
9,N/A,N/A,N/A,452,461,N/A,6,3
10,N/A,N/A,N/A,442,452,N/A,12,3
9,N/A,N/A,N/A,433,442,N/A,17,2
31,N/A,N/A,N/A,402,433,N/A,21,6
23,N/A,N/A,N/A,379,402,N/A,25,4
13,N/A,N/A,N/A,366,379,N/A,31,4
6,N/A,N/A,N/A,360,366,N/A,34,1
36,N/A,N/A,N/A,324,360,N/A,39,6
9,N/A,N/A,N/A,315,324,N/A,42,3
9,N/A,N/A,N/A,306,315,N/A,46,1
7,N/A,N/A,N/A,299,306,N/A,52,1
28,N/A,N/A,N/A,271,299,N/A,56,5
29,N/A,N/A,N/A,242,271,N/A,61,4
8,N/A,N/A,N/A,234,242,N/A,64,1
22,N/A,N/A,N/A,212,234,N/A,67,4
12,N/A,N/A,N/A,200,212,N/A,73,4
15,N/A,N/A,N/A,185,200,N/A,79,4
7,N/A,N/A,N/A,178,185,N/A,82,1
29,N/A,N/A,N/A,149,178,N/A,87,6
19,N/A,N/A,N/A,130,149,N/A,91,4
11,N/A,N/A,N/A,119,130,N/A,95,2
30,N/A,N/A,N/A,89,119,N/A,98,5
47,N/A,N/A,N/A,42,89,N/A,104,5
7,N/A,N/A,N/A,35,42,N/A,108,3
33,N/A,N/A,N/A,2,35,N/A,111,6
9,N/A,N/A,N/A,-7,2,N/A,114,3
8,N/A,N/A,N/A,1719,1727,N/A,6,3
10,N/A,N/A,N/A,1709,1719,N/A,12,3
10,N/A,N/A,N/A,1699,1709,N/A,18,3
28,N/A,N/A,N/A,1671,1699,N/A,21,6
8,N/A,N/A,N/A,1663,1671,N/A,24,3
8,N/A,N/A,N/A,1655,1663,N/A,29,2
8,N/A,N/A,N/A,1647,1655,N/A,34,1
21,N/A,N/A,N/A,1626,1647,N/A,37,4
7,N/A,N/A,N/A,1619,1626,N/A,40,1
29,N/A,N/A,N/A,1590,1619,N/A,43,4
7,N/A,N/A,N/A,1583,1590,N/A,46,1
49,N/A,N/A,N/A,1534,1583,N/A,51,6
6,N/A,N/A,N/A,1528,1534,N/A,57,0
26,N/A,N/A,N/A,1502,1528,N/A,61,4
5,N/A,N/A,N/A,1497,1502,N/A,64,1
44,N/A,N/A,N/A,1453,1497,N/A,68,5
28,N/A,N/A,N/A,1425,1453,N/A,73,4
9,N/A,N/A,N/A,1416,1425,N/A,77,2
9,N/A,N/A,N/A,1407,1416,N/A,83,2
11,N/A,N/A,N/A,1396,1407,N/A,89,2
32,N/A,N/A,N/A,1364,1396,N/A,93,6
9,N/A,N/A,N/A,1355,1364,N/A,96,3
29,N/A,N/A,N/A,1326,1355,N/A,99,6
9,N/A,N/A,N/A,1317,1326,N/A,105,0
25,N/A,N/A,N/A,1292,1317,N/A,111,6
13,N/A,N/A,N/A,1279,1292,N/A,115,4
9,N/A,N/A,N/A,1270,1279,N/A,120,3
10,N/A,N/A,N/A,1260,1270,N/A,126,3
6,N/A,N/A,N/A,1254,1260,N/A,130,1
5,N/A,N/A,N/A,1249,1254,N/A,136,1
16,N/A,N/A,N/A,721,737,N/A,4,4
9,N/A,N/A,N/A,712,721,N/A,9,3
25,N/A,N/A,N/A,687,712,N/A,12,6
5,N/A,N/A,N/A,682,687,N/A,18,0
31,N/A,N/A,N/A,651,682,N/A,23,5
23,N/A,N/A,N/A,628,651,N/A,28,4
10,N/A,N/A,N/A,618,628,N/A,33,3
10,N/A,N/A,N/A,608,618,N/A,39,3
40,N/A,N/A,N/A,568,608,N/A,42,6
27,N/A,N/A,N/A,541,568,N/A,46,4
5,N/A,N/A,N/A,536,541,N/A,49,1
29,N/A,N/A,N/A,507,536,N/A,53,5
8,N/A,N/A,N/A,499,507,N/A,57,3
8,N/A,N/A,N/A,491,499,N/A,61,1
6,N/A,N/A,N/A,485,491,N/A,67,1
13,N/A,N/A,N/A,472,485,N/A,70,4
11,N/A,N/A,N/A,461,472,N/A,75,3
29,N/A,N/A,N/A,432,461,N/A,78,6
21,N/A,N/A,N/A,411,432,N/A,82,4
19,N/A,N/A,N/A,392,411,N/A,88,4
7,N/A,N/A,N/A,385,392,N/A,93,3
28,N/A,N/A,N/A,357,385,N/A,96,6
25,N/A,N/A,N/A,332,357,N/A,100,4
10,N/A,N/A,N/A,322,332,N/A,104,2
11,N/A,N/A,N/A,311,322,N/A,110,2
40,N/A,N/A,N/A,271,311,N/A,113,5
29,N/A,N/A,N/A,242,271,N/A,118,4
7,N/A,N/A,N/A,235,242,N/A,123,3
34,N/A,N/A,N/A,201,235,N/A,126,6
29,N/A,N/A,N/A,172,201,N/A,130,4
38,N/A,N/A,N/A,1655,1693,N/A,4,5
7,N/A,N/A,N/A,1648,1655,N/A,7,2
35,N/A,N/A,N/A,1613,1648,N/A,10,5
13,N/A,N/A,N/A,1600,1613,N/A,15,4
7,N/A,N/A,N/A,1593,1600,N/A,19,2
6,N/A,N/A,N/A,1587,1593,N/A,24,1
6,N/A,N/A,N/A,1581,1587,N/A,30,1
26,N/A,N/A,N/A,1555,1581,N/A,34,5
7,N/A,N/A,N/A,1548,1555,N/A,37,2
30,N/A,N/A,N/A,1518,1548,N/A,40,5
11,N/A,N/A,N/A,1507,1518,N/A,44,3
7,N/A,N/A,N/A,1500,1507,N/A,48,1
27,N/A,N/A,N/A,1473,1500,N/A,51,4
14,N/A,N/A,N/A,1459,1473,N/A,57,4
18,N/A,N/A,N/A,1441,1459,N/A,63,4
9,N/A,N/A,N/A,1432,1441,N/A,68,3
11,N/A,N/A,N/A,1421,1432,N/A,73,2
11,N/A,N/A,N/A,1410,1421,N/A,79,2
43,N/A,N/A,N/A,1367,1410,N/A,82,5
25,N/A,N/A,N/A,1342,1367,N/A,88,5
27,N/A,N/A,N/A,1315,1342,N/A,94,5
13,N/A,N/A,N/A,1302,1315,N/A,99,4
28,N/A,N/A,N/A,1274,1302,N/A,105,4
25,N/A,N/A,N/A,1249,1274,N/A,111,4
23,N/A,N/A,N/A,1226,1249,N/A,117,4
11,N/A,N/A,N/A,1215,1226,N/A,121,2
11,N/A,N/A,N/A,1204,1215,N/A,127,2
45,N/A,N/A,N/A,1159,1204,N/A,131,6
46,N/A,N/A,N/A,1113,1159,N/A,136,5
7,N/A,N/A,N/A,1106,1113,N/A,139,2
42,N/A,N/A,N/A,563,605,N/A,3,6
10,N/A,N/A,N/A,553,563,N/A,6,3
9,N/A,N/A,N/A,544,553,N/A,12,3
10,N/A,N/A,N/A,534,544,N/A,18,3
8,N/A,N/A,N/A,526,534,N/A,23,2
7,N/A,N/A,N/A,519,526,N/A,28,1
11,N/A,N/A,N/A,508,519,N/A,31,4
17,N/A,N/A,N/A,491,508,N/A,37,4
8,N/A,N/A,N/A,483,491,N/A,41,2
8,N/A,N/A,N/A,475,483,N/A,47,2
45,N/A,N/A,N/A,430,475,N/A,50,5
48,N/A,N/A,N/A,382,430,N/A,56,5
13,N/A,N/A,N/A,369,382,N/A,61,4
9,N/A,N/A,N/A,360,369,N/A,64,1
39,N/A,N/A,N/A,321,360,N/A,68,5
9,N/A,N/A,N/A,312,321,N/A,72,3
5,N/A,N/A,N/A,307,312,N/A,76,1
39,N/A,N/A,N/A,268,307,N/A,80,5
11,N/A,N/A,N/A,257,268,N/A,84,3
33,N/A,N/A,N/A,224,257,N/A,87,6
5,N/A,N/A,N/A,219,224,N/A,93,0
36,N/A,N/A,N/A,183,219,N/A,98,5
9,N/A,N/A,N/A,174,183,N/A,102,3
7,N/A,N/A,N/A,167,174,N/A,107,2
40,N/A,N/A,N/A,127,167,N/A,110,5
8,N/A,N/A,N/A,119,127,N/A,114,3
9,N/A,N/A,N/A,110,119,N/A,119,2
48,N/A,N/A,N/A,62,110,N/A,122,5
8,N/A,N/A,N/A,54,62,N/A,125,2
30,N/A,N/A,N/A,24,54,N/A,128,5
6,N/A,N/A,N/A,1723,1729,N/A,6,1
6,N/A,N/A,N/A,1717,1723,N/A,12,1
18,N/A,N/A,N/A,1699,1717,N/A,15,4
5,N/A,N/A,N/A,1694,1699,N/A,18,1
28,N/A,N/A,N/A,1666,1694,N/A,23,6
8,N/A,N/A,N/A,1658,1666,N/A,26,3
5,N/A,N/A,N/A,1653,1658,N/A,30,1
7,N/A,N/A,N/A,1646,1653,N/A,36,1
12,N/A,N/A,N/A,1634,1646,N/A,39,4
8,N/A,N/A,N/A,1626,1634,N/A,44,3
39,N/A,N/A,N/A,1587,1626,N/A,47,6
10,N/A,N/A,N/A,1577,1587,N/A,50,3
11,N/A,N/A,N/A,1566,1577,N/A,55,2
11,N/A,N/A,N/A,1555,1566,N/A,61,2
10,N/A,N/A,N/A,1545,1555,N/A,67,2
10,N/A,N/A,N/A,1535,1545,N/A,73,2
5,N/A,N/A,N/A,1530,1535,N/A,78,1
5,N/A,N/A,N/A,1525,1530,N/A,84,1
27,N/A,N/A,N/A,1498,1525,N/A,89,6
7,N/A,N/A,N/A,1491,1498,N/A,95,0
19,N/A,N/A,N/A,1472,1491,N/A,99,4
7,N/A,N/A,N/A,1465,1472,N/A,104,3
6,N/A,N/A,N/A,1459,1465,N/A,108,1
49,N/A,N/A,N/A,1410,1459,N/A,113,6
6,N/A,N/A,N/A,1404,1410,N/A,119,0
44,N/A,N/A,N/A,1360,1404,N/A,125,6
30,N/A,N/A,N/A,1330,1360,N/A,130,5
7,N/A,N/A,N/A,1323,1330,N/A,133,2
34,N/A,N/A,N/A,1289,1323,N/A,136,5
10,N/A,N/A,N/A,1279,1289,N/A,140,3
24,N/A,N/A,N/A,905,929,N/A,3,4
8,N/A,N/A,N/A,897,905,N/A,6,1
46,N/A,N/A,N/A,851,897,N/A,11,6
27,N/A,N/A,N/A,824,851,N/A,15,4
10,N/A,N/A,N/A,814,824,N/A,20,3
7,N/A,N/A,N/A,807,814,N/A,26,3
8,N/A,N/A,N/A,799,807,N/A,30,1
26,N/A,N/A,N/A,773,799,N/A,33,4
20,N/A,N/A,N/A,753,773,N/A,39,4
8,N/A,N/A,N/A,745,753,N/A,42,1
8,N/A,N/A,N/A,737,745,N/A,48,1
29,N/A,N/A,N/A,708,737,N/A,51,4
9,N/A,N/A,N/A,699,708,N/A,54,1
5,N/A,N/A,N/A,694,699,N/A,60,1
30,N/A,N/A,N/A,664,694,N/A,65,6
8,N/A,N/A,N/A,656,664,N/A,71,0
28,N/A,N/A,N/A,628,656,N/A,75,4
7,N/A,N/A,N/A,621,628,N/A,80,3
5,N/A,N/A,N/A,616,621,N/A,84,1
6,N/A,N/A,N/A,610,616,N/A,90,1
13,N/A,N/A,N/A,597,610,N/A,93,4
5,N/A,N/A,N/A,592,597,N/A,96,1
41,N/A,N/A,N/A,551,592,N/A,100,5
9,N/A,N/A,N/A,542,551,N/A,104,3
7,N/A,N/A,N/A,535,542,N/A,109,2
43,N/A,N/A,N/A,492,535,N/A,113,6
33,N/A,N/A,N/A,459,492,N/A,118,5
11,N/A,N/A,N/A,448,459,N/A,121,2
9,N/A,N/A,N/A,439,448,N/A,126,1
5,N/A,N/A,N/A,434,439,N/A,132,1
8,N/A,N/A,N/A,1882,1890,N/A,5,1
8,N/A,N/A,N/A,1874,1882,N/A,11,1
8,N/A,N/A,N/A,1866,1874,N/A,17,1
19,N/A,N/A,N/A,1847,1866,N/A,20,4
9,N/A,N/A,N/A,1838,1847,N/A,24,2
8,N/A,N/A,N/A,1830,1838,N/A,30,2
33,N/A,N/A,N/A,1797,1830,N/A,34,6
7,N/A,N/A,N/A,1790,1797,N/A,37,3
5,N/A,N/A,N/A,1785,1790,N/A,41,1
25,N/A,N/A,N/A,1760,1785,N/A,44,4
7,N/A,N/A,N/A,1753,1760,N/A,48,2
8,N/A,N/A,N/A,1745,1753,N/A,53,1
42,N/A,N/A,N/A,1703,1745,N/A,57,5
28,N/A,N/A,N/A,1675,1703,N/A,63,5
9,N/A,N/A,N/A,1666,1675,N/A,67,3
11,N/A,N/A,N/A,1655,1666,N/A,73,3
42,N/A,N/A,N/A,1613,1655,N/A,76,6
14,N/A,N/A,N/A,1599,1613,N/A,80,4
9,N/A,N/A,N/A,1590,1599,N/A,84,2
39,N/A,N/A,N/A,1551,1590,N/A,87,5
8,N/A,N/A,N/A,1543,1551,N/A,91,3
9,N/A,N/A,N/A,1534,1543,N/A,96,2
7,N/A,N/A,N/A,1527,1534,N/A,101,1
45,N/A,N/A,N/A,1482,1527,N/A,105,5
11,N/A,N/A,N/A,1471,1482,N/A,108,2
9,N/A,N/A,N/A,1462,1471,N/A,113,1
46,N/A,N/A,N/A,1416,1462,N/A,117,5
11,N/A,N/A,N/A,1405,1416,N/A,121,3
7,N/A,N/A,N/A,1398,1405,N/A,126,2
5,N/A,N/A,N/A,1393,1398,N/A,131,1
8,N/A,N/A,N/A,1258,1266,N/A,6,1
5,N/A,N/A,N/A,1253,1258,N/A,12,1
37,N/A,N/A,N/A,1216,1253,N/A,16,5
13,N/A,N/A,N/A,1203,1216,N/A,21,4
8,N/A,N/A,N/A,1195,1203,N/A,26,3
10,N/A,N/A,N/A,1185,1195,N/A,31,2
11,N/A,N/A,N/A,1174,1185,N/A,37,2
26,N/A,N/A,N/A,1148,1174,N/A,41,6
36,N/A,N/A,N/A,1112,1148,N/A,46,5
28,N/A,N/A,N/A,1084,1112,N/A,51,4
6,N/A,N/A,N/A,1078,1084,N/A,54,1
36,N/A,N/A,N/A,1042,1078,N/A,59,6
8,N/A,N/A,N/A,1034,1042,N/A,62,3
10,N/A,N/A,N/A,1024,1034,N/A,67,2
10,N/A,N/A,N/A,1014,1024,N/A,73,2
34,N/A,N/A,N/A,980,1014,N/A,77,6
8,N/A,N/A,N/A,972,980,N/A,80,3
9,N/A,N/A,N/A,963,972,N/A,85,2
29,N/A,N/A,N/A,934,963,N/A,89,6
9,N/A,N/A,N/A,925,934,N/A,92,3
6,N/A,N/A,N/A,919,925,N/A,96,1
5,N/A,N/A,N/A,914,919,N/A,102,1
47,N/A,N/A,N/A,867,914,N/A,107,6
15,N/A,N/A,N/A,852,867,N/A,111,4
5,N/A,N/A,N/A,847,852,N/A,114,1
34,N/A,N/A,N/A,813,847,N/A,118,5
42,N/A,N/A,N/A,771,813,N/A,124,5
11,N/A,N/A,N/A,760,771,N/A,127,2
33,N/A,N/A,N/A,727,760,N/A,130,5
8,N/A,N/A,N/A,719,727,N/A,134,3
9,N/A,N/A,N/A,1697,1706,N/A,4,1
38,N/A,N/A,N/A,1659,1697,N/A,8,5
49,N/A,N/A,N/A,1610,1659,N/A,14,5
11,N/A,N/A,N/A,1599,1610,N/A,17,2
9,N/A,N/A,N/A,1590,1599,N/A,23,2
44,N/A,N/A,N/A,1546,1590,N/A,26,5
38,N/A,N/A,N/A,1508,1546,N/A,32,5
16,N/A,N/A,N/A,1492,1508,N/A,37,4
7,N/A,N/A,N/A,1485,1492,N/A,41,2
30,N/A,N/A,N/A,1455,1485,N/A,44,5
9,N/A,N/A,N/A,1446,1455,N/A,48,3
7,N/A,N/A,N/A,1439,1446,N/A,53,2
6,N/A,N/A,N/A,1433,1439,N/A,58,1
33,N/A,N/A,N/A,1400,1433,N/A,62,5
19,N/A,N/A,N/A,1381,1400,N/A,67,4
8,N/A,N/A,N/A,1373,1381,N/A,72,3
11,N/A,N/A,N/A,1362,1373,N/A,78,3
6,N/A,N/A,N/A,1356,1362,N/A,82,1
34,N/A,N/A,N/A,1322,1356,N/A,86,5
20,N/A,N/A,N/A,1302,1322,N/A,91,4
11,N/A,N/A,N/A,1291,1302,N/A,96,3
36,N/A,N/A,N/A,1255,1291,N/A,99,6
10,N/A,N/A,N/A,1245,1255,N/A,102,3
11,N/A,N/A,N/A,1234,1245,N/A,108,3
9,N/A,N/A,N/A,1225,1234,N/A,114,3
10,N/A,N/A,N/A,1215,1225,N/A,120,3
31,N/A,N/A,N/A,1184,1215,N/A,123,6
29,N/A,N/A,N/A,1155,1184,N/A,127,4
9,N/A,N/A,N/A,1146,1155,N/A,132,3
7,N/A,N/A,N/A,1139,1146,N/A,136,1
16,N/A,N/A,N/A,564,580,N/A,4,4
9,N/A,N/A,N/A,555,564,N/A,9,3
10,N/A,N/A,N/A,545,555,N/A,15,3
7,N/A,N/A,N/A,538,545,N/A,20,2
6,N/A,N/A,N/A,532,538,N/A,25,1
24,N/A,N/A,N/A,508,532,N/A,28,4
6,N/A,N/A,N/A,502,508,N/A,31,1
27,N/A,N/A,N/A,475,502,N/A,34,4
8,N/A,N/A,N/A,467,475,N/A,38,2
49,N/A,N/A,N/A,418,467,N/A,42,6
11,N/A,N/A,N/A,407,418,N/A,46,4
7,N/A,N/A,N/A,400,407,N/A,51,3
7,N/A,N/A,N/A,393,400,N/A,57,3
8,N/A,N/A,N/A,385,393,N/A,62,2
10,N/A,N/A,N/A,375,385,N/A,68,2
8,N/A,N/A,N/A,367,375,N/A,74,2
10,N/A,N/A,N/A,357,367,N/A,80,2
42,N/A,N/A,N/A,315,357,N/A,83,5
15,N/A,N/A,N/A,300,315,N/A,88,4
11,N/A,N/A,N/A,289,300,N/A,93,3
9,N/A,N/A,N/A,280,289,N/A,98,2
7,N/A,N/A,N/A,273,280,N/A,104,2
8,N/A,N/A,N/A,265,273,N/A,110,2
25,N/A,N/A,N/A,240,265,N/A,114,6
8,N/A,N/A,N/A,232,240,N/A,120,0
42,N/A,N/A,N/A,190,232,N/A,126,6
9,N/A,N/A,N/A,181,190,N/A,132,0
43,N/A,N/A,N/A,138,181,N/A,138,6
9,N/A,N/A,N/A,129,138,N/A,141,3
38,N/A,N/A,N/A,91,129,N/A,144,6
14,N/A,N/A,N/A,1720,1734,N/A,6,4
17,N/A,N/A,N/A,1703,1720,N/A,12,4
7,N/A,N/A,N/A,1696,1703,N/A,17,3
10,N/A,N/A,N/A,1686,1696,N/A,22,2
39,N/A,N/A,N/A,1647,1686,N/A,26,6
37,N/A,N/A,N/A,1610,1647,N/A,31,5
9,N/A,N/A,N/A,1601,1610,N/A,34,2
26,N/A,N/A,N/A,1575,1601,N/A,38,6
7,N/A,N/A,N/A,1568,1575,N/A,41,3
9,N/A,N/A,N/A,1559,1568,N/A,47,3
41,N/A,N/A,N/A,1518,1559,N/A,50,6
45,N/A,N/A,N/A,1473,1518,N/A,55,5
46,N/A,N/A,N/A,1427,1473,N/A,61,5
26,N/A,N/A,N/A,1401,1427,N/A,66,4
23,N/A,N/A,N/A,1378,1401,N/A,72,4
11,N/A,N/A,N/A,1367,1378,N/A,77,3
49,N/A,N/A,N/A,1318,1367,N/A,80,6
16,N/A,N/A,N/A,1302,1318,N/A,84,4
23,N/A,N/A,N/A,1279,1302,N/A,90,4
18,N/A,N/A,N/A,1261,1279,N/A,96,4
20,N/A,N/A,N/A,1241,1261,N/A,102,4
8,N/A,N/A,N/A,1233,1241,N/A,107,3
40,N/A,N/A,N/A,1193,1233,N/A,110,6
46,N/A,N/A,N/A,1147,1193,N/A,115,5
7,N/A,N/A,N/A,1140,1147,N/A,118,2
44,N/A,N/A,N/A,1096,1140,N/A,122,6
8,N/A,N/A,N/A,1088,1096,N/A,128,0
44,N/A,N/A,N/A,1044,1088,N/A,133,5
44,N/A,N/A,N/A,1000,1044,N/A,139,5
27,N/A,N/A,N/A,973,1000,N/A,144,4
26,N/A,N/A,N/A,609,635,N/A,3,5
10,N/A,N/A,N/A,599,609,N/A,6,2
26,N/A,N/A,N/A,573,599,N/A,9,5
9,N/A,N/A,N/A,564,573,N/A,13,3
42,N/A,N/A,N/A,522,564,N/A,16,6
25,N/A,N/A,N/A,497,522,N/A,21,5
29,N/A,N/A,N/A,468,497,N/A,26,4
9,N/A,N/A,N/A,459,468,N/A,31,3
7,N/A,N/A,N/A,452,459,N/A,35,1
40,N/A,N/A,N/A,412,452,N/A,40,6
8,N/A,N/A,N/A,404,412,N/A,43,3
7,N/A,N/A,N/A,397,404,N/A,49,3
26,N/A,N/A,N/A,371,397,N/A,52,6
8,N/A,N/A,N/A,363,371,N/A,58,0
21,N/A,N/A,N/A,342,363,N/A,62,4
7,N/A,N/A,N/A,335,342,N/A,66,2
48,N/A,N/A,N/A,287,335,N/A,69,5
11,N/A,N/A,N/A,276,287,N/A,72,2
32,N/A,N/A,N/A,244,276,N/A,76,6
9,N/A,N/A,N/A,235,244,N/A,79,3
8,N/A,N/A,N/A,227,235,N/A,84,2
9,N/A,N/A,N/A,218,227,N/A,90,2
8,N/A,N/A,N/A,210,218,N/A,95,1
44,N/A,N/A,N/A,166,210,N/A,100,6
8,N/A,N/A,N/A,158,166,N/A,103,3
10,N/A,N/A,N/A,148,158,N/A,109,3
9,N/A,N/A,N/A,139,148,N/A,115,3
7,N/A,N/A,N/A,132,139,N/A,119,1
9,N/A,N/A,N/A,123,132,N/A,125,1
6,N/A,N/A,N/A,117,123,N/A,131,1
26,N/A,N/A,N/A,1584,1610,N/A,5,6
11,N/A,N/A,N/A,1573,1584,N/A,8,3
38,N/A,N/A,N/A,1535,1573,N/A,11,6
8,N/A,N/A,N/A,1527,1535,N/A,14,3
8,N/A,N/A,N/A,1519,1527,N/A,18,1
7,N/A,N/A,N/A,1512,1519,N/A,24,1
6,N/A,N/A,N/A,1506,1512,N/A,30,1
36,N/A,N/A,N/A,1470,1506,N/A,35,6
22,N/A,N/A,N/A,1448,1470,N/A,39,4
14,N/A,N/A,N/A,1434,1448,N/A,45,4
10,N/A,N/A,N/A,1424,1434,N/A,49,2
10,N/A,N/A,N/A,1414,1424,N/A,55,2
48,N/A,N/A,N/A,1366,1414,N/A,58,5
8,N/A,N/A,N/A,1358,1366,N/A,62,3
11,N/A,N/A,N/A,1347,1358,N/A,67,2
6,N/A,N/A,N/A,1341,1347,N/A,72,1
10,N/A,N/A,N/A,1331,1341,N/A,75,4
26,N/A,N/A,N/A,1305,1331,N/A,81,4
10,N/A,N/A,N/A,1295,1305,N/A,85,2
38,N/A,N/A,N/A,1257,1295,N/A,89,6
19,N/A,N/A,N/A,1238,1257,N/A,93,4
10,N/A,N/A,N/A,1228,1238,N/A,98,3
10,N/A,N/A,N/A,1218,1228,N/A,104,3
43,N/A,N/A,N/A,1175,1218,N/A,107,6
7,N/A,N/A,N/A,1168,1175,N/A,110,3
5,N/A,N/A,N/A,1163,1168,N/A,114,1
19,N/A,N/A,N/A,1144,1163,N/A,117,4
8,N/A,N/A,N/A,1136,1144,N/A,120,1
43,N/A,N/A,N/A,1093,1136,N/A,124,5
41,N/A,N/A,N/A,1052,1093,N/A,130,5
40,N/A,N/A,N/A,554,594,N/A,4,6
11,N/A,N/A,N/A,543,554,N/A,7,3
7,N/A,N/A,N/A,536,543,N/A,13,3
11,N/A,N/A,N/A,525,536,N/A,19,3
7,N/A,N/A,N/A,518,525,N/A,25,3
8,N/A,N/A,N/A,510,518,N/A,29,1
27,N/A,N/A,N/A,483,510,N/A,32,4
9,N/A,N/A,N/A,474,483,N/A,37,3
48,N/A,N/A,N/A,426,474,N/A,40,6
19,N/A,N/A,N/A,407,426,N/A,44,4
24,N/A,N/A,N/A,383,407,N/A,50,4
21,N/A,N/A,N/A,362,383,N/A,56,4
10,N/A,N/A,N/A,352,362,N/A,60,2
38,N/A,N/A,N/A,314,352,N/A,64,6
34,N/A,N/A,N/A,280,314,N/A,69,5
46,N/A,N/A,N/A,234,280,N/A,75,5
10,N/A,N/A,N/A,224,234,N/A,78,2
25,N/A,N/A,N/A,199,224,N/A,81,5
7,N/A,N/A,N/A,192,199,N/A,84,2
48,N/A,N/A,N/A,144,192,N/A,87,5
11,N/A,N/A,N/A,133,144,N/A,91,3
5,N/A,N/A,N/A,128,133,N/A,95,1
7,N/A,N/A,N/A,121,128,N/A,101,1
6,N/A,N/A,N/A,115,121,N/A,107,1
26,N/A,N/A,N/A,89,115,N/A,112,6
11,N/A,N/A,N/A,78,89,N/A,116,4
9,N/A,N/A,N/A,69,78,N/A,121,3
10,N/A,N/A,N/A,59,69,N/A,127,3
28,N/A,N/A,N/A,31,59,N/A,130,6
37,N/A,N/A,N/A,-6,31,N/A,135,5
11,N/A,N/A,N/A,1398,1409,N/A,4,2
9,N/A,N/A,N/A,1389,1398,N/A,10,2
28,N/A,N/A,N/A,1361,1389,N/A,13,5
28,N/A,N/A,N/A,1333,1361,N/A,18,4
7,N/A,N/A,N/A,1326,1333,N/A,22,2
32,N/A,N/A,N/A,1294,1326,N/A,25,5
7,N/A,N/A,N/A,1287,1294,N/A,29,3
8,N/A,N/A,N/A,1279,1287,N/A,35,3
9,N/A,N/A,N/A,1270,1279,N/A,41,3
11,N/A,N/A,N/A,1259,1270,N/A,46,2
8,N/A,N/A,N/A,1251,1259,N/A,51,1
39,N/A,N/A,N/A,1212,1251,N/A,56,6
49,N/A,N/A,N/A,1163,1212,N/A,61,5
9,N/A,N/A,N/A,1154,1163,N/A,65,3
9,N/A,N/A,N/A,1145,1154,N/A,70,2
47,N/A,N/A,N/A,1098,1145,N/A,74,6
49,N/A,N/A,N/A,1049,1098,N/A,79,5
8,N/A,N/A,N/A,1041,1049,N/A,82,2
9,N/A,N/A,N/A,1032,1041,N/A,88,2
7,N/A,N/A,N/A,1025,1032,N/A,93,1
39,N/A,N/A,N/A,986,1025,N/A,97,5
39,N/A,N/A,N/A,947,986,N/A,103,5
7,N/A,N/A,N/A,940,947,N/A,107,3
5,N/A,N/A,N/A,935,940,N/A,111,1
6,N/A,N/A,N/A,929,935,N/A,117,1
20,N/A,N/A,N/A,909,929,N/A,120,4
14,N/A,N/A,N/A,895,909,N/A,126,4
8,N/A,N/A,N/A,887,895,N/A,131,3
7,N/A,N/A,N/A,880,887,N/A,136,2
33,N/A,N/A,N/A,847,880,N/A,139,5
9,N/A,N/A,N/A,808,817,N/A,3,3
7,N/A,N/A,N/A,801,808,N/A,7,1
48,N/A,N/A,N/A,753,801,N/A,11,5
7,N/A,N/A,N/A,746,753,N/A,14,2
6,N/A,N/A,N/A,740,746,N/A,19,1
26,N/A,N/A,N/A,714,740,N/A,23,5
28,N/A,N/A,N/A,686,714,N/A,28,4
8,N/A,N/A,N/A,678,686,N/A,33,3
31,N/A,N/A,N/A,647,678,N/A,36,6
16,N/A,N/A,N/A,631,647,N/A,40,4
9,N/A,N/A,N/A,622,631,N/A,44,2
9,N/A,N/A,N/A,613,622,N/A,50,2
45,N/A,N/A,N/A,568,613,N/A,54,6
11,N/A,N/A,N/A,557,568,N/A,57,3
35,N/A,N/A,N/A,522,557,N/A,60,6
13,N/A,N/A,N/A,509,522,N/A,64,4
8,N/A,N/A,N/A,501,509,N/A,69,3
8,N/A,N/A,N/A,493,501,N/A,74,2
36,N/A,N/A,N/A,457,493,N/A,77,5
11,N/A,N/A,N/A,446,457,N/A,80,2
30,N/A,N/A,N/A,416,446,N/A,84,6
7,N/A,N/A,N/A,409,416,N/A,90,0
8,N/A,N/A,N/A,401,409,N/A,93,3
9,N/A,N/A,N/A,392,401,N/A,98,2
6,N/A,N/A,N/A,386,392,N/A,103,1
36,N/A,N/A,N/A,350,386,N/A,108,6
11,N/A,N/A,N/A,339,350,N/A,111,3
9,N/A,N/A,N/A,330,339,N/A,115,1
37,N/A,N/A,N/A,293,330,N/A,120,6
7,N/A,N/A,N/A,286,293,N/A,126,0
9,N/A,N/A,N/A,1206,1215,N/A,6,1
34,N/A,N/A,N/A,1172,1206,N/A,11,6
24,N/A,N/A,N/A,1148,1172,N/A,15,4
11,N/A,N/A,N/A,1137,1148,N/A,19,2
9,N/A,N/A,N/A,1128,1137,N/A,24,1
15,N/A,N/A,N/A,1113,1128,N/A,27,4
8,N/A,N/A,N/A,1105,1113,N/A,31,2
9,N/A,N/A,N/A,1096,1105,N/A,36,1
18,N/A,N/A,N/A,1078,1096,N/A,39,4
15,N/A,N/A,N/A,1063,1078,N/A,45,4
9,N/A,N/A,N/A,1054,1063,N/A,50,3
26,N/A,N/A,N/A,1028,1054,N/A,53,6
10,N/A,N/A,N/A,1018,1028,N/A,56,3
8,N/A,N/A,N/A,1010,1018,N/A,62,3
7,N/A,N/A,N/A,1003,1010,N/A,68,3
48,N/A,N/A,N/A,955,1003,N/A,71,6
28,N/A,N/A,N/A,927,955,N/A,75,4
10,N/A,N/A,N/A,917,927,N/A,80,3
9,N/A,N/A,N/A,908,917,N/A,84,1
28,N/A,N/A,N/A,880,908,N/A,87,4
7,N/A,N/A,N/A,873,880,N/A,92,3
44,N/A,N/A,N/A,829,873,N/A,95,6
9,N/A,N/A,N/A,820,829,N/A,98,3
6,N/A,N/A,N/A,814,820,N/A,102,1
46,N/A,N/A,N/A,768,814,N/A,106,5
21,N/A,N/A,N/A,747,768,N/A,111,4
22,N/A,N/A,N/A,725,747,N/A,117,4
19,N/A,N/A,N/A,706,725,N/A,123,4
8,N/A,N/A,N/A,698,706,N/A,126,1
33,N/A,N/A,N/A,665,698,N/A,131,6
10,N/A,N/A,N/A,657,667,N/A,3,2
33,N/A,N/A,N/A,624,657,N/A,7,6
10,N/A,N/A,N/A,614,624,N/A,10,3
5,N/A,N/A,N/A,609,614,N/A,14,1
43,N/A,N/A,N/A,566,609,N/A,19,6
6,N/A,N/A,N/A,560,566,N/A,25,0
29,N/A,N/A,N/A,531,560,N/A,30,5
9,N/A,N/A,N/A,522,531,N/A,33,2
8,N/A,N/A,N/A,514,522,N/A,39,2
7,N/A,N/A,N/A,507,514,N/A,45,2
11,N/A,N/A,N/A,496,507,N/A,51,2
25,N/A,N/A,N/A,471,496,N/A,54,5
7,N/A,N/A,N/A,464,471,N/A,57,2
30,N/A,N/A,N/A,434,464,N/A,60,5
24,N/A,N/A,N/A,410,434,N/A,65,4
8,N/A,N/A,N/A,402,410,N/A,68,1
14,N/A,N/A,N/A,388,402,N/A,71,4
9,N/A,N/A,N/A,379,388,N/A,74,1
47,N/A,N/A,N/A,332,379,N/A,78,5
11,N/A,N/A,N/A,321,332,N/A,82,3
40,N/A,N/A,N/A,281,321,N/A,85,6
9,N/A,N/A,N/A,272,281,N/A,91,0
26,N/A,N/A,N/A,246,272,N/A,97,6
8,N/A,N/A,N/A,238,246,N/A,103,0
25,N/A,N/A,N/A,213,238,N/A,107,4
11,N/A,N/A,N/A,202,213,N/A,112,3
7,N/A,N/A,N/A,195,202,N/A,117,2
10,N/A,N/A,N/A,185,195,N/A,123,2
28,N/A,N/A,N/A,157,185,N/A,126,5
14,N/A,N/A,N/A,143,157,N/A,131,4
11,N/A,N/A,N/A,1598,1609,N/A,5,2
38,N/A,N/A,N/A,1560,1598,N/A,8,5
9,N/A,N/A,N/A,1551,1560,N/A,12,3
11,N/A,N/A,N/A,1540,1551,N/A,18,3
26,N/A,N/A,N/A,1514,1540,N/A,21,6
41,N/A,N/A,N/A,1473,1514,N/A,26,5
10,N/A,N/A,N/A,1463,1473,N/A,29,2
46,N/A,N/A,N/A,1417,1463,N/A,33,6
7,N/A,N/A,N/A,1410,1417,N/A,39,0
17,N/A,N/A,N/A,1393,1410,N/A,43,4
9,N/A,N/A,N/A,1384,1393,N/A,48,3
7,N/A,N/A,N/A,1377,1384,N/A,52,1
43,N/A,N/A,N/A,1334,1377,N/A,56,5
7,N/A,N/A,N/A,1327,1334,N/A,59,2
7,N/A,N/A,N/A,1320,1327,N/A,64,1
21,N/A,N/A,N/A,1299,1320,N/A,67,4
8,N/A,N/A,N/A,1291,1299,N/A,71,2
7,N/A,N/A,N/A,1284,1291,N/A,77,2
7,N/A,N/A,N/A,1277,1284,N/A,83,2
34,N/A,N/A,N/A,1243,1277,N/A,86,5
11,N/A,N/A,N/A,1232,1243,N/A,89,2
42,N/A,N/A,N/A,1190,1232,N/A,92,5
43,N/A,N/A,N/A,1147,1190,N/A,98,5
11,N/A,N/A,N/A,1136,1147,N/A,101,2
5,N/A,N/A,N/A,1131,1136,N/A,106,1
44,N/A,N/A,N/A,1087,1131,N/A,111,6
7,N/A,N/A,N/A,1080,1087,N/A,114,3
11,N/A,N/A,N/A,1069,1080,N/A,120,3
8,N/A,N/A,N/A,1061,1069,N/A,125,2
9,N/A,N/A,N/A,1052,1061,N/A,131,2
7,N/A,N/A,N/A,1678,1685,N/A,6,3
11,N/A,N/A,N/A,1667,1678,N/A,11,2
6,N/A,N/A,N/A,1661,1667,N/A,16,1
6,N/A,N/A,N/A,1655,1661,N/A,22,1
32,N/A,N/A,N/A,1623,1655,N/A,26,5
11,N/A,N/A,N/A,1612,1623,N/A,30,3
7,N/A,N/A,N/A,1605,1612,N/A,34,1
26,N/A,N/A,N/A,1579,1605,N/A,38,5
24,N/A,N/A,N/A,1555,1579,N/A,43,4
16,N/A,N/A,N/A,1539,1555,N/A,49,4
8,N/A,N/A,N/A,1531,1539,N/A,53,2
27,N/A,N/A,N/A,1504,1531,N/A,56,5
14,N/A,N/A,N/A,1490,1504,N/A,61,4
8,N/A,N/A,N/A,1482,1490,N/A,65,2
45,N/A,N/A,N/A,1437,1482,N/A,69,6
29,N/A,N/A,N/A,1408,1437,N/A,73,4
9,N/A,N/A,N/A,1399,1408,N/A,77,2
11,N/A,N/A,N/A,1388,1399,N/A,83,2
46,N/A,N/A,N/A,1342,1388,N/A,87,6
12,N/A,N/A,N/A,1330,1342,N/A,91,4
9,N/A,N/A,N/A,1321,1330,N/A,96,3
9,N/A,N/A,N/A,1312,1321,N/A,102,3
7,N/A,N/A,N/A,1305,1312,N/A,108,3
10,N/A,N/A,N/A,1295,1305,N/A,114,3
11,N/A,N/A,N/A,1284,1295,N/A,120,3
8,N/A,N/A,N/A,1276,1284,N/A,125,2
6,N/A,N/A,N/A,1270,1276,N/A,130,1
28,N/A,N/A,N/A,1242,1270,N/A,133,4
29,N/A,N/A,N/A,1213,1242,N/A,139,4
9,N/A,N/A,N/A,1204,1213,N/A,143,2
26,N/A,N/A,N/A,1861,1887,N/A,3,5
9,N/A,N/A,N/A,1852,1861,N/A,7,3
27,N/A,N/A,N/A,1825,1852,N/A,10,6
11,N/A,N/A,N/A,1814,1825,N/A,13,3
30,N/A,N/A,N/A,1784,1814,N/A,16,6
25,N/A,N/A,N/A,1759,1784,N/A,20,4
11,N/A,N/A,N/A,1748,1759,N/A,24,2
11,N/A,N/A,N/A,1737,1748,N/A,30,2
45,N/A,N/A,N/A,1692,1737,N/A,34,6
5,N/A,N/A,N/A,1687,1692,N/A,40,0
32,N/A,N/A,N/A,1655,1687,N/A,45,5
12,N/A,N/A,N/A,1643,1655,N/A,50,4
9,N/A,N/A,N/A,1634,1643,N/A,53,1
15,N/A,N/A,N/A,1619,1634,N/A,56,4
11,N/A,N/A,N/A,1608,1619,N/A,60,2
40,N/A,N/A,N/A,1568,1608,N/A,63,5
7,N/A,N/A,N/A,1561,1568,N/A,67,3
27,N/A,N/A,N/A,1534,1561,N/A,70,6
5,N/A,N/A,N/A,1529,1534,N/A,76,0
25,N/A,N/A,N/A,1504,1529,N/A,82,6
7,N/A,N/A,N/A,1497,1504,N/A,88,0
43,N/A,N/A,N/A,1454,1497,N/A,93,5
46,N/A,N/A,N/A,1408,1454,N/A,99,5
20,N/A,N/A,N/A,1388,1408,N/A,104,4
20,N/A,N/A,N/A,1368,1388,N/A,110,4
12,N/A,N/A,N/A,1356,1368,N/A,116,4
14,N/A,N/A,N/A,1342,1356,N/A,122,4
9,N/A,N/A,N/A,1333,1342,N/A,126,2
7,N/A,N/A,N/A,1326,1333,N/A,132,2
46,N/A,N/A,N/A,1280,1326,N/A,135,5
8,N/A,N/A,N/A,1920,1928,N/A,5,3
9,N/A,N/A,N/A,1911,1920,N/A,11,3
7,N/A,N/A,N/A,1904,1911,N/A,15,1
10,N/A,N/A,N/A,1894,1904,N/A,18,4
11,N/A,N/A,N/A,1883,1894,N/A,22,2
43,N/A,N/A,N/A,1840,1883,N/A,25,5
8,N/A,N/A,N/A,1832,1840,N/A,28,2
32,N/A,N/A,N/A,1800,1832,N/A,31,5
49,N/A,N/A,N/A,1751,1800,N/A,37,5
8,N/A,N/A,N/A,1743,1751,N/A,41,3
8,N/A,N/A,N/A,1735,1743,N/A,45,1
38,N/A,N/A,N/A,1697,1735,N/A,50,6
21,N/A,N/A,N/A,1676,1697,N/A,54,4
10,N/A,N/A,N/A,1666,1676,N/A,59,3
11,N/A,N/A,N/A,1655,1666,N/A,65,3
31,N/A,N/A,N/A,1624,1655,N/A,68,6
22,N/A,N/A,N/A,1602,1624,N/A,72,4
8,N/A,N/A,N/A,1594,1602,N/A,77,3
11,N/A,N/A,N/A,1583,1594,N/A,83,3
11,N/A,N/A,N/A,1572,1583,N/A,89,3
43,N/A,N/A,N/A,1529,1572,N/A,92,6
5,N/A,N/A,N/A,1524,1529,N/A,98,0
28,N/A,N/A,N/A,1496,1524,N/A,102,4
13,N/A,N/A,N/A,1483,1496,N/A,108,4
20,N/A,N/A,N/A,1463,1483,N/A,114,4
11,N/A,N/A,N/A,1452,1463,N/A,118,2
41,N/A,N/A,N/A,1411,1452,N/A,122,6
9,N/A,N/A,N/A,1402,1411,N/A,128,0
34,N/A,N/A,N/A,1368,1402,N/A,133,5
47,N/A,N/A,N/A,1321,1368,N/A,139,5
7,N/A,N/A,N/A,1322,1329,N/A,3,1
29,N/A,N/A,N/A,1293,1322,N/A,7,5
9,N/A,N/A,N/A,1284,1293,N/A,10,2
47,N/A,N/A,N/A,1237,1284,N/A,14,6
7,N/A,N/A,N/A,1230,1237,N/A,20,0
45,N/A,N/A,N/A,1185,1230,N/A,25,5
27,N/A,N/A,N/A,1158,1185,N/A,31,5
8,N/A,N/A,N/A,1150,1158,N/A,35,3
29,N/A,N/A,N/A,1121,1150,N/A,38,6
11,N/A,N/A,N/A,1110,1121,N/A,41,3
39,N/A,N/A,N/A,1071,1110,N/A,44,6
10,N/A,N/A,N/A,1061,1071,N/A,48,4
8,N/A,N/A,N/A,1053,1061,N/A,53,3
26,N/A,N/A,N/A,1027,1053,N/A,56,6
36,N/A,N/A,N/A,991,1027,N/A,61,5
34,N/A,N/A,N/A,957,991,N/A,67,5
18,N/A,N/A,N/A,939,957,N/A,72,4
10,N/A,N/A,N/A,929,939,N/A,76,2
10,N/A,N/A,N/A,919,929,N/A,82,2
44,N/A,N/A,N/A,875,919,N/A,85,5
7,N/A,N/A,N/A,868,875,N/A,88,2
44,N/A,N/A,N/A,824,868,N/A,91,5
11,N/A,N/A,N/A,813,824,N/A,95,3
9,N/A,N/A,N/A,804,813,N/A,101,3
9,N/A,N/A,N/A,795,804,N/A,105,1
8,N/A,N/A,N/A,787,795,N/A,111,1
33,N/A,N/A,N/A,754,787,N/A,116,6
30,N/A,N/A,N/A,724,754,N/A,121,5
10,N/A,N/A,N/A,714,724,N/A,126,4
12,N/A,N/A,N/A,702,714,N/A,132,4
8,N/A,N/A,N/A,1431,1439,N/A,4,2
7,N/A,N/A,N/A,1424,1431,N/A,10,2
33,N/A,N/A,N/A,1391,1424,N/A,13,5
9,N/A,N/A,N/A,1382,1391,N/A,16,2
35,N/A,N/A,N/A,1347,1382,N/A,19,5
8,N/A,N/A,N/A,1339,1347,N/A,23,3
10,N/A,N/A,N/A,1329,1339,N/A,28,2
31,N/A,N/A,N/A,1298,1329,N/A,32,6
7,N/A,N/A,N/A,1291,1298,N/A,38,0
34,N/A,N/A,N/A,1257,1291,N/A,44,6
26,N/A,N/A,N/A,1231,1257,N/A,49,5
11,N/A,N/A,N/A,1220,1231,N/A,52,2
45,N/A,N/A,N/A,1175,1220,N/A,56,6
23,N/A,N/A,N/A,1152,1175,N/A,60,4
7,N/A,N/A,N/A,1145,1152,N/A,63,1
48,N/A,N/A,N/A,1097,1145,N/A,67,5
29,N/A,N/A,N/A,1068,1097,N/A,72,4
27,N/A,N/A,N/A,1041,1068,N/A,78,4
9,N/A,N/A,N/A,1032,1041,N/A,82,2
42,N/A,N/A,N/A,990,1032,N/A,85,5
10,N/A,N/A,N/A,980,990,N/A,88,2
7,N/A,N/A,N/A,973,980,N/A,94,2
7,N/A,N/A,N/A,966,973,N/A,100,2
8,N/A,N/A,N/A,958,966,N/A,105,1
47,N/A,N/A,N/A,911,958,N/A,110,6
25,N/A,N/A,N/A,886,911,N/A,115,5
8,N/A,N/A,N/A,878,886,N/A,118,2
42,N/A,N/A,N/A,836,878,N/A,121,5
11,N/A,N/A,N/A,825,836,N/A,124,2
27,N/A,N/A,N/A,798,825,N/A,128,6
25,N/A,N/A,N/A,1964,1989,N/A,5,6
10,N/A,N/A,N/A,1954,1964,N/A,8,3
9,N/A,N/A,N/A,1945,1954,N/A,12,1
6,N/A,N/A,N/A,1939,1945,N/A,18,1
17,N/A,N/A,N/A,1922,1939,N/A,21,4
5,N/A,N/A,N/A,1917,1922,N/A,24,1
48,N/A,N/A,N/A,1869,1917,N/A,28,5
44,N/A,N/A,N/A,1825,1869,N/A,34,5
11,N/A,N/A,N/A,1814,1825,N/A,38,3
9,N/A,N/A,N/A,1805,1814,N/A,44,3
9,N/A,N/A,N/A,1796,1805,N/A,50,3
5,N/A,N/A,N/A,1791,1796,N/A,54,1
11,N/A,N/A,N/A,1780,1791,N/A,57,4
8,N/A,N/A,N/A,1772,1780,N/A,62,3
6,N/A,N/A,N/A,1766,1772,N/A,66,1
5,N/A,N/A,N/A,1761,1766,N/A,72,1
42,N/A,N/A,N/A,1719,1761,N/A,76,5
11,N/A,N/A,N/A,1708,1719,N/A,80,3
7,N/A,N/A,N/A,1701,1708,N/A,86,3
8,N/A,N/A,N/A,1693,1701,N/A,90,1
33,N/A,N/A,N/A,1660,1693,N/A,94,5
11,N/A,N/A,N/A,1649,1660,N/A,98,3
5,N/A,N/A,N/A,1644,1649,N/A,102,1
45,N/A,N/A,N/A,1599,1644,N/A,107,6
9,N/A,N/A,N/A,1590,1599,N/A,110,3
9,N/A,N/A,N/A,1581,1590,N/A,115,2
36,N/A,N/A,N/A,1545,1581,N/A,118,5
8,N/A,N/A,N/A,1537,1545,N/A,121,2
30,N/A,N/A,N/A,1507,1537,N/A,125,6
21,N/A,N/A,N/A,1486,1507,N/A,129,4
25,N/A,N/A,N/A,1797,1822,N/A,4,4
19,N/A,N/A,N/A,1778,1797,N/A,10,4
9,N/A,N/A,N/A,1769,1778,N/A,14,2
6,N/A,N/A,N/A,1763,1769,N/A,19,1
35,N/A,N/A,N/A,1728,1763,N/A,24,6
11,N/A,N/A,N/A,1717,1728,N/A,27,3
10,N/A,N/A,N/A,1707,1717,N/A,33,3
30,N/A,N/A,N/A,1677,1707,N/A,36,6
11,N/A,N/A,N/A,1666,1677,N/A,39,3
10,N/A,N/A,N/A,1656,1666,N/A,45,3
7,N/A,N/A,N/A,1649,1656,N/A,49,1
40,N/A,N/A,N/A,1609,1649,N/A,53,5
8,N/A,N/A,N/A,1601,1609,N/A,57,3
5,N/A,N/A,N/A,1596,1601,N/A,61,1
8,N/A,N/A,N/A,1588,1596,N/A,67,1
17,N/A,N/A,N/A,1571,1588,N/A,70,4
7,N/A,N/A,N/A,1564,1571,N/A,73,1
45,N/A,N/A,N/A,1519,1564,N/A,78,6
40,N/A,N/A,N/A,1479,1519,N/A,83,5
38,N/A,N/A,N/A,1441,1479,N/A,89,5
16,N/A,N/A,N/A,1425,1441,N/A,94,4
9,N/A,N/A,N/A,1416,1425,N/A,98,2
42,N/A,N/A,N/A,1374,1416,N/A,102,6
7,N/A,N/A,N/A,1367,1374,N/A,108,0
48,N/A,N/A,N/A,1319,1367,N/A,113,5
8,N/A,N/A,N/A,1311,1319,N/A,117,3
7,N/A,N/A,N/A,1304,1311,N/A,123,3
8,N/A,N/A,N/A,1296,1304,N/A,128,2
43,N/A,N/A,N/A,1253,1296,N/A,132,6
5,N/A,N/A,N/A,1248,1253,N/A,138,0
9,N/A,N/A,N/A,1148,1157,N/A,4,2
25,N/A,N/A,N/A,1123,1148,N/A,7,5
43,N/A,N/A,N/A,1080,1123,N/A,13,5
25,N/A,N/A,N/A,1055,1080,N/A,18,4
11,N/A,N/A,N/A,1044,1055,N/A,23,3
40,N/A,N/A,N/A,1004,1044,N/A,26,6
8,N/A,N/A,N/A,996,1004,N/A,29,3
10,N/A,N/A,N/A,986,996,N/A,34,2
46,N/A,N/A,N/A,940,986,N/A,38,6
5,N/A,N/A,N/A,935,940,N/A,44,0
11,N/A,N/A,N/A,924,935,N/A,47,3
8,N/A,N/A,N/A,916,924,N/A,53,3
8,N/A,N/A,N/A,908,916,N/A,58,2
9,N/A,N/A,N/A,899,908,N/A,64,2
8,N/A,N/A,N/A,891,899,N/A,69,1
13,N/A,N/A,N/A,878,891,N/A,72,4
11,N/A,N/A,N/A,867,878,N/A,77,3
7,N/A,N/A,N/A,860,867,N/A,81,1
20,N/A,N/A,N/A,840,860,N/A,84,4
7,N/A,N/A,N/A,833,840,N/A,87,1
7,N/A,N/A,N/A,826,833,N/A,93,1
7,N/A,N/A,N/A,819,826,N/A,99,1
36,N/A,N/A,N/A,783,819,N/A,103,5
38,N/A,N/A,N/A,745,783,N/A,109,5
22,N/A,N/A,N/A,723,745,N/A,114,4
10,N/A,N/A,N/A,713,723,N/A,118,2
34,N/A,N/A,N/A,679,713,N/A,122,6
7,N/A,N/A,N/A,672,679,N/A,125,3
8,N/A,N/A,N/A,664,672,N/A,129,1
46,N/A,N/A,N/A,618,664,N/A,133,5
11,N/A,N/A,N/A,1398,1409,N/A,3,3
9,N/A,N/A,N/A,1389,1398,N/A,9,3
9,N/A,N/A,N/A,1380,1389,N/A,14,2
28,N/A,N/A,N/A,1352,1380,N/A,18,6
7,N/A,N/A,N/A,1345,1352,N/A,24,0
30,N/A,N/A,N/A,1315,1345,N/A,30,6
25,N/A,N/A,N/A,1290,1315,N/A,34,4
11,N/A,N/A,N/A,1279,1290,N/A,40,4
7,N/A,N/A,N/A,1272,1279,N/A,44,2
35,N/A,N/A,N/A,1237,1272,N/A,47,5
46,N/A,N/A,N/A,1191,1237,N/A,53,5
14,N/A,N/A,N/A,1177,1191,N/A,58,4
5,N/A,N/A,N/A,1172,1177,N/A,61,1
38,N/A,N/A,N/A,1134,1172,N/A,66,6
48,N/A,N/A,N/A,1086,1134,N/A,71,5
21,N/A,N/A,N/A,1065,1086,N/A,76,4
9,N/A,N/A,N/A,1056,1065,N/A,80,2
39,N/A,N/A,N/A,1017,1056,N/A,84,6
44,N/A,N/A,N/A,973,1017,N/A,89,5
10,N/A,N/A,N/A,963,973,N/A,94,4
19,N/A,N/A,N/A,944,963,N/A,100,4
8,N/A,N/A,N/A,936,944,N/A,103,1
49,N/A,N/A,N/A,887,936,N/A,108,6
8,N/A,N/A,N/A,879,887,N/A,114,0
26,N/A,N/A,N/A,853,879,N/A,119,5
7,N/A,N/A,N/A,846,853,N/A,123,3
11,N/A,N/A,N/A,835,846,N/A,128,2
7,N/A,N/A,N/A,828,835,N/A,133,1
32,N/A,N/A,N/A,796,828,N/A,138,6
7,N/A,N/A,N/A,789,796,N/A,144,0
10,N/A,N/A,N/A,1206,1216,N/A,6,3
9,N/A,N/A,N/A,1197,1206,N/A,10,1
23,N/A,N/A,N/A,1174,1197,N/A,13,4
9,N/A,N/A,N/A,1165,1174,N/A,17,2
10,N/A,N/A,N/A,1155,1165,N/A,23,2
25,N/A,N/A,N/A,1130,1155,N/A,27,6
7,N/A,N/A,N/A,1123,1130,N/A,30,3
10,N/A,N/A,N/A,1113,1123,N/A,36,3
8,N/A,N/A,N/A,1105,1113,N/A,41,2
35,N/A,N/A,N/A,1070,1105,N/A,44,5
19,N/A,N/A,N/A,1051,1070,N/A,49,4
18,N/A,N/A,N/A,1033,1051,N/A,55,4
15,N/A,N/A,N/A,1018,1033,N/A,61,4
5,N/A,N/A,N/A,1013,1018,N/A,64,1
43,N/A,N/A,N/A,970,1013,N/A,68,5
21,N/A,N/A,N/A,949,970,N/A,73,4
8,N/A,N/A,N/A,941,949,N/A,77,2
7,N/A,N/A,N/A,934,941,N/A,83,2
27,N/A,N/A,N/A,907,934,N/A,87,6
13,N/A,N/A,N/A,894,907,N/A,91,4
9,N/A,N/A,N/A,885,894,N/A,96,3
11,N/A,N/A,N/A,874,885,N/A,102,3
7,N/A,N/A,N/A,867,874,N/A,107,2
40,N/A,N/A,N/A,827,867,N/A,110,5
24,N/A,N/A,N/A,803,827,N/A,115,4
9,N/A,N/A,N/A,794,803,N/A,118,1
44,N/A,N/A,N/A,750,794,N/A,123,6
24,N/A,N/A,N/A,726,750,N/A,127,4
8,N/A,N/A,N/A,718,726,N/A,132,3
30,N/A,N/A,N/A,688,718,N/A,135,6
10,N/A,N/A,N/A,1862,1872,N/A,4,2
10,N/A,N/A,N/A,1852,1862,N/A,10,2
47,N/A,N/A,N/A,1805,1852,N/A,13,5
19,N/A,N/A,N/A,1786,1805,N/A,18,4
9,N/A,N/A,N/A,1777,1786,N/A,23,3
7,N/A,N/A,N/A,1770,1777,N/A,29,3
7,N/A,N/A,N/A,1763,1770,N/A,35,3
36,N/A,N/A,N/A,1727,1763,N/A,38,6
7,N/A,N/A,N/A,1720,1727,N/A,41,3
9,N/A,N/A,N/A,1711,1720,N/A,46,2
9,N/A,N/A,N/A,1702,1711,N/A,52,2
9,N/A,N/A,N/A,1693,1702,N/A,57,1
40,N/A,N/A,N/A,1653,1693,N/A,62,6
10,N/A,N/A,N/A,1643,1653,N/A,65,3
5,N/A,N/A,N/A,1638,1643,N/A,69,1
48,N/A,N/A,N/A,1590,1638,N/A,73,5
19,N/A,N/A,N/A,1571,1590,N/A,78,4
8,N/A,N/A,N/A,1563,1571,N/A,83,3
8,N/A,N/A,N/A,1555,1563,N/A,87,1
29,N/A,N/A,N/A,1526,1555,N/A,92,6
10,N/A,N/A,N/A,1516,1526,N/A,95,3
31,N/A,N/A,N/A,1485,1516,N/A,98,6
8,N/A,N/A,N/A,1477,1485,N/A,101,3
11,N/A,N/A,N/A,1466,1477,N/A,107,3
7,N/A,N/A,N/A,1459,1466,N/A,112,2
6,N/A,N/A,N/A,1453,1459,N/A,117,1
49,N/A,N/A,N/A,1404,1453,N/A,121,5
23,N/A,N/A,N/A,1381,1404,N/A,126,4
8,N/A,N/A,N/A,1373,1381,N/A,131,3
9,N/A,N/A,N/A,1364,1373,N/A,137,3
10,N/A,N/A,N/A,404,414,N/A,5,3
7,N/A,N/A,N/A,397,404,N/A,10,2
28,N/A,N/A,N/A,369,397,N/A,13,5
45,N/A,N/A,N/A,324,369,N/A,19,5
10,N/A,N/A,N/A,314,324,N/A,22,2
9,N/A,N/A,N/A,305,314,N/A,28,2
37,N/A,N/A,N/A,268,305,N/A,32,6
10,N/A,N/A,N/A,258,268,N/A,35,3
10,N/A,N/A,N/A,248,258,N/A,40,2
27,N/A,N/A,N/A,221,248,N/A,43,5
44,N/A,N/A,N/A,177,221,N/A,49,5
36,N/A,N/A,N/A,141,177,N/A,55,5
21,N/A,N/A,N/A,120,141,N/A,60,4
5,N/A,N/A,N/A,115,120,N/A,63,1
6,N/A,N/A,N/A,109,115,N/A,69,1
38,N/A,N/A,N/A,71,109,N/A,73,5
10,N/A,N/A,N/A,61,71,N/A,77,3
49,N/A,N/A,N/A,12,61,N/A,80,6
8,N/A,N/A,N/A,4,12,N/A,86,0
40,N/A,N/A,N/A,-36,4,N/A,91,5
8,N/A,N/A,N/A,1363,1371,N/A,3,2
32,N/A,N/A,N/A,1331,1363,N/A,7,6
26,N/A,N/A,N/A,1305,1331,N/A,11,4
8,N/A,N/A,N/A,1297,1305,N/A,14,1
39,N/A,N/A,N/A,1258,1297,N/A,19,6
11,N/A,N/A,N/A,1247,1258,N/A,22,3
9,N/A,N/A,N/A,1238,1247,N/A,26,1
47,N/A,N/A,N/A,1191,1238,N/A,30,5
9,N/A,N/A,N/A,1182,1191,N/A,34,3
31,N/A,N/A,N/A,1151,1182,N/A,37,6
13,N/A,N/A,N/A,1138,1151,N/A,41,4
14,N/A,N/A,N/A,1124,1138,N/A,47,4
20,N/A,N/A,N/A,1104,1124,N/A,53,4
7,N/A,N/A,N/A,1097,1104,N/A,56,1
13,N/A,N/A,N/A,1084,1097,N/A,59,4
8,N/A,N/A,N/A,1076,1084,N/A,62,1
42,N/A,N/A,N/A,1034,1076,N/A,67,6
32,N/A,N/A,N/A,1002,1034,N/A,72,5
23,N/A,N/A,N/A,979,1002,N/A,77,4
7,N/A,N/A,N/A,972,979,N/A,81,2
10,N/A,N/A,N/A,962,972,N/A,87,2
32,N/A,N/A,N/A,930,962,N/A,91,6
26,N/A,N/A,N/A,904,930,N/A,95,4
29,N/A,N/A,N/A,875,904,N/A,101,4
7,N/A,N/A,N/A,868,875,N/A,106,3
33,N/A,N/A,N/A,835,868,N/A,109,6
11,N/A,N/A,N/A,824,835,N/A,112,3
11,N/A,N/A,N/A,813,824,N/A,118,3
7,N/A,N/A,N/A,806,813,N/A,123,2
8,N/A,N/A,N/A,798,806,N/A,128,1
10,N/A,N/A,N/A,1270,1280,N/A,4,2
5,N/A,N/A,N/A,1265,1270,N/A,9,1
7,N/A,N/A,N/A,1258,1265,N/A,15,1
27,N/A,N/A,N/A,1231,1258,N/A,20,6
16,N/A,N/A,N/A,1215,1231,N/A,24,4
11,N/A,N/A,N/A,1204,1215,N/A,30,4
8,N/A,N/A,N/A,1196,1204,N/A,34,2
10,N/A,N/A,N/A,1186,1196,N/A,40,2
7,N/A,N/A,N/A,1179,1186,N/A,46,2
9,N/A,N/A,N/A,1170,1179,N/A,51,1
11,N/A,N/A,N/A,1159,1170,N/A,54,4
11,N/A,N/A,N/A,1148,1159,N/A,58,2
46,N/A,N/A,N/A,1102,1148,N/A,61,5
41,N/A,N/A,N/A,1061,1102,N/A,67,5
14,N/A,N/A,N/A,1047,1061,N/A,72,4
10,N/A,N/A,N/A,1037,1047,N/A,77,3
8,N/A,N/A,N/A,1029,1037,N/A,83,3
33,N/A,N/A,N/A,996,1029,N/A,86,6
10,N/A,N/A,N/A,986,996,N/A,89,3
48,N/A,N/A,N/A,938,986,N/A,92,6
14,N/A,N/A,N/A,924,938,N/A,96,4
25,N/A,N/A,N/A,899,924,N/A,102,4
6,N/A,N/A,N/A,893,899,N/A,105,1
31,N/A,N/A,N/A,862,893,N/A,109,5
48,N/A,N/A,N/A,814,862,N/A,115,5
22,N/A,N/A,N/A,792,814,N/A,120,4
10,N/A,N/A,N/A,782,792,N/A,125,3
11,N/A,N/A,N/A,771,782,N/A,131,3
48,N/A,N/A,N/A,723,771,N/A,134,6
42,N/A,N/A,N/A,681,723,N/A,139,5
22,N/A,N/A,N/A,1391,1413,N/A,4,4
11,N/A,N/A,N/A,1380,1391,N/A,9,3
11,N/A,N/A,N/A,1369,1380,N/A,14,2
7,N/A,N/A,N/A,1362,1369,N/A,19,1
27,N/A,N/A,N/A,1335,1362,N/A,22,4
9,N/A,N/A,N/A,1326,1335,N/A,25,1
7,N/A,N/A,N/A,1319,1326,N/A,31,1
24,N/A,N/A,N/A,1295,1319,N/A,34,4
8,N/A,N/A,N/A,1287,1295,N/A,37,1
44,N/A,N/A,N/A,1243,1287,N/A,42,6
10,N/A,N/A,N/A,1233,1243,N/A,45,3
8,N/A,N/A,N/A,1225,1233,N/A,50,2
46,N/A,N/A,N/A,1179,1225,N/A,54,6
24,N/A,N/A,N/A,1155,1179,N/A,58,4
6,N/A,N/A,N/A,1149,1155,N/A,61,1
8,N/A,N/A,N/A,1141,1149,N/A,67,1
34,N/A,N/A,N/A,1107,1141,N/A,72,6
18,N/A,N/A,N/A,1089,1107,N/A,76,4
10,N/A,N/A,N/A,1079,1089,N/A,80,2
6,N/A,N/A,N/A,1073,1079,N/A,85,1
27,N/A,N/A,N/A,1046,1073,N/A,88,4
9,N/A,N/A,N/A,1037,1046,N/A,92,2
46,N/A,N/A,N/A,991,1037,N/A,95,5
7,N/A,N/A,N/A,984,991,N/A,99,3
8,N/A,N/A,N/A,976,984,N/A,105,3
6,N/A,N/A,N/A,970,976,N/A,109,1
29,N/A,N/A,N/A,941,970,N/A,114,6
7,N/A,N/A,N/A,934,941,N/A,120,0
24,N/A,N/A,N/A,910,934,N/A,124,4
9,N/A,N/A,N/A,901,910,N/A,128,2
9,N/A,N/A,N/A,996,1005,N/A,4,2
47,N/A,N/A,N/A,949,996,N/A,7,5
24,N/A,N/A,N/A,925,949,N/A,12,4
8,N/A,N/A,N/A,917,925,N/A,16,2
45,N/A,N/A,N/A,872,917,N/A,19,5
47,N/A,N/A,N/A,825,872,N/A,25,5
28,N/A,N/A,N/A,797,825,N/A,31,5
16,N/A,N/A,N/A,781,797,N/A,36,4
11,N/A,N/A,N/A,770,781,N/A,40,2
34,N/A,N/A,N/A,736,770,N/A,44,6
8,N/A,N/A,N/A,728,736,N/A,47,3
10,N/A,N/A,N/A,718,728,N/A,52,2
38,N/A,N/A,N/A,680,718,N/A,56,6
5,N/A,N/A,N/A,675,680,N/A,62,0
25,N/A,N/A,N/A,650,675,N/A,67,5
11,N/A,N/A,N/A,639,650,N/A,71,3
8,N/A,N/A,N/A,631,639,N/A,76,2
7,N/A,N/A,N/A,624,631,N/A,82,2
48,N/A,N/A,N/A,576,624,N/A,86,6
27,N/A,N/A,N/A,549,576,N/A,91,5
7,N/A,N/A,N/A,542,549,N/A,95,3
38,N/A,N/A,N/A,504,542,N/A,98,6
21,N/A,N/A,N/A,483,504,N/A,102,4
28,N/A,N/A,N/A,455,483,N/A,108,4
5,N/A,N/A,N/A,450,455,N/A,111,1
39,N/A,N/A,N/A,411,450,N/A,116,6
20,N/A,N/A,N/A,391,411,N/A,120,4
5,N/A,N/A,N/A,386,391,N/A,123,1
34,N/A,N/A,N/A,352,386,N/A,128,6
26,N/A,N/A,N/A,326,352,N/A,132,4
29,N/A,N/A,N/A,1798,1827,N/A,4,5
9,N/A,N/A,N/A,1789,1798,N/A,7,2
35,N/A,N/A,N/A,1754,1789,N/A,11,6
31,N/A,N/A,N/A,1723,1754,N/A,16,5
25,N/A,N/A,N/A,1698,1723,N/A,22,5
33,N/A,N/A,N/A,1665,1698,N/A,28,5
15,N/A,N/A,N/A,1650,1665,N/A,33,4
8,N/A,N/A,N/A,1642,1650,N/A,36,1
32,N/A,N/A,N/A,1610,1642,N/A,40,5
7,N/A,N/A,N/A,1603,1610,N/A,44,3
7,N/A,N/A,N/A,1596,1603,N/A,49,2
9,N/A,N/A,N/A,1587,1596,N/A,55,2
9,N/A,N/A,N/A,1578,1587,N/A,60,1
6,N/A,N/A,N/A,1572,1578,N/A,66,1
6,N/A,N/A,N/A,1566,1572,N/A,72,1
29,N/A,N/A,N/A,1537,1566,N/A,76,5
19,N/A,N/A,N/A,1518,1537,N/A,81,4
8,N/A,N/A,N/A,1510,1518,N/A,85,2
6,N/A,N/A,N/A,1504,1510,N/A,90,1
16,N/A,N/A,N/A,1488,1504,N/A,93,4
16,N/A,N/A,N/A,1472,1488,N/A,99,4
6,N/A,N/A,N/A,1466,1472,N/A,102,1
17,N/A,N/A,N/A,1449,1466,N/A,105,4
10,N/A,N/A,N/A,1439,1449,N/A,110,3
11,N/A,N/A,N/A,1428,1439,N/A,115,2
27,N/A,N/A,N/A,1401,1428,N/A,119,6
11,N/A,N/A,N/A,1390,1401,N/A,122,3
7,N/A,N/A,N/A,1383,1390,N/A,127,2
7,N/A,N/A,N/A,1376,1383,N/A,132,1
39,N/A,N/A,N/A,1337,1376,N/A,137,6
36,N/A,N/A,N/A,1766,1802,N/A,3,5
17,N/A,N/A,N/A,1749,1766,N/A,8,4
10,N/A,N/A,N/A,1739,1749,N/A,13,3
9,N/A,N/A,N/A,1730,1739,N/A,17,1
44,N/A,N/A,N/A,1686,1730,N/A,21,5
9,N/A,N/A,N/A,1677,1686,N/A,25,3
39,N/A,N/A,N/A,1638,1677,N/A,28,6
9,N/A,N/A,N/A,1629,1638,N/A,34,0
28,N/A,N/A,N/A,1601,1629,N/A,38,4
22,N/A,N/A,N/A,1579,1601,N/A,44,4
9,N/A,N/A,N/A,1570,1579,N/A,47,1
18,N/A,N/A,N/A,1552,1570,N/A,50,4
11,N/A,N/A,N/A,1541,1552,N/A,56,4
5,N/A,N/A,N/A,1536,1541,N/A,59,1
13,N/A,N/A,N/A,1523,1536,N/A,62,4
8,N/A,N/A,N/A,1515,1523,N/A,66,2
9,N/A,N/A,N/A,1506,1515,N/A,72,2
6,N/A,N/A,N/A,1500,1506,N/A,77,1
8,N/A,N/A,N/A,1492,1500,N/A,83,1
48,N/A,N/A,N/A,1444,1492,N/A,87,5
9,N/A,N/A,N/A,1435,1444,N/A,91,3
9,N/A,N/A,N/A,1426,1435,N/A,97,3
7,N/A,N/A,N/A,1419,1426,N/A,101,1
39,N/A,N/A,N/A,1380,1419,N/A,106,6
8,N/A,N/A,N/A,1372,1380,N/A,112,0
11,N/A,N/A,N/A,1361,1372,N/A,115,3
8,N/A,N/A,N/A,1353,1361,N/A,120,2
40,N/A,N/A,N/A,1313,1353,N/A,124,6
9,N/A,N/A,N/A,1304,1313,N/A,127,3
9,N/A,N/A,N/A,1295,1304,N/A,132,2
22,N/A,N/A,N/A,1019,1041,N/A,4,4
11,N/A,N/A,N/A,1008,1019,N/A,8,2
8,N/A,N/A,N/A,1000,1008,N/A,13,1
37,N/A,N/A,N/A,963,1000,N/A,18,6
9,N/A,N/A,N/A,954,963,N/A,21,3
7,N/A,N/A,N/A,947,954,N/A,25,1
9,N/A,N/A,N/A,938,947,N/A,31,1
28,N/A,N/A,N/A,910,938,N/A,34,4
7,N/A,N/A,N/A,903,910,N/A,38,2
8,N/A,N/A,N/A,895,903,N/A,43,1
5,N/A,N/A,N/A,890,895,N/A,49,1
45,N/A,N/A,N/A,845,890,N/A,53,5
9,N/A,N/A,N/A,836,845,N/A,57,3
7,N/A,N/A,N/A,829,836,N/A,62,2
45,N/A,N/A,N/A,784,829,N/A,66,6
10,N/A,N/A,N/A,774,784,N/A,69,3
9,N/A,N/A,N/A,765,774,N/A,75,3
7,N/A,N/A,N/A,758,765,N/A,80,2
10,N/A,N/A,N/A,748,758,N/A,86,2
11,N/A,N/A,N/A,737,748,N/A,92,2
42,N/A,N/A,N/A,695,737,N/A,95,5
7,N/A,N/A,N/A,688,695,N/A,98,2
10,N/A,N/A,N/A,678,688,N/A,104,2
9,N/A,N/A,N/A,669,678,N/A,110,2
6,N/A,N/A,N/A,663,669,N/A,115,1
37,N/A,N/A,N/A,626,663,N/A,120,6
28,N/A,N/A,N/A,598,626,N/A,125,5
25,N/A,N/A,N/A,573,598,N/A,131,5
9,N/A,N/A,N/A,564,573,N/A,134,2
39,N/A,N/A,N/A,525,564,N/A,137,5
30,N/A,N/A,N/A,788,818,N/A,6,5
9,N/A,N/A,N/A,779,788,N/A,10,3
7,N/A,N/A,N/A,772,779,N/A,14,1
28,N/A,N/A,N/A,744,772,N/A,17,4
7,N/A,N/A,N/A,737,744,N/A,21,2
39,N/A,N/A,N/A,698,737,N/A,25,6
11,N/A,N/A,N/A,687,698,N/A,28,3
43,N/A,N/A,N/A,644,687,N/A,31,6
8,N/A,N/A,N/A,636,644,N/A,37,0
10,N/A,N/A,N/A,626,636,N/A,40,3
9,N/A,N/A,N/A,617,626,N/A,44,1
6,N/A,N/A,N/A,611,617,N/A,50,1
32,N/A,N/A,N/A,579,611,N/A,55,6
7,N/A,N/A,N/A,572,579,N/A,58,3
8,N/A,N/A,N/A,564,572,N/A,62,1
13,N/A,N/A,N/A,551,564,N/A,65,4
11,N/A,N/A,N/A,540,551,N/A,71,4
8,N/A,N/A,N/A,532,540,N/A,76,3
9,N/A,N/A,N/A,523,532,N/A,82,3
7,N/A,N/A,N/A,516,523,N/A,88,3
30,N/A,N/A,N/A,486,516,N/A,91,6
37,N/A,N/A,N/A,449,486,N/A,96,5
17,N/A,N/A,N/A,432,449,N/A,101,4
6,N/A,N/A,N/A,426,432,N/A,104,1
28,N/A,N/A,N/A,398,426,N/A,107,4
8,N/A,N/A,N/A,390,398,N/A,110,1
13,N/A,N/A,N/A,377,390,N/A,113,4
7,N/A,N/A,N/A,370,377,N/A,118,3
10,N/A,N/A,N/A,360,370,N/A,124,3
5,N/A,N/A,N/A,355,360,N/A,128,1
8,N/A,N/A,N/A,1626,1634,N/A,6,3
8,N/A,N/A,N/A,1618,1626,N/A,12,3
7,N/A,N/A,N/A,1611,1618,N/A,16,1
44,N/A,N/A,N/A,1567,1611,N/A,20,5
10,N/A,N/A,N/A,1557,1567,N/A,25,4
6,N/A,N/A,N/A,1551,1557,N/A,28,1
43,N/A,N/A,N/A,1508,1551,N/A,33,6
11,N/A,N/A,N/A,1497,1508,N/A,36,3
9,N/A,N/A,N/A,1488,1497,N/A,40,1
32,N/A,N/A,N/A,1456,1488,N/A,45,6
11,N/A,N/A,N/A,1445,1456,N/A,49,4
6,N/A,N/A,N/A,1439,1445,N/A,52,1
6,N/A,N/A,N/A,1433,1439,N/A,58,1
7,N/A,N/A,N/A,1426,1433,N/A,64,1
7,N/A,N/A,N/A,1419,1426,N/A,70,1
5,N/A,N/A,N/A,1414,1419,N/A,76,1
7,N/A,N/A,N/A,1407,1414,N/A,82,1
5,N/A,N/A,N/A,1402,1407,N/A,88,1
31,N/A,N/A,N/A,1371,1402,N/A,92,5
26,N/A,N/A,N/A,1345,1371,N/A,97,4
6,N/A,N/A,N/A,1339,1345,N/A,100,1
9,N/A,N/A,N/A,1330,1339,N/A,106,1
15,N/A,N/A,N/A,1315,1330,N/A,109,4
11,N/A,N/A,N/A,1304,1315,N/A,114,3
10,N/A,N/A,N/A,1294,1304,N/A,119,2
9,N/A,N/A,N/A,1285,1294,N/A,125,2
6,N/A,N/A,N/A,1279,1285,N/A,130,1
27,N/A,N/A,N/A,1252,1279,N/A,133,4
10,N/A,N/A,N/A,1242,1252,N/A,137,2
26,N/A,N/A,N/A,1216,1242,N/A,140,5
9,N/A,N/A,N/A,720,729,N/A,5,1
48,N/A,N/A,N/A,672,720,N/A,10,6
46,N/A,N/A,N/A,626,672,N/A,15,5
10,N/A,N/A,N/A,616,626,N/A,19,3
9,N/A,N/A,N/A,607,616,N/A,24,2
32,N/A,N/A,N/A,575,607,N/A,28,6
10,N/A,N/A,N/A,565,575,N/A,31,3
9,N/A,N/A,N/A,556,565,N/A,36,2
8,N/A,N/A,N/A,548,556,N/A,41,1
33,N/A,N/A,N/A,515,548,N/A,46,6
44,N/A,N/A,N/A,471,515,N/A,51,5
24,N/A,N/A,N/A,447,471,N/A,56,4
22,N/A,N/A,N/A,425,447,N/A,62,4
9,N/A,N/A,N/A,416,425,N/A,65,1
24,N/A,N/A,N/A,392,416,N/A,68,4
17,N/A,N/A,N/A,375,392,N/A,74,4
11,N/A,N/A,N/A,364,375,N/A,80,4
10,N/A,N/A,N/A,354,364,N/A,85,3
37,N/A,N/A,N/A,317,354,N/A,88,6
34,N/A,N/A,N/A,283,317,N/A,93,5
29,N/A,N/A,N/A,254,283,N/A,98,4
5,N/A,N/A,N/A,249,254,N/A,101,1
15,N/A,N/A,N/A,234,249,N/A,104,4
21,N/A,N/A,N/A,213,234,N/A,110,4
6,N/A,N/A,N/A,207,213,N/A,113,1
42,N/A,N/A,N/A,165,207,N/A,117,5
18,N/A,N/A,N/A,147,165,N/A,122,4
9,N/A,N/A,N/A,138,147,N/A,127,3
46,N/A,N/A,N/A,92,138,N/A,130,6
10,N/A,N/A,N/A,82,92,N/A,133,3
10,N/A,N/A,N/A,704,714,N/A,3,2
29,N/A,N/A,N/A,675,704,N/A,7,6
8,N/A,N/A,N/A,667,675,N/A,13,0
26,N/A,N/A,N/A,641,667,N/A,19,6
41,N/A,N/A,N/A,600,641,N/A,24,5
16,N/A,N/A,N/A,584,600,N/A,29,4
21,N/A,N/A,N/A,563,584,N/A,35,4
5,N/A,N/A,N/A,558,563,N/A,38,1
42,N/A,N/A,N/A,516,558,N/A,42,5
47,N/A,N/A,N/A,469,516,N/A,48,5
7,N/A,N/A,N/A,462,469,N/A,51,2
8,N/A,N/A,N/A,454,462,N/A,57,2
9,N/A,N/A,N/A,445,454,N/A,63,2
40,N/A,N/A,N/A,405,445,N/A,67,6
7,N/A,N/A,N/A,398,405,N/A,70,3
8,N/A,N/A,N/A,390,398,N/A,74,1
5,N/A,N/A,N/A,385,390,N/A,80,1
33,N/A,N/A,N/A,352,385,N/A,84,5
17,N/A,N/A,N/A,335,352,N/A,89,4
8,N/A,N/A,N/A,327,335,N/A,94,3
28,N/A,N/A,N/A,299,327,N/A,97,6
27,N/A,N/A,N/A,272,299,N/A,102,5
16,N/A,N/A,N/A,256,272,N/A,107,4
10,N/A,N/A,N/A,246,256,N/A,112,3
8,N/A,N/A,N/A,238,246,N/A,117,2
11,N/A,N/A,N/A,227,238,N/A,123,2
34,N/A,N/A,N/A,193,227,N/A,126,5
8,N/A,N/A,N/A,185,193,N/A,130,3
9,N/A,N/A,N/A,176,185,N/A,134,1
36,N/A,N/A,N/A,140,176,N/A,138,5
7,N/A,N/A,N/A,1384,1391,N/A,3,2
8,N/A,N/A,N/A,1376,1384,N/A,9,2
37,N/A,N/A,N/A,1339,1376,N/A,13,6
11,N/A,N/A,N/A,1328,1339,N/A,17,4
6,N/A,N/A,N/A,1322,1328,N/A,20,1
41,N/A,N/A,N/A,1281,1322,N/A,24,5
14,N/A,N/A,N/A,1267,1281,N/A,29,4
28,N/A,N/A,N/A,1239,1267,N/A,35,4
7,N/A,N/A,N/A,1232,1239,N/A,38,1
26,N/A,N/A,N/A,1206,1232,N/A,41,4
10,N/A,N/A,N/A,1196,1206,N/A,45,2
29,N/A,N/A,N/A,1167,1196,N/A,49,6
9,N/A,N/A,N/A,1158,1167,N/A,55,0
36,N/A,N/A,N/A,1122,1158,N/A,61,6
8,N/A,N/A,N/A,1114,1122,N/A,67,0
18,N/A,N/A,N/A,1096,1114,N/A,71,4
10,N/A,N/A,N/A,1086,1096,N/A,75,2
25,N/A,N/A,N/A,1061,1086,N/A,79,6
28,N/A,N/A,N/A,1033,1061,N/A,84,5
20,N/A,N/A,N/A,1013,1033,N/A,89,4
11,N/A,N/A,N/A,1002,1013,N/A,94,3
8,N/A,N/A,N/A,994,1002,N/A,100,3
46,N/A,N/A,N/A,948,994,N/A,103,6
21,N/A,N/A,N/A,927,948,N/A,107,4
10,N/A,N/A,N/A,917,927,N/A,111,2
6,N/A,N/A,N/A,911,917,N/A,116,1
23,N/A,N/A,N/A,888,911,N/A,119,4
9,N/A,N/A,N/A,879,888,N/A,122,1
44,N/A,N/A,N/A,835,879,N/A,127,6
7,N/A,N/A,N/A,828,835,N/A,130,3
11,N/A,N/A,N/A,1359,1370,N/A,3,2
38,N/A,N/A,N/A,1321,1359,N/A,7,6
42,N/A,N/A,N/A,1279,1321,N/A,12,5
9,N/A,N/A,N/A,1270,1279,N/A,15,2
7,N/A,N/A,N/A,1263,1270,N/A,20,1
33,N/A,N/A,N/A,1230,1263,N/A,25,6
5,N/A,N/A,N/A,1225,1230,N/A,31,0
45,N/A,N/A,N/A,1180,1225,N/A,36,5
9,N/A,N/A,N/A,1171,1180,N/A,39,2
28,N/A,N/A,N/A,1143,1171,N/A,42,5
7,N/A,N/A,N/A,1136,1143,N/A,45,2
5,N/A,N/A,N/A,1131,1136,N/A,50,1
41,N/A,N/A,N/A,1090,1131,N/A,55,6
47,N/A,N/A,N/A,1043,1090,N/A,60,5
11,N/A,N/A,N/A,1032,1043,N/A,64,3
7,N/A,N/A,N/A,1025,1032,N/A,70,3
36,N/A,N/A,N/A,989,1025,N/A,73,6
15,N/A,N/A,N/A,974,989,N/A,77,4
9,N/A,N/A,N/A,965,974,N/A,80,1
7,N/A,N/A,N/A,958,965,N/A,86,1
5,N/A,N/A,N/A,953,958,N/A,92,1
47,N/A,N/A,N/A,906,953,N/A,97,6
5,N/A,N/A,N/A,901,906,N/A,103,0
46,N/A,N/A,N/A,855,901,N/A,108,5
18,N/A,N/A,N/A,837,855,N/A,113,4
8,N/A,N/A,N/A,829,837,N/A,116,1
31,N/A,N/A,N/A,798,829,N/A,120,5
8,N/A,N/A,N/A,790,798,N/A,124,3
27,N/A,N/A,N/A,763,790,N/A,127,6
10,N/A,N/A,N/A,753,763,N/A,130,3
19,N/A,N/A,N/A,533,552,N/A,4,4
8,N/A,N/A,N/A,525,533,N/A,8,2
7,N/A,N/A,N/A,518,525,N/A,14,2
29,N/A,N/A,N/A,489,518,N/A,17,5
41,N/A,N/A,N/A,448,489,N/A,23,5
9,N/A,N/A,N/A,439,448,N/A,27,3
7,N/A,N/A,N/A,432,439,N/A,32,2
41,N/A,N/A,N/A,391,432,N/A,35,5
11,N/A,N/A,N/A,380,391,N/A,40,4
8,N/A,N/A,N/A,372,380,N/A,44,2
47,N/A,N/A,N/A,325,372,N/A,48,6
7,N/A,N/A,N/A,318,325,N/A,54,0
34,N/A,N/A,N/A,284,318,N/A,59,5
11,N/A,N/A,N/A,273,284,N/A,64,4
11,N/A,N/A,N/A,262,273,N/A,69,3
8,N/A,N/A,N/A,254,262,N/A,75,3
8,N/A,N/A,N/A,246,254,N/A,80,2
5,N/A,N/A,N/A,241,246,N/A,85,1
43,N/A,N/A,N/A,198,241,N/A,89,5
28,N/A,N/A,N/A,170,198,N/A,94,4
11,N/A,N/A,N/A,159,170,N/A,100,4
7,N/A,N/A,N/A,152,159,N/A,105,3
36,N/A,N/A,N/A,116,152,N/A,108,6
8,N/A,N/A,N/A,108,116,N/A,114,0
7,N/A,N/A,N/A,101,108,N/A,117,3
47,N/A,N/A,N/A,54,101,N/A,120,6
7,N/A,N/A,N/A,47,54,N/A,126,0
24,N/A,N/A,N/A,23,47,N/A,130,4
19,N/A,N/A,N/A,4,23,N/A,136,4
9,N/A,N/A,N/A,-5,4,N/A,139,1
32,N/A,N/A,N/A,1049,1081,N/A,6,6
9,N/A,N/A,N/A,1040,1049,N/A,12,0
17,N/A,N/A,N/A,1023,1040,N/A,16,4
10,N/A,N/A,N/A,1013,1023,N/A,21,3
10,N/A,N/A,N/A,1003,1013,N/A,26,2
5,N/A,N/A,N/A,998,1003,N/A,31,1
28,N/A,N/A,N/A,970,998,N/A,34,4
11,N/A,N/A,N/A,959,970,N/A,38,2
38,N/A,N/A,N/A,921,959,N/A,42,6
13,N/A,N/A,N/A,908,921,N/A,46,4
15,N/A,N/A,N/A,893,908,N/A,52,4
8,N/A,N/A,N/A,885,893,N/A,56,2
32,N/A,N/A,N/A,853,885,N/A,59,5
27,N/A,N/A,N/A,826,853,N/A,65,5
26,N/A,N/A,N/A,800,826,N/A,71,5
19,N/A,N/A,N/A,781,800,N/A,76,4
9,N/A,N/A,N/A,772,781,N/A,80,2
30,N/A,N/A,N/A,742,772,N/A,83,5
30,N/A,N/A,N/A,712,742,N/A,89,5
10,N/A,N/A,N/A,702,712,N/A,92,2
8,N/A,N/A,N/A,694,702,N/A,98,2
11,N/A,N/A,N/A,683,694,N/A,104,2
26,N/A,N/A,N/A,657,683,N/A,108,6
10,N/A,N/A,N/A,647,657,N/A,111,3
9,N/A,N/A,N/A,638,647,N/A,117,3
10,N/A,N/A,N/A,628,638,N/A,122,2
38,N/A,N/A,N/A,590,628,N/A,126,6
41,N/A,N/A,N/A,549,590,N/A,131,5
9,N/A,N/A,N/A,540,549,N/A,135,3
8,N/A,N/A,N/A,532,540,N/A,141,3
7,N/A,N/A,N/A,1370,1377,N/A,6,3
48,N/A,N/A,N/A,1322,1370,N/A,9,6
17,N/A,N/A,N/A,1305,1322,N/A,13,4
9,N/A,N/A,N/A,1296,1305,N/A,17,2
6,N/A,N/A,N/A,1290,1296,N/A,22,1
5,N/A,N/A,N/A,1285,1290,N/A,28,1
31,N/A,N/A,N/A,1254,1285,N/A,32,5
8,N/A,N/A,N/A,1246,1254,N/A,35,2
42,N/A,N/A,N/A,1204,1246,N/A,39,6
36,N/A,N/A,N/A,1168,1204,N/A,44,5
23,N/A,N/A,N/A,1145,1168,N/A,49,4
8,N/A,N/A,N/A,1137,1145,N/A,52,1
39,N/A,N/A,N/A,1098,1137,N/A,56,5
9,N/A,N/A,N/A,1089,1098,N/A,60,3
9,N/A,N/A,N/A,1080,1089,N/A,64,1
45,N/A,N/A,N/A,1035,1080,N/A,68,5
9,N/A,N/A,N/A,1026,1035,N/A,72,3
38,N/A,N/A,N/A,988,1026,N/A,75,6
10,N/A,N/A,N/A,978,988,N/A,78,3
7,N/A,N/A,N/A,971,978,N/A,82,1
40,N/A,N/A,N/A,931,971,N/A,87,6
8,N/A,N/A,N/A,923,931,N/A,93,0
22,N/A,N/A,N/A,901,923,N/A,97,4
6,N/A,N/A,N/A,895,901,N/A,100,1
41,N/A,N/A,N/A,854,895,N/A,105,6
22,N/A,N/A,N/A,832,854,N/A,109,4
9,N/A,N/A,N/A,823,832,N/A,114,3
28,N/A,N/A,N/A,795,823,N/A,117,6
28,N/A,N/A,N/A,767,795,N/A,122,5
12,N/A,N/A,N/A,755,767,N/A,127,4
44,N/A,N/A,N/A,923,967,N/A,6,5
49,N/A,N/A,N/A,874,923,N/A,12,5
9,N/A,N/A,N/A,865,874,N/A,15,2
11,N/A,N/A,N/A,854,865,N/A,21,2
9,N/A,N/A,N/A,845,854,N/A,27,2
6,N/A,N/A,N/A,839,845,N/A,32,1
15,N/A,N/A,N/A,824,839,N/A,35,4
8,N/A,N/A,N/A,816,824,N/A,40,3
26,N/A,N/A,N/A,790,816,N/A,43,6
43,N/A,N/A,N/A,747,790,N/A,48,5
11,N/A,N/A,N/A,736,747,N/A,52,3
7,N/A,N/A,N/A,729,736,N/A,56,1
49,N/A,N/A,N/A,680,729,N/A,60,5
36,N/A,N/A,N/A,644,680,N/A,66,5
40,N/A,N/A,N/A,604,644,N/A,72,5
39,N/A,N/A,N/A,565,604,N/A,78,5
7,N/A,N/A,N/A,558,565,N/A,82,3
5,N/A,N/A,N/A,553,558,N/A,86,1
9,N/A,N/A,N/A,544,553,N/A,92,1
19,N/A,N/A,N/A,525,544,N/A,95,4
7,N/A,N/A,N/A,518,525,N/A,100,3
5,N/A,N/A,N/A,513,518,N/A,104,1
20,N/A,N/A,N/A,493,513,N/A,107,4
9,N/A,N/A,N/A,484,493,N/A,111,2
46,N/A,N/A,N/A,438,484,N/A,114,5
10,N/A,N/A,N/A,428,438,N/A,118,3
6,N/A,N/A,N/A,422,428,N/A,122,1
33,N/A,N/A,N/A,389,422,N/A,126,5
31,N/A,N/A,N/A,358,389,N/A,132,5
9,N/A,N/A,N/A,349,358,N/A,136,3
9,N/A,N/A,N/A,431,440,N/A,4,2
7,N/A,N/A,N/A,424,431,N/A,9,1
48,N/A,N/A,N/A,376,424,N/A,13,5
25,N/A,N/A,N/A,351,376,N/A,19,5
8,N/A,N/A,N/A,343,351,N/A,23,3
7,N/A,N/A,N/A,336,343,N/A,29,3
46,N/A,N/A,N/A,290,336,N/A,32,6
43,N/A,N/A,N/A,247,290,N/A,37,5
38,N/A,N/A,N/A,209,247,N/A,43,5
32,N/A,N/A,N/A,177,209,N/A,49,5
7,N/A,N/A,N/A,170,177,N/A,53,3
5,N/A,N/A,N/A,165,170,N/A,57,1
15,N/A,N/A,N/A,150,165,N/A,60,4
14,N/A,N/A,N/A,136,150,N/A,66,4
20,N/A,N/A,N/A,116,136,N/A,72,4
5,N/A,N/A,N/A,111,116,N/A,75,1
7,N/A,N/A,N/A,104,111,N/A,81,1
6,N/A,N/A,N/A,98,104,N/A,87,1
6,N/A,N/A,N/A,92,98,N/A,93,1
7,N/A,N/A,N/A,85,92,N/A,99,1
26,N/A,N/A,N/A,59,85,N/A,104,6
36,N/A,N/A,N/A,23,59,N/A,109,5
41,N/A,N/A,N/A,-18,23,N/A,115,5
11,N/A,N/A,N/A,580,591,N/A,5,2
6,N/A,N/A,N/A,574,580,N/A,10,1
32,N/A,N/A,N/A,542,574,N/A,14,5
8,N/A,N/A,N/A,534,542,N/A,18,3
8,N/A,N/A,N/A,526,534,N/A,22,1
19,N/A,N/A,N/A,507,526,N/A,25,4
10,N/A,N/A,N/A,497,507,N/A,29,2
46,N/A,N/A,N/A,451,497,N/A,33,6
9,N/A,N/A,N/A,442,451,N/A,36,3
11,N/A,N/A,N/A,431,442,N/A,42,3
11,N/A,N/A,N/A,420,431,N/A,48,3
9,N/A,N/A,N/A,411,420,N/A,52,1
8,N/A,N/A,N/A,403,411,N/A,58,1
29,N/A,N/A,N/A,374,403,N/A,63,6
27,N/A,N/A,N/A,347,374,N/A,67,4
9,N/A,N/A,N/A,338,347,N/A,71,2
8,N/A,N/A,N/A,330,338,N/A,77,2
36,N/A,N/A,N/A,294,330,N/A,80,5
48,N/A,N/A,N/A,246,294,N/A,86,5
22,N/A,N/A,N/A,224,246,N/A,91,4
17,N/A,N/A,N/A,207,224,N/A,97,4
11,N/A,N/A,N/A,196,207,N/A,101,2
27,N/A,N/A,N/A,169,196,N/A,104,5
35,N/A,N/A,N/A,134,169,N/A,110,5
27,N/A,N/A,N/A,107,134,N/A,115,4
27,N/A,N/A,N/A,80,107,N/A,121,4
28,N/A,N/A,N/A,52,80,N/A,127,4
8,N/A,N/A,N/A,44,52,N/A,132,3
8,N/A,N/A,N/A,36,44,N/A,136,1
22,N/A,N/A,N/A,14,36,N/A,139,4
10,N/A,N/A,N/A,1502,1512,N/A,5,2
49,N/A,N/A,N/A,1453,1502,N/A,8,5
10,N/A,N/A,N/A,1443,1453,N/A,13,4
7,N/A,N/A,N/A,1436,1443,N/A,16,1
8,N/A,N/A,N/A,1428,1436,N/A,22,1
36,N/A,N/A,N/A,1392,1428,N/A,27,6
43,N/A,N/A,N/A,1349,1392,N/A,32,5
8,N/A,N/A,N/A,1341,1349,N/A,35,2
28,N/A,N/A,N/A,1313,1341,N/A,38,5
8,N/A,N/A,N/A,1305,1313,N/A,41,2
41,N/A,N/A,N/A,1264,1305,N/A,44,5
45,N/A,N/A,N/A,1219,1264,N/A,50,5
7,N/A,N/A,N/A,1212,1219,N/A,54,3
30,N/A,N/A,N/A,1182,1212,N/A,57,6
9,N/A,N/A,N/A,1173,1182,N/A,63,0
36,N/A,N/A,N/A,1137,1173,N/A,68,5
28,N/A,N/A,N/A,1109,1137,N/A,74,5
11,N/A,N/A,N/A,1098,1109,N/A,77,2
29,N/A,N/A,N/A,1069,1098,N/A,81,6
10,N/A,N/A,N/A,1059,1069,N/A,84,3
10,N/A,N/A,N/A,1049,1059,N/A,90,3
9,N/A,N/A,N/A,1040,1049,N/A,94,1
26,N/A,N/A,N/A,1014,1040,N/A,97,4
10,N/A,N/A,N/A,1004,1014,N/A,101,2
26,N/A,N/A,N/A,978,1004,N/A,105,6
36,N/A,N/A,N/A,942,978,N/A,110,5
34,N/A,N/A,N/A,908,942,N/A,116,5
7,N/A,N/A,N/A,901,908,N/A,119,2
9,N/A,N/A,N/A,892,901,N/A,124,1
28,N/A,N/A,N/A,864,892,N/A,127,4
42,N/A,N/A,N/A,387,429,N/A,6,5
35,N/A,N/A,N/A,352,387,N/A,12,5
8,N/A,N/A,N/A,344,352,N/A,16,3
25,N/A,N/A,N/A,319,344,N/A,19,6
35,N/A,N/A,N/A,284,319,N/A,24,5
8,N/A,N/A,N/A,276,284,N/A,28,3
7,N/A,N/A,N/A,269,276,N/A,34,3
29,N/A,N/A,N/A,240,269,N/A,37,6
9,N/A,N/A,N/A,231,240,N/A,40,3
5,N/A,N/A,N/A,226,231,N/A,44,1
9,N/A,N/A,N/A,217,226,N/A,50,1
44,N/A,N/A,N/A,173,217,N/A,55,6
10,N/A,N/A,N/A,163,173,N/A,58,3
39,N/A,N/A,N/A,124,163,N/A,61,6
45,N/A,N/A,N/A,79,124,N/A,66,5
11,N/A,N/A,N/A,68,79,N/A,69,2
34,N/A,N/A,N/A,34,68,N/A,72,5
8,N/A,N/A,N/A,26,34,N/A,75,2
9,N/A,N/A,N/A,17,26,N/A,80,1
35,N/A,N/A,N/A,-18,17,N/A,85,6
6,N/A,N/A,N/A,361,367,N/A,3,1
25,N/A,N/A,N/A,336,361,N/A,7,5
7,N/A,N/A,N/A,329,336,N/A,11,3
10,N/A,N/A,N/A,319,329,N/A,16,2
27,N/A,N/A,N/A,292,319,N/A,20,6
13,N/A,N/A,N/A,279,292,N/A,24,4
9,N/A,N/A,N/A,270,279,N/A,27,1
17,N/A,N/A,N/A,253,270,N/A,30,4
7,N/A,N/A,N/A,246,253,N/A,34,2
46,N/A,N/A,N/A,200,246,N/A,38,6
12,N/A,N/A,N/A,188,200,N/A,42,4
5,N/A,N/A,N/A,183,188,N/A,45,1
29,N/A,N/A,N/A,154,183,N/A,50,6
5,N/A,N/A,N/A,149,154,N/A,56,0
42,N/A,N/A,N/A,107,149,N/A,62,6
27,N/A,N/A,N/A,80,107,N/A,66,4
9,N/A,N/A,N/A,71,80,N/A,71,3
5,N/A,N/A,N/A,66,71,N/A,75,1
11,N/A,N/A,N/A,55,66,N/A,78,4
8,N/A,N/A,N/A,47,55,N/A,82,2
26,N/A,N/A,N/A,21,47,N/A,86,6
29,N/A,N/A,N/A,-8,21,N/A,90,4
15,N/A,N/A,N/A,1059,1074,N/A,3,4
7,N/A,N/A,N/A,1052,1059,N/A,6,1
8,N/A,N/A,N/A,1044,1052,N/A,12,1
38,N/A,N/A,N/A,1006,1044,N/A,17,6
6,N/A,N/A,N/A,1000,1006,N/A,23,0
27,N/A,N/A,N/A,973,1000,N/A,27,4
23,N/A,N/A,N/A,950,973,N/A,33,4
29,N/A,N/A,N/A,921,950,N/A,39,4
7,N/A,N/A,N/A,914,921,N/A,43,2
37,N/A,N/A,N/A,877,914,N/A,46,5
14,N/A,N/A,N/A,863,877,N/A,51,4
6,N/A,N/A,N/A,857,863,N/A,54,1
6,N/A,N/A,N/A,851,857,N/A,60,1
15,N/A,N/A,N/A,836,851,N/A,63,4
7,N/A,N/A,N/A,829,836,N/A,67,2
8,N/A,N/A,N/A,821,829,N/A,72,1
28,N/A,N/A,N/A,793,821,N/A,75,4
11,N/A,N/A,N/A,782,793,N/A,81,4
22,N/A,N/A,N/A,760,782,N/A,87,4
12,N/A,N/A,N/A,748,760,N/A,93,4
9,N/A,N/A,N/A,739,748,N/A,96,1
31,N/A,N/A,N/A,708,739,N/A,101,6
42,N/A,N/A,N/A,666,708,N/A,106,5
35,N/A,N/A,N/A,631,666,N/A,112,5
17,N/A,N/A,N/A,614,631,N/A,117,4
5,N/A,N/A,N/A,609,614,N/A,120,1
47,N/A,N/A,N/A,562,609,N/A,125,6
9,N/A,N/A,N/A,553,562,N/A,131,0
48,N/A,N/A,N/A,505,553,N/A,136,5
22,N/A,N/A,N/A,483,505,N/A,141,4
25,N/A,N/A,N/A,1243,1268,N/A,6,5
10,N/A,N/A,N/A,1233,1243,N/A,10,3
10,N/A,N/A,N/A,1223,1233,N/A,15,2
6,N/A,N/A,N/A,1217,1223,N/A,20,1
12,N/A,N/A,N/A,1205,1217,N/A,23,4
9,N/A,N/A,N/A,1196,1205,N/A,27,2
8,N/A,N/A,N/A,1188,1196,N/A,33,2
36,N/A,N/A,N/A,1152,1188,N/A,37,6
7,N/A,N/A,N/A,1145,1152,N/A,43,0
7,N/A,N/A,N/A,1138,1145,N/A,46,3
9,N/A,N/A,N/A,1129,1138,N/A,52,3
9,N/A,N/A,N/A,1120,1129,N/A,58,3
10,N/A,N/A,N/A,1110,1120,N/A,64,3
8,N/A,N/A,N/A,1102,1110,N/A,68,1
41,N/A,N/A,N/A,1061,1102,N/A,72,5
48,N/A,N/A,N/A,1013,1061,N/A,78,5
42,N/A,N/A,N/A,971,1013,N/A,84,5
11,N/A,N/A,N/A,960,971,N/A,89,4
7,N/A,N/A,N/A,953,960,N/A,93,2
9,N/A,N/A,N/A,944,953,N/A,98,1
44,N/A,N/A,N/A,900,944,N/A,103,6
34,N/A,N/A,N/A,866,900,N/A,108,5
11,N/A,N/A,N/A,855,866,N/A,112,3
11,N/A,N/A,N/A,844,855,N/A,118,3
9,N/A,N/A,N/A,835,844,N/A,124,3
11,N/A,N/A,N/A,824,835,N/A,130,3
8,N/A,N/A,N/A,816,824,N/A,134,1
12,N/A,N/A,N/A,804,816,N/A,137,4
27,N/A,N/A,N/A,777,804,N/A,143,4
8,N/A,N/A,N/A,769,777,N/A,148,3
26,N/A,N/A,N/A,319,345,N/A,5,6
6,N/A,N/A,N/A,313,319,N/A,11,0
47,N/A,N/A,N/A,266,313,N/A,16,5
30,N/A,N/A,N/A,236,266,N/A,22,5
10,N/A,N/A,N/A,226,236,N/A,26,3
11,N/A,N/A,N/A,215,226,N/A,31,2
9,N/A,N/A,N/A,206,215,N/A,36,1
39,N/A,N/A,N/A,167,206,N/A,40,5
21,N/A,N/A,N/A,146,167,N/A,45,4
9,N/A,N/A,N/A,137,146,N/A,49,2
46,N/A,N/A,N/A,91,137,N/A,53,6
39,N/A,N/A,N/A,52,91,N/A,58,5
15,N/A,N/A,N/A,37,52,N/A,63,4
7,N/A,N/A,N/A,30,37,N/A,67,2
7,N/A,N/A,N/A,23,30,N/A,72,1
45,N/A,N/A,N/A,-22,23,N/A,77,6
30,N/A,N/A,N/A,1133,1163,N/A,3,5
9,N/A,N/A,N/A,1124,1133,N/A,6,2
34,N/A,N/A,N/A,1090,1124,N/A,10,6
9,N/A,N/A,N/A,1081,1090,N/A,13,3
42,N/A,N/A,N/A,1039,1081,N/A,16,6
8,N/A,N/A,N/A,1031,1039,N/A,22,0
8,N/A,N/A,N/A,1023,1031,N/A,25,3
46,N/A,N/A,N/A,977,1023,N/A,28,6
47,N/A,N/A,N/A,930,977,N/A,33,5
34,N/A,N/A,N/A,896,930,N/A,39,5
7,N/A,N/A,N/A,889,896,N/A,43,3
5,N/A,N/A,N/A,884,889,N/A,47,1
45,N/A,N/A,N/A,839,884,N/A,51,5
36,N/A,N/A,N/A,803,839,N/A,57,5
22,N/A,N/A,N/A,781,803,N/A,62,4
15,N/A,N/A,N/A,766,781,N/A,68,4
10,N/A,N/A,N/A,756,766,N/A,72,2
8,N/A,N/A,N/A,748,756,N/A,77,1
31,N/A,N/A,N/A,717,748,N/A,81,5
7,N/A,N/A,N/A,710,717,N/A,84,2
44,N/A,N/A,N/A,666,710,N/A,87,5
8,N/A,N/A,N/A,658,666,N/A,91,3
40,N/A,N/A,N/A,618,658,N/A,94,6
9,N/A,N/A,N/A,609,618,N/A,100,0
11,N/A,N/A,N/A,598,609,N/A,104,4
7,N/A,N/A,N/A,591,598,N/A,109,3
7,N/A,N/A,N/A,584,591,N/A,115,3
7,N/A,N/A,N/A,577,584,N/A,120,2
35,N/A,N/A,N/A,542,577,N/A,123,5
16,N/A,N/A,N/A,526,542,N/A,128,4
7,N/A,N/A,N/A,1397,1404,N/A,3,1
5,N/A,N/A,N/A,1392,1397,N/A,9,1
28,N/A,N/A,N/A,1364,1392,N/A,14,6
19,N/A,N/A,N/A,1345,1364,N/A,18,4
5,N/A,N/A,N/A,1340,1345,N/A,21,1
45,N/A,N/A,N/A,1295,1340,N/A,25,5
9,N/A,N/A,N/A,1286,1295,N/A,28,2
30,N/A,N/A,N/A,1256,1286,N/A,31,5
10,N/A,N/A,N/A,1246,1256,N/A,34,2
42,N/A,N/A,N/A,1204,1246,N/A,38,6
23,N/A,N/A,N/A,1181,1204,N/A,42,4
22,N/A,N/A,N/A,1159,1181,N/A,48,4
10,N/A,N/A,N/A,1149,1159,N/A,52,2
48,N/A,N/A,N/A,1101,1149,N/A,56,6
9,N/A,N/A,N/A,1092,1101,N/A,62,0
41,N/A,N/A,N/A,1051,1092,N/A,68,6
29,N/A,N/A,N/A,1022,1051,N/A,72,4
8,N/A,N/A,N/A,1014,1022,N/A,77,3
9,N/A,N/A,N/A,1005,1014,N/A,82,2
7,N/A,N/A,N/A,998,1005,N/A,87,1
46,N/A,N/A,N/A,952,998,N/A,91,5
10,N/A,N/A,N/A,942,952,N/A,95,3
11,N/A,N/A,N/A,931,942,N/A,101,3
8,N/A,N/A,N/A,923,931,N/A,106,2
7,N/A,N/A,N/A,916,923,N/A,111,1
27,N/A,N/A,N/A,889,916,N/A,116,6
19,N/A,N/A,N/A,870,889,N/A,120,4
11,N/A,N/A,N/A,859,870,N/A,124,2
7,N/A,N/A,N/A,852,859,N/A,129,1
25,N/A,N/A,N/A,827,852,N/A,134,6
36,N/A,N/A,N/A,586,622,N/A,5,6
6,N/A,N/A,N/A,580,586,N/A,11,0
26,N/A,N/A,N/A,554,580,N/A,17,6
10,N/A,N/A,N/A,544,554,N/A,20,3
9,N/A,N/A,N/A,535,544,N/A,26,3
9,N/A,N/A,N/A,526,535,N/A,30,1
5,N/A,N/A,N/A,521,526,N/A,36,1
26,N/A,N/A,N/A,495,521,N/A,39,4
7,N/A,N/A,N/A,488,495,N/A,42,1
26,N/A,N/A,N/A,462,488,N/A,46,5
7,N/A,N/A,N/A,455,462,N/A,50,3
11,N/A,N/A,N/A,444,455,N/A,56,3
29,N/A,N/A,N/A,415,444,N/A,59,6
21,N/A,N/A,N/A,394,415,N/A,63,4
7,N/A,N/A,N/A,387,394,N/A,66,1
28,N/A,N/A,N/A,359,387,N/A,71,6
10,N/A,N/A,N/A,349,359,N/A,75,4
6,N/A,N/A,N/A,343,349,N/A,78,1
26,N/A,N/A,N/A,317,343,N/A,82,5
10,N/A,N/A,N/A,307,317,N/A,85,2
7,N/A,N/A,N/A,300,307,N/A,90,1
7,N/A,N/A,N/A,293,300,N/A,96,1
31,N/A,N/A,N/A,262,293,N/A,100,5
11,N/A,N/A,N/A,251,262,N/A,103,2
8,N/A,N/A,N/A,243,251,N/A,108,1
9,N/A,N/A,N/A,234,243,N/A,114,1
5,N/A,N/A,N/A,229,234,N/A,120,1
28,N/A,N/A,N/A,201,229,N/A,125,6
25,N/A,N/A,N/A,176,201,N/A,130,5
8,N/A,N/A,N/A,168,176,N/A,134,3
28,N/A,N/A,N/A,836,864,N/A,4,5
24,N/A,N/A,N/A,812,836,N/A,9,4
8,N/A,N/A,N/A,804,812,N/A,12,1
37,N/A,N/A,N/A,767,804,N/A,17,6
10,N/A,N/A,N/A,757,767,N/A,20,3
7,N/A,N/A,N/A,750,757,N/A,26,3
6,N/A,N/A,N/A,744,750,N/A,30,1
6,N/A,N/A,N/A,738,744,N/A,36,1
39,N/A,N/A,N/A,699,738,N/A,41,6
11,N/A,N/A,N/A,688,699,N/A,45,4
8,N/A,N/A,N/A,680,688,N/A,50,3
8,N/A,N/A,N/A,672,680,N/A,54,1
41,N/A,N/A,N/A,631,672,N/A,59,6
16,N/A,N/A,N/A,615,631,N/A,63,4
7,N/A,N/A,N/A,608,615,N/A,68,3
9,N/A,N/A,N/A,599,608,N/A,73,2
49,N/A,N/A,N/A,550,599,N/A,76,5
9,N/A,N/A,N/A,541,550,N/A,80,3
5,N/A,N/A,N/A,536,541,N/A,84,1
31,N/A,N/A,N/A,505,536,N/A,89,6
29,N/A,N/A,N/A,476,505,N/A,93,4
9,N/A,N/A,N/A,467,476,N/A,97,2
47,N/A,N/A,N/A,420,467,N/A,101,6
28,N/A,N/A,N/A,392,420,N/A,105,4
26,N/A,N/A,N/A,366,392,N/A,111,4
5,N/A,N/A,N/A,361,366,N/A,114,1
8,N/A,N/A,N/A,353,361,N/A,120,1
24,N/A,N/A,N/A,329,353,N/A,123,4
11,N/A,N/A,N/A,318,329,N/A,127,2
8,N/A,N/A,N/A,310,318,N/A,132,1
29,N/A,N/A,N/A,564,593,N/A,4,4
9,N/A,N/A,N/A,555,564,N/A,8,2
48,N/A,N/A,N/A,507,555,N/A,12,6
28,N/A,N/A,N/A,479,507,N/A,16,4
8,N/A,N/A,N/A,471,479,N/A,20,2
9,N/A,N/A,N/A,462,471,N/A,26,2
7,N/A,N/A,N/A,455,462,N/A,32,2
44,N/A,N/A,N/A,411,455,N/A,35,5
32,N/A,N/A,N/A,379,411,N/A,41,5
30,N/A,N/A,N/A,349,379,N/A,47,5
10,N/A,N/A,N/A,339,349,N/A,52,4
28,N/A,N/A,N/A,311,339,N/A,58,4
7,N/A,N/A,N/A,304,311,N/A,61,1
6,N/A,N/A,N/A,298,304,N/A,67,1
6,N/A,N/A,N/A,292,298,N/A,73,1
34,N/A,N/A,N/A,258,292,N/A,77,5
7,N/A,N/A,N/A,251,258,N/A,80,2
7,N/A,N/A,N/A,244,251,N/A,85,1
32,N/A,N/A,N/A,212,244,N/A,89,5
20,N/A,N/A,N/A,192,212,N/A,94,4
9,N/A,N/A,N/A,183,192,N/A,97,1
38,N/A,N/A,N/A,145,183,N/A,101,5
9,N/A,N/A,N/A,136,145,N/A,104,2
7,N/A,N/A,N/A,129,136,N/A,110,2
7,N/A,N/A,N/A,122,129,N/A,115,1
5,N/A,N/A,N/A,117,122,N/A,121,1
31,N/A,N/A,N/A,86,117,N/A,125,5
24,N/A,N/A,N/A,62,86,N/A,130,4
7,N/A,N/A,N/A,55,62,N/A,134,2
41,N/A,N/A,N/A,14,55,N/A,137,5
43,N/A,N/A,N/A,1667,1710,N/A,4,5
10,N/A,N/A,N/A,1657,1667,N/A,7,2
35,N/A,N/A,N/A,1622,1657,N/A,11,6
16,N/A,N/A,N/A,1606,1622,N/A,15,4
6,N/A,N/A,N/A,1600,1606,N/A,18,1
28,N/A,N/A,N/A,1572,1600,N/A,22,5
20,N/A,N/A,N/A,1552,1572,N/A,27,4
5,N/A,N/A,N/A,1547,1552,N/A,30,1
28,N/A,N/A,N/A,1519,1547,N/A,33,4
10,N/A,N/A,N/A,1509,1519,N/A,38,3
28,N/A,N/A,N/A,1481,1509,N/A,41,6
40,N/A,N/A,N/A,1441,1481,N/A,46,5
26,N/A,N/A,N/A,1415,1441,N/A,52,5
42,N/A,N/A,N/A,1373,1415,N/A,58,5
20,N/A,N/A,N/A,1353,1373,N/A,63,4
28,N/A,N/A,N/A,1325,1353,N/A,69,4
18,N/A,N/A,N/A,1307,1325,N/A,75,4
8,N/A,N/A,N/A,1299,1307,N/A,78,1
24,N/A,N/A,N/A,1275,1299,N/A,81,4
18,N/A,N/A,N/A,1257,1275,N/A,87,4
9,N/A,N/A,N/A,1248,1257,N/A,92,3
7,N/A,N/A,N/A,1241,1248,N/A,98,3
6,N/A,N/A,N/A,1235,1241,N/A,102,1
7,N/A,N/A,N/A,1228,1235,N/A,108,1
7,N/A,N/A,N/A,1221,1228,N/A,114,1
5,N/A,N/A,N/A,1216,1221,N/A,120,1
17,N/A,N/A,N/A,1199,1216,N/A,123,4
23,N/A,N/A,N/A,1176,1199,N/A,129,4
5,N/A,N/A,N/A,1171,1176,N/A,132,1
37,N/A,N/A,N/A,1134,1171,N/A,136,5
9,N/A,N/A,N/A,1431,1440,N/A,3,2
33,N/A,N/A,N/A,1398,1431,N/A,7,6
8,N/A,N/A,N/A,1390,1398,N/A,10,3
8,N/A,N/A,N/A,1382,1390,N/A,15,2
9,N/A,N/A,N/A,1373,1382,N/A,21,2
9,N/A,N/A,N/A,1364,1373,N/A,27,2
30,N/A,N/A,N/A,1334,1364,N/A,30,5
8,N/A,N/A,N/A,1326,1334,N/A,33,2
9,N/A,N/A,N/A,1317,1326,N/A,38,1
21,N/A,N/A,N/A,1296,1317,N/A,41,4
8,N/A,N/A,N/A,1288,1296,N/A,45,2
9,N/A,N/A,N/A,1279,1288,N/A,50,1
47,N/A,N/A,N/A,1232,1279,N/A,54,5
40,N/A,N/A,N/A,1192,1232,N/A,60,5
43,N/A,N/A,N/A,1149,1192,N/A,66,5
8,N/A,N/A,N/A,1141,1149,N/A,70,3
11,N/A,N/A,N/A,1130,1141,N/A,75,2
41,N/A,N/A,N/A,1089,1130,N/A,79,6
18,N/A,N/A,N/A,1071,1089,N/A,83,4
11,N/A,N/A,N/A,1060,1071,N/A,87,2
44,N/A,N/A,N/A,1016,1060,N/A,91,6
46,N/A,N/A,N/A,970,1016,N/A,96,5
7,N/A,N/A,N/A,963,970,N/A,100,3
6,N/A,N/A,N/A,957,963,N/A,104,1
16,N/A,N/A,N/A,941,957,N/A,107,4
10,N/A,N/A,N/A,931,941,N/A,112,3
7,N/A,N/A,N/A,924,931,N/A,116,1
31,N/A,N/A,N/A,893,924,N/A,120,5
10,N/A,N/A,N/A,883,893,N/A,123,2
6,N/A,N/A,N/A,877,883,N/A,128,1
5,N/A,N/A,N/A,1540,1545,N/A,6,1
6,N/A,N/A,N/A,1534,1540,N/A,12,1
6,N/A,N/A,N/A,1528,1534,N/A,18,1
45,N/A,N/A,N/A,1483,1528,N/A,22,5
23,N/A,N/A,N/A,1460,1483,N/A,27,4
8,N/A,N/A,N/A,1452,1460,N/A,32,3
7,N/A,N/A,N/A,1445,1452,N/A,36,1
47,N/A,N/A,N/A,1398,1445,N/A,40,5
17,N/A,N/A,N/A,1381,1398,N/A,45,4
11,N/A,N/A,N/A,1370,1381,N/A,50,3
5,N/A,N/A,N/A,1365,1370,N/A,54,1
25,N/A,N/A,N/A,1340,1365,N/A,59,6
33,N/A,N/A,N/A,1307,1340,N/A,64,5
39,N/A,N/A,N/A,1268,1307,N/A,70,5
40,N/A,N/A,N/A,1228,1268,N/A,76,5
22,N/A,N/A,N/A,1206,1228,N/A,81,4
7,N/A,N/A,N/A,1199,1206,N/A,85,2
9,N/A,N/A,N/A,1190,1199,N/A,90,1
7,N/A,N/A,N/A,1183,1190,N/A,96,1
16,N/A,N/A,N/A,1167,1183,N/A,99,4
9,N/A,N/A,N/A,1158,1167,N/A,102,1
36,N/A,N/A,N/A,1122,1158,N/A,107,6
9,N/A,N/A,N/A,1113,1122,N/A,110,3
44,N/A,N/A,N/A,1069,1113,N/A,113,6
11,N/A,N/A,N/A,1058,1069,N/A,117,4
22,N/A,N/A,N/A,1036,1058,N/A,123,4
7,N/A,N/A,N/A,1029,1036,N/A,128,3
10,N/A,N/A,N/A,1019,1029,N/A,133,2
26,N/A,N/A,N/A,993,1019,N/A,136,5
42,N/A,N/A,N/A,951,993,N/A,142,5
10,N/A,N/A,N/A,1959,1969,N/A,6,2
7,N/A,N/A,N/A,1952,1959,N/A,11,1
15,N/A,N/A,N/A,1937,1952,N/A,14,4
23,N/A,N/A,N/A,1914,1937,N/A,20,4
19,N/A,N/A,N/A,1895,1914,N/A,26,4
10,N/A,N/A,N/A,1885,1895,N/A,31,3
40,N/A,N/A,N/A,1845,1885,N/A,34,6
7,N/A,N/A,N/A,1838,1845,N/A,37,3
8,N/A,N/A,N/A,1830,1838,N/A,43,3
8,N/A,N/A,N/A,1822,1830,N/A,47,1
14,N/A,N/A,N/A,1808,1822,N/A,50,4
8,N/A,N/A,N/A,1800,1808,N/A,54,2
8,N/A,N/A,N/A,1792,1800,N/A,60,2
35,N/A,N/A,N/A,1757,1792,N/A,63,5
45,N/A,N/A,N/A,1712,1757,N/A,69,5
20,N/A,N/A,N/A,1692,1712,N/A,74,4
6,N/A,N/A,N/A,1686,1692,N/A,77,1
6,N/A,N/A,N/A,1680,1686,N/A,83,1
8,N/A,N/A,N/A,1672,1680,N/A,89,1
8,N/A,N/A,N/A,1664,1672,N/A,95,1
20,N/A,N/A,N/A,1644,1664,N/A,98,4
10,N/A,N/A,N/A,1634,1644,N/A,103,3
9,N/A,N/A,N/A,1625,1634,N/A,108,2
6,N/A,N/A,N/A,1619,1625,N/A,113,1
11,N/A,N/A,N/A,1608,1619,N/A,116,4
9,N/A,N/A,N/A,1599,1608,N/A,119,1
37,N/A,N/A,N/A,1562,1599,N/A,124,6
48,N/A,N/A,N/A,1514,1562,N/A,129,5
33,N/A,N/A,N/A,1481,1514,N/A,135,5
17,N/A,N/A,N/A,1464,1481,N/A,140,4
10,N/A,N/A,N/A,1353,1363,N/A,4,2
8,N/A,N/A,N/A,1345,1353,N/A,9,1
5,N/A,N/A,N/A,1340,1345,N/A,15,1
40,N/A,N/A,N/A,1300,1340,N/A,19,5
7,N/A,N/A,N/A,1293,1300,N/A,22,2
40,N/A,N/A,N/A,1253,1293,N/A,25,5
8,N/A,N/A,N/A,1245,1253,N/A,29,3
9,N/A,N/A,N/A,1236,1245,N/A,34,2
5,N/A,N/A,N/A,1231,1236,N/A,39,1
18,N/A,N/A,N/A,1213,1231,N/A,42,4
9,N/A,N/A,N/A,1204,1213,N/A,45,1
27,N/A,N/A,N/A,1177,1204,N/A,50,6
11,N/A,N/A,N/A,1166,1177,N/A,53,3
7,N/A,N/A,N/A,1159,1166,N/A,57,1
41,N/A,N/A,N/A,1118,1159,N/A,61,5
10,N/A,N/A,N/A,1108,1118,N/A,64,2
7,N/A,N/A,N/A,1101,1108,N/A,70,2
11,N/A,N/A,N/A,1090,1101,N/A,76,2
9,N/A,N/A,N/A,1081,1090,N/A,82,2
27,N/A,N/A,N/A,1054,1081,N/A,85,5
9,N/A,N/A,N/A,1045,1054,N/A,89,3
9,N/A,N/A,N/A,1036,1045,N/A,94,2
9,N/A,N/A,N/A,1027,1036,N/A,99,1
8,N/A,N/A,N/A,1019,1027,N/A,105,1
18,N/A,N/A,N/A,1001,1019,N/A,108,4
11,N/A,N/A,N/A,990,1001,N/A,113,3
39,N/A,N/A,N/A,951,990,N/A,116,6
5,N/A,N/A,N/A,946,951,N/A,122,0
49,N/A,N/A,N/A,897,946,N/A,128,6
47,N/A,N/A,N/A,850,897,N/A,133,5
11,N/A,N/A,N/A,730,741,N/A,3,2
10,N/A,N/A,N/A,720,730,N/A,9,2
7,N/A,N/A,N/A,713,720,N/A,14,1
31,N/A,N/A,N/A,682,713,N/A,18,5
8,N/A,N/A,N/A,674,682,N/A,22,3
6,N/A,N/A,N/A,668,674,N/A,26,1
21,N/A,N/A,N/A,647,668,N/A,29,4
20,N/A,N/A,N/A,627,647,N/A,35,4
14,N/A,N/A,N/A,613,627,N/A,41,4
26,N/A,N/A,N/A,587,613,N/A,47,4
8,N/A,N/A,N/A,579,587,N/A,50,1
45,N/A,N/A,N/A,534,579,N/A,55,6
10,N/A,N/A,N/A,524,534,N/A,58,3
35,N/A,N/A,N/A,489,524,N/A,61,6
8,N/A,N/A,N/A,481,489,N/A,64,3
38,N/A,N/A,N/A,443,481,N/A,67,6
7,N/A,N/A,N/A,436,443,N/A,73,0
29,N/A,N/A,N/A,407,436,N/A,79,6
44,N/A,N/A,N/A,363,407,N/A,84,5
29,N/A,N/A,N/A,334,363,N/A,89,4
10,N/A,N/A,N/A,324,334,N/A,94,3
8,N/A,N/A,N/A,316,324,N/A,99,2
9,N/A,N/A,N/A,307,316,N/A,105,2
6,N/A,N/A,N/A,301,307,N/A,110,1
46,N/A,N/A,N/A,255,301,N/A,114,5
43,N/A,N/A,N/A,212,255,N/A,120,5
11,N/A,N/A,N/A,201,212,N/A,125,4
11,N/A,N/A,N/A,190,201,N/A,130,3
46,N/A,N/A,N/A,144,190,N/A,133,6
5,N/A,N/A,N/A,139,144,N/A,139,0
7,N/A,N/A,N/A,837,844,N/A,4,3
11,N/A,N/A,N/A,826,837,N/A,10,3
9,N/A,N/A,N/A,817,826,N/A,15,2
9,N/A,N/A,N/A,808,817,N/A,21,2
7,N/A,N/A,N/A,801,808,N/A,26,1
6,N/A,N/A,N/A,795,801,N/A,32,1
27,N/A,N/A,N/A,768,795,N/A,35,4
7,N/A,N/A,N/A,761,768,N/A,38,1
24,N/A,N/A,N/A,737,761,N/A,41,4
9,N/A,N/A,N/A,728,737,N/A,46,3
48,N/A,N/A,N/A,680,728,N/A,49,6
15,N/A,N/A,N/A,665,680,N/A,53,4
8,N/A,N/A,N/A,657,665,N/A,57,2
8,N/A,N/A,N/A,649,657,N/A,62,1
9,N/A,N/A,N/A,640,649,N/A,68,1
23,N/A,N/A,N/A,617,640,N/A,71,4
7,N/A,N/A,N/A,610,617,N/A,74,1
6,N/A,N/A,N/A,604,610,N/A,80,1
35,N/A,N/A,N/A,569,604,N/A,84,5
10,N/A,N/A,N/A,559,569,N/A,89,4
11,N/A,N/A,N/A,548,559,N/A,94,3
45,N/A,N/A,N/A,503,548,N/A,97,6
33,N/A,N/A,N/A,470,503,N/A,102,5
28,N/A,N/A,N/A,442,470,N/A,107,4
11,N/A,N/A,N/A,431,442,N/A,111,2
25,N/A,N/A,N/A,406,431,N/A,115,6
14,N/A,N/A,N/A,392,406,N/A,119,4
20,N/A,N/A,N/A,372,392,N/A,125,4
9,N/A,N/A,N/A,363,372,N/A,129,2
11,N/A,N/A,N/A,352,363,N/A,135,2
31,N/A,N/A,N/A,1302,1333,N/A,6,5
49,N/A,N/A,N/A,1253,1302,N/A,12,5
9,N/A,N/A,N/A,1244,1253,N/A,15,2
27,N/A,N/A,N/A,1217,1244,N/A,18,5
29,N/A,N/A,N/A,1188,1217,N/A,24,5
31,N/A,N/A,N/A,1157,1188,N/A,30,5
26,N/A,N/A,N/A,1131,1157,N/A,35,4
26,N/A,N/A,N/A,1105,1131,N/A,41,4
10,N/A,N/A,N/A,1095,1105,N/A,45,2
7,N/A,N/A,N/A,1088,1095,N/A,50,1
42,N/A,N/A,N/A,1046,1088,N/A,55,6
45,N/A,N/A,N/A,1001,1046,N/A,60,5
43,N/A,N/A,N/A,958,1001,N/A,66,5
7,N/A,N/A,N/A,951,958,N/A,69,2
10,N/A,N/A,N/A,941,951,N/A,75,2
34,N/A,N/A,N/A,907,941,N/A,79,6
5,N/A,N/A,N/A,902,907,N/A,85,0
10,N/A,N/A,N/A,892,902,N/A,88,3
47,N/A,N/A,N/A,845,892,N/A,91,6
5,N/A,N/A,N/A,840,845,N/A,97,0
31,N/A,N/A,N/A,809,840,N/A,103,6
10,N/A,N/A,N/A,799,809,N/A,106,3
8,N/A,N/A,N/A,791,799,N/A,110,1
8,N/A,N/A,N/A,783,791,N/A,116,1
9,N/A,N/A,N/A,774,783,N/A,122,1
44,N/A,N/A,N/A,730,774,N/A,127,6
27,N/A,N/A,N/A,703,730,N/A,131,4
9,N/A,N/A,N/A,694,703,N/A,134,1
27,N/A,N/A,N/A,667,694,N/A,139,6
8,N/A,N/A,N/A,659,667,N/A,145,0
38,N/A,N/A,N/A,587,625,N/A,3,6
29,N/A,N/A,N/A,558,587,N/A,8,5
7,N/A,N/A,N/A,551,558,N/A,11,2
5,N/A,N/A,N/A,546,551,N/A,16,1
33,N/A,N/A,N/A,513,546,N/A,20,5
8,N/A,N/A,N/A,505,513,N/A,23,2
49,N/A,N/A,N/A,456,505,N/A,26,5
12,N/A,N/A,N/A,444,456,N/A,31,4
8,N/A,N/A,N/A,436,444,N/A,35,2
10,N/A,N/A,N/A,426,436,N/A,41,2
31,N/A,N/A,N/A,395,426,N/A,44,5
11,N/A,N/A,N/A,384,395,N/A,48,3
7,N/A,N/A,N/A,377,384,N/A,53,2
11,N/A,N/A,N/A,366,377,N/A,59,2
9,N/A,N/A,N/A,357,366,N/A,65,2
27,N/A,N/A,N/A,330,357,N/A,68,5
10,N/A,N/A,N/A,320,330,N/A,71,2
7,N/A,N/A,N/A,313,320,N/A,76,1
27,N/A,N/A,N/A,286,313,N/A,79,4
7,N/A,N/A,N/A,279,286,N/A,84,3
9,N/A,N/A,N/A,270,279,N/A,89,2
29,N/A,N/A,N/A,241,270,N/A,92,5
10,N/A,N/A,N/A,231,241,N/A,95,2
34,N/A,N/A,N/A,197,231,N/A,99,6
8,N/A,N/A,N/A,189,197,N/A,105,0
37,N/A,N/A,N/A,152,189,N/A,111,6
8,N/A,N/A,N/A,144,152,N/A,114,3
11,N/A,N/A,N/A,133,144,N/A,120,3
27,N/A,N/A,N/A,106,133,N/A,123,6
11,N/A,N/A,N/A,95,106,N/A,126,3
10,N/A,N/A,N/A,901,911,N/A,4,3
34,N/A,N/A,N/A,867,901,N/A,7,6
48,N/A,N/A,N/A,819,867,N/A,12,5
11,N/A,N/A,N/A,808,819,N/A,16,3
7,N/A,N/A,N/A,801,808,N/A,20,1
18,N/A,N/A,N/A,783,801,N/A,23,4
9,N/A,N/A,N/A,774,783,N/A,26,1
13,N/A,N/A,N/A,761,774,N/A,29,4
5,N/A,N/A,N/A,756,761,N/A,32,1
42,N/A,N/A,N/A,714,756,N/A,36,5
9,N/A,N/A,N/A,705,714,N/A,39,2
6,N/A,N/A,N/A,699,705,N/A,44,1
23,N/A,N/A,N/A,676,699,N/A,47,4
10,N/A,N/A,N/A,666,676,N/A,52,3
5,N/A,N/A,N/A,661,666,N/A,56,1
14,N/A,N/A,N/A,647,661,N/A,59,4
9,N/A,N/A,N/A,638,647,N/A,63,2
41,N/A,N/A,N/A,597,638,N/A,66,5
42,N/A,N/A,N/A,555,597,N/A,72,5
9,N/A,N/A,N/A,546,555,N/A,76,3
10,N/A,N/A,N/A,536,546,N/A,81,2
6,N/A,N/A,N/A,530,536,N/A,86,1
49,N/A,N/A,N/A,481,530,N/A,90,5
46,N/A,N/A,N/A,435,481,N/A,96,5
8,N/A,N/A,N/A,427,435,N/A,99,2
40,N/A,N/A,N/A,387,427,N/A,102,5
36,N/A,N/A,N/A,351,387,N/A,108,5
17,N/A,N/A,N/A,334,351,N/A,113,4
9,N/A,N/A,N/A,325,334,N/A,117,2
5,N/A,N/A,N/A,320,325,N/A,122,1
9,N/A,N/A,N/A,707,716,N/A,6,3
11,N/A,N/A,N/A,696,707,N/A,11,2
42,N/A,N/A,N/A,654,696,N/A,15,6
11,N/A,N/A,N/A,643,654,N/A,18,3
35,N/A,N/A,N/A,608,643,N/A,21,6
10,N/A,N/A,N/A,598,608,N/A,24,3
7,N/A,N/A,N/A,591,598,N/A,30,3
9,N/A,N/A,N/A,582,591,N/A,36,3
8,N/A,N/A,N/A,574,582,N/A,42,3
41,N/A,N/A,N/A,533,574,N/A,45,6
9,N/A,N/A,N/A,524,533,N/A,48,3
8,N/A,N/A,N/A,516,524,N/A,53,2
45,N/A,N/A,N/A,471,516,N/A,57,6
7,N/A,N/A,N/A,464,471,N/A,63,0
28,N/A,N/A,N/A,436,464,N/A,69,6
11,N/A,N/A,N/A,425,436,N/A,72,3
7,N/A,N/A,N/A,418,425,N/A,78,3
7,N/A,N/A,N/A,411,418,N/A,84,3
25,N/A,N/A,N/A,386,411,N/A,87,6
6,N/A,N/A,N/A,380,386,N/A,93,0
35,N/A,N/A,N/A,345,380,N/A,98,5
18,N/A,N/A,N/A,327,345,N/A,103,4
9,N/A,N/A,N/A,318,327,N/A,106,1
28,N/A,N/A,N/A,290,318,N/A,111,6
5,N/A,N/A,N/A,285,290,N/A,117,0
45,N/A,N/A,N/A,240,285,N/A,122,5
10,N/A,N/A,N/A,230,240,N/A,126,3
8,N/A,N/A,N/A,222,230,N/A,132,3
7,N/A,N/A,N/A,215,222,N/A,138,3
11,N/A,N/A,N/A,204,215,N/A,143,2
11,N/A,N/A,N/A,387,398,N/A,4,2
34,N/A,N/A,N/A,353,387,N/A,7,5
10,N/A,N/A,N/A,343,353,N/A,12,4
11,N/A,N/A,N/A,332,343,N/A,16,2
29,N/A,N/A,N/A,303,332,N/A,20,6
38,N/A,N/A,N/A,265,303,N/A,25,5
36,N/A,N/A,N/A,229,265,N/A,31,5
11,N/A,N/A,N/A,218,229,N/A,36,4
22,N/A,N/A,N/A,196,218,N/A,42,4
29,N/A,N/A,N/A,167,196,N/A,48,4
7,N/A,N/A,N/A,160,167,N/A,51,1
9,N/A,N/A,N/A,151,160,N/A,57,1
39,N/A,N/A,N/A,112,151,N/A,61,5
8,N/A,N/A,N/A,104,112,N/A,65,3
10,N/A,N/A,N/A,94,104,N/A,71,3
9,N/A,N/A,N/A,85,94,N/A,76,2
7,N/A,N/A,N/A,78,85,N/A,81,1
6,N/A,N/A,N/A,72,78,N/A,87,1
46,N/A,N/A,N/A,26,72,N/A,92,6
7,N/A,N/A,N/A,19,26,N/A,95,3
5,N/A,N/A,N/A,14,19,N/A,99,1
29,N/A,N/A,N/A,-15,14,N/A,104,6
21,N/A,N/A,N/A,886,907,N/A,3,4
10,N/A,N/A,N/A,876,886,N/A,8,3
40,N/A,N/A,N/A,836,876,N/A,11,6
7,N/A,N/A,N/A,829,836,N/A,17,0
45,N/A,N/A,N/A,784,829,N/A,22,5
40,N/A,N/A,N/A,744,784,N/A,28,5
35,N/A,N/A,N/A,709,744,N/A,34,5
8,N/A,N/A,N/A,701,709,N/A,38,3
6,N/A,N/A,N/A,695,701,N/A,42,1
21,N/A,N/A,N/A,674,695,N/A,45,4
11,N/A,N/A,N/A,663,674,N/A,50,3
7,N/A,N/A,N/A,656,663,N/A,56,3
5,N/A,N/A,N/A,651,656,N/A,60,1
16,N/A,N/A,N/A,635,651,N/A,63,4
7,N/A,N/A,N/A,628,635,N/A,67,2
38,N/A,N/A,N/A,590,628,N/A,70,5
45,N/A,N/A,N/A,545,590,N/A,76,5
9,N/A,N/A,N/A,536,545,N/A,79,2
43,N/A,N/A,N/A,493,536,N/A,83,6
10,N/A,N/A,N/A,483,493,N/A,87,4
6,N/A,N/A,N/A,477,483,N/A,90,1
8,N/A,N/A,N/A,469,477,N/A,96,1
46,N/A,N/A,N/A,423,469,N/A,101,6
8,N/A,N/A,N/A,415,423,N/A,104,3
7,N/A,N/A,N/A,408,415,N/A,108,1
46,N/A,N/A,N/A,362,408,N/A,112,5
10,N/A,N/A,N/A,352,362,N/A,115,2
10,N/A,N/A,N/A,342,352,N/A,121,2
5,N/A,N/A,N/A,337,342,N/A,126,1
28,N/A,N/A,N/A,309,337,N/A,131,6
31,N/A,N/A,N/A,858,889,N/A,3,5
8,N/A,N/A,N/A,850,858,N/A,6,2
10,N/A,N/A,N/A,840,850,N/A,12,2
31,N/A,N/A,N/A,809,840,N/A,16,6
39,N/A,N/A,N/A,770,809,N/A,21,5
18,N/A,N/A,N/A,752,770,N/A,26,4
22,N/A,N/A,N/A,730,752,N/A,32,4
11,N/A,N/A,N/A,719,730,N/A,37,3
34,N/A,N/A,N/A,685,719,N/A,40,6
25,N/A,N/A,N/A,660,685,N/A,45,5
25,N/A,N/A,N/A,635,660,N/A,50,4
7,N/A,N/A,N/A,628,635,N/A,54,2
10,N/A,N/A,N/A,618,628,N/A,60,2
30,N/A,N/A,N/A,588,618,N/A,64,6
35,N/A,N/A,N/A,553,588,N/A,69,5
10,N/A,N/A,N/A,543,553,N/A,73,3
9,N/A,N/A,N/A,534,543,N/A,79,3
8,N/A,N/A,N/A,526,534,N/A,83,1
47,N/A,N/A,N/A,479,526,N/A,88,6
7,N/A,N/A,N/A,472,479,N/A,91,3
11,N/A,N/A,N/A,461,472,N/A,97,3
8,N/A,N/A,N/A,453,461,N/A,101,1
11,N/A,N/A,N/A,442,453,N/A,104,4
7,N/A,N/A,N/A,435,442,N/A,107,1
21,N/A,N/A,N/A,414,435,N/A,110,4
10,N/A,N/A,N/A,404,414,N/A,115,3
7,N/A,N/A,N/A,397,404,N/A,121,3
9,N/A,N/A,N/A,388,397,N/A,127,3
8,N/A,N/A,N/A,380,388,N/A,132,2
5,N/A,N/A,N/A,375,380,N/A,137,1
26,N/A,N/A,N/A,1690,1716,N/A,4,4
7,N/A,N/A,N/A,1683,1690,N/A,9,3
7,N/A,N/A,N/A,1676,1683,N/A,13,1
18,N/A,N/A,N/A,1658,1676,N/A,16,4
20,N/A,N/A,N/A,1638,1658,N/A,22,4
8,N/A,N/A,N/A,1630,1638,N/A,27,3
6,N/A,N/A,N/A,1624,1630,N/A,31,1
43,N/A,N/A,N/A,1581,1624,N/A,35,5
23,N/A,N/A,N/A,1558,1581,N/A,40,4
10,N/A,N/A,N/A,1548,1558,N/A,46,4
9,N/A,N/A,N/A,1539,1548,N/A,51,3
7,N/A,N/A,N/A,1532,1539,N/A,56,2
45,N/A,N/A,N/A,1487,1532,N/A,60,6
41,N/A,N/A,N/A,1446,1487,N/A,65,5
22,N/A,N/A,N/A,1424,1446,N/A,70,4
10,N/A,N/A,N/A,1414,1424,N/A,75,3
11,N/A,N/A,N/A,1403,1414,N/A,81,3
11,N/A,N/A,N/A,1392,1403,N/A,87,3
10,N/A,N/A,N/A,1382,1392,N/A,92,2
8,N/A,N/A,N/A,1374,1382,N/A,98,2
40,N/A,N/A,N/A,1334,1374,N/A,102,6
33,N/A,N/A,N/A,1301,1334,N/A,107,5
19,N/A,N/A,N/A,1282,1301,N/A,112,4
19,N/A,N/A,N/A,1263,1282,N/A,118,4
8,N/A,N/A,N/A,1255,1263,N/A,121,1
33,N/A,N/A,N/A,1222,1255,N/A,125,5
8,N/A,N/A,N/A,1214,1222,N/A,128,2
36,N/A,N/A,N/A,1178,1214,N/A,132,6
21,N/A,N/A,N/A,1157,1178,N/A,136,4
10,N/A,N/A,N/A,1147,1157,N/A,140,2
40,N/A,N/A,N/A,1156,1196,N/A,5,6
9,N/A,N/A,N/A,1147,1156,N/A,8,3
7,N/A,N/A,N/A,1140,1147,N/A,13,2
10,N/A,N/A,N/A,1130,1140,N/A,19,2
49,N/A,N/A,N/A,1081,1130,N/A,23,6
5,N/A,N/A,N/A,1076,1081,N/A,29,0
14,N/A,N/A,N/A,1062,1076,N/A,33,4
5,N/A,N/A,N/A,1057,1062,N/A,36,1
25,N/A,N/A,N/A,1032,1057,N/A,40,5
11,N/A,N/A,N/A,1021,1032,N/A,44,3
7,N/A,N/A,N/A,1014,1021,N/A,50,3
10,N/A,N/A,N/A,1004,1014,N/A,56,3
11,N/A,N/A,N/A,993,1004,N/A,62,3
8,N/A,N/A,N/A,985,993,N/A,68,3
9,N/A,N/A,N/A,976,985,N/A,74,3
6,N/A,N/A,N/A,970,976,N/A,78,1
35,N/A,N/A,N/A,935,970,N/A,82,5
27,N/A,N/A,N/A,908,935,N/A,87,4
11,N/A,N/A,N/A,897,908,N/A,92,3
49,N/A,N/A,N/A,848,897,N/A,95,6
23,N/A,N/A,N/A,825,848,N/A,99,4
8,N/A,N/A,N/A,817,825,N/A,104,3
33,N/A,N/A,N/A,784,817,N/A,107,6
36,N/A,N/A,N/A,748,784,N/A,112,5
22,N/A,N/A,N/A,726,748,N/A,117,4
26,N/A,N/A,N/A,700,726,N/A,123,4
8,N/A,N/A,N/A,692,700,N/A,128,3
10,N/A,N/A,N/A,682,692,N/A,133,2
9,N/A,N/A,N/A,673,682,N/A,139,2
28,N/A,N/A,N/A,645,673,N/A,143,6
7,N/A,N/A,N/A,969,976,N/A,3,1
22,N/A,N/A,N/A,947,969,N/A,6,4
7,N/A,N/A,N/A,940,947,N/A,10,2
10,N/A,N/A,N/A,930,940,N/A,16,2
6,N/A,N/A,N/A,924,930,N/A,21,1
38,N/A,N/A,N/A,886,924,N/A,26,6
31,N/A,N/A,N/A,855,886,N/A,31,5
24,N/A,N/A,N/A,831,855,N/A,36,4
11,N/A,N/A,N/A,820,831,N/A,42,4
8,N/A,N/A,N/A,812,820,N/A,46,2
28,N/A,N/A,N/A,784,812,N/A,50,6
28,N/A,N/A,N/A,756,784,N/A,54,4
23,N/A,N/A,N/A,733,756,N/A,60,4
11,N/A,N/A,N/A,722,733,N/A,64,2
6,N/A,N/A,N/A,716,722,N/A,69,1
6,N/A,N/A,N/A,710,716,N/A,75,1
8,N/A,N/A,N/A,702,710,N/A,81,1
9,N/A,N/A,N/A,693,702,N/A,87,1
36,N/A,N/A,N/A,657,693,N/A,91,5
14,N/A,N/A,N/A,643,657,N/A,96,4
8,N/A,N/A,N/A,635,643,N/A,100,2
33,N/A,N/A,N/A,602,635,N/A,104,6
16,N/A,N/A,N/A,586,602,N/A,108,4
7,N/A,N/A,N/A,579,586,N/A,111,1
42,N/A,N/A,N/A,537,579,N/A,116,6
5,N/A,N/A,N/A,532,537,N/A,122,0
8,N/A,N/A,N/A,524,532,N/A,125,3
8,N/A,N/A,N/A,516,524,N/A,129,1
23,N/A,N/A,N/A,493,516,N/A,132,4
5,N/A,N/A,N/A,488,493,N/A,135,1
9,N/A,N/A,N/A,414,423,N/A,3,3
7,N/A,N/A,N/A,407,414,N/A,8,2
7,N/A,N/A,N/A,400,407,N/A,13,1
32,N/A,N/A,N/A,368,400,N/A,17,5
22,N/A,N/A,N/A,346,368,N/A,22,4
26,N/A,N/A,N/A,320,346,N/A,28,4
20,N/A,N/A,N/A,300,320,N/A,34,4
9,N/A,N/A,N/A,291,300,N/A,39,3
9,N/A,N/A,N/A,282,291,N/A,44,2
39,N/A,N/A,N/A,243,282,N/A,47,5
33,N/A,N/A,N/A,210,243,N/A,53,5
11,N/A,N/A,N/A,199,210,N/A,57,3
7,N/A,N/A,N/A,192,199,N/A,61,1
39,N/A,N/A,N/A,153,192,N/A,65,5
31,N/A,N/A,N/A,122,153,N/A,71,5
10,N/A,N/A,N/A,112,122,N/A,75,3
9,N/A,N/A,N/A,103,112,N/A,81,3
11,N/A,N/A,N/A,92,103,N/A,86,2
9,N/A,N/A,N/A,83,92,N/A,91,1
31,N/A,N/A,N/A,52,83,N/A,96,6
10,N/A,N/A,N/A,42,52,N/A,99,3
42,N/A,N/A,N/A,0,42,N/A,102,6
32,N/A,N/A,N/A,405,437,N/A,6,5
20,N/A,N/A,N/A,385,405,N/A,11,4
7,N/A,N/A,N/A,378,385,N/A,14,1
6,N/A,N/A,N/A,372,378,N/A,20,1
6,N/A,N/A,N/A,366,372,N/A,26,1
37,N/A,N/A,N/A,329,366,N/A,30,5
43,N/A,N/A,N/A,286,329,N/A,36,5
24,N/A,N/A,N/A,262,286,N/A,41,4
26,N/A,N/A,N/A,236,262,N/A,47,4
6,N/A,N/A,N/A,230,236,N/A,50,1
27,N/A,N/A,N/A,203,230,N/A,55,6
46,N/A,N/A,N/A,157,203,N/A,60,5
16,N/A,N/A,N/A,141,157,N/A,65,4
5,N/A,N/A,N/A,136,141,N/A,68,1
37,N/A,N/A,N/A,99,136,N/A,72,5
7,N/A,N/A,N/A,92,99,N/A,75,2
43,N/A,N/A,N/A,49,92,N/A,79,6
9,N/A,N/A,N/A,40,49,N/A,82,3
7,N/A,N/A,N/A,33,40,N/A,87,2
46,N/A,N/A,N/A,-13,33,N/A,90,5
11,N/A,N/A,N/A,579,590,N/A,5,2
32,N/A,N/A,N/A,547,579,N/A,9,6
13,N/A,N/A,N/A,534,547,N/A,13,4
9,N/A,N/A,N/A,525,534,N/A,17,2
47,N/A,N/A,N/A,478,525,N/A,20,5
10,N/A,N/A,N/A,468,478,N/A,24,3
11,N/A,N/A,N/A,457,468,N/A,30,3
9,N/A,N/A,N/A,448,457,N/A,35,2
5,N/A,N/A,N/A,443,448,N/A,40,1
20,N/A,N/A,N/A,423,443,N/A,43,4
10,N/A,N/A,N/A,413,423,N/A,49,4
11,N/A,N/A,N/A,402,413,N/A,54,3
6,N/A,N/A,N/A,396,402,N/A,58,1
28,N/A,N/A,N/A,368,396,N/A,61,4
9,N/A,N/A,N/A,359,368,N/A,64,1
31,N/A,N/A,N/A,328,359,N/A,69,6
40,N/A,N/A,N/A,288,328,N/A,74,5
36,N/A,N/A,N/A,252,288,N/A,80,5
14,N/A,N/A,N/A,238,252,N/A,85,4
11,N/A,N/A,N/A,227,238,N/A,91,4
6,N/A,N/A,N/A,221,227,N/A,94,1
8,N/A,N/A,N/A,213,221,N/A,100,1
14,N/A,N/A,N/A,199,213,N/A,103,4
7,N/A,N/A,N/A,192,199,N/A,106,1
27,N/A,N/A,N/A,165,192,N/A,111,6
27,N/A,N/A,N/A,138,165,N/A,116,5
33,N/A,N/A,N/A,105,138,N/A,122,5
12,N/A,N/A,N/A,93,105,N/A,127,4
18,N/A,N/A,N/A,75,93,N/A,133,4
29,N/A,N/A,N/A,46,75,N/A,139,4
28,N/A,N/A,N/A,1538,1566,N/A,5,4
8,N/A,N/A,N/A,1530,1538,N/A,10,3
11,N/A,N/A,N/A,1519,1530,N/A,15,2
35,N/A,N/A,N/A,1484,1519,N/A,18,5
32,N/A,N/A,N/A,1452,1484,N/A,24,5
23,N/A,N/A,N/A,1429,1452,N/A,29,4
8,N/A,N/A,N/A,1421,1429,N/A,34,3
6,N/A,N/A,N/A,1415,1421,N/A,38,1
27,N/A,N/A,N/A,1388,1415,N/A,43,6
24,N/A,N/A,N/A,1364,1388,N/A,47,4
8,N/A,N/A,N/A,1356,1364,N/A,51,2
34,N/A,N/A,N/A,1322,1356,N/A,55,6
9,N/A,N/A,N/A,1313,1322,N/A,58,3
9,N/A,N/A,N/A,1304,1313,N/A,64,3
11,N/A,N/A,N/A,1293,1304,N/A,70,3
38,N/A,N/A,N/A,1255,1293,N/A,73,6
12,N/A,N/A,N/A,1243,1255,N/A,77,4
10,N/A,N/A,N/A,1233,1243,N/A,82,3
46,N/A,N/A,N/A,1187,1233,N/A,85,6
44,N/A,N/A,N/A,1143,1187,N/A,90,5
8,N/A,N/A,N/A,1135,1143,N/A,94,3
8,N/A,N/A,N/A,1127,1135,N/A,98,1
22,N/A,N/A,N/A,1105,1127,N/A,101,4
5,N/A,N/A,N/A,1100,1105,N/A,104,1
47,N/A,N/A,N/A,1053,1100,N/A,108,5
12,N/A,N/A,N/A,1041,1053,N/A,113,4
8,N/A,N/A,N/A,1033,1041,N/A,117,2
5,N/A,N/A,N/A,1028,1033,N/A,122,1
10,N/A,N/A,N/A,1018,1028,N/A,125,4
5,N/A,N/A,N/A,1013,1018,N/A,128,1
7,N/A,N/A,N/A,508,515,N/A,4,1
15,N/A,N/A,N/A,493,508,N/A,7,4
11,N/A,N/A,N/A,482,493,N/A,11,2
8,N/A,N/A,N/A,474,482,N/A,17,2
7,N/A,N/A,N/A,467,474,N/A,23,2
33,N/A,N/A,N/A,434,467,N/A,26,5
12,N/A,N/A,N/A,422,434,N/A,31,4
11,N/A,N/A,N/A,411,422,N/A,37,4
15,N/A,N/A,N/A,396,411,N/A,43,4
8,N/A,N/A,N/A,388,396,N/A,46,1
24,N/A,N/A,N/A,364,388,N/A,49,4
6,N/A,N/A,N/A,358,364,N/A,52,1
5,N/A,N/A,N/A,353,358,N/A,58,1
45,N/A,N/A,N/A,308,353,N/A,62,5
11,N/A,N/A,N/A,297,308,N/A,66,3
6,N/A,N/A,N/A,291,297,N/A,70,1
45,N/A,N/A,N/A,246,291,N/A,74,5
29,N/A,N/A,N/A,217,246,N/A,80,5
19,N/A,N/A,N/A,198,217,N/A,85,4
8,N/A,N/A,N/A,190,198,N/A,89,2
35,N/A,N/A,N/A,155,190,N/A,92,5
18,N/A,N/A,N/A,137,155,N/A,97,4
6,N/A,N/A,N/A,131,137,N/A,100,1
37,N/A,N/A,N/A,94,131,N/A,104,5
33,N/A,N/A,N/A,61,94,N/A,110,5
9,N/A,N/A,N/A,52,61,N/A,114,3
26,N/A,N/A,N/A,26,52,N/A,117,6
28,N/A,N/A,N/A,-2,26,N/A,122,5
5,N/A,N/A,N/A,1046,1051,N/A,4,1
16,N/A,N/A,N/A,1030,1046,N/A,7,4
9,N/A,N/A,N/A,1021,1030,N/A,11,2
30,N/A,N/A,N/A,991,1021,N/A,14,5
9,N/A,N/A,N/A,982,991,N/A,17,2
36,N/A,N/A,N/A,946,982,N/A,20,5
21,N/A,N/A,N/A,925,946,N/A,25,4
7,N/A,N/A,N/A,918,925,N/A,28,1
14,N/A,N/A,N/A,904,918,N/A,31,4
13,N/A,N/A,N/A,891,904,N/A,37,4
8,N/A,N/A,N/A,883,891,N/A,41,2
8,N/A,N/A,N/A,875,883,N/A,47,2
7,N/A,N/A,N/A,868,875,N/A,52,1
22,N/A,N/A,N/A,846,868,N/A,55,4
16,N/A,N/A,N/A,830,846,N/A,61,4
7,N/A,N/A,N/A,823,830,N/A,66,3
49,N/A,N/A,N/A,774,823,N/A,69,6
8,N/A,N/A,N/A,766,774,N/A,75,0
11,N/A,N/A,N/A,755,766,N/A,79,4
9,N/A,N/A,N/A,746,755,N/A,82,1
36,N/A,N/A,N/A,710,746,N/A,87,6
8,N/A,N/A,N/A,702,710,N/A,90,3
6,N/A,N/A,N/A,696,702,N/A,94,1
25,N/A,N/A,N/A,671,696,N/A,98,5
11,N/A,N/A,N/A,660,671,N/A,102,3
6,N/A,N/A,N/A,654,660,N/A,106,1
49,N/A,N/A,N/A,605,654,N/A,110,5
35,N/A,N/A,N/A,570,605,N/A,116,5
7,N/A,N/A,N/A,563,570,N/A,120,3
11,N/A,N/A,N/A,552,563,N/A,125,2
5,N/A,N/A,N/A,931,936,N/A,4,1
20,N/A,N/A,N/A,911,931,N/A,7,4
10,N/A,N/A,N/A,901,911,N/A,11,2
49,N/A,N/A,N/A,852,901,N/A,15,6
11,N/A,N/A,N/A,841,852,N/A,18,3
44,N/A,N/A,N/A,797,841,N/A,21,6
28,N/A,N/A,N/A,769,797,N/A,26,5
22,N/A,N/A,N/A,747,769,N/A,31,4
9,N/A,N/A,N/A,738,747,N/A,35,2
6,N/A,N/A,N/A,732,738,N/A,40,1
31,N/A,N/A,N/A,701,732,N/A,45,6
8,N/A,N/A,N/A,693,701,N/A,51,0
29,N/A,N/A,N/A,664,693,N/A,56,5
8,N/A,N/A,N/A,656,664,N/A,60,3
8,N/A,N/A,N/A,648,656,N/A,66,3
31,N/A,N/A,N/A,617,648,N/A,69,6
8,N/A,N/A,N/A,609,617,N/A,72,3
34,N/A,N/A,N/A,575,609,N/A,75,6
34,N/A,N/A,N/A,541,575,N/A,80,5
42,N/A,N/A,N/A,499,541,N/A,86,5
9,N/A,N/A,N/A,490,499,N/A,90,3
11,N/A,N/A,N/A,479,490,N/A,96,3
8,N/A,N/A,N/A,471,479,N/A,100,1
6,N/A,N/A,N/A,465,471,N/A,106,1
8,N/A,N/A,N/A,457,465,N/A,112,1
39,N/A,N/A,N/A,418,457,N/A,116,5
28,N/A,N/A,N/A,390,418,N/A,121,4
6,N/A,N/A,N/A,384,390,N/A,124,1
32,N/A,N/A,N/A,352,384,N/A,129,6
6,N/A,N/A,N/A,346,352,N/A,135,0
40,N/A,N/A,N/A,1325,1365,N/A,3,5
46,N/A,N/A,N/A,1279,1325,N/A,9,5
37,N/A,N/A,N/A,1242,1279,N/A,15,5
15,N/A,N/A,N/A,1227,1242,N/A,20,4
13,N/A,N/A,N/A,1214,1227,N/A,26,4
10,N/A,N/A,N/A,1204,1214,N/A,31,3
8,N/A,N/A,N/A,1196,1204,N/A,36,2
7,N/A,N/A,N/A,1189,1196,N/A,42,2
27,N/A,N/A,N/A,1162,1189,N/A,46,6
6,N/A,N/A,N/A,1156,1162,N/A,52,0
13,N/A,N/A,N/A,1143,1156,N/A,56,4
10,N/A,N/A,N/A,1133,1143,N/A,62,4
23,N/A,N/A,N/A,1110,1133,N/A,68,4
10,N/A,N/A,N/A,1100,1110,N/A,73,3
8,N/A,N/A,N/A,1092,1100,N/A,78,2
36,N/A,N/A,N/A,1056,1092,N/A,82,6
7,N/A,N/A,N/A,1049,1056,N/A,85,3
37,N/A,N/A,N/A,1012,1049,N/A,88,6
7,N/A,N/A,N/A,1005,1012,N/A,94,0
38,N/A,N/A,N/A,967,1005,N/A,100,6
24,N/A,N/A,N/A,943,967,N/A,104,4
9,N/A,N/A,N/A,934,943,N/A,109,3
10,N/A,N/A,N/A,924,934,N/A,115,3
6,N/A,N/A,N/A,918,924,N/A,119,1
29,N/A,N/A,N/A,889,918,N/A,124,6
5,N/A,N/A,N/A,884,889,N/A,130,0
22,N/A,N/A,N/A,862,884,N/A,134,4
8,N/A,N/A,N/A,854,862,N/A,137,1
44,N/A,N/A,N/A,810,854,N/A,141,5
30,N/A,N/A,N/A,780,810,N/A,147,5
38,N/A,N/A,N/A,268,306,N/A,6,6
6,N/A,N/A,N/A,262,268,N/A,12,0
25,N/A,N/A,N/A,237,262,N/A,18,6
30,N/A,N/A,N/A,207,237,N/A,23,5
27,N/A,N/A,N/A,180,207,N/A,29,5
15,N/A,N/A,N/A,165,180,N/A,34,4
8,N/A,N/A,N/A,157,165,N/A,39,3
46,N/A,N/A,N/A,111,157,N/A,42,6
8,N/A,N/A,N/A,103,111,N/A,48,0
28,N/A,N/A,N/A,75,103,N/A,52,4
10,N/A,N/A,N/A,65,75,N/A,56,2
46,N/A,N/A,N/A,19,65,N/A,59,5
24,N/A,N/A,N/A,-5,19,N/A,64,4
9,N/A,N/A,N/A,871,880,N/A,5,2
10,N/A,N/A,N/A,861,871,N/A,11,2
5,N/A,N/A,N/A,856,861,N/A,16,1
47,N/A,N/A,N/A,809,856,N/A,20,5
10,N/A,N/A,N/A,799,809,N/A,24,3
42,N/A,N/A,N/A,757,799,N/A,27,6
5,N/A,N/A,N/A,752,757,N/A,33,0
10,N/A,N/A,N/A,742,752,N/A,36,3
11,N/A,N/A,N/A,731,742,N/A,42,3
10,N/A,N/A,N/A,721,731,N/A,48,3
38,N/A,N/A,N/A,683,721,N/A,51,6
11,N/A,N/A,N/A,672,683,N/A,54,3
5,N/A,N/A,N/A,667,672,N/A,58,1
43,N/A,N/A,N/A,624,667,N/A,63,6
25,N/A,N/A,N/A,599,624,N/A,67,4
8,N/A,N/A,N/A,591,599,N/A,72,3
10,N/A,N/A,N/A,581,591,N/A,78,3
36,N/A,N/A,N/A,545,581,N/A,81,6
15,N/A,N/A,N/A,530,545,N/A,85,4
23,N/A,N/A,N/A,507,530,N/A,91,4
10,N/A,N/A,N/A,497,507,N/A,97,4
11,N/A,N/A,N/A,486,497,N/A,103,4
8,N/A,N/A,N/A,478,486,N/A,106,1
47,N/A,N/A,N/A,431,478,N/A,111,6
10,N/A,N/A,N/A,421,431,N/A,115,4
7,N/A,N/A,N/A,414,421,N/A,118,1
48,N/A,N/A,N/A,366,414,N/A,123,6
8,N/A,N/A,N/A,358,366,N/A,126,3
9,N/A,N/A,N/A,349,358,N/A,131,2
46,N/A,N/A,N/A,303,349,N/A,135,6
11,N/A,N/A,N/A,1655,1666,N/A,4,3
26,N/A,N/A,N/A,1629,1655,N/A,7,6
11,N/A,N/A,N/A,1618,1629,N/A,10,3
8,N/A,N/A,N/A,1610,1618,N/A,14,1
35,N/A,N/A,N/A,1575,1610,N/A,19,6
9,N/A,N/A,N/A,1566,1575,N/A,25,0
8,N/A,N/A,N/A,1558,1566,N/A,28,3
8,N/A,N/A,N/A,1550,1558,N/A,34,3
7,N/A,N/A,N/A,1543,1550,N/A,38,1
7,N/A,N/A,N/A,1536,1543,N/A,44,1
8,N/A,N/A,N/A,1528,1536,N/A,50,1
27,N/A,N/A,N/A,1501,1528,N/A,54,5
27,N/A,N/A,N/A,1474,1501,N/A,59,4
7,N/A,N/A,N/A,1467,1474,N/A,64,3
27,N/A,N/A,N/A,1440,1467,N/A,67,6
26,N/A,N/A,N/A,1414,1440,N/A,71,4
16,N/A,N/A,N/A,1398,1414,N/A,77,4
6,N/A,N/A,N/A,1392,1398,N/A,80,1
8,N/A,N/A,N/A,1384,1392,N/A,86,1
41,N/A,N/A,N/A,1343,1384,N/A,90,5
35,N/A,N/A,N/A,1308,1343,N/A,96,5
8,N/A,N/A,N/A,1300,1308,N/A,99,2
43,N/A,N/A,N/A,1257,1300,N/A,103,6
22,N/A,N/A,N/A,1235,1257,N/A,107,4
18,N/A,N/A,N/A,1217,1235,N/A,113,4
8,N/A,N/A,N/A,1209,1217,N/A,117,2
5,N/A,N/A,N/A,1204,1209,N/A,122,1
48,N/A,N/A,N/A,1156,1204,N/A,127,6
39,N/A,N/A,N/A,1117,1156,N/A,132,5
32,N/A,N/A,N/A,1085,1117,N/A,138,5
30,N/A,N/A,N/A,630,660,N/A,3,5
7,N/A,N/A,N/A,623,630,N/A,6,2
27,N/A,N/A,N/A,596,623,N/A,10,6
19,N/A,N/A,N/A,577,596,N/A,14,4
8,N/A,N/A,N/A,569,577,N/A,19,3
9,N/A,N/A,N/A,560,569,N/A,23,1
5,N/A,N/A,N/A,555,560,N/A,29,1
27,N/A,N/A,N/A,528,555,N/A,32,4
10,N/A,N/A,N/A,518,528,N/A,37,3
11,N/A,N/A,N/A,507,518,N/A,42,2
8,N/A,N/A,N/A,499,507,N/A,48,2
26,N/A,N/A,N/A,473,499,N/A,52,6
40,N/A,N/A,N/A,433,473,N/A,57,5
9,N/A,N/A,N/A,424,433,N/A,60,2
34,N/A,N/A,N/A,390,424,N/A,63,5
7,N/A,N/A,N/A,383,390,N/A,66,2
33,N/A,N/A,N/A,350,383,N/A,70,6
10,N/A,N/A,N/A,340,350,N/A,73,3
9,N/A,N/A,N/A,331,340,N/A,79,3
49,N/A,N/A,N/A,282,331,N/A,82,6
43,N/A,N/A,N/A,239,282,N/A,87,5
9,N/A,N/A,N/A,230,239,N/A,91,3
9,N/A,N/A,N/A,221,230,N/A,96,2
44,N/A,N/A,N/A,177,221,N/A,99,5
10,N/A,N/A,N/A,167,177,N/A,103,3
30,N/A,N/A,N/A,137,167,N/A,106,6
7,N/A,N/A,N/A,130,137,N/A,112,0
37,N/A,N/A,N/A,93,130,N/A,118,6
8,N/A,N/A,N/A,85,93,N/A,124,0
12,N/A,N/A,N/A,73,85,N/A,128,4
11,N/A,N/A,N/A,1251,1262,N/A,3,4
6,N/A,N/A,N/A,1245,1251,N/A,6,1
5,N/A,N/A,N/A,1240,1245,N/A,12,1
44,N/A,N/A,N/A,1196,1240,N/A,17,6
43,N/A,N/A,N/A,1153,1196,N/A,22,5
15,N/A,N/A,N/A,1138,1153,N/A,27,4
9,N/A,N/A,N/A,1129,1138,N/A,31,2
27,N/A,N/A,N/A,1102,1129,N/A,35,6
23,N/A,N/A,N/A,1079,1102,N/A,39,4
11,N/A,N/A,N/A,1068,1079,N/A,44,3
8,N/A,N/A,N/A,1060,1068,N/A,50,3
5,N/A,N/A,N/A,1055,1060,N/A,54,1
39,N/A,N/A,N/A,1016,1055,N/A,58,5
13,N/A,N/A,N/A,1003,1016,N/A,63,4
5,N/A,N/A,N/A,998,1003,N/A,66,1
32,N/A,N/A,N/A,966,998,N/A,70,5
7,N/A,N/A,N/A,959,966,N/A,74,3
7,N/A,N/A,N/A,952,959,N/A,80,3
9,N/A,N/A,N/A,943,952,N/A,84,1
19,N/A,N/A,N/A,924,943,N/A,87,4
28,N/A,N/A,N/A,896,924,N/A,93,4
9,N/A,N/A,N/A,887,896,N/A,96,1
41,N/A,N/A,N/A,846,887,N/A,100,5
8,N/A,N/A,N/A,838,846,N/A,103,2
40,N/A,N/A,N/A,798,838,N/A,107,6
26,N/A,N/A,N/A,772,798,N/A,111,4
11,N/A,N/A,N/A,761,772,N/A,116,3
9,N/A,N/A,N/A,752,761,N/A,121,2
9,N/A,N/A,N/A,743,752,N/A,126,1
8,N/A,N/A,N/A,735,743,N/A,132,1
9,N/A,N/A,N/A,1335,1344,N/A,3,1
34,N/A,N/A,N/A,1301,1335,N/A,8,6
17,N/A,N/A,N/A,1284,1301,N/A,12,4
15,N/A,N/A,N/A,1269,1284,N/A,18,4
27,N/A,N/A,N/A,1242,1269,N/A,24,4
7,N/A,N/A,N/A,1235,1242,N/A,29,3
7,N/A,N/A,N/A,1228,1235,N/A,34,2
8,N/A,N/A,N/A,1220,1228,N/A,39,1
32,N/A,N/A,N/A,1188,1220,N/A,44,6
8,N/A,N/A,N/A,1180,1188,N/A,50,0
40,N/A,N/A,N/A,1140,1180,N/A,56,6
10,N/A,N/A,N/A,1130,1140,N/A,60,4
10,N/A,N/A,N/A,1120,1130,N/A,66,4
24,N/A,N/A,N/A,1096,1120,N/A,72,4
6,N/A,N/A,N/A,1090,1096,N/A,75,1
47,N/A,N/A,N/A,1043,1090,N/A,79,5
11,N/A,N/A,N/A,1032,1043,N/A,83,3
9,N/A,N/A,N/A,1023,1032,N/A,89,3
8,N/A,N/A,N/A,1015,1023,N/A,94,2
10,N/A,N/A,N/A,1005,1015,N/A,100,2
9,N/A,N/A,N/A,996,1005,N/A,105,1
44,N/A,N/A,N/A,952,996,N/A,109,5
25,N/A,N/A,N/A,927,952,N/A,115,5
39,N/A,N/A,N/A,888,927,N/A,121,5
10,N/A,N/A,N/A,878,888,N/A,124,2
46,N/A,N/A,N/A,832,878,N/A,128,6
16,N/A,N/A,N/A,816,832,N/A,132,4
11,N/A,N/A,N/A,805,816,N/A,136,2
39,N/A,N/A,N/A,766,805,N/A,140,6
32,N/A,N/A,N/A,734,766,N/A,145,5
7,N/A,N/A,N/A,1223,1230,N/A,6,3
10,N/A,N/A,N/A,1213,1223,N/A,12,3
7,N/A,N/A,N/A,1206,1213,N/A,17,2
8,N/A,N/A,N/A,1198,1206,N/A,23,2
8,N/A,N/A,N/A,1190,1198,N/A,29,2
11,N/A,N/A,N/A,1179,1190,N/A,35,2
7,N/A,N/A,N/A,1172,1179,N/A,41,2
10,N/A,N/A,N/A,1162,1172,N/A,47,2
5,N/A,N/A,N/A,1157,1162,N/A,52,1
7,N/A,N/A,N/A,1150,1157,N/A,58,1
46,N/A,N/A,N/A,1104,1150,N/A,63,6
40,N/A,N/A,N/A,1064,1104,N/A,68,5
20,N/A,N/A,N/A,1044,1064,N/A,73,4
9,N/A,N/A,N/A,1035,1044,N/A,78,3
8,N/A,N/A,N/A,1027,1035,N/A,83,2
7,N/A,N/A,N/A,1020,1027,N/A,88,1
13,N/A,N/A,N/A,1007,1020,N/A,91,4
25,N/A,N/A,N/A,982,1007,N/A,97,4
16,N/A,N/A,N/A,966,982,N/A,103,4
5,N/A,N/A,N/A,961,966,N/A,106,1
24,N/A,N/A,N/A,937,961,N/A,109,4
8,N/A,N/A,N/A,929,937,N/A,112,1
8,N/A,N/A,N/A,921,929,N/A,118,1
9,N/A,N/A,N/A,912,921,N/A,124,1
9,N/A,N/A,N/A,903,912,N/A,130,1
42,N/A,N/A,N/A,861,903,N/A,134,5
10,N/A,N/A,N/A,851,861,N/A,137,2
7,N/A,N/A,N/A,844,851,N/A,142,1
8,N/A,N/A,N/A,836,844,N/A,148,1
7,N/A,N/A,N/A,829,836,N/A,154,1
9,N/A,N/A,N/A,895,904,N/A,6,2
37,N/A,N/A,N/A,858,895,N/A,10,6
38,N/A,N/A,N/A,820,858,N/A,15,5
11,N/A,N/A,N/A,809,820,N/A,19,3
8,N/A,N/A,N/A,801,809,N/A,23,1
43,N/A,N/A,N/A,758,801,N/A,28,6
25,N/A,N/A,N/A,733,758,N/A,33,5
11,N/A,N/A,N/A,722,733,N/A,37,3
8,N/A,N/A,N/A,714,722,N/A,43,3
7,N/A,N/A,N/A,707,714,N/A,49,3
6,N/A,N/A,N/A,701,707,N/A,53,1
9,N/A,N/A,N/A,692,701,N/A,59,1
48,N/A,N/A,N/A,644,692,N/A,63,5
26,N/A,N/A,N/A,618,644,N/A,69,5
16,N/A,N/A,N/A,602,618,N/A,74,4
7,N/A,N/A,N/A,595,602,N/A,78,2
37,N/A,N/A,N/A,558,595,N/A,81,5
7,N/A,N/A,N/A,551,558,N/A,84,2
34,N/A,N/A,N/A,517,551,N/A,88,6
17,N/A,N/A,N/A,500,517,N/A,92,4
9,N/A,N/A,N/A,491,500,N/A,97,3
8,N/A,N/A,N/A,483,491,N/A,101,1
48,N/A,N/A,N/A,435,483,N/A,105,5
35,N/A,N/A,N/A,400,435,N/A,111,5
7,N/A,N/A,N/A,393,400,N/A,115,3
7,N/A,N/A,N/A,386,393,N/A,119,1
39,N/A,N/A,N/A,347,386,N/A,124,6
12,N/A,N/A,N/A,335,347,N/A,128,4
9,N/A,N/A,N/A,326,335,N/A,133,3
8,N/A,N/A,N/A,318,326,N/A,139,3
48,N/A,N/A,N/A,1762,1810,N/A,5,6
24,N/A,N/A,N/A,1738,1762,N/A,9,4
21,N/A,N/A,N/A,1717,1738,N/A,15,4
9,N/A,N/A,N/A,1708,1717,N/A,20,3
8,N/A,N/A,N/A,1700,1708,N/A,24,1
7,N/A,N/A,N/A,1693,1700,N/A,30,1
25,N/A,N/A,N/A,1668,1693,N/A,35,6
8,N/A,N/A,N/A,1660,1668,N/A,38,3
8,N/A,N/A,N/A,1652,1660,N/A,43,2
7,N/A,N/A,N/A,1645,1652,N/A,48,1
39,N/A,N/A,N/A,1606,1645,N/A,53,6
11,N/A,N/A,N/A,1595,1606,N/A,56,3
11,N/A,N/A,N/A,1584,1595,N/A,62,3
9,N/A,N/A,N/A,1575,1584,N/A,67,2
49,N/A,N/A,N/A,1526,1575,N/A,71,6
7,N/A,N/A,N/A,1519,1526,N/A,74,3
9,N/A,N/A,N/A,1510,1519,N/A,80,3
11,N/A,N/A,N/A,1499,1510,N/A,85,2
28,N/A,N/A,N/A,1471,1499,N/A,88,5
49,N/A,N/A,N/A,1422,1471,N/A,94,5
8,N/A,N/A,N/A,1414,1422,N/A,98,3
45,N/A,N/A,N/A,1369,1414,N/A,101,6
10,N/A,N/A,N/A,1359,1369,N/A,105,4
11,N/A,N/A,N/A,1348,1359,N/A,109,2
35,N/A,N/A,N/A,1313,1348,N/A,112,5
40,N/A,N/A,N/A,1273,1313,N/A,118,5
23,N/A,N/A,N/A,1250,1273,N/A,123,4
12,N/A,N/A,N/A,1238,1250,N/A,129,4
8,N/A,N/A,N/A,1230,1238,N/A,134,3
9,N/A,N/A,N/A,1221,1230,N/A,138,1
7,N/A,N/A,N/A,746,753,N/A,5,1
29,N/A,N/A,N/A,717,746,N/A,10,6
26,N/A,N/A,N/A,691,717,N/A,15,5
48,N/A,N/A,N/A,643,691,N/A,21,5
27,N/A,N/A,N/A,616,643,N/A,26,4
8,N/A,N/A,N/A,608,616,N/A,29,1
6,N/A,N/A,N/A,602,608,N/A,35,1
7,N/A,N/A,N/A,595,602,N/A,41,1
47,N/A,N/A,N/A,548,595,N/A,46,6
29,N/A,N/A,N/A,519,548,N/A,50,4
10,N/A,N/A,N/A,509,519,N/A,55,3
39,N/A,N/A,N/A,470,509,N/A,58,6
18,N/A,N/A,N/A,452,470,N/A,62,4
18,N/A,N/A,N/A,434,452,N/A,68,4
11,N/A,N/A,N/A,423,434,N/A,73,3
11,N/A,N/A,N/A,412,423,N/A,78,2
34,N/A,N/A,N/A,378,412,N/A,81,5
10,N/A,N/A,N/A,368,378,N/A,84,2
7,N/A,N/A,N/A,361,368,N/A,90,2
35,N/A,N/A,N/A,326,361,N/A,94,6
24,N/A,N/A,N/A,302,326,N/A,98,4
9,N/A,N/A,N/A,293,302,N/A,101,1
5,N/A,N/A,N/A,288,293,N/A,107,1
12,N/A,N/A,N/A,276,288,N/A,110,4
7,N/A,N/A,N/A,269,276,N/A,114,2
7,N/A,N/A,N/A,262,269,N/A,119,1
47,N/A,N/A,N/A,215,262,N/A,124,6
38,N/A,N/A,N/A,177,215,N/A,129,5
11,N/A,N/A,N/A,166,177,N/A,133,3
29,N/A,N/A,N/A,137,166,N/A,136,6
30,N/A,N/A,N/A,548,578,N/A,4,5
10,N/A,N/A,N/A,538,548,N/A,8,3
45,N/A,N/A,N/A,493,538,N/A,11,6
11,N/A,N/A,N/A,482,493,N/A,15,4
10,N/A,N/A,N/A,472,482,N/A,19,2
7,N/A,N/A,N/A,465,472,N/A,24,1
8,N/A,N/A,N/A,457,465,N/A,30,1
26,N/A,N/A,N/A,431,457,N/A,35,6
10,N/A,N/A,N/A,421,431,N/A,39,4
8,N/A,N/A,N/A,413,421,N/A,43,2
8,N/A,N/A,N/A,405,413,N/A,49,2
9,N/A,N/A,N/A,396,405,N/A,55,2
11,N/A,N/A,N/A,385,396,N/A,61,2
6,N/A,N/A,N/A,379,385,N/A,66,1
9,N/A,N/A,N/A,370,379,N/A,72,1
9,N/A,N/A,N/A,361,370,N/A,78,1
39,N/A,N/A,N/A,322,361,N/A,82,5
38,N/A,N/A,N/A,284,322,N/A,88,5
11,N/A,N/A,N/A,273,284,N/A,92,3
8,N/A,N/A,N/A,265,273,N/A,96,1
7,N/A,N/A,N/A,258,265,N/A,102,1
42,N/A,N/A,N/A,216,258,N/A,106,5
7,N/A,N/A,N/A,209,216,N/A,109,2
40,N/A,N/A,N/A,169,209,N/A,113,6
30,N/A,N/A,N/A,139,169,N/A,118,5
29,N/A,N/A,N/A,110,139,N/A,124,5
10,N/A,N/A,N/A,100,110,N/A,129,4
10,N/A,N/A,N/A,90,100,N/A,134,3
38,N/A,N/A,N/A,52,90,N/A,137,6
24,N/A,N/A,N/A,28,52,N/A,141,4
28,N/A,N/A,N/A,770,798,N/A,6,5
11,N/A,N/A,N/A,759,770,N/A,9,2
6,N/A,N/A,N/A,753,759,N/A,14,1
11,N/A,N/A,N/A,742,753,N/A,17,4
7,N/A,N/A,N/A,735,742,N/A,20,1
29,N/A,N/A,N/A,706,735,N/A,23,4
10,N/A,N/A,N/A,696,706,N/A,28,3
38,N/A,N/A,N/A,658,696,N/A,31,6
29,N/A,N/A,N/A,629,658,N/A,35,4
5,N/A,N/A,N/A,624,629,N/A,38,1
5,N/A,N/A,N/A,619,624,N/A,44,1
30,N/A,N/A,N/A,589,619,N/A,48,5
9,N/A,N/A,N/A,580,589,N/A,52,3
8,N/A,N/A,N/A,572,580,N/A,57,2
48,N/A,N/A,N/A,524,572,N/A,61,6
8,N/A,N/A,N/A,516,524,N/A,67,0
39,N/A,N/A,N/A,477,516,N/A,73,6
8,N/A,N/A,N/A,469,477,N/A,76,3
35,N/A,N/A,N/A,434,469,N/A,79,6
23,N/A,N/A,N/A,411,434,N/A,83,4
19,N/A,N/A,N/A,392,411,N/A,89,4
10,N/A,N/A,N/A,382,392,N/A,93,2
42,N/A,N/A,N/A,340,382,N/A,96,5
7,N/A,N/A,N/A,333,340,N/A,99,2
11,N/A,N/A,N/A,322,333,N/A,105,2
42,N/A,N/A,N/A,280,322,N/A,108,5
36,N/A,N/A,N/A,244,280,N/A,114,5
11,N/A,N/A,N/A,233,244,N/A,119,4
8,N/A,N/A,N/A,225,233,N/A,124,3
6,N/A,N/A,N/A,219,225,N/A,128,1
43,N/A,N/A,N/A,412,455,N/A,5,5
10,N/A,N/A,N/A,402,412,N/A,10,4
11,N/A,N/A,N/A,391,402,N/A,14,2
40,N/A,N/A,N/A,351,391,N/A,18,6
5,N/A,N/A,N/A,346,351,N/A,24,0
14,N/A,N/A,N/A,332,346,N/A,28,4
10,N/A,N/A,N/A,322,332,N/A,32,2
44,N/A,N/A,N/A,278,322,N/A,35,5
10,N/A,N/A,N/A,268,278,N/A,38,2
29,N/A,N/A,N/A,239,268,N/A,42,6
28,N/A,N/A,N/A,211,239,N/A,47,5
7,N/A,N/A,N/A,204,211,N/A,51,3
29,N/A,N/A,N/A,175,204,N/A,54,6
10,N/A,N/A,N/A,165,175,N/A,57,3
11,N/A,N/A,N/A,154,165,N/A,62,2
25,N/A,N/A,N/A,129,154,N/A,66,6
22,N/A,N/A,N/A,107,129,N/A,70,4
9,N/A,N/A,N/A,98,107,N/A,73,1
26,N/A,N/A,N/A,72,98,N/A,76,4
11,N/A,N/A,N/A,61,72,N/A,81,3
9,N/A,N/A,N/A,52,61,N/A,85,1
29,N/A,N/A,N/A,23,52,N/A,89,5
26,N/A,N/A,N/A,-3,23,N/A,94,4
10,N/A,N/A,N/A,1260,1270,N/A,4,2
42,N/A,N/A,N/A,1218,1260,N/A,8,6
6,N/A,N/A,N/A,1212,1218,N/A,14,0
10,N/A,N/A,N/A,1202,1212,N/A,17,3
7,N/A,N/A,N/A,1195,1202,N/A,22,2
6,N/A,N/A,N/A,1189,1195,N/A,27,1
6,N/A,N/A,N/A,1183,1189,N/A,33,1
32,N/A,N/A,N/A,1151,1183,N/A,37,5
9,N/A,N/A,N/A,1142,1151,N/A,40,2
34,N/A,N/A,N/A,1108,1142,N/A,44,6
8,N/A,N/A,N/A,1100,1108,N/A,50,0
36,N/A,N/A,N/A,1064,1100,N/A,55,5
10,N/A,N/A,N/A,1054,1064,N/A,59,3
11,N/A,N/A,N/A,1043,1054,N/A,64,2
41,N/A,N/A,N/A,1002,1043,N/A,68,6
27,N/A,N/A,N/A,975,1002,N/A,72,4
8,N/A,N/A,N/A,967,975,N/A,77,3
8,N/A,N/A,N/A,959,967,N/A,82,2
9,N/A,N/A,N/A,950,959,N/A,88,2
8,N/A,N/A,N/A,942,950,N/A,93,1
42,N/A,N/A,N/A,900,942,N/A,98,6
8,N/A,N/A,N/A,892,900,N/A,101,3
37,N/A,N/A,N/A,855,892,N/A,104,6
48,N/A,N/A,N/A,807,855,N/A,109,5
22,N/A,N/A,N/A,785,807,N/A,114,4
5,N/A,N/A,N/A,780,785,N/A,117,1
18,N/A,N/A,N/A,762,780,N/A,120,4
7,N/A,N/A,N/A,755,762,N/A,123,1
10,N/A,N/A,N/A,745,755,N/A,126,4
14,N/A,N/A,N/A,731,745,N/A,132,4
7,N/A,N/A,N/A,1426,1433,N/A,4,2
46,N/A,N/A,N/A,1380,1426,N/A,8,6
27,N/A,N/A,N/A,1353,1380,N/A,13,5
14,N/A,N/A,N/A,1339,1353,N/A,18,4
25,N/A,N/A,N/A,1314,1339,N/A,24,4
10,N/A,N/A,N/A,1304,1314,N/A,28,2
35,N/A,N/A,N/A,1269,1304,N/A,32,6
20,N/A,N/A,N/A,1249,1269,N/A,36,4
10,N/A,N/A,N/A,1239,1249,N/A,42,4
7,N/A,N/A,N/A,1232,1239,N/A,47,3
7,N/A,N/A,N/A,1225,1232,N/A,52,2
48,N/A,N/A,N/A,1177,1225,N/A,56,6
14,N/A,N/A,N/A,1163,1177,N/A,60,4
9,N/A,N/A,N/A,1154,1163,N/A,63,1
9,N/A,N/A,N/A,1145,1154,N/A,69,1
28,N/A,N/A,N/A,1117,1145,N/A,74,6
16,N/A,N/A,N/A,1101,1117,N/A,78,4
10,N/A,N/A,N/A,1091,1101,N/A,83,3
5,N/A,N/A,N/A,1086,1091,N/A,87,1
47,N/A,N/A,N/A,1039,1086,N/A,92,6
16,N/A,N/A,N/A,1023,1039,N/A,96,4
26,N/A,N/A,N/A,997,1023,N/A,102,4
18,N/A,N/A,N/A,979,997,N/A,108,4
7,N/A,N/A,N/A,972,979,N/A,113,3
39,N/A,N/A,N/A,933,972,N/A,116,6
8,N/A,N/A,N/A,925,933,N/A,122,0
30,N/A,N/A,N/A,895,925,N/A,127,5
7,N/A,N/A,N/A,888,895,N/A,130,2
9,N/A,N/A,N/A,879,888,N/A,136,2
34,N/A,N/A,N/A,845,879,N/A,139,5
26,N/A,N/A,N/A,1911,1937,N/A,5,5
11,N/A,N/A,N/A,1900,1911,N/A,9,3
40,N/A,N/A,N/A,1860,1900,N/A,12,6
8,N/A,N/A,N/A,1852,1860,N/A,15,3
7,N/A,N/A,N/A,1845,1852,N/A,21,3
11,N/A,N/A,N/A,1834,1845,N/A,27,3
11,N/A,N/A,N/A,1823,1834,N/A,33,3
33,N/A,N/A,N/A,1790,1823,N/A,36,6
20,N/A,N/A,N/A,1770,1790,N/A,40,4
5,N/A,N/A,N/A,1765,1770,N/A,43,1
46,N/A,N/A,N/A,1719,1765,N/A,47,5
7,N/A,N/A,N/A,1712,1719,N/A,51,3
8,N/A,N/A,N/A,1704,1712,N/A,57,3
5,N/A,N/A,N/A,1699,1704,N/A,61,1
48,N/A,N/A,N/A,1651,1699,N/A,66,6
26,N/A,N/A,N/A,1625,1651,N/A,71,5
11,N/A,N/A,N/A,1614,1625,N/A,74,2
5,N/A,N/A,N/A,1609,1614,N/A,79,1
32,N/A,N/A,N/A,1577,1609,N/A,84,6
19,N/A,N/A,N/A,1558,1577,N/A,88,4
9,N/A,N/A,N/A,1549,1558,N/A,93,3
8,N/A,N/A,N/A,1541,1549,N/A,97,1
24,N/A,N/A,N/A,1517,1541,N/A,100,4
8,N/A,N/A,N/A,1509,1517,N/A,104,2
11,N/A,N/A,N/A,1498,1509,N/A,110,2
5,N/A,N/A,N/A,1493,1498,N/A,115,1
45,N/A,N/A,N/A,1448,1493,N/A,119,5
15,N/A,N/A,N/A,1433,1448,N/A,124,4
7,N/A,N/A,N/A,1426,1433,N/A,129,3
7,N/A,N/A,N/A,1419,1426,N/A,135,3
47,N/A,N/A,N/A,1919,1966,N/A,6,6
7,N/A,N/A,N/A,1912,1919,N/A,9,3
7,N/A,N/A,N/A,1905,1912,N/A,13,1
26,N/A,N/A,N/A,1879,1905,N/A,18,6
20,N/A,N/A,N/A,1859,1879,N/A,22,4
15,N/A,N/A,N/A,1844,1859,N/A,28,4
10,N/A,N/A,N/A,1834,1844,N/A,34,4
9,N/A,N/A,N/A,1825,1834,N/A,39,3
8,N/A,N/A,N/A,1817,1825,N/A,45,3
47,N/A,N/A,N/A,1770,1817,N/A,48,6
27,N/A,N/A,N/A,1743,1770,N/A,52,4
24,N/A,N/A,N/A,1719,1743,N/A,58,4
9,N/A,N/A,N/A,1710,1719,N/A,61,1
25,N/A,N/A,N/A,1685,1710,N/A,64,4
8,N/A,N/A,N/A,1677,1685,N/A,67,1
38,N/A,N/A,N/A,1639,1677,N/A,72,6
42,N/A,N/A,N/A,1597,1639,N/A,77,5
9,N/A,N/A,N/A,1588,1597,N/A,81,3
8,N/A,N/A,N/A,1580,1588,N/A,85,1
15,N/A,N/A,N/A,1565,1580,N/A,88,4
10,N/A,N/A,N/A,1555,1565,N/A,92,2
9,N/A,N/A,N/A,1546,1555,N/A,97,1
8,N/A,N/A,N/A,1538,1546,N/A,103,1
42,N/A,N/A,N/A,1496,1538,N/A,108,6
16,N/A,N/A,N/A,1480,1496,N/A,112,4
7,N/A,N/A,N/A,1473,1480,N/A,115,1
30,N/A,N/A,N/A,1443,1473,N/A,119,5
11,N/A,N/A,N/A,1432,1443,N/A,123,3
5,N/A,N/A,N/A,1427,1432,N/A,127,1
9,N/A,N/A,N/A,1418,1427,N/A,133,1
5,N/A,N/A,N/A,866,871,N/A,3,1
47,N/A,N/A,N/A,819,866,N/A,8,6
13,N/A,N/A,N/A,806,819,N/A,12,4
10,N/A,N/A,N/A,796,806,N/A,16,2
33,N/A,N/A,N/A,763,796,N/A,19,5
38,N/A,N/A,N/A,725,763,N/A,25,5
20,N/A,N/A,N/A,705,725,N/A,30,4
7,N/A,N/A,N/A,698,705,N/A,34,2
5,N/A,N/A,N/A,693,698,N/A,39,1
33,N/A,N/A,N/A,660,693,N/A,44,6
5,N/A,N/A,N/A,655,660,N/A,50,0
45,N/A,N/A,N/A,610,655,N/A,55,5
48,N/A,N/A,N/A,562,610,N/A,61,5
20,N/A,N/A,N/A,542,562,N/A,66,4
25,N/A,N/A,N/A,517,542,N/A,72,4
21,N/A,N/A,N/A,496,517,N/A,78,4
14,N/A,N/A,N/A,482,496,N/A,84,4
10,N/A,N/A,N/A,472,482,N/A,88,2
7,N/A,N/A,N/A,465,472,N/A,93,1
6,N/A,N/A,N/A,459,465,N/A,99,1
9,N/A,N/A,N/A,450,459,N/A,105,1
46,N/A,N/A,N/A,404,450,N/A,109,5
23,N/A,N/A,N/A,381,404,N/A,114,4
8,N/A,N/A,N/A,373,381,N/A,119,3
41,N/A,N/A,N/A,332,373,N/A,122,6
6,N/A,N/A,N/A,326,332,N/A,128,0
7,N/A,N/A,N/A,319,326,N/A,131,3
8,N/A,N/A,N/A,311,319,N/A,137,3
5,N/A,N/A,N/A,306,311,N/A,141,1
25,N/A,N/A,N/A,281,306,N/A,145,5
31,N/A,N/A,N/A,773,804,N/A,4,5
8,N/A,N/A,N/A,765,773,N/A,8,3
32,N/A,N/A,N/A,733,765,N/A,11,6
9,N/A,N/A,N/A,724,733,N/A,14,3
9,N/A,N/A,N/A,715,724,N/A,20,3
9,N/A,N/A,N/A,706,715,N/A,24,1
8,N/A,N/A,N/A,698,706,N/A,30,1
49,N/A,N/A,N/A,649,698,N/A,34,5
8,N/A,N/A,N/A,641,649,N/A,37,2
8,N/A,N/A,N/A,633,641,N/A,42,1
39,N/A,N/A,N/A,594,633,N/A,46,5
16,N/A,N/A,N/A,578,594,N/A,51,4
7,N/A,N/A,N/A,571,578,N/A,55,2
48,N/A,N/A,N/A,523,571,N/A,59,6
35,N/A,N/A,N/A,488,523,N/A,64,5
29,N/A,N/A,N/A,459,488,N/A,70,5
8,N/A,N/A,N/A,451,459,N/A,73,2
8,N/A,N/A,N/A,443,451,N/A,79,2
9,N/A,N/A,N/A,434,443,N/A,85,2
33,N/A,N/A,N/A,401,434,N/A,88,5
46,N/A,N/A,N/A,355,401,N/A,94,5
8,N/A,N/A,N/A,347,355,N/A,97,2
46,N/A,N/A,N/A,301,347,N/A,101,6
6,N/A,N/A,N/A,295,301,N/A,107,0
10,N/A,N/A,N/A,285,295,N/A,111,4
11,N/A,N/A,N/A,274,285,N/A,116,3
7,N/A,N/A,N/A,267,274,N/A,120,1
31,N/A,N/A,N/A,236,267,N/A,124,5
10,N/A,N/A,N/A,226,236,N/A,127,2
28,N/A,N/A,N/A,198,226,N/A,131,6
7,N/A,N/A,N/A,1311,1318,N/A,6,2
8,N/A,N/A,N/A,1303,1311,N/A,11,1
18,N/A,N/A,N/A,1285,1303,N/A,14,4
10,N/A,N/A,N/A,1275,1285,N/A,19,3
11,N/A,N/A,N/A,1264,1275,N/A,25,3
7,N/A,N/A,N/A,1257,1264,N/A,29,1
26,N/A,N/A,N/A,1231,1257,N/A,33,5
46,N/A,N/A,N/A,1185,1231,N/A,39,5
31,N/A,N/A,N/A,1154,1185,N/A,45,5
11,N/A,N/A,N/A,1143,1154,N/A,48,2
7,N/A,N/A,N/A,1136,1143,N/A,53,1
49,N/A,N/A,N/A,1087,1136,N/A,57,5
17,N/A,N/A,N/A,1070,1087,N/A,62,4
11,N/A,N/A,N/A,1059,1070,N/A,67,3
49,N/A,N/A,N/A,1010,1059,N/A,70,6
6,N/A,N/A,N/A,1004,1010,N/A,76,0
25,N/A,N/A,N/A,979,1004,N/A,81,5
46,N/A,N/A,N/A,933,979,N/A,87,5
10,N/A,N/A,N/A,923,933,N/A,90,2
38,N/A,N/A,N/A,885,923,N/A,94,6
23,N/A,N/A,N/A,862,885,N/A,98,4
11,N/A,N/A,N/A,851,862,N/A,103,3
10,N/A,N/A,N/A,841,851,N/A,108,2
45,N/A,N/A,N/A,796,841,N/A,112,6
11,N/A,N/A,N/A,785,796,N/A,115,3
7,N/A,N/A,N/A,778,785,N/A,120,2
11,N/A,N/A,N/A,767,778,N/A,126,2
47,N/A,N/A,N/A,720,767,N/A,129,5
12,N/A,N/A,N/A,708,720,N/A,134,4
9,N/A,N/A,N/A,699,708,N/A,137,1
37,N/A,N/A,N/A,855,892,N/A,4,6
30,N/A,N/A,N/A,825,855,N/A,9,5
40,N/A,N/A,N/A,785,825,N/A,15,5
9,N/A,N/A,N/A,776,785,N/A,19,3
6,N/A,N/A,N/A,770,776,N/A,23,1
38,N/A,N/A,N/A,732,770,N/A,28,6
27,N/A,N/A,N/A,705,732,N/A,33,5
12,N/A,N/A,N/A,693,705,N/A,38,4
9,N/A,N/A,N/A,684,693,N/A,43,3
8,N/A,N/A,N/A,676,684,N/A,49,3
7,N/A,N/A,N/A,669,676,N/A,55,3
40,N/A,N/A,N/A,629,669,N/A,58,6
45,N/A,N/A,N/A,584,629,N/A,63,5
29,N/A,N/A,N/A,555,584,N/A,68,4
20,N/A,N/A,N/A,535,555,N/A,74,4
11,N/A,N/A,N/A,524,535,N/A,78,2
46,N/A,N/A,N/A,478,524,N/A,82,6
7,N/A,N/A,N/A,471,478,N/A,88,0
11,N/A,N/A,N/A,460,471,N/A,91,3
5,N/A,N/A,N/A,455,460,N/A,95,1
30,N/A,N/A,N/A,425,455,N/A,100,6
6,N/A,N/A,N/A,419,425,N/A,106,0
8,N/A,N/A,N/A,411,419,N/A,109,3
8,N/A,N/A,N/A,403,411,N/A,115,3
8,N/A,N/A,N/A,395,403,N/A,120,2
7,N/A,N/A,N/A,388,395,N/A,125,1
5,N/A,N/A,N/A,383,388,N/A,131,1
48,N/A,N/A,N/A,335,383,N/A,135,5
39,N/A,N/A,N/A,296,335,N/A,141,5
7,N/A,N/A,N/A,289,296,N/A,144,2
5,N/A,N/A,N/A,1010,1015,N/A,5,1
5,N/A,N/A,N/A,1005,1010,N/A,11,1
30,N/A,N/A,N/A,975,1005,N/A,16,6
44,N/A,N/A,N/A,931,975,N/A,21,5
9,N/A,N/A,N/A,922,931,N/A,24,2
26,N/A,N/A,N/A,896,922,N/A,28,6
10,N/A,N/A,N/A,886,896,N/A,31,3
42,N/A,N/A,N/A,844,886,N/A,34,6
5,N/A,N/A,N/A,839,844,N/A,40,0
27,N/A,N/A,N/A,812,839,N/A,44,4
10,N/A,N/A,N/A,802,812,N/A,49,3
9,N/A,N/A,N/A,793,802,N/A,53,1
5,N/A,N/A,N/A,788,793,N/A,59,1
27,N/A,N/A,N/A,761,788,N/A,62,4
6,N/A,N/A,N/A,755,761,N/A,65,1
30,N/A,N/A,N/A,725,755,N/A,70,6
9,N/A,N/A,N/A,716,725,N/A,76,0
36,N/A,N/A,N/A,680,716,N/A,82,6
15,N/A,N/A,N/A,665,680,N/A,86,4
11,N/A,N/A,N/A,654,665,N/A,90,2
7,N/A,N/A,N/A,647,654,N/A,95,1
28,N/A,N/A,N/A,619,647,N/A,99,5
11,N/A,N/A,N/A,608,619,N/A,103,3
6,N/A,N/A,N/A,602,608,N/A,107,1
48,N/A,N/A,N/A,554,602,N/A,112,6
36,N/A,N/A,N/A,518,554,N/A,117,5
31,N/A,N/A,N/A,487,518,N/A,123,5
14,N/A,N/A,N/A,473,487,N/A,128,4
9,N/A,N/A,N/A,464,473,N/A,132,2
28,N/A,N/A,N/A,436,464,N/A,136,6
44,N/A,N/A,N/A,900,944,N/A,5,6
14,N/A,N/A,N/A,886,900,N/A,9,4
6,N/A,N/A,N/A,880,886,N/A,12,1
6,N/A,N/A,N/A,874,880,N/A,18,1
5,N/A,N/A,N/A,869,874,N/A,24,1
36,N/A,N/A,N/A,833,869,N/A,28,5
29,N/A,N/A,N/A,804,833,N/A,33,4
11,N/A,N/A,N/A,793,804,N/A,37,2
9,N/A,N/A,N/A,784,793,N/A,42,1
42,N/A,N/A,N/A,742,784,N/A,47,6
13,N/A,N/A,N/A,729,742,N/A,51,4
11,N/A,N/A,N/A,718,729,N/A,56,3
10,N/A,N/A,N/A,708,718,N/A,62,3
34,N/A,N/A,N/A,674,708,N/A,65,6
33,N/A,N/A,N/A,641,674,N/A,70,5
11,N/A,N/A,N/A,630,641,N/A,73,2
34,N/A,N/A,N/A,596,630,N/A,77,6
10,N/A,N/A,N/A,586,596,N/A,80,3
40,N/A,N/A,N/A,546,586,N/A,83,6
42,N/A,N/A,N/A,504,546,N/A,88,5
23,N/A,N/A,N/A,481,504,N/A,93,4
20,N/A,N/A,N/A,461,481,N/A,99,4
8,N/A,N/A,N/A,453,461,N/A,103,2
34,N/A,N/A,N/A,419,453,N/A,107,6
40,N/A,N/A,N/A,379,419,N/A,112,5
32,N/A,N/A,N/A,347,379,N/A,118,5
11,N/A,N/A,N/A,336,347,N/A,121,2
5,N/A,N/A,N/A,331,336,N/A,126,1
10,N/A,N/A,N/A,321,331,N/A,129,4
9,N/A,N/A,N/A,312,321,N/A,133,2
7,N/A,N/A,N/A,1579,1586,N/A,5,1
6,N/A,N/A,N/A,1573,1579,N/A,11,1
48,N/A,N/A,N/A,1525,1573,N/A,16,6
19,N/A,N/A,N/A,1506,1525,N/A,20,4
7,N/A,N/A,N/A,1499,1506,N/A,24,2
38,N/A,N/A,N/A,1461,1499,N/A,28,6
6,N/A,N/A,N/A,1455,1461,N/A,34,0
25,N/A,N/A,N/A,1430,1455,N/A,38,4
7,N/A,N/A,N/A,1423,1430,N/A,42,2
37,N/A,N/A,N/A,1386,1423,N/A,45,5
48,N/A,N/A,N/A,1338,1386,N/A,51,5
25,N/A,N/A,N/A,1313,1338,N/A,57,5
11,N/A,N/A,N/A,1302,1313,N/A,61,3
7,N/A,N/A,N/A,1295,1302,N/A,67,3
26,N/A,N/A,N/A,1269,1295,N/A,70,6
8,N/A,N/A,N/A,1261,1269,N/A,73,3
29,N/A,N/A,N/A,1232,1261,N/A,76,6
36,N/A,N/A,N/A,1196,1232,N/A,81,5
9,N/A,N/A,N/A,1187,1196,N/A,85,3
10,N/A,N/A,N/A,1177,1187,N/A,90,2
47,N/A,N/A,N/A,1130,1177,N/A,93,5
23,N/A,N/A,N/A,1107,1130,N/A,98,4
7,N/A,N/A,N/A,1100,1107,N/A,102,2
27,N/A,N/A,N/A,1073,1100,N/A,105,5
11,N/A,N/A,N/A,1062,1073,N/A,109,3
9,N/A,N/A,N/A,1053,1062,N/A,114,2
6,N/A,N/A,N/A,1047,1053,N/A,119,1
8,N/A,N/A,N/A,1039,1047,N/A,125,1
32,N/A,N/A,N/A,1007,1039,N/A,130,6
19,N/A,N/A,N/A,988,1007,N/A,134,4
40,N/A,N/A,N/A,435,475,N/A,3,6
10,N/A,N/A,N/A,425,435,N/A,6,3
8,N/A,N/A,N/A,417,425,N/A,11,2
5,N/A,N/A,N/A,412,417,N/A,16,1
32,N/A,N/A,N/A,380,412,N/A,21,6
9,N/A,N/A,N/A,371,380,N/A,27,0
20,N/A,N/A,N/A,351,371,N/A,31,4
18,N/A,N/A,N/A,333,351,N/A,37,4
12,N/A,N/A,N/A,321,333,N/A,43,4
6,N/A,N/A,N/A,315,321,N/A,46,1
7,N/A,N/A,N/A,308,315,N/A,52,1
6,N/A,N/A,N/A,302,308,N/A,58,1
20,N/A,N/A,N/A,282,302,N/A,61,4
11,N/A,N/A,N/A,271,282,N/A,65,2
9,N/A,N/A,N/A,262,271,N/A,70,1
5,N/A,N/A,N/A,257,262,N/A,76,1
20,N/A,N/A,N/A,237,257,N/A,79,4
8,N/A,N/A,N/A,229,237,N/A,83,2
35,N/A,N/A,N/A,194,229,N/A,87,6
35,N/A,N/A,N/A,159,194,N/A,92,5
11,N/A,N/A,N/A,148,159,N/A,97,4
8,N/A,N/A,N/A,140,148,N/A,100,1
7,N/A,N/A,N/A,133,140,N/A,106,1
6,N/A,N/A,N/A,127,133,N/A,112,1
40,N/A,N/A,N/A,87,127,N/A,117,6
7,N/A,N/A,N/A,80,87,N/A,123,0
10,N/A,N/A,N/A,70,80,N/A,126,3
11,N/A,N/A,N/A,59,70,N/A,131,2
6,N/A,N/A,N/A,53,59,N/A,136,1
6,N/A,N/A,N/A,47,53,N/A,142,1
34,N/A,N/A,N/A,503,537,N/A,4,6
47,N/A,N/A,N/A,456,503,N/A,9,5
7,N/A,N/A,N/A,449,456,N/A,13,3
7,N/A,N/A,N/A,442,449,N/A,19,3
8,N/A,N/A,N/A,434,442,N/A,25,3
34,N/A,N/A,N/A,400,434,N/A,28,6
22,N/A,N/A,N/A,378,400,N/A,32,4
24,N/A,N/A,N/A,354,378,N/A,38,4
10,N/A,N/A,N/A,344,354,N/A,44,4
8,N/A,N/A,N/A,336,344,N/A,47,1
36,N/A,N/A,N/A,300,336,N/A,51,5
37,N/A,N/A,N/A,263,300,N/A,57,5
47,N/A,N/A,N/A,216,263,N/A,63,5
10,N/A,N/A,N/A,206,216,N/A,67,3
42,N/A,N/A,N/A,164,206,N/A,70,6
9,N/A,N/A,N/A,155,164,N/A,73,3
9,N/A,N/A,N/A,146,155,N/A,78,2
27,N/A,N/A,N/A,119,146,N/A,82,6
43,N/A,N/A,N/A,76,119,N/A,87,5
37,N/A,N/A,N/A,39,76,N/A,93,5
27,N/A,N/A,N/A,12,39,N/A,98,4
7,N/A,N/A,N/A,5,12,N/A,103,3
8,N/A,N/A,N/A,-3,5,N/A,109,3
7,N/A,N/A,N/A,523,530,N/A,6,3
7,N/A,N/A,N/A,516,523,N/A,10,1
19,N/A,N/A,N/A,497,516,N/A,13,4
11,N/A,N/A,N/A,486,497,N/A,19,4
5,N/A,N/A,N/A,481,486,N/A,22,1
18,N/A,N/A,N/A,463,481,N/A,25,4
6,N/A,N/A,N/A,457,463,N/A,28,1
6,N/A,N/A,N/A,451,457,N/A,34,1
15,N/A,N/A,N/A,436,451,N/A,37,4
7,N/A,N/A,N/A,429,436,N/A,41,2
34,N/A,N/A,N/A,395,429,N/A,45,6
24,N/A,N/A,N/A,371,395,N/A,49,4
9,N/A,N/A,N/A,362,371,N/A,53,2
45,N/A,N/A,N/A,317,362,N/A,56,5
23,N/A,N/A,N/A,294,317,N/A,61,4
8,N/A,N/A,N/A,286,294,N/A,64,1
17,N/A,N/A,N/A,269,286,N/A,67,4
8,N/A,N/A,N/A,261,269,N/A,71,2
42,N/A,N/A,N/A,219,261,N/A,75,6
26,N/A,N/A,N/A,193,219,N/A,80,5
12,N/A,N/A,N/A,181,193,N/A,85,4
18,N/A,N/A,N/A,163,181,N/A,91,4
9,N/A,N/A,N/A,154,163,N/A,96,3
11,N/A,N/A,N/A,143,154,N/A,101,2
37,N/A,N/A,N/A,106,143,N/A,104,5
25,N/A,N/A,N/A,81,106,N/A,110,5
8,N/A,N/A,N/A,73,81,N/A,113,2
7,N/A,N/A,N/A,66,73,N/A,119,2
11,N/A,N/A,N/A,55,66,N/A,125,2
27,N/A,N/A,N/A,28,55,N/A,129,6
9,N/A,N/A,N/A,1016,1025,N/A,6,3
28,N/A,N/A,N/A,988,1016,N/A,9,6
40,N/A,N/A,N/A,948,988,N/A,14,5
7,N/A,N/A,N/A,941,948,N/A,17,2
38,N/A,N/A,N/A,903,941,N/A,20,5
7,N/A,N/A,N/A,896,903,N/A,23,2
43,N/A,N/A,N/A,853,896,N/A,26,5
11,N/A,N/A,N/A,842,853,N/A,30,3
7,N/A,N/A,N/A,835,842,N/A,36,3
5,N/A,N/A,N/A,830,835,N/A,40,1
46,N/A,N/A,N/A,784,830,N/A,45,6
48,N/A,N/A,N/A,736,784,N/A,50,5
11,N/A,N/A,N/A,725,736,N/A,54,3
7,N/A,N/A,N/A,718,725,N/A,60,3
39,N/A,N/A,N/A,679,718,N/A,63,6
5,N/A,N/A,N/A,674,679,N/A,69,0
38,N/A,N/A,N/A,636,674,N/A,74,5
12,N/A,N/A,N/A,624,636,N/A,79,4
7,N/A,N/A,N/A,617,624,N/A,83,2
10,N/A,N/A,N/A,607,617,N/A,89,2
39,N/A,N/A,N/A,568,607,N/A,92,5
10,N/A,N/A,N/A,558,568,N/A,96,3
6,N/A,N/A,N/A,552,558,N/A,100,1
21,N/A,N/A,N/A,531,552,N/A,103,4
7,N/A,N/A,N/A,524,531,N/A,106,1
43,N/A,N/A,N/A,481,524,N/A,110,5
35,N/A,N/A,N/A,446,481,N/A,116,5
17,N/A,N/A,N/A,429,446,N/A,121,4
7,N/A,N/A,N/A,422,429,N/A,124,1
38,N/A,N/A,N/A,384,422,N/A,128,5
22,N/A,N/A,N/A,1328,1350,N/A,6,4
11,N/A,N/A,N/A,1317,1328,N/A,10,2
36,N/A,N/A,N/A,1281,1317,N/A,13,5
10,N/A,N/A,N/A,1271,1281,N/A,16,2
42,N/A,N/A,N/A,1229,1271,N/A,20,6
7,N/A,N/A,N/A,1222,1229,N/A,26,0
38,N/A,N/A,N/A,1184,1222,N/A,32,6
10,N/A,N/A,N/A,1174,1184,N/A,35,3
11,N/A,N/A,N/A,1163,1174,N/A,40,2
39,N/A,N/A,N/A,1124,1163,N/A,43,5
9,N/A,N/A,N/A,1115,1124,N/A,47,3
5,N/A,N/A,N/A,1110,1115,N/A,51,1
8,N/A,N/A,N/A,1102,1110,N/A,57,1
7,N/A,N/A,N/A,1095,1102,N/A,63,1
21,N/A,N/A,N/A,1074,1095,N/A,66,4
19,N/A,N/A,N/A,1055,1074,N/A,72,4
10,N/A,N/A,N/A,1045,1055,N/A,77,3
8,N/A,N/A,N/A,1037,1045,N/A,82,2
47,N/A,N/A,N/A,990,1037,N/A,86,6
6,N/A,N/A,N/A,984,990,N/A,92,0
7,N/A,N/A,N/A,977,984,N/A,95,3
28,N/A,N/A,N/A,949,977,N/A,98,6
10,N/A,N/A,N/A,939,949,N/A,101,3
5,N/A,N/A,N/A,934,939,N/A,105,1
8,N/A,N/A,N/A,926,934,N/A,111,1
6,N/A,N/A,N/A,920,926,N/A,117,1
38,N/A,N/A,N/A,882,920,N/A,122,6
37,N/A,N/A,N/A,845,882,N/A,127,5
7,N/A,N/A,N/A,838,845,N/A,130,2
29,N/A,N/A,N/A,809,838,N/A,133,5
34,N/A,N/A,N/A,1876,1910,N/A,4,6
29,N/A,N/A,N/A,1847,1876,N/A,9,5
8,N/A,N/A,N/A,1839,1847,N/A,13,3
33,N/A,N/A,N/A,1806,1839,N/A,16,6
39,N/A,N/A,N/A,1767,1806,N/A,21,5
10,N/A,N/A,N/A,1757,1767,N/A,24,2
10,N/A,N/A,N/A,1747,1757,N/A,30,2
7,N/A,N/A,N/A,1740,1747,N/A,36,2
39,N/A,N/A,N/A,1701,1740,N/A,40,6
7,N/A,N/A,N/A,1694,1701,N/A,43,3
11,N/A,N/A,N/A,1683,1694,N/A,49,3
47,N/A,N/A,N/A,1636,1683,N/A,52,6
7,N/A,N/A,N/A,1629,1636,N/A,58,0
10,N/A,N/A,N/A,1619,1629,N/A,61,3
28,N/A,N/A,N/A,1591,1619,N/A,64,6
28,N/A,N/A,N/A,1563,1591,N/A,68,4
11,N/A,N/A,N/A,1552,1563,N/A,72,2
7,N/A,N/A,N/A,1545,1552,N/A,78,2
7,N/A,N/A,N/A,1538,1545,N/A,83,1
44,N/A,N/A,N/A,1494,1538,N/A,88,6
39,N/A,N/A,N/A,1455,1494,N/A,93,5
7,N/A,N/A,N/A,1448,1455,N/A,97,3
8,N/A,N/A,N/A,1440,1448,N/A,101,1
44,N/A,N/A,N/A,1396,1440,N/A,106,6
30,N/A,N/A,N/A,1366,1396,N/A,111,5
11,N/A,N/A,N/A,1355,1366,N/A,115,3
9,N/A,N/A,N/A,1346,1355,N/A,120,2
39,N/A,N/A,N/A,1307,1346,N/A,123,5
11,N/A,N/A,N/A,1296,1307,N/A,127,3
11,N/A,N/A,N/A,1285,1296,N/A,133,3
7,N/A,N/A,N/A,1508,1515,N/A,5,3
7,N/A,N/A,N/A,1501,1508,N/A,9,1
27,N/A,N/A,N/A,1474,1501,N/A,12,4
9,N/A,N/A,N/A,1465,1474,N/A,16,2
5,N/A,N/A,N/A,1460,1465,N/A,21,1
35,N/A,N/A,N/A,1425,1460,N/A,25,5
10,N/A,N/A,N/A,1415,1425,N/A,30,4
8,N/A,N/A,N/A,1407,1415,N/A,35,3
11,N/A,N/A,N/A,1396,1407,N/A,40,2
32,N/A,N/A,N/A,1364,1396,N/A,43,5
9,N/A,N/A,N/A,1355,1364,N/A,46,2
7,N/A,N/A,N/A,1348,1355,N/A,52,2
36,N/A,N/A,N/A,1312,1348,N/A,56,6
19,N/A,N/A,N/A,1293,1312,N/A,60,4
23,N/A,N/A,N/A,1270,1293,N/A,66,4
9,N/A,N/A,N/A,1261,1270,N/A,69,1
47,N/A,N/A,N/A,1214,1261,N/A,74,6
42,N/A,N/A,N/A,1172,1214,N/A,79,5
11,N/A,N/A,N/A,1161,1172,N/A,82,2
11,N/A,N/A,N/A,1150,1161,N/A,88,2
42,N/A,N/A,N/A,1108,1150,N/A,92,6
10,N/A,N/A,N/A,1098,1108,N/A,96,4
22,N/A,N/A,N/A,1076,1098,N/A,102,4
20,N/A,N/A,N/A,1056,1076,N/A,108,4
11,N/A,N/A,N/A,1045,1056,N/A,112,2
9,N/A,N/A,N/A,1036,1045,N/A,118,2
34,N/A,N/A,N/A,1002,1036,N/A,121,5
8,N/A,N/A,N/A,994,1002,N/A,124,2
28,N/A,N/A,N/A,966,994,N/A,128,6
7,N/A,N/A,N/A,959,966,N/A,131,3
35,N/A,N/A,N/A,327,362,N/A,5,6
8,N/A,N/A,N/A,319,327,N/A,8,3
7,N/A,N/A,N/A,312,319,N/A,14,3
8,N/A,N/A,N/A,304,312,N/A,20,3
8,N/A,N/A,N/A,296,304,N/A,25,2
7,N/A,N/A,N/A,289,296,N/A,30,1
28,N/A,N/A,N/A,261,289,N/A,35,6
14,N/A,N/A,N/A,247,261,N/A,39,4
7,N/A,N/A,N/A,240,247,N/A,44,3
11,N/A,N/A,N/A,229,240,N/A,50,3
37,N/A,N/A,N/A,192,229,N/A,53,6
20,N/A,N/A,N/A,172,192,N/A,57,4
10,N/A,N/A,N/A,162,172,N/A,62,3
5,N/A,N/A,N/A,157,162,N/A,66,1
8,N/A,N/A,N/A,149,157,N/A,72,1
8,N/A,N/A,N/A,141,149,N/A,78,1
28,N/A,N/A,N/A,113,141,N/A,81,4
9,N/A,N/A,N/A,104,113,N/A,86,3
49,N/A,N/A,N/A,55,104,N/A,89,6
7,N/A,N/A,N/A,48,55,N/A,92,3
29,N/A,N/A,N/A,19,48,N/A,95,6
18,N/A,N/A,N/A,1,19,N/A,99,4
11,N/A,N/A,N/A,-10,1,N/A,103,2
30,N/A,N/A,N/A,960,990,N/A,6,5
9,N/A,N/A,N/A,951,960,N/A,10,3
47,N/A,N/A,N/A,904,951,N/A,13,6
25,N/A,N/A,N/A,879,904,N/A,18,5
23,N/A,N/A,N/A,856,879,N/A,23,4
9,N/A,N/A,N/A,847,856,N/A,26,1
32,N/A,N/A,N/A,815,847,N/A,31,6
7,N/A,N/A,N/A,808,815,N/A,34,3
11,N/A,N/A,N/A,797,808,N/A,39,2
45,N/A,N/A,N/A,752,797,N/A,42,5
20,N/A,N/A,N/A,732,752,N/A,47,4
9,N/A,N/A,N/A,723,732,N/A,50,1
49,N/A,N/A,N/A,674,723,N/A,54,5
9,N/A,N/A,N/A,665,674,N/A,58,3
8,N/A,N/A,N/A,657,665,N/A,63,2
43,N/A,N/A,N/A,614,657,N/A,67,6
15,N/A,N/A,N/A,599,614,N/A,71,4
11,N/A,N/A,N/A,588,599,N/A,75,2
31,N/A,N/A,N/A,557,588,N/A,78,5
11,N/A,N/A,N/A,546,557,N/A,82,3
5,N/A,N/A,N/A,541,546,N/A,86,1
13,N/A,N/A,N/A,528,541,N/A,89,4
11,N/A,N/A,N/A,517,528,N/A,94,3
9,N/A,N/A,N/A,508,517,N/A,98,1
9,N/A,N/A,N/A,499,508,N/A,104,1
17,N/A,N/A,N/A,482,499,N/A,107,4
5,N/A,N/A,N/A,477,482,N/A,110,1
44,N/A,N/A,N/A,433,477,N/A,114,5
35,N/A,N/A,N/A,398,433,N/A,120,5
22,N/A,N/A,N/A,376,398,N/A,125,4
9,N/A,N/A,N/A,689,698,N/A,4,1
32,N/A,N/A,N/A,657,689,N/A,8,5
8,N/A,N/A,N/A,649,657,N/A,11,2
8,N/A,N/A,N/A,641,649,N/A,17,2
8,N/A,N/A,N/A,633,641,N/A,23,2
8,N/A,N/A,N/A,625,633,N/A,28,1
29,N/A,N/A,N/A,596,625,N/A,33,6
9,N/A,N/A,N/A,587,596,N/A,36,3
9,N/A,N/A,N/A,578,587,N/A,42,3
36,N/A,N/A,N/A,542,578,N/A,45,6
8,N/A,N/A,N/A,534,542,N/A,51,0
8,N/A,N/A,N/A,526,534,N/A,54,3
9,N/A,N/A,N/A,517,526,N/A,58,1
7,N/A,N/A,N/A,510,517,N/A,64,1
30,N/A,N/A,N/A,480,510,N/A,68,5
7,N/A,N/A,N/A,473,480,N/A,71,2
9,N/A,N/A,N/A,464,473,N/A,76,1
28,N/A,N/A,N/A,436,464,N/A,81,6
9,N/A,N/A,N/A,427,436,N/A,87,0
34,N/A,N/A,N/A,393,427,N/A,93,6
46,N/A,N/A,N/A,347,393,N/A,98,5
7,N/A,N/A,N/A,340,347,N/A,101,2
7,N/A,N/A,N/A,333,340,N/A,107,2
8,N/A,N/A,N/A,325,333,N/A,112,1
17,N/A,N/A,N/A,308,325,N/A,115,4
8,N/A,N/A,N/A,300,308,N/A,118,1
7,N/A,N/A,N/A,293,300,N/A,124,1
9,N/A,N/A,N/A,284,293,N/A,130,1
37,N/A,N/A,N/A,247,284,N/A,134,5
35,N/A,N/A,N/A,212,247,N/A,140,5
9,N/A,N/A,N/A,1811,1820,N/A,3,1
25,N/A,N/A,N/A,1786,1811,N/A,8,6
11,N/A,N/A,N/A,1775,1786,N/A,11,3
11,N/A,N/A,N/A,1764,1775,N/A,17,3
6,N/A,N/A,N/A,1758,1764,N/A,21,1
46,N/A,N/A,N/A,1712,1758,N/A,26,6
42,N/A,N/A,N/A,1670,1712,N/A,31,5
29,N/A,N/A,N/A,1641,1670,N/A,36,4
16,N/A,N/A,N/A,1625,1641,N/A,42,4
9,N/A,N/A,N/A,1616,1625,N/A,47,3
47,N/A,N/A,N/A,1569,1616,N/A,50,6
7,N/A,N/A,N/A,1562,1569,N/A,53,3
11,N/A,N/A,N/A,1551,1562,N/A,59,3
7,N/A,N/A,N/A,1544,1551,N/A,64,2
39,N/A,N/A,N/A,1505,1544,N/A,68,6
16,N/A,N/A,N/A,1489,1505,N/A,72,4
5,N/A,N/A,N/A,1484,1489,N/A,75,1
39,N/A,N/A,N/A,1445,1484,N/A,79,5
8,N/A,N/A,N/A,1437,1445,N/A,83,3
7,N/A,N/A,N/A,1430,1437,N/A,87,1
47,N/A,N/A,N/A,1383,1430,N/A,92,6
26,N/A,N/A,N/A,1357,1383,N/A,96,4
27,N/A,N/A,N/A,1330,1357,N/A,102,4
9,N/A,N/A,N/A,1321,1330,N/A,107,3
5,N/A,N/A,N/A,1316,1321,N/A,111,1
35,N/A,N/A,N/A,1281,1316,N/A,115,5
29,N/A,N/A,N/A,1252,1281,N/A,120,4
5,N/A,N/A,N/A,1247,1252,N/A,123,1
20,N/A,N/A,N/A,1227,1247,N/A,126,4
11,N/A,N/A,N/A,1216,1227,N/A,131,3
11,N/A,N/A,N/A,1432,1443,N/A,3,3
8,N/A,N/A,N/A,1424,1432,N/A,8,2
9,N/A,N/A,N/A,1415,1424,N/A,13,1
28,N/A,N/A,N/A,1387,1415,N/A,17,5
41,N/A,N/A,N/A,1346,1387,N/A,23,5
11,N/A,N/A,N/A,1335,1346,N/A,26,2
10,N/A,N/A,N/A,1325,1335,N/A,32,2
34,N/A,N/A,N/A,1291,1325,N/A,36,6
32,N/A,N/A,N/A,1259,1291,N/A,41,5
16,N/A,N/A,N/A,1243,1259,N/A,46,4
9,N/A,N/A,N/A,1234,1243,N/A,51,3
8,N/A,N/A,N/A,1226,1234,N/A,56,2
46,N/A,N/A,N/A,1180,1226,N/A,59,5
11,N/A,N/A,N/A,1169,1180,N/A,64,4
9,N/A,N/A,N/A,1160,1169,N/A,67,1
6,N/A,N/A,N/A,1154,1160,N/A,73,1
34,N/A,N/A,N/A,1120,1154,N/A,77,5
28,N/A,N/A,N/A,1092,1120,N/A,82,4
7,N/A,N/A,N/A,1085,1092,N/A,85,1
38,N/A,N/A,N/A,1047,1085,N/A,89,5
10,N/A,N/A,N/A,1037,1047,N/A,92,2
5,N/A,N/A,N/A,1032,1037,N/A,97,1
33,N/A,N/A,N/A,999,1032,N/A,101,5
17,N/A,N/A,N/A,982,999,N/A,106,4
8,N/A,N/A,N/A,974,982,N/A,111,3
11,N/A,N/A,N/A,963,974,N/A,117,3
6,N/A,N/A,N/A,957,963,N/A,121,1
20,N/A,N/A,N/A,937,957,N/A,124,4
10,N/A,N/A,N/A,927,937,N/A,128,2
36,N/A,N/A,N/A,891,927,N/A,132,6
6,N/A,N/A,N/A,1191,1197,N/A,3,1
9,N/A,N/A,N/A,1182,1191,N/A,9,1
48,N/A,N/A,N/A,1134,1182,N/A,13,5
18,N/A,N/A,N/A,1116,1134,N/A,18,4
5,N/A,N/A,N/A,1111,1116,N/A,21,1
11,N/A,N/A,N/A,1100,1111,N/A,24,4
20,N/A,N/A,N/A,1080,1100,N/A,30,4
28,N/A,N/A,N/A,1052,1080,N/A,36,4
20,N/A,N/A,N/A,1032,1052,N/A,42,4
5,N/A,N/A,N/A,1027,1032,N/A,45,1
6,N/A,N/A,N/A,1021,1027,N/A,51,1
5,N/A,N/A,N/A,1016,1021,N/A,57,1
9,N/A,N/A,N/A,1007,1016,N/A,63,1
17,N/A,N/A,N/A,990,1007,N/A,66,4
9,N/A,N/A,N/A,981,990,N/A,71,3
10,N/A,N/A,N/A,971,981,N/A,76,2
11,N/A,N/A,N/A,960,971,N/A,82,2
8,N/A,N/A,N/A,952,960,N/A,87,1
36,N/A,N/A,N/A,916,952,N/A,91,5
8,N/A,N/A,N/A,908,916,N/A,95,3
8,N/A,N/A,N/A,900,908,N/A,100,2
31,N/A,N/A,N/A,869,900,N/A,104,6
6,N/A,N/A,N/A,863,869,N/A,110,0
36,N/A,N/A,N/A,827,863,N/A,116,6
9,N/A,N/A,N/A,818,827,N/A,119,3
9,N/A,N/A,N/A,809,818,N/A,123,1
48,N/A,N/A,N/A,761,809,N/A,128,6
41,N/A,N/A,N/A,720,761,N/A,133,5
11,N/A,N/A,N/A,709,720,N/A,137,3
8,N/A,N/A,N/A,701,709,N/A,141,1
9,N/A,N/A,N/A,1111,1120,N/A,3,1
40,N/A,N/A,N/A,1071,1111,N/A,8,6
25,N/A,N/A,N/A,1046,1071,N/A,12,4
27,N/A,N/A,N/A,1019,1046,N/A,18,4
10,N/A,N/A,N/A,1009,1019,N/A,22,2
46,N/A,N/A,N/A,963,1009,N/A,25,5
11,N/A,N/A,N/A,952,963,N/A,29,3
11,N/A,N/A,N/A,941,952,N/A,35,3
7,N/A,N/A,N/A,934,941,N/A,39,1
19,N/A,N/A,N/A,915,934,N/A,42,4
9,N/A,N/A,N/A,906,915,N/A,47,3
8,N/A,N/A,N/A,898,906,N/A,52,2
6,N/A,N/A,N/A,892,898,N/A,57,1
5,N/A,N/A,N/A,887,892,N/A,63,1
29,N/A,N/A,N/A,858,887,N/A,68,6
21,N/A,N/A,N/A,837,858,N/A,72,4
8,N/A,N/A,N/A,829,837,N/A,75,1
48,N/A,N/A,N/A,781,829,N/A,79,5
9,N/A,N/A,N/A,772,781,N/A,83,3
8,N/A,N/A,N/A,764,772,N/A,89,3
8,N/A,N/A,N/A,756,764,N/A,95,3
34,N/A,N/A,N/A,722,756,N/A,98,6
10,N/A,N/A,N/A,712,722,N/A,101,3
7,N/A,N/A,N/A,705,712,N/A,106,2
7,N/A,N/A,N/A,698,705,N/A,112,2
31,N/A,N/A,N/A,667,698,N/A,116,6
30,N/A,N/A,N/A,637,667,N/A,121,5
39,N/A,N/A,N/A,598,637,N/A,127,5
32,N/A,N/A,N/A,566,598,N/A,133,5
10,N/A,N/A,N/A,556,566,N/A,137,3
11,N/A,N/A,N/A,1313,1324,N/A,6,2
7,N/A,N/A,N/A,1306,1313,N/A,11,1
32,N/A,N/A,N/A,1274,1306,N/A,15,5
26,N/A,N/A,N/A,1248,1274,N/A,20,4
5,N/A,N/A,N/A,1243,1248,N/A,23,1
9,N/A,N/A,N/A,1234,1243,N/A,29,1
14,N/A,N/A,N/A,1220,1234,N/A,32,4
25,N/A,N/A,N/A,1195,1220,N/A,38,4
22,N/A,N/A,N/A,1173,1195,N/A,44,4
7,N/A,N/A,N/A,1166,1173,N/A,49,3
9,N/A,N/A,N/A,1157,1166,N/A,55,3
9,N/A,N/A,N/A,1148,1157,N/A,61,3
29,N/A,N/A,N/A,1119,1148,N/A,64,6
9,N/A,N/A,N/A,1110,1119,N/A,67,3
8,N/A,N/A,N/A,1102,1110,N/A,72,2
6,N/A,N/A,N/A,1096,1102,N/A,77,1
10,N/A,N/A,N/A,1086,1096,N/A,80,4
8,N/A,N/A,N/A,1078,1086,N/A,83,1
47,N/A,N/A,N/A,1031,1078,N/A,88,6
26,N/A,N/A,N/A,1005,1031,N/A,92,4
14,N/A,N/A,N/A,991,1005,N/A,98,4
9,N/A,N/A,N/A,982,991,N/A,102,2
26,N/A,N/A,N/A,956,982,N/A,106,6
6,N/A,N/A,N/A,950,956,N/A,112,0
14,N/A,N/A,N/A,936,950,N/A,116,4
26,N/A,N/A,N/A,910,936,N/A,122,4
11,N/A,N/A,N/A,899,910,N/A,126,2
10,N/A,N/A,N/A,889,899,N/A,132,2
7,N/A,N/A,N/A,882,889,N/A,138,2
33,N/A,N/A,N/A,849,882,N/A,141,5
9,N/A,N/A,N/A,392,401,N/A,6,3
27,N/A,N/A,N/A,365,392,N/A,9,6
40,N/A,N/A,N/A,325,365,N/A,14,5
37,N/A,N/A,N/A,288,325,N/A,20,5
20,N/A,N/A,N/A,268,288,N/A,25,4
10,N/A,N/A,N/A,258,268,N/A,29,2
38,N/A,N/A,N/A,220,258,N/A,32,5
26,N/A,N/A,N/A,194,220,N/A,37,4
10,N/A,N/A,N/A,184,194,N/A,41,2
42,N/A,N/A,N/A,142,184,N/A,44,5
10,N/A,N/A,N/A,132,142,N/A,47,2
29,N/A,N/A,N/A,103,132,N/A,51,6
26,N/A,N/A,N/A,77,103,N/A,56,5
10,N/A,N/A,N/A,67,77,N/A,59,2
25,N/A,N/A,N/A,42,67,N/A,63,6
9,N/A,N/A,N/A,33,42,N/A,66,3
9,N/A,N/A,N/A,24,33,N/A,71,2
6,N/A,N/A,N/A,18,24,N/A,76,1
49,N/A,N/A,N/A,-31,18,N/A,81,6
43,N/A,N/A,N/A,1227,1270,N/A,3,6
16,N/A,N/A,N/A,1211,1227,N/A,7,4
7,N/A,N/A,N/A,1204,1211,N/A,11,2
48,N/A,N/A,N/A,1156,1204,N/A,14,5
18,N/A,N/A,N/A,1138,1156,N/A,19,4
16,N/A,N/A,N/A,1122,1138,N/A,25,4
11,N/A,N/A,N/A,1111,1122,N/A,30,3
9,N/A,N/A,N/A,1102,1111,N/A,35,2
10,N/A,N/A,N/A,1092,1102,N/A,41,2
49,N/A,N/A,N/A,1043,1092,N/A,44,5
9,N/A,N/A,N/A,1034,1043,N/A,48,3
10,N/A,N/A,N/A,1024,1034,N/A,53,2
26,N/A,N/A,N/A,998,1024,N/A,56,5
17,N/A,N/A,N/A,981,998,N/A,61,4
8,N/A,N/A,N/A,973,981,N/A,64,1
48,N/A,N/A,N/A,925,973,N/A,68,5
16,N/A,N/A,N/A,909,925,N/A,73,4
10,N/A,N/A,N/A,899,909,N/A,78,3
6,N/A,N/A,N/A,893,899,N/A,82,1
47,N/A,N/A,N/A,846,893,N/A,87,6
25,N/A,N/A,N/A,821,846,N/A,91,4
5,N/A,N/A,N/A,816,821,N/A,94,1
5,N/A,N/A,N/A,811,816,N/A,100,1
31,N/A,N/A,N/A,780,811,N/A,105,6
8,N/A,N/A,N/A,772,780,N/A,108,3
9,N/A,N/A,N/A,763,772,N/A,112,1
21,N/A,N/A,N/A,742,763,N/A,115,4
18,N/A,N/A,N/A,724,742,N/A,121,4
7,N/A,N/A,N/A,717,724,N/A,126,3
9,N/A,N/A,N/A,708,717,N/A,132,3
11,N/A,N/A,N/A,1721,1732,N/A,3,3
31,N/A,N/A,N/A,1690,1721,N/A,6,6
38,N/A,N/A,N/A,1652,1690,N/A,11,5
7,N/A,N/A,N/A,1645,1652,N/A,14,2
48,N/A,N/A,N/A,1597,1645,N/A,17,5
7,N/A,N/A,N/A,1590,1597,N/A,21,3
8,N/A,N/A,N/A,1582,1590,N/A,26,2
28,N/A,N/A,N/A,1554,1582,N/A,30,6
9,N/A,N/A,N/A,1545,1554,N/A,36,0
23,N/A,N/A,N/A,1522,1545,N/A,40,4
11,N/A,N/A,N/A,1511,1522,N/A,45,3
27,N/A,N/A,N/A,1484,1511,N/A,48,6
6,N/A,N/A,N/A,1478,1484,N/A,54,0
35,N/A,N/A,N/A,1443,1478,N/A,59,5
28,N/A,N/A,N/A,1415,1443,N/A,64,4
7,N/A,N/A,N/A,1408,1415,N/A,67,1
6,N/A,N/A,N/A,1402,1408,N/A,73,1
25,N/A,N/A,N/A,1377,1402,N/A,77,5
8,N/A,N/A,N/A,1369,1377,N/A,80,2
7,N/A,N/A,N/A,1362,1369,N/A,86,2
6,N/A,N/A,N/A,1356,1362,N/A,91,1
29,N/A,N/A,N/A,1327,1356,N/A,94,4
10,N/A,N/A,N/A,1317,1327,N/A,100,4
7,N/A,N/A,N/A,1310,1317,N/A,103,1
29,N/A,N/A,N/A,1281,1310,N/A,108,6
30,N/A,N/A,N/A,1251,1281,N/A,113,5
39,N/A,N/A,N/A,1212,1251,N/A,119,5
11,N/A,N/A,N/A,1201,1212,N/A,122,2
5,N/A,N/A,N/A,1196,1201,N/A,127,1
9,N/A,N/A,N/A,1187,1196,N/A,133,1
6,N/A,N/A,N/A,1866,1872,N/A,3,1
9,N/A,N/A,N/A,1857,1866,N/A,9,1
11,N/A,N/A,N/A,1846,1857,N/A,12,4
9,N/A,N/A,N/A,1837,1846,N/A,15,1
46,N/A,N/A,N/A,1791,1837,N/A,20,6
5,N/A,N/A,N/A,1786,1791,N/A,26,0
32,N/A,N/A,N/A,1754,1786,N/A,32,6
43,N/A,N/A,N/A,1711,1754,N/A,37,5
10,N/A,N/A,N/A,1701,1711,N/A,40,2
43,N/A,N/A,N/A,1658,1701,N/A,44,6
40,N/A,N/A,N/A,1618,1658,N/A,49,5
11,N/A,N/A,N/A,1607,1618,N/A,52,2
7,N/A,N/A,N/A,1600,1607,N/A,57,1
43,N/A,N/A,N/A,1557,1600,N/A,61,5
35,N/A,N/A,N/A,1522,1557,N/A,67,5
8,N/A,N/A,N/A,1514,1522,N/A,71,3
10,N/A,N/A,N/A,1504,1514,N/A,76,2
39,N/A,N/A,N/A,1465,1504,N/A,79,5
42,N/A,N/A,N/A,1423,1465,N/A,85,5
20,N/A,N/A,N/A,1403,1423,N/A,90,4
11,N/A,N/A,N/A,1392,1403,N/A,96,4
28,N/A,N/A,N/A,1364,1392,N/A,102,4
28,N/A,N/A,N/A,1336,1364,N/A,108,4
7,N/A,N/A,N/A,1329,1336,N/A,112,2
7,N/A,N/A,N/A,1322,1329,N/A,118,2
27,N/A,N/A,N/A,1295,1322,N/A,121,5
7,N/A,N/A,N/A,1288,1295,N/A,124,2
39,N/A,N/A,N/A,1249,1288,N/A,128,6
23,N/A,N/A,N/A,1226,1249,N/A,132,4
13,N/A,N/A,N/A,1213,1226,N/A,138,4
9,N/A,N/A,N/A,1128,1137,N/A,5,2
31,N/A,N/A,N/A,1097,1128,N/A,9,6
8,N/A,N/A,N/A,1089,1097,N/A,15,0
25,N/A,N/A,N/A,1064,1089,N/A,19,4
28,N/A,N/A,N/A,1036,1064,N/A,25,4
7,N/A,N/A,N/A,1029,1036,N/A,28,1
5,N/A,N/A,N/A,1024,1029,N/A,34,1
42,N/A,N/A,N/A,982,1024,N/A,39,6
27,N/A,N/A,N/A,955,982,N/A,44,5
22,N/A,N/A,N/A,933,955,N/A,49,4
9,N/A,N/A,N/A,924,933,N/A,54,3
8,N/A,N/A,N/A,916,924,N/A,59,2
7,N/A,N/A,N/A,909,916,N/A,64,1
43,N/A,N/A,N/A,866,909,N/A,69,6
20,N/A,N/A,N/A,846,866,N/A,73,4
9,N/A,N/A,N/A,837,846,N/A,78,3
7,N/A,N/A,N/A,830,837,N/A,82,1
14,N/A,N/A,N/A,816,830,N/A,85,4
20,N/A,N/A,N/A,796,816,N/A,91,4
7,N/A,N/A,N/A,789,796,N/A,96,3
39,N/A,N/A,N/A,750,789,N/A,99,6
42,N/A,N/A,N/A,708,750,N/A,104,5
10,N/A,N/A,N/A,698,708,N/A,108,3
27,N/A,N/A,N/A,671,698,N/A,111,6
43,N/A,N/A,N/A,628,671,N/A,116,5
18,N/A,N/A,N/A,610,628,N/A,121,4
6,N/A,N/A,N/A,604,610,N/A,124,1
9,N/A,N/A,N/A,595,604,N/A,130,1
27,N/A,N/A,N/A,568,595,N/A,135,6
7,N/A,N/A,N/A,561,568,N/A,141,0
8,N/A,N/A,N/A,624,632,N/A,5,2
32,N/A,N/A,N/A,592,624,N/A,9,6
8,N/A,N/A,N/A,584,592,N/A,12,3
11,N/A,N/A,N/A,573,584,N/A,18,3
9,N/A,N/A,N/A,564,573,N/A,22,1
32,N/A,N/A,N/A,532,564,N/A,27,6
26,N/A,N/A,N/A,506,532,N/A,31,4
8,N/A,N/A,N/A,498,506,N/A,35,2
9,N/A,N/A,N/A,489,498,N/A,41,2
5,N/A,N/A,N/A,484,489,N/A,46,1
7,N/A,N/A,N/A,477,484,N/A,52,1
23,N/A,N/A,N/A,454,477,N/A,55,4
22,N/A,N/A,N/A,432,454,N/A,61,4
13,N/A,N/A,N/A,419,432,N/A,67,4
5,N/A,N/A,N/A,414,419,N/A,70,1
25,N/A,N/A,N/A,389,414,N/A,74,5
9,N/A,N/A,N/A,380,389,N/A,77,2
10,N/A,N/A,N/A,370,380,N/A,83,2
31,N/A,N/A,N/A,339,370,N/A,87,6
5,N/A,N/A,N/A,334,339,N/A,93,0
24,N/A,N/A,N/A,310,334,N/A,97,4
11,N/A,N/A,N/A,299,310,N/A,103,4
9,N/A,N/A,N/A,290,299,N/A,108,3
11,N/A,N/A,N/A,279,290,N/A,113,2
29,N/A,N/A,N/A,250,279,N/A,116,5
36,N/A,N/A,N/A,214,250,N/A,122,5
10,N/A,N/A,N/A,204,214,N/A,126,3
7,N/A,N/A,N/A,197,204,N/A,131,2
49,N/A,N/A,N/A,148,197,N/A,135,6
9,N/A,N/A,N/A,139,148,N/A,138,3
11,N/A,N/A,N/A,1487,1498,N/A,6,3
37,N/A,N/A,N/A,1450,1487,N/A,9,6
26,N/A,N/A,N/A,1424,1450,N/A,13,4
9,N/A,N/A,N/A,1415,1424,N/A,18,3
36,N/A,N/A,N/A,1379,1415,N/A,21,6
46,N/A,N/A,N/A,1333,1379,N/A,26,5
48,N/A,N/A,N/A,1285,1333,N/A,32,5
8,N/A,N/A,N/A,1277,1285,N/A,35,2
41,N/A,N/A,N/A,1236,1277,N/A,39,6
8,N/A,N/A,N/A,1228,1236,N/A,45,0
35,N/A,N/A,N/A,1193,1228,N/A,51,6
27,N/A,N/A,N/A,1166,1193,N/A,55,4
22,N/A,N/A,N/A,1144,1166,N/A,61,4
16,N/A,N/A,N/A,1128,1144,N/A,67,4
16,N/A,N/A,N/A,1112,1128,N/A,73,4
6,N/A,N/A,N/A,1106,1112,N/A,76,1
28,N/A,N/A,N/A,1078,1106,N/A,79,4
7,N/A,N/A,N/A,1071,1078,N/A,83,2
36,N/A,N/A,N/A,1035,1071,N/A,86,5
10,N/A,N/A,N/A,1025,1035,N/A,89,2
7,N/A,N/A,N/A,1018,1025,N/A,94,1
42,N/A,N/A,N/A,976,1018,N/A,98,5
8,N/A,N/A,N/A,968,976,N/A,101,2
5,N/A,N/A,N/A,963,968,N/A,106,1
37,N/A,N/A,N/A,926,963,N/A,111,6
11,N/A,N/A,N/A,915,926,N/A,114,3
7,N/A,N/A,N/A,908,915,N/A,119,2
27,N/A,N/A,N/A,881,908,N/A,122,5
11,N/A,N/A,N/A,870,881,N/A,125,2
38,N/A,N/A,N/A,832,870,N/A,128,5
29,N/A,N/A,N/A,452,481,N/A,3,4
21,N/A,N/A,N/A,431,452,N/A,9,4
9,N/A,N/A,N/A,422,431,N/A,14,3
7,N/A,N/A,N/A,415,422,N/A,19,2
5,N/A,N/A,N/A,410,415,N/A,24,1
34,N/A,N/A,N/A,376,410,N/A,29,6
38,N/A,N/A,N/A,338,376,N/A,34,5
40,N/A,N/A,N/A,298,338,N/A,40,5
7,N/A,N/A,N/A,291,298,N/A,43,2
46,N/A,N/A,N/A,245,291,N/A,47,6
10,N/A,N/A,N/A,235,245,N/A,50,3
9,N/A,N/A,N/A,226,235,N/A,55,2
32,N/A,N/A,N/A,194,226,N/A,58,5
7,N/A,N/A,N/A,187,194,N/A,62,3
10,N/A,N/A,N/A,177,187,N/A,67,2
7,N/A,N/A,N/A,170,177,N/A,72,1
8,N/A,N/A,N/A,162,170,N/A,78,1
5,N/A,N/A,N/A,157,162,N/A,84,1
9,N/A,N/A,N/A,148,157,N/A,90,1
36,N/A,N/A,N/A,112,148,N/A,94,5
8,N/A,N/A,N/A,104,112,N/A,98,3
9,N/A,N/A,N/A,95,104,N/A,104,3
9,N/A,N/A,N/A,86,95,N/A,109,2
45,N/A,N/A,N/A,41,86,N/A,112,5
32,N/A,N/A,N/A,9,41,N/A,118,5
10,N/A,N/A,N/A,-1,9,N/A,121,2
7,N/A,N/A,N/A,926,933,N/A,6,3
31,N/A,N/A,N/A,895,926,N/A,9,6
5,N/A,N/A,N/A,890,895,N/A,15,0
47,N/A,N/A,N/A,843,890,N/A,20,5
8,N/A,N/A,N/A,835,843,N/A,23,2
11,N/A,N/A,N/A,824,835,N/A,29,2
38,N/A,N/A,N/A,786,824,N/A,32,5
9,N/A,N/A,N/A,777,786,N/A,36,3
7,N/A,N/A,N/A,770,777,N/A,40,1
45,N/A,N/A,N/A,725,770,N/A,45,6
36,N/A,N/A,N/A,689,725,N/A,50,5
37,N/A,N/A,N/A,652,689,N/A,56,5
49,N/A,N/A,N/A,603,652,N/A,62,5
32,N/A,N/A,N/A,571,603,N/A,68,5
24,N/A,N/A,N/A,547,571,N/A,73,4
11,N/A,N/A,N/A,536,547,N/A,78,3
33,N/A,N/A,N/A,503,536,N/A,81,6
19,N/A,N/A,N/A,484,503,N/A,85,4
7,N/A,N/A,N/A,477,484,N/A,90,3
11,N/A,N/A,N/A,466,477,N/A,96,3
8,N/A,N/A,N/A,458,466,N/A,102,3
8,N/A,N/A,N/A,450,458,N/A,107,2
11,N/A,N/A,N/A,439,450,N/A,113,2
25,N/A,N/A,N/A,414,439,N/A,116,5
15,N/A,N/A,N/A,399,414,N/A,121,4
9,N/A,N/A,N/A,390,399,N/A,124,1
34,N/A,N/A,N/A,356,390,N/A,129,6
20,N/A,N/A,N/A,336,356,N/A,133,4
6,N/A,N/A,N/A,330,336,N/A,136,1
12,N/A,N/A,N/A,318,330,N/A,139,4
23,N/A,N/A,N/A,1109,1132,N/A,4,4
8,N/A,N/A,N/A,1101,1109,N/A,8,2
11,N/A,N/A,N/A,1090,1101,N/A,14,2
29,N/A,N/A,N/A,1061,1090,N/A,17,5
13,N/A,N/A,N/A,1048,1061,N/A,22,4
9,N/A,N/A,N/A,1039,1048,N/A,25,1
7,N/A,N/A,N/A,1032,1039,N/A,31,1
9,N/A,N/A,N/A,1023,1032,N/A,37,1
11,N/A,N/A,N/A,1012,1023,N/A,40,4
23,N/A,N/A,N/A,989,1012,N/A,46,4
6,N/A,N/A,N/A,983,989,N/A,49,1
37,N/A,N/A,N/A,946,983,N/A,54,6
9,N/A,N/A,N/A,937,946,N/A,57,3
6,N/A,N/A,N/A,931,937,N/A,61,1
31,N/A,N/A,N/A,900,931,N/A,65,5
8,N/A,N/A,N/A,892,900,N/A,69,3
8,N/A,N/A,N/A,884,892,N/A,75,3
49,N/A,N/A,N/A,835,884,N/A,78,6
10,N/A,N/A,N/A,825,835,N/A,82,4
8,N/A,N/A,N/A,817,825,N/A,87,3
8,N/A,N/A,N/A,809,817,N/A,93,3
7,N/A,N/A,N/A,802,809,N/A,97,1
7,N/A,N/A,N/A,795,802,N/A,103,1
39,N/A,N/A,N/A,756,795,N/A,108,6
28,N/A,N/A,N/A,728,756,N/A,112,4
10,N/A,N/A,N/A,718,728,N/A,116,2
28,N/A,N/A,N/A,690,718,N/A,120,6
20,N/A,N/A,N/A,670,690,N/A,124,4
8,N/A,N/A,N/A,662,670,N/A,129,3
7,N/A,N/A,N/A,655,662,N/A,133,1
9,N/A,N/A,N/A,575,584,N/A,6,2
7,N/A,N/A,N/A,568,575,N/A,12,2
8,N/A,N/A,N/A,560,568,N/A,17,1
30,N/A,N/A,N/A,530,560,N/A,22,6
10,N/A,N/A,N/A,520,530,N/A,25,3
10,N/A,N/A,N/A,510,520,N/A,30,2
8,N/A,N/A,N/A,502,510,N/A,36,2
31,N/A,N/A,N/A,471,502,N/A,39,5
11,N/A,N/A,N/A,460,471,N/A,42,2
8,N/A,N/A,N/A,452,460,N/A,48,2
9,N/A,N/A,N/A,443,452,N/A,53,1
32,N/A,N/A,N/A,411,443,N/A,58,6
41,N/A,N/A,N/A,370,411,N/A,63,5
30,N/A,N/A,N/A,340,370,N/A,69,5
37,N/A,N/A,N/A,303,340,N/A,75,5
27,N/A,N/A,N/A,276,303,N/A,80,4
7,N/A,N/A,N/A,269,276,N/A,83,1
32,N/A,N/A,N/A,237,269,N/A,88,6
10,N/A,N/A,N/A,227,237,N/A,91,3
5,N/A,N/A,N/A,222,227,N/A,95,1
34,N/A,N/A,N/A,188,222,N/A,100,6
6,N/A,N/A,N/A,182,188,N/A,106,0
7,N/A,N/A,N/A,175,182,N/A,109,3
7,N/A,N/A,N/A,168,175,N/A,115,3
33,N/A,N/A,N/A,135,168,N/A,118,6
39,N/A,N/A,N/A,96,135,N/A,123,5
47,N/A,N/A,N/A,49,96,N/A,129,5
10,N/A,N/A,N/A,39,49,N/A,133,3
7,N/A,N/A,N/A,32,39,N/A,138,2
36,N/A,N/A,N/A,-4,32,N/A,141,5
9,N/A,N/A,N/A,531,540,N/A,6,1
34,N/A,N/A,N/A,497,531,N/A,11,6
7,N/A,N/A,N/A,490,497,N/A,14,3
8,N/A,N/A,N/A,482,490,N/A,19,2
10,N/A,N/A,N/A,472,482,N/A,25,2
35,N/A,N/A,N/A,437,472,N/A,28,5
38,N/A,N/A,N/A,399,437,N/A,34,5
11,N/A,N/A,N/A,388,399,N/A,38,3
7,N/A,N/A,N/A,381,388,N/A,43,2
34,N/A,N/A,N/A,347,381,N/A,46,5
9,N/A,N/A,N/A,338,347,N/A,49,2
10,N/A,N/A,N/A,328,338,N/A,55,2
7,N/A,N/A,N/A,321,328,N/A,60,1
7,N/A,N/A,N/A,314,321,N/A,66,1
38,N/A,N/A,N/A,276,314,N/A,71,6
9,N/A,N/A,N/A,267,276,N/A,74,3
8,N/A,N/A,N/A,259,267,N/A,80,3
9,N/A,N/A,N/A,250,259,N/A,85,2
45,N/A,N/A,N/A,205,250,N/A,89,6
9,N/A,N/A,N/A,196,205,N/A,95,0
8,N/A,N/A,N/A,188,196,N/A,98,3
25,N/A,N/A,N/A,163,188,N/A,101,6
6,N/A,N/A,N/A,157,163,N/A,107,0
11,N/A,N/A,N/A,146,157,N/A,110,3
11,N/A,N/A,N/A,135,146,N/A,116,3
10,N/A,N/A,N/A,125,135,N/A,122,3
11,N/A,N/A,N/A,114,125,N/A,128,3
9,N/A,N/A,N/A,105,114,N/A,134,3
11,N/A,N/A,N/A,94,105,N/A,139,2
30,N/A,N/A,N/A,64,94,N/A,142,5
10,N/A,N/A,N/A,540,550,N/A,3,2
28,N/A,N/A,N/A,512,540,N/A,7,6
5,N/A,N/A,N/A,507,512,N/A,13,0
41,N/A,N/A,N/A,466,507,N/A,18,5
10,N/A,N/A,N/A,456,466,N/A,21,2
25,N/A,N/A,N/A,431,456,N/A,25,6
28,N/A,N/A,N/A,403,431,N/A,29,4
10,N/A,N/A,N/A,393,403,N/A,34,3
9,N/A,N/A,N/A,384,393,N/A,39,2
47,N/A,N/A,N/A,337,384,N/A,43,6
35,N/A,N/A,N/A,302,337,N/A,48,5
11,N/A,N/A,N/A,291,302,N/A,52,3
10,N/A,N/A,N/A,281,291,N/A,58,3
10,N/A,N/A,N/A,271,281,N/A,64,3
10,N/A,N/A,N/A,261,271,N/A,70,3
10,N/A,N/A,N/A,251,261,N/A,75,2
30,N/A,N/A,N/A,221,251,N/A,78,5
10,N/A,N/A,N/A,211,221,N/A,82,3
9,N/A,N/A,N/A,202,211,N/A,88,3
11,N/A,N/A,N/A,191,202,N/A,93,2
11,N/A,N/A,N/A,180,191,N/A,99,2
8,N/A,N/A,N/A,172,180,N/A,104,1
28,N/A,N/A,N/A,144,172,N/A,107,4
8,N/A,N/A,N/A,136,144,N/A,110,1
44,N/A,N/A,N/A,92,136,N/A,114,5
19,N/A,N/A,N/A,73,92,N/A,119,4
11,N/A,N/A,N/A,62,73,N/A,123,2
42,N/A,N/A,N/A,20,62,N/A,127,6
11,N/A,N/A,N/A,9,20,N/A,130,3
28,N/A,N/A,N/A,-19,9,N/A,133,6
26,N/A,N/A,N/A,1606,1632,N/A,6,5
28,N/A,N/A,N/A,1578,1606,N/A,12,5
8,N/A,N/A,N/A,1570,1578,N/A,15,2
5,N/A,N/A,N/A,1565,1570,N/A,20,1
37,N/A,N/A,N/A,1528,1565,N/A,24,5
41,N/A,N/A,N/A,1487,1528,N/A,30,5
9,N/A,N/A,N/A,1478,1487,N/A,34,3
7,N/A,N/A,N/A,1471,1478,N/A,39,2
38,N/A,N/A,N/A,1433,1471,N/A,43,6
22,N/A,N/A,N/A,1411,1433,N/A,47,4
17,N/A,N/A,N/A,1394,1411,N/A,53,4
24,N/A,N/A,N/A,1370,1394,N/A,59,4
10,N/A,N/A,N/A,1360,1370,N/A,64,3
9,N/A,N/A,N/A,1351,1360,N/A,70,3
10,N/A,N/A,N/A,1341,1351,N/A,76,3
8,N/A,N/A,N/A,1333,1341,N/A,82,3
8,N/A,N/A,N/A,1325,1333,N/A,87,2
7,N/A,N/A,N/A,1318,1325,N/A,92,1
6,N/A,N/A,N/A,1312,1318,N/A,98,1
6,N/A,N/A,N/A,1306,1312,N/A,104,1
7,N/A,N/A,N/A,1299,1306,N/A,110,1
11,N/A,N/A,N/A,1288,1299,N/A,113,4
7,N/A,N/A,N/A,1281,1288,N/A,118,3
7,N/A,N/A,N/A,1274,1281,N/A,123,2
40,N/A,N/A,N/A,1234,1274,N/A,126,5
22,N/A,N/A,N/A,1212,1234,N/A,131,4
20,N/A,N/A,N/A,1192,1212,N/A,137,4
15,N/A,N/A,N/A,1177,1192,N/A,143,4
23,N/A,N/A,N/A,1154,1177,N/A,149,4
8,N/A,N/A,N/A,1146,1154,N/A,152,1
8,N/A,N/A,N/A,643,651,N/A,6,1
29,N/A,N/A,N/A,614,643,N/A,9,4
9,N/A,N/A,N/A,605,614,N/A,13,2
7,N/A,N/A,N/A,598,605,N/A,19,2
29,N/A,N/A,N/A,569,598,N/A,23,6
43,N/A,N/A,N/A,526,569,N/A,28,5
35,N/A,N/A,N/A,491,526,N/A,34,5
10,N/A,N/A,N/A,481,491,N/A,37,2
8,N/A,N/A,N/A,473,481,N/A,43,2
6,N/A,N/A,N/A,467,473,N/A,48,1
9,N/A,N/A,N/A,458,467,N/A,54,1
42,N/A,N/A,N/A,416,458,N/A,58,5
43,N/A,N/A,N/A,373,416,N/A,64,5
10,N/A,N/A,N/A,363,373,N/A,68,3
49,N/A,N/A,N/A,314,363,N/A,71,6
35,N/A,N/A,N/A,279,314,N/A,76,5
25,N/A,N/A,N/A,254,279,N/A,82,5
8,N/A,N/A,N/A,246,254,N/A,86,3
37,N/A,N/A,N/A,209,246,N/A,89,6
5,N/A,N/A,N/A,204,209,N/A,95,0
43,N/A,N/A,N/A,161,204,N/A,101,6
48,N/A,N/A,N/A,113,161,N/A,106,5
28,N/A,N/A,N/A,85,113,N/A,111,4
9,N/A,N/A,N/A,76,85,N/A,114,1
49,N/A,N/A,N/A,27,76,N/A,119,6
5,N/A,N/A,N/A,22,27,N/A,125,0
11,N/A,N/A,N/A,11,22,N/A,128,3
7,N/A,N/A,N/A,4,11,N/A,132,1
13,N/A,N/A,N/A,-9,4,N/A,135,4
11,N/A,N/A,N/A,1802,1813,N/A,5,2
36,N/A,N/A,N/A,1766,1802,N/A,9,6
7,N/A,N/A,N/A,1759,1766,N/A,15,0
10,N/A,N/A,N/A,1749,1759,N/A,19,4
7,N/A,N/A,N/A,1742,1749,N/A,24,3
8,N/A,N/A,N/A,1734,1742,N/A,28,1
29,N/A,N/A,N/A,1705,1734,N/A,33,6
8,N/A,N/A,N/A,1697,1705,N/A,39,0
16,N/A,N/A,N/A,1681,1697,N/A,43,4
9,N/A,N/A,N/A,1672,1681,N/A,46,1
6,N/A,N/A,N/A,1666,1672,N/A,52,1
8,N/A,N/A,N/A,1658,1666,N/A,58,1
32,N/A,N/A,N/A,1626,1658,N/A,62,5
38,N/A,N/A,N/A,1588,1626,N/A,68,5
11,N/A,N/A,N/A,1577,1588,N/A,72,3
45,N/A,N/A,N/A,1532,1577,N/A,75,6
7,N/A,N/A,N/A,1525,1532,N/A,78,3
33,N/A,N/A,N/A,1492,1525,N/A,81,6
26,N/A,N/A,N/A,1466,1492,N/A,86,5
22,N/A,N/A,N/A,1444,1466,N/A,91,4
19,N/A,N/A,N/A,1425,1444,N/A,97,4
11,N/A,N/A,N/A,1414,1425,N/A,102,3
9,N/A,N/A,N/A,1405,1414,N/A,106,1
14,N/A,N/A,N/A,1391,1405,N/A,109,4
27,N/A,N/A,N/A,1364,1391,N/A,115,4
11,N/A,N/A,N/A,1353,1364,N/A,120,3
5,N/A,N/A,N/A,1348,1353,N/A,124,1
29,N/A,N/A,N/A,1319,1348,N/A,127,4
11,N/A,N/A,N/A,1308,1319,N/A,131,2
41,N/A,N/A,N/A,1267,1308,N/A,135,6
12,N/A,N/A,N/A,648,660,N/A,5,4
17,N/A,N/A,N/A,631,648,N/A,11,4
29,N/A,N/A,N/A,602,631,N/A,17,4
18,N/A,N/A,N/A,584,602,N/A,23,4
9,N/A,N/A,N/A,575,584,N/A,27,2
37,N/A,N/A,N/A,538,575,N/A,30,5
9,N/A,N/A,N/A,529,538,N/A,34,3
10,N/A,N/A,N/A,519,529,N/A,40,3
28,N/A,N/A,N/A,491,519,N/A,43,6
7,N/A,N/A,N/A,484,491,N/A,49,0
45,N/A,N/A,N/A,439,484,N/A,54,5
29,N/A,N/A,N/A,410,439,N/A,60,5
16,N/A,N/A,N/A,394,410,N/A,65,4
11,N/A,N/A,N/A,383,394,N/A,70,3
10,N/A,N/A,N/A,373,383,N/A,75,2
11,N/A,N/A,N/A,362,373,N/A,81,2
5,N/A,N/A,N/A,357,362,N/A,86,1
29,N/A,N/A,N/A,328,357,N/A,90,5
14,N/A,N/A,N/A,314,328,N/A,95,4
12,N/A,N/A,N/A,302,314,N/A,101,4
8,N/A,N/A,N/A,294,302,N/A,105,2
10,N/A,N/A,N/A,284,294,N/A,111,2
27,N/A,N/A,N/A,257,284,N/A,114,5
44,N/A,N/A,N/A,213,257,N/A,120,5
10,N/A,N/A,N/A,203,213,N/A,123,2
8,N/A,N/A,N/A,195,203,N/A,128,1
47,N/A,N/A,N/A,148,195,N/A,133,6
9,N/A,N/A,N/A,139,148,N/A,139,0
7,N/A,N/A,N/A,132,139,N/A,142,3
30,N/A,N/A,N/A,102,132,N/A,145,6
26,N/A,N/A,N/A,746,772,N/A,4,4
22,N/A,N/A,N/A,724,746,N/A,10,4
10,N/A,N/A,N/A,714,724,N/A,14,2
31,N/A,N/A,N/A,683,714,N/A,18,6
23,N/A,N/A,N/A,660,683,N/A,22,4
9,N/A,N/A,N/A,651,660,N/A,26,2
47,N/A,N/A,N/A,604,651,N/A,30,6
9,N/A,N/A,N/A,595,604,N/A,36,0
9,N/A,N/A,N/A,586,595,N/A,39,3
7,N/A,N/A,N/A,579,586,N/A,45,3
8,N/A,N/A,N/A,571,579,N/A,49,1
6,N/A,N/A,N/A,565,571,N/A,55,1
29,N/A,N/A,N/A,536,565,N/A,60,6
25,N/A,N/A,N/A,511,536,N/A,64,4
25,N/A,N/A,N/A,486,511,N/A,70,4
9,N/A,N/A,N/A,477,486,N/A,74,2
28,N/A,N/A,N/A,449,477,N/A,77,5
8,N/A,N/A,N/A,441,449,N/A,80,2
43,N/A,N/A,N/A,398,441,N/A,83,5
15,N/A,N/A,N/A,383,398,N/A,88,4
20,N/A,N/A,N/A,363,383,N/A,94,4
9,N/A,N/A,N/A,354,363,N/A,98,2
47,N/A,N/A,N/A,307,354,N/A,101,5
42,N/A,N/A,N/A,265,307,N/A,107,5
11,N/A,N/A,N/A,254,265,N/A,112,4
8,N/A,N/A,N/A,246,254,N/A,116,2
8,N/A,N/A,N/A,238,246,N/A,121,1
40,N/A,N/A,N/A,198,238,N/A,125,5
8,N/A,N/A,N/A,190,198,N/A,128,2
35,N/A,N/A,N/A,155,190,N/A,131,5
40,N/A,N/A,N/A,595,635,N/A,5,6
11,N/A,N/A,N/A,584,595,N/A,9,4
9,N/A,N/A,N/A,575,584,N/A,12,1
31,N/A,N/A,N/A,544,575,N/A,17,6
9,N/A,N/A,N/A,535,544,N/A,23,0
11,N/A,N/A,N/A,524,535,N/A,26,3
8,N/A,N/A,N/A,516,524,N/A,30,1
6,N/A,N/A,N/A,510,516,N/A,36,1
25,N/A,N/A,N/A,485,510,N/A,41,6
23,N/A,N/A,N/A,462,485,N/A,45,4
7,N/A,N/A,N/A,455,462,N/A,49,2
27,N/A,N/A,N/A,428,455,N/A,53,6
5,N/A,N/A,N/A,423,428,N/A,59,0
7,N/A,N/A,N/A,416,423,N/A,62,3
9,N/A,N/A,N/A,407,416,N/A,66,1
5,N/A,N/A,N/A,402,407,N/A,72,1
7,N/A,N/A,N/A,395,402,N/A,78,1
32,N/A,N/A,N/A,363,395,N/A,83,6
46,N/A,N/A,N/A,317,363,N/A,88,5
15,N/A,N/A,N/A,302,317,N/A,93,4
11,N/A,N/A,N/A,291,302,N/A,97,2
5,N/A,N/A,N/A,286,291,N/A,102,1
47,N/A,N/A,N/A,239,286,N/A,107,6
6,N/A,N/A,N/A,233,239,N/A,113,0
7,N/A,N/A,N/A,226,233,N/A,116,3
7,N/A,N/A,N/A,219,226,N/A,121,2
40,N/A,N/A,N/A,179,219,N/A,125,6
17,N/A,N/A,N/A,162,179,N/A,129,4
11,N/A,N/A,N/A,151,162,N/A,134,3
8,N/A,N/A,N/A,143,151,N/A,138,1
39,N/A,N/A,N/A,273,312,N/A,5,6
29,N/A,N/A,N/A,244,273,N/A,10,5
9,N/A,N/A,N/A,235,244,N/A,14,3
5,N/A,N/A,N/A,230,235,N/A,18,1
27,N/A,N/A,N/A,203,230,N/A,21,4
10,N/A,N/A,N/A,193,203,N/A,25,2
6,N/A,N/A,N/A,187,193,N/A,30,1
16,N/A,N/A,N/A,171,187,N/A,33,4
27,N/A,N/A,N/A,144,171,N/A,39,4
10,N/A,N/A,N/A,134,144,N/A,43,2
8,N/A,N/A,N/A,126,134,N/A,49,2
11,N/A,N/A,N/A,115,126,N/A,55,2
29,N/A,N/A,N/A,86,115,N/A,58,5
29,N/A,N/A,N/A,57,86,N/A,63,4
8,N/A,N/A,N/A,49,57,N/A,66,1
25,N/A,N/A,N/A,24,49,N/A,69,4
7,N/A,N/A,N/A,17,24,N/A,73,2
9,N/A,N/A,N/A,8,17,N/A,79,2
8,N/A,N/A,N/A,0,8,N/A,85,2
10,N/A,N/A,N/A,1535,1545,N/A,6,3
10,N/A,N/A,N/A,1525,1535,N/A,12,3
10,N/A,N/A,N/A,1515,1525,N/A,18,3
9,N/A,N/A,N/A,1506,1515,N/A,24,3
11,N/A,N/A,N/A,1495,1506,N/A,30,3
6,N/A,N/A,N/A,1489,1495,N/A,34,1
7,N/A,N/A,N/A,1482,1489,N/A,40,1
26,N/A,N/A,N/A,1456,1482,N/A,45,6
14,N/A,N/A,N/A,1442,1456,N/A,49,4
9,N/A,N/A,N/A,1433,1442,N/A,53,2
29,N/A,N/A,N/A,1404,1433,N/A,56,5
7,N/A,N/A,N/A,1397,1404,N/A,60,3
32,N/A,N/A,N/A,1365,1397,N/A,63,6
13,N/A,N/A,N/A,1352,1365,N/A,67,4
8,N/A,N/A,N/A,1344,1352,N/A,72,3
7,N/A,N/A,N/A,1337,1344,N/A,76,1
44,N/A,N/A,N/A,1293,1337,N/A,81,6
9,N/A,N/A,N/A,1284,1293,N/A,87,0
21,N/A,N/A,N/A,1263,1284,N/A,91,4
11,N/A,N/A,N/A,1252,1263,N/A,95,2
40,N/A,N/A,N/A,1212,1252,N/A,99,6
7,N/A,N/A,N/A,1205,1212,N/A,105,0
9,N/A,N/A,N/A,1196,1205,N/A,108,3
5,N/A,N/A,N/A,1191,1196,N/A,112,1
44,N/A,N/A,N/A,1147,1191,N/A,116,5
22,N/A,N/A,N/A,1125,1147,N/A,121,4
5,N/A,N/A,N/A,1120,1125,N/A,124,1
8,N/A,N/A,N/A,1112,1120,N/A,130,1
47,N/A,N/A,N/A,1065,1112,N/A,135,6
5,N/A,N/A,N/A,1060,1065,N/A,141,0
48,N/A,N/A,N/A,1570,1618,N/A,6,5
8,N/A,N/A,N/A,1562,1570,N/A,9,2
25,N/A,N/A,N/A,1537,1562,N/A,13,6
11,N/A,N/A,N/A,1526,1537,N/A,16,3
25,N/A,N/A,N/A,1501,1526,N/A,19,6
25,N/A,N/A,N/A,1476,1501,N/A,24,5
9,N/A,N/A,N/A,1467,1476,N/A,28,3
6,N/A,N/A,N/A,1461,1467,N/A,32,1
29,N/A,N/A,N/A,1432,1461,N/A,35,4
23,N/A,N/A,N/A,1409,1432,N/A,41,4
25,N/A,N/A,N/A,1384,1409,N/A,47,4
10,N/A,N/A,N/A,1374,1384,N/A,52,3
10,N/A,N/A,N/A,1364,1374,N/A,57,2
7,N/A,N/A,N/A,1357,1364,N/A,62,1
7,N/A,N/A,N/A,1350,1357,N/A,68,1
6,N/A,N/A,N/A,1344,1350,N/A,74,1
6,N/A,N/A,N/A,1338,1344,N/A,80,1
26,N/A,N/A,N/A,1312,1338,N/A,83,4
24,N/A,N/A,N/A,1288,1312,N/A,89,4
8,N/A,N/A,N/A,1280,1288,N/A,92,1
29,N/A,N/A,N/A,1251,1280,N/A,96,5
7,N/A,N/A,N/A,1244,1251,N/A,100,3
11,N/A,N/A,N/A,1233,1244,N/A,106,3
9,N/A,N/A,N/A,1224,1233,N/A,112,3
7,N/A,N/A,N/A,1217,1224,N/A,118,3
43,N/A,N/A,N/A,1174,1217,N/A,121,6
42,N/A,N/A,N/A,1132,1174,N/A,126,5
23,N/A,N/A,N/A,1109,1132,N/A,131,4
9,N/A,N/A,N/A,1100,1109,N/A,134,1
41,N/A,N/A,N/A,1059,1100,N/A,139,6
8,N/A,N/A,N/A,325,333,N/A,3,1
26,N/A,N/A,N/A,299,325,N/A,8,6
19,N/A,N/A,N/A,280,299,N/A,12,4
13,N/A,N/A,N/A,267,280,N/A,18,4
9,N/A,N/A,N/A,258,267,N/A,22,2
7,N/A,N/A,N/A,251,258,N/A,28,2
42,N/A,N/A,N/A,209,251,N/A,32,6
8,N/A,N/A,N/A,201,209,N/A,38,0
7,N/A,N/A,N/A,194,201,N/A,41,3
7,N/A,N/A,N/A,187,194,N/A,46,2
7,N/A,N/A,N/A,180,187,N/A,51,1
19,N/A,N/A,N/A,161,180,N/A,54,4
6,N/A,N/A,N/A,155,161,N/A,57,1
37,N/A,N/A,N/A,118,155,N/A,62,6
7,N/A,N/A,N/A,111,118,N/A,65,3
45,N/A,N/A,N/A,66,111,N/A,68,6
9,N/A,N/A,N/A,57,66,N/A,74,0
19,N/A,N/A,N/A,38,57,N/A,78,4
7,N/A,N/A,N/A,31,38,N/A,83,3
5,N/A,N/A,N/A,26,31,N/A,87,1
49,N/A,N/A,N/A,-23,26,N/A,92,6
8,N/A,N/A,N/A,1239,1247,N/A,3,2
35,N/A,N/A,N/A,1204,1239,N/A,6,5
15,N/A,N/A,N/A,1189,1204,N/A,11,4
18,N/A,N/A,N/A,1171,1189,N/A,17,4
10,N/A,N/A,N/A,1161,1171,N/A,21,2
46,N/A,N/A,N/A,1115,1161,N/A,24,5
19,N/A,N/A,N/A,1096,1115,N/A,29,4
8,N/A,N/A,N/A,1088,1096,N/A,33,2
6,N/A,N/A,N/A,1082,1088,N/A,38,1
17,N/A,N/A,N/A,1065,1082,N/A,41,4
10,N/A,N/A,N/A,1055,1065,N/A,46,3
32,N/A,N/A,N/A,1023,1055,N/A,49,6
13,N/A,N/A,N/A,1010,1023,N/A,53,4
9,N/A,N/A,N/A,1001,1010,N/A,56,1
38,N/A,N/A,N/A,963,1001,N/A,61,6
7,N/A,N/A,N/A,956,963,N/A,64,3
6,N/A,N/A,N/A,950,956,N/A,68,1
30,N/A,N/A,N/A,920,950,N/A,72,5
9,N/A,N/A,N/A,911,920,N/A,76,3
6,N/A,N/A,N/A,905,911,N/A,80,1
8,N/A,N/A,N/A,897,905,N/A,86,1
14,N/A,N/A,N/A,883,897,N/A,89,4
11,N/A,N/A,N/A,872,883,N/A,93,2
40,N/A,N/A,N/A,832,872,N/A,97,6
46,N/A,N/A,N/A,786,832,N/A,102,5
10,N/A,N/A,N/A,776,786,N/A,105,2
8,N/A,N/A,N/A,768,776,N/A,111,2
7,N/A,N/A,N/A,761,768,N/A,117,2
38,N/A,N/A,N/A,723,761,N/A,120,5
9,N/A,N/A,N/A,714,723,N/A,124,3
11,N/A,N/A,N/A,1505,1516,N/A,4,3
11,N/A,N/A,N/A,1494,1505,N/A,10,3
5,N/A,N/A,N/A,1489,1494,N/A,14,1
27,N/A,N/A,N/A,1462,1489,N/A,19,6
46,N/A,N/A,N/A,1416,1462,N/A,24,5
8,N/A,N/A,N/A,1408,1416,N/A,27,2
9,N/A,N/A,N/A,1399,1408,N/A,32,1
5,N/A,N/A,N/A,1394,1399,N/A,38,1
49,N/A,N/A,N/A,1345,1394,N/A,42,5
7,N/A,N/A,N/A,1338,1345,N/A,45,2
34,N/A,N/A,N/A,1304,1338,N/A,48,5
24,N/A,N/A,N/A,1280,1304,N/A,53,4
11,N/A,N/A,N/A,1269,1280,N/A,58,3
7,N/A,N/A,N/A,1262,1269,N/A,63,2
48,N/A,N/A,N/A,1214,1262,N/A,66,5
8,N/A,N/A,N/A,1206,1214,N/A,69,2
5,N/A,N/A,N/A,1201,1206,N/A,74,1
10,N/A,N/A,N/A,1191,1201,N/A,77,4
7,N/A,N/A,N/A,1184,1191,N/A,82,3
10,N/A,N/A,N/A,1174,1184,N/A,88,3
11,N/A,N/A,N/A,1163,1174,N/A,94,3
8,N/A,N/A,N/A,1155,1163,N/A,98,1
16,N/A,N/A,N/A,1139,1155,N/A,101,4
26,N/A,N/A,N/A,1113,1139,N/A,107,4
7,N/A,N/A,N/A,1106,1113,N/A,110,1
38,N/A,N/A,N/A,1068,1106,N/A,114,5
13,N/A,N/A,N/A,1055,1068,N/A,119,4
7,N/A,N/A,N/A,1048,1055,N/A,122,1
24,N/A,N/A,N/A,1024,1048,N/A,125,4
11,N/A,N/A,N/A,1013,1024,N/A,131,4
7,N/A,N/A,N/A,1384,1391,N/A,4,2
10,N/A,N/A,N/A,1374,1384,N/A,10,2
39,N/A,N/A,N/A,1335,1374,N/A,14,6
26,N/A,N/A,N/A,1309,1335,N/A,18,4
19,N/A,N/A,N/A,1290,1309,N/A,24,4
8,N/A,N/A,N/A,1282,1290,N/A,27,1
24,N/A,N/A,N/A,1258,1282,N/A,30,4
14,N/A,N/A,N/A,1244,1258,N/A,36,4
9,N/A,N/A,N/A,1235,1244,N/A,39,1
28,N/A,N/A,N/A,1207,1235,N/A,42,4
23,N/A,N/A,N/A,1184,1207,N/A,48,4
20,N/A,N/A,N/A,1164,1184,N/A,54,4
10,N/A,N/A,N/A,1154,1164,N/A,59,3
10,N/A,N/A,N/A,1144,1154,N/A,64,2
8,N/A,N/A,N/A,1136,1144,N/A,70,2
7,N/A,N/A,N/A,1129,1136,N/A,76,2
37,N/A,N/A,N/A,1092,1129,N/A,80,6
9,N/A,N/A,N/A,1083,1092,N/A,83,3
11,N/A,N/A,N/A,1072,1083,N/A,89,3
8,N/A,N/A,N/A,1064,1072,N/A,93,1
5,N/A,N/A,N/A,1059,1064,N/A,99,1
22,N/A,N/A,N/A,1037,1059,N/A,102,4
26,N/A,N/A,N/A,1011,1037,N/A,108,4
8,N/A,N/A,N/A,1003,1011,N/A,113,3
8,N/A,N/A,N/A,995,1003,N/A,117,1
32,N/A,N/A,N/A,963,995,N/A,121,5
26,N/A,N/A,N/A,937,963,N/A,126,4
7,N/A,N/A,N/A,930,937,N/A,130,2
11,N/A,N/A,N/A,919,930,N/A,136,2
49,N/A,N/A,N/A,870,919,N/A,139,5
18,N/A,N/A,N/A,833,851,N/A,5,4
26,N/A,N/A,N/A,807,833,N/A,11,4
18,N/A,N/A,N/A,789,807,N/A,17,4
19,N/A,N/A,N/A,770,789,N/A,23,4
9,N/A,N/A,N/A,761,770,N/A,26,1
5,N/A,N/A,N/A,756,761,N/A,32,1
35,N/A,N/A,N/A,721,756,N/A,37,6
20,N/A,N/A,N/A,701,721,N/A,41,4
11,N/A,N/A,N/A,690,701,N/A,45,2
33,N/A,N/A,N/A,657,690,N/A,49,6
32,N/A,N/A,N/A,625,657,N/A,54,5
24,N/A,N/A,N/A,601,625,N/A,59,4
7,N/A,N/A,N/A,594,601,N/A,62,1
28,N/A,N/A,N/A,566,594,N/A,66,5
22,N/A,N/A,N/A,544,566,N/A,71,4
8,N/A,N/A,N/A,536,544,N/A,75,2
9,N/A,N/A,N/A,527,536,N/A,81,2
29,N/A,N/A,N/A,498,527,N/A,84,5
9,N/A,N/A,N/A,489,498,N/A,88,3
6,N/A,N/A,N/A,483,489,N/A,92,1
29,N/A,N/A,N/A,454,483,N/A,97,6
9,N/A,N/A,N/A,445,454,N/A,100,3
11,N/A,N/A,N/A,434,445,N/A,105,2
47,N/A,N/A,N/A,387,434,N/A,109,6
27,N/A,N/A,N/A,360,387,N/A,113,4
7,N/A,N/A,N/A,353,360,N/A,118,3
10,N/A,N/A,N/A,343,353,N/A,123,2
8,N/A,N/A,N/A,335,343,N/A,128,1
26,N/A,N/A,N/A,309,335,N/A,132,5
21,N/A,N/A,N/A,288,309,N/A,137,4
11,N/A,N/A,N/A,516,527,N/A,5,3
9,N/A,N/A,N/A,507,516,N/A,10,2
40,N/A,N/A,N/A,467,507,N/A,14,6
34,N/A,N/A,N/A,433,467,N/A,19,5
10,N/A,N/A,N/A,423,433,N/A,22,2
10,N/A,N/A,N/A,413,423,N/A,28,2
41,N/A,N/A,N/A,372,413,N/A,32,6
41,N/A,N/A,N/A,331,372,N/A,37,5
10,N/A,N/A,N/A,321,331,N/A,40,2
10,N/A,N/A,N/A,311,321,N/A,46,2
41,N/A,N/A,N/A,270,311,N/A,49,5
10,N/A,N/A,N/A,260,270,N/A,53,3
10,N/A,N/A,N/A,250,260,N/A,58,2
6,N/A,N/A,N/A,244,250,N/A,63,1
15,N/A,N/A,N/A,229,244,N/A,66,4
6,N/A,N/A,N/A,223,229,N/A,69,1
25,N/A,N/A,N/A,198,223,N/A,72,4
8,N/A,N/A,N/A,190,198,N/A,77,3
10,N/A,N/A,N/A,180,190,N/A,83,3
9,N/A,N/A,N/A,171,180,N/A,89,3
7,N/A,N/A,N/A,164,171,N/A,94,2
39,N/A,N/A,N/A,125,164,N/A,97,5
11,N/A,N/A,N/A,114,125,N/A,100,2
7,N/A,N/A,N/A,107,114,N/A,105,1
9,N/A,N/A,N/A,98,107,N/A,111,1
29,N/A,N/A,N/A,69,98,N/A,114,4
10,N/A,N/A,N/A,59,69,N/A,118,2
6,N/A,N/A,N/A,53,59,N/A,123,1
6,N/A,N/A,N/A,47,53,N/A,129,1
7,N/A,N/A,N/A,40,47,N/A,135,1
7,N/A,N/A,N/A,971,978,N/A,6,1
45,N/A,N/A,N/A,926,971,N/A,10,5
10,N/A,N/A,N/A,916,926,N/A,14,3
29,N/A,N/A,N/A,887,916,N/A,17,6
19,N/A,N/A,N/A,868,887,N/A,21,4
14,N/A,N/A,N/A,854,868,N/A,27,4
23,N/A,N/A,N/A,831,854,N/A,33,4
8,N/A,N/A,N/A,823,831,N/A,36,1
29,N/A,N/A,N/A,794,823,N/A,41,6
9,N/A,N/A,N/A,785,794,N/A,47,0
9,N/A,N/A,N/A,776,785,N/A,50,3
6,N/A,N/A,N/A,770,776,N/A,54,1
39,N/A,N/A,N/A,731,770,N/A,58,5
49,N/A,N/A,N/A,682,731,N/A,64,5
26,N/A,N/A,N/A,656,682,N/A,69,4
5,N/A,N/A,N/A,651,656,N/A,72,1
46,N/A,N/A,N/A,605,651,N/A,76,5
15,N/A,N/A,N/A,590,605,N/A,81,4
9,N/A,N/A,N/A,581,590,N/A,84,1
9,N/A,N/A,N/A,572,581,N/A,90,1
18,N/A,N/A,N/A,554,572,N/A,93,4
7,N/A,N/A,N/A,547,554,N/A,98,3
10,N/A,N/A,N/A,537,547,N/A,103,2
10,N/A,N/A,N/A,527,537,N/A,109,2
8,N/A,N/A,N/A,519,527,N/A,114,1
43,N/A,N/A,N/A,476,519,N/A,119,6
7,N/A,N/A,N/A,469,476,N/A,125,0
31,N/A,N/A,N/A,438,469,N/A,131,6
44,N/A,N/A,N/A,394,438,N/A,136,5
9,N/A,N/A,N/A,385,394,N/A,139,2
32,N/A,N/A,N/A,342,374,N/A,3,5
43,N/A,N/A,N/A,299,342,N/A,9,5
20,N/A,N/A,N/A,279,299,N/A,14,4
23,N/A,N/A,N/A,256,279,N/A,20,4
7,N/A,N/A,N/A,249,256,N/A,25,3
49,N/A,N/A,N/A,200,249,N/A,28,6
27,N/A,N/A,N/A,173,200,N/A,32,4
10,N/A,N/A,N/A,163,173,N/A,36,2
5,N/A,N/A,N/A,158,163,N/A,41,1
48,N/A,N/A,N/A,110,158,N/A,46,6
25,N/A,N/A,N/A,85,110,N/A,50,4
10,N/A,N/A,N/A,75,85,N/A,54,2
5,N/A,N/A,N/A,70,75,N/A,59,1
48,N/A,N/A,N/A,22,70,N/A,63,5
28,N/A,N/A,N/A,-6,22,N/A,69,5
6,N/A,N/A,N/A,1491,1497,N/A,4,1
23,N/A,N/A,N/A,1468,1491,N/A,7,4
8,N/A,N/A,N/A,1460,1468,N/A,11,2
7,N/A,N/A,N/A,1453,1460,N/A,17,2
8,N/A,N/A,N/A,1445,1453,N/A,23,2
48,N/A,N/A,N/A,1397,1445,N/A,27,6
9,N/A,N/A,N/A,1388,1397,N/A,30,3
8,N/A,N/A,N/A,1380,1388,N/A,35,2
9,N/A,N/A,N/A,1371,1380,N/A,40,1
27,N/A,N/A,N/A,1344,1371,N/A,44,5
11,N/A,N/A,N/A,1333,1344,N/A,49,4
5,N/A,N/A,N/A,1328,1333,N/A,52,1
40,N/A,N/A,N/A,1288,1328,N/A,56,5
8,N/A,N/A,N/A,1280,1288,N/A,59,2
48,N/A,N/A,N/A,1232,1280,N/A,62,5
38,N/A,N/A,N/A,1194,1232,N/A,68,5
28,N/A,N/A,N/A,1166,1194,N/A,74,5
7,N/A,N/A,N/A,1159,1166,N/A,77,2
7,N/A,N/A,N/A,1152,1159,N/A,82,1
47,N/A,N/A,N/A,1105,1152,N/A,87,6
8,N/A,N/A,N/A,1097,1105,N/A,93,0
26,N/A,N/A,N/A,1071,1097,N/A,97,4
8,N/A,N/A,N/A,1063,1071,N/A,100,1
28,N/A,N/A,N/A,1035,1063,N/A,105,6
8,N/A,N/A,N/A,1027,1035,N/A,111,0
42,N/A,N/A,N/A,985,1027,N/A,117,6
11,N/A,N/A,N/A,974,985,N/A,120,3
9,N/A,N/A,N/A,965,974,N/A,125,2
33,N/A,N/A,N/A,932,965,N/A,128,5
47,N/A,N/A,N/A,885,932,N/A,134,5
8,N/A,N/A,N/A,1348,1356,N/A,3,3
10,N/A,N/A,N/A,1338,1348,N/A,9,3
7,N/A,N/A,N/A,1331,1338,N/A,15,3
8,N/A,N/A,N/A,1323,1331,N/A,19,1
24,N/A,N/A,N/A,1299,1323,N/A,22,4
7,N/A,N/A,N/A,1292,1299,N/A,26,2
26,N/A,N/A,N/A,1266,1292,N/A,29,5
36,N/A,N/A,N/A,1230,1266,N/A,35,5
27,N/A,N/A,N/A,1203,1230,N/A,41,5
24,N/A,N/A,N/A,1179,1203,N/A,46,4
7,N/A,N/A,N/A,1172,1179,N/A,50,2
6,N/A,N/A,N/A,1166,1172,N/A,55,1
29,N/A,N/A,N/A,1137,1166,N/A,58,4
11,N/A,N/A,N/A,1126,1137,N/A,63,3
9,N/A,N/A,N/A,1117,1126,N/A,69,3
7,N/A,N/A,N/A,1110,1117,N/A,74,2
10,N/A,N/A,N/A,1100,1110,N/A,80,2
9,N/A,N/A,N/A,1091,1100,N/A,86,2
9,N/A,N/A,N/A,1082,1091,N/A,91,1
6,N/A,N/A,N/A,1076,1082,N/A,97,1
32,N/A,N/A,N/A,1044,1076,N/A,102,6
10,N/A,N/A,N/A,1034,1044,N/A,105,3
41,N/A,N/A,N/A,993,1034,N/A,108,6
19,N/A,N/A,N/A,974,993,N/A,112,4
6,N/A,N/A,N/A,968,974,N/A,115,1
31,N/A,N/A,N/A,937,968,N/A,120,6
15,N/A,N/A,N/A,922,937,N/A,124,4
17,N/A,N/A,N/A,905,922,N/A,130,4
10,N/A,N/A,N/A,895,905,N/A,135,3
10,N/A,N/A,N/A,885,895,N/A,140,2
8,N/A,N/A,N/A,1116,1124,N/A,4,1
20,N/A,N/A,N/A,1096,1116,N/A,7,4
7,N/A,N/A,N/A,1089,1096,N/A,11,2
46,N/A,N/A,N/A,1043,1089,N/A,14,5
9,N/A,N/A,N/A,1034,1043,N/A,18,3
11,N/A,N/A,N/A,1023,1034,N/A,23,2
43,N/A,N/A,N/A,980,1023,N/A,26,5
8,N/A,N/A,N/A,972,980,N/A,29,2
38,N/A,N/A,N/A,934,972,N/A,32,5
10,N/A,N/A,N/A,924,934,N/A,36,3
9,N/A,N/A,N/A,915,924,N/A,42,3
9,N/A,N/A,N/A,906,915,N/A,47,2
31,N/A,N/A,N/A,875,906,N/A,51,6
26,N/A,N/A,N/A,849,875,N/A,55,4
11,N/A,N/A,N/A,838,849,N/A,60,3
8,N/A,N/A,N/A,830,838,N/A,66,3
9,N/A,N/A,N/A,821,830,N/A,71,2
5,N/A,N/A,N/A,816,821,N/A,76,1
27,N/A,N/A,N/A,789,816,N/A,79,4
8,N/A,N/A,N/A,781,789,N/A,83,2
33,N/A,N/A,N/A,748,781,N/A,87,6
6,N/A,N/A,N/A,742,748,N/A,93,0
23,N/A,N/A,N/A,719,742,N/A,97,4
7,N/A,N/A,N/A,712,719,N/A,102,3
31,N/A,N/A,N/A,681,712,N/A,105,6
47,N/A,N/A,N/A,634,681,N/A,110,5
43,N/A,N/A,N/A,591,634,N/A,116,5
27,N/A,N/A,N/A,564,591,N/A,121,4
11,N/A,N/A,N/A,553,564,N/A,125,2
38,N/A,N/A,N/A,515,553,N/A,128,5
32,N/A,N/A,N/A,1111,1143,N/A,5,6
42,N/A,N/A,N/A,1069,1111,N/A,10,5
48,N/A,N/A,N/A,1021,1069,N/A,16,5
41,N/A,N/A,N/A,980,1021,N/A,22,5
9,N/A,N/A,N/A,971,980,N/A,26,3
31,N/A,N/A,N/A,940,971,N/A,29,6
6,N/A,N/A,N/A,934,940,N/A,35,0
31,N/A,N/A,N/A,903,934,N/A,41,6
8,N/A,N/A,N/A,895,903,N/A,47,0
27,N/A,N/A,N/A,868,895,N/A,52,5
11,N/A,N/A,N/A,857,868,N/A,55,2
30,N/A,N/A,N/A,827,857,N/A,58,5
7,N/A,N/A,N/A,820,827,N/A,61,2
35,N/A,N/A,N/A,785,820,N/A,65,6
36,N/A,N/A,N/A,749,785,N/A,70,5
7,N/A,N/A,N/A,742,749,N/A,74,3
41,N/A,N/A,N/A,701,742,N/A,77,6
33,N/A,N/A,N/A,668,701,N/A,82,5
9,N/A,N/A,N/A,659,668,N/A,85,2
10,N/A,N/A,N/A,649,659,N/A,91,2
8,N/A,N/A,N/A,641,649,N/A,96,1
34,N/A,N/A,N/A,607,641,N/A,100,5
8,N/A,N/A,N/A,599,607,N/A,103,2
7,N/A,N/A,N/A,592,599,N/A,109,2
9,N/A,N/A,N/A,583,592,N/A,114,1
14,N/A,N/A,N/A,569,583,N/A,117,4
8,N/A,N/A,N/A,561,569,N/A,120,1
8,N/A,N/A,N/A,553,561,N/A,126,1
9,N/A,N/A,N/A,544,553,N/A,132,1
10,N/A,N/A,N/A,534,544,N/A,135,4
19,N/A,N/A,N/A,1835,1854,N/A,3,4
12,N/A,N/A,N/A,1823,1835,N/A,9,4
8,N/A,N/A,N/A,1815,1823,N/A,13,2
26,N/A,N/A,N/A,1789,1815,N/A,17,6
43,N/A,N/A,N/A,1746,1789,N/A,22,5
7,N/A,N/A,N/A,1739,1746,N/A,25,2
7,N/A,N/A,N/A,1732,1739,N/A,31,2
6,N/A,N/A,N/A,1726,1732,N/A,36,1
27,N/A,N/A,N/A,1699,1726,N/A,40,5
8,N/A,N/A,N/A,1691,1699,N/A,43,2
8,N/A,N/A,N/A,1683,1691,N/A,48,1
7,N/A,N/A,N/A,1676,1683,N/A,54,1
28,N/A,N/A,N/A,1648,1676,N/A,59,6
45,N/A,N/A,N/A,1603,1648,N/A,64,5
22,N/A,N/A,N/A,1581,1603,N/A,69,4
18,N/A,N/A,N/A,1563,1581,N/A,75,4
11,N/A,N/A,N/A,1552,1563,N/A,79,2
8,N/A,N/A,N/A,1544,1552,N/A,84,1
37,N/A,N/A,N/A,1507,1544,N/A,89,6
42,N/A,N/A,N/A,1465,1507,N/A,94,5
9,N/A,N/A,N/A,1456,1465,N/A,98,3
7,N/A,N/A,N/A,1449,1456,N/A,102,1
5,N/A,N/A,N/A,1444,1449,N/A,108,1
33,N/A,N/A,N/A,1411,1444,N/A,112,5
8,N/A,N/A,N/A,1403,1411,N/A,115,2
6,N/A,N/A,N/A,1397,1403,N/A,120,1
48,N/A,N/A,N/A,1349,1397,N/A,125,6
9,N/A,N/A,N/A,1340,1349,N/A,128,3
11,N/A,N/A,N/A,1329,1340,N/A,133,2
6,N/A,N/A,N/A,1323,1329,N/A,138,1
33,N/A,N/A,N/A,1944,1977,N/A,6,6
22,N/A,N/A,N/A,1922,1944,N/A,10,4
9,N/A,N/A,N/A,1913,1922,N/A,15,3
31,N/A,N/A,N/A,1882,1913,N/A,18,6
8,N/A,N/A,N/A,1874,1882,N/A,24,0
15,N/A,N/A,N/A,1859,1874,N/A,28,4
9,N/A,N/A,N/A,1850,1859,N/A,32,2
10,N/A,N/A,N/A,1840,1850,N/A,38,2
38,N/A,N/A,N/A,1802,1840,N/A,42,6
9,N/A,N/A,N/A,1793,1802,N/A,48,0
26,N/A,N/A,N/A,1767,1793,N/A,52,4
5,N/A,N/A,N/A,1762,1767,N/A,55,1
45,N/A,N/A,N/A,1717,1762,N/A,59,5
33,N/A,N/A,N/A,1684,1717,N/A,65,5
32,N/A,N/A,N/A,1652,1684,N/A,71,5
10,N/A,N/A,N/A,1642,1652,N/A,75,3
8,N/A,N/A,N/A,1634,1642,N/A,80,2
9,N/A,N/A,N/A,1625,1634,N/A,85,1
9,N/A,N/A,N/A,1616,1625,N/A,91,1
14,N/A,N/A,N/A,1602,1616,N/A,94,4
21,N/A,N/A,N/A,1581,1602,N/A,100,4
11,N/A,N/A,N/A,1570,1581,N/A,104,2
46,N/A,N/A,N/A,1524,1570,N/A,107,5
22,N/A,N/A,N/A,1502,1524,N/A,112,4
10,N/A,N/A,N/A,1492,1502,N/A,117,3
7,N/A,N/A,N/A,1485,1492,N/A,121,1
40,N/A,N/A,N/A,1445,1485,N/A,125,5
7,N/A,N/A,N/A,1438,1445,N/A,128,2
34,N/A,N/A,N/A,1404,1438,N/A,131,5
21,N/A,N/A,N/A,1383,1404,N/A,136,4
9,N/A,N/A,N/A,570,579,N/A,5,2
6,N/A,N/A,N/A,564,570,N/A,10,1
9,N/A,N/A,N/A,555,564,N/A,16,1
7,N/A,N/A,N/A,548,555,N/A,22,1
38,N/A,N/A,N/A,510,548,N/A,26,5
11,N/A,N/A,N/A,499,510,N/A,29,2
27,N/A,N/A,N/A,472,499,N/A,32,5
9,N/A,N/A,N/A,463,472,N/A,35,2
33,N/A,N/A,N/A,430,463,N/A,38,5
9,N/A,N/A,N/A,421,430,N/A,41,2
47,N/A,N/A,N/A,374,421,N/A,44,5
33,N/A,N/A,N/A,341,374,N/A,50,5
10,N/A,N/A,N/A,331,341,N/A,53,2
38,N/A,N/A,N/A,293,331,N/A,57,6
10,N/A,N/A,N/A,283,293,N/A,60,3
7,N/A,N/A,N/A,276,283,N/A,66,3
45,N/A,N/A,N/A,231,276,N/A,69,6
8,N/A,N/A,N/A,223,231,N/A,72,3
9,N/A,N/A,N/A,214,223,N/A,76,1
17,N/A,N/A,N/A,197,214,N/A,79,4
11,N/A,N/A,N/A,186,197,N/A,83,2
25,N/A,N/A,N/A,161,186,N/A,87,6
5,N/A,N/A,N/A,156,161,N/A,93,0
10,N/A,N/A,N/A,146,156,N/A,96,3
8,N/A,N/A,N/A,138,146,N/A,100,1
34,N/A,N/A,N/A,104,138,N/A,105,6
39,N/A,N/A,N/A,65,104,N/A,110,5
44,N/A,N/A,N/A,21,65,N/A,116,5
7,N/A,N/A,N/A,14,21,N/A,119,2
7,N/A,N/A,N/A,7,14,N/A,124,1
32,N/A,N/A,N/A,458,490,N/A,6,5
20,N/A,N/A,N/A,438,458,N/A,11,4
10,N/A,N/A,N/A,428,438,N/A,16,3
11,N/A,N/A,N/A,417,428,N/A,22,3
48,N/A,N/A,N/A,369,417,N/A,25,6
22,N/A,N/A,N/A,347,369,N/A,29,4
19,N/A,N/A,N/A,328,347,N/A,35,4
15,N/A,N/A,N/A,313,328,N/A,41,4
7,N/A,N/A,N/A,306,313,N/A,46,3
10,N/A,N/A,N/A,296,306,N/A,51,2
9,N/A,N/A,N/A,287,296,N/A,56,1
34,N/A,N/A,N/A,253,287,N/A,61,6
29,N/A,N/A,N/A,224,253,N/A,66,5
7,N/A,N/A,N/A,217,224,N/A,70,3
8,N/A,N/A,N/A,209,217,N/A,76,3
8,N/A,N/A,N/A,201,209,N/A,80,1
29,N/A,N/A,N/A,172,201,N/A,83,4
13,N/A,N/A,N/A,159,172,N/A,89,4
10,N/A,N/A,N/A,149,159,N/A,93,2
9,N/A,N/A,N/A,140,149,N/A,98,1
5,N/A,N/A,N/A,135,140,N/A,104,1
44,N/A,N/A,N/A,91,135,N/A,108,5
8,N/A,N/A,N/A,83,91,N/A,112,3
9,N/A,N/A,N/A,74,83,N/A,117,2
11,N/A,N/A,N/A,63,74,N/A,123,2
10,N/A,N/A,N/A,53,63,N/A,129,2
9,N/A,N/A,N/A,44,53,N/A,134,1
39,N/A,N/A,N/A,5,44,N/A,138,5
10,N/A,N/A,N/A,-5,5,N/A,141,2
8,N/A,N/A,N/A,331,339,N/A,6,1
41,N/A,N/A,N/A,290,331,N/A,11,6
27,N/A,N/A,N/A,263,290,N/A,15,4
11,N/A,N/A,N/A,252,263,N/A,19,2
6,N/A,N/A,N/A,246,252,N/A,24,1
49,N/A,N/A,N/A,197,246,N/A,28,5
7,N/A,N/A,N/A,190,197,N/A,31,2
36,N/A,N/A,N/A,154,190,N/A,35,6
8,N/A,N/A,N/A,146,154,N/A,38,3
9,N/A,N/A,N/A,137,146,N/A,43,2
10,N/A,N/A,N/A,127,137,N/A,49,2
7,N/A,N/A,N/A,120,127,N/A,54,1
30,N/A,N/A,N/A,90,120,N/A,58,5
15,N/A,N/A,N/A,75,90,N/A,63,4
11,N/A,N/A,N/A,64,75,N/A,68,3
8,N/A,N/A,N/A,56,64,N/A,74,3
11,N/A,N/A,N/A,45,56,N/A,80,3
7,N/A,N/A,N/A,38,45,N/A,86,3
8,N/A,N/A,N/A,30,38,N/A,92,3
5,N/A,N/A,N/A,25,30,N/A,96,1
26,N/A,N/A,N/A,-1,25,N/A,100,5
8,N/A,N/A,N/A,1798,1806,N/A,3,3
43,N/A,N/A,N/A,1755,1798,N/A,6,6
23,N/A,N/A,N/A,1732,1755,N/A,10,4
7,N/A,N/A,N/A,1725,1732,N/A,15,3
11,N/A,N/A,N/A,1714,1725,N/A,21,3
7,N/A,N/A,N/A,1707,1714,N/A,25,1
31,N/A,N/A,N/A,1676,1707,N/A,30,6
25,N/A,N/A,N/A,1651,1676,N/A,34,4
18,N/A,N/A,N/A,1633,1651,N/A,40,4
7,N/A,N/A,N/A,1626,1633,N/A,45,3
11,N/A,N/A,N/A,1615,1626,N/A,51,3
5,N/A,N/A,N/A,1610,1615,N/A,55,1
7,N/A,N/A,N/A,1603,1610,N/A,61,1
38,N/A,N/A,N/A,1565,1603,N/A,66,6
18,N/A,N/A,N/A,1547,1565,N/A,70,4
20,N/A,N/A,N/A,1527,1547,N/A,76,4
7,N/A,N/A,N/A,1520,1527,N/A,81,3
11,N/A,N/A,N/A,1509,1520,N/A,86,2
31,N/A,N/A,N/A,1478,1509,N/A,90,6
8,N/A,N/A,N/A,1470,1478,N/A,96,0
25,N/A,N/A,N/A,1445,1470,N/A,101,5
10,N/A,N/A,N/A,1435,1445,N/A,105,3
8,N/A,N/A,N/A,1427,1435,N/A,109,1
37,N/A,N/A,N/A,1390,1427,N/A,113,5
7,N/A,N/A,N/A,1383,1390,N/A,117,3
46,N/A,N/A,N/A,1337,1383,N/A,120,6
7,N/A,N/A,N/A,1330,1337,N/A,123,3
11,N/A,N/A,N/A,1319,1330,N/A,129,3
10,N/A,N/A,N/A,1309,1319,N/A,135,3
10,N/A,N/A,N/A,1299,1309,N/A,140,2
41,N/A,N/A,N/A,1130,1171,N/A,5,5
11,N/A,N/A,N/A,1119,1130,N/A,8,2
9,N/A,N/A,N/A,1110,1119,N/A,13,1
43,N/A,N/A,N/A,1067,1110,N/A,17,5
10,N/A,N/A,N/A,1057,1067,N/A,20,2
7,N/A,N/A,N/A,1050,1057,N/A,25,1
9,N/A,N/A,N/A,1041,1050,N/A,31,1
13,N/A,N/A,N/A,1028,1041,N/A,34,4
20,N/A,N/A,N/A,1008,1028,N/A,40,4
16,N/A,N/A,N/A,992,1008,N/A,46,4
27,N/A,N/A,N/A,965,992,N/A,52,4
6,N/A,N/A,N/A,959,965,N/A,55,1
6,N/A,N/A,N/A,953,959,N/A,61,1
43,N/A,N/A,N/A,910,953,N/A,66,6
45,N/A,N/A,N/A,865,910,N/A,71,5
8,N/A,N/A,N/A,857,865,N/A,74,2
6,N/A,N/A,N/A,851,857,N/A,79,1
30,N/A,N/A,N/A,821,851,N/A,84,6
37,N/A,N/A,N/A,784,821,N/A,89,5
37,N/A,N/A,N/A,747,784,N/A,95,5
44,N/A,N/A,N/A,703,747,N/A,101,5
29,N/A,N/A,N/A,674,703,N/A,106,4
9,N/A,N/A,N/A,665,674,N/A,111,3
7,N/A,N/A,N/A,658,665,N/A,115,1
27,N/A,N/A,N/A,631,658,N/A,118,4
23,N/A,N/A,N/A,608,631,N/A,124,4
19,N/A,N/A,N/A,589,608,N/A,130,4
5,N/A,N/A,N/A,584,589,N/A,133,1
44,N/A,N/A,N/A,540,584,N/A,137,5
26,N/A,N/A,N/A,514,540,N/A,143,5
10,N/A,N/A,N/A,1442,1452,N/A,5,3
33,N/A,N/A,N/A,1409,1442,N/A,8,6
9,N/A,N/A,N/A,1400,1409,N/A,11,3
28,N/A,N/A,N/A,1372,1400,N/A,14,6
11,N/A,N/A,N/A,1361,1372,N/A,18,4
11,N/A,N/A,N/A,1350,1361,N/A,23,3
8,N/A,N/A,N/A,1342,1350,N/A,29,3
8,N/A,N/A,N/A,1334,1342,N/A,35,3
9,N/A,N/A,N/A,1325,1334,N/A,39,1
35,N/A,N/A,N/A,1290,1325,N/A,44,6
12,N/A,N/A,N/A,1278,1290,N/A,48,4
11,N/A,N/A,N/A,1267,1278,N/A,54,4
9,N/A,N/A,N/A,1258,1267,N/A,59,3
39,N/A,N/A,N/A,1219,1258,N/A,62,6
17,N/A,N/A,N/A,1202,1219,N/A,66,4
9,N/A,N/A,N/A,1193,1202,N/A,71,3
6,N/A,N/A,N/A,1187,1193,N/A,75,1
35,N/A,N/A,N/A,1152,1187,N/A,80,6
12,N/A,N/A,N/A,1140,1152,N/A,84,4
9,N/A,N/A,N/A,1131,1140,N/A,89,3
11,N/A,N/A,N/A,1120,1131,N/A,94,2
8,N/A,N/A,N/A,1112,1120,N/A,100,2
45,N/A,N/A,N/A,1067,1112,N/A,104,6
46,N/A,N/A,N/A,1021,1067,N/A,109,5
38,N/A,N/A,N/A,983,1021,N/A,115,5
12,N/A,N/A,N/A,971,983,N/A,120,4
9,N/A,N/A,N/A,962,971,N/A,125,3
33,N/A,N/A,N/A,929,962,N/A,128,6
7,N/A,N/A,N/A,922,929,N/A,134,0
49,N/A,N/A,N/A,873,922,N/A,139,5
26,N/A,N/A,N/A,1676,1702,N/A,5,5
9,N/A,N/A,N/A,1667,1676,N/A,9,3
46,N/A,N/A,N/A,1621,1667,N/A,12,6
15,N/A,N/A,N/A,1606,1621,N/A,16,4
10,N/A,N/A,N/A,1596,1606,N/A,22,4
21,N/A,N/A,N/A,1575,1596,N/A,28,4
11,N/A,N/A,N/A,1564,1575,N/A,33,3
29,N/A,N/A,N/A,1535,1564,N/A,36,6
24,N/A,N/A,N/A,1511,1535,N/A,40,4
9,N/A,N/A,N/A,1502,1511,N/A,45,3
8,N/A,N/A,N/A,1494,1502,N/A,50,2
43,N/A,N/A,N/A,1451,1494,N/A,54,6
6,N/A,N/A,N/A,1445,1451,N/A,60,0
11,N/A,N/A,N/A,1434,1445,N/A,64,4
9,N/A,N/A,N/A,1425,1434,N/A,68,2
8,N/A,N/A,N/A,1417,1425,N/A,74,2
7,N/A,N/A,N/A,1410,1417,N/A,80,2
40,N/A,N/A,N/A,1370,1410,N/A,83,5
35,N/A,N/A,N/A,1335,1370,N/A,89,5
9,N/A,N/A,N/A,1326,1335,N/A,93,3
6,N/A,N/A,N/A,1320,1326,N/A,97,1
21,N/A,N/A,N/A,1299,1320,N/A,100,4
9,N/A,N/A,N/A,1290,1299,N/A,104,2
27,N/A,N/A,N/A,1263,1290,N/A,108,6
7,N/A,N/A,N/A,1256,1263,N/A,114,0
24,N/A,N/A,N/A,1232,1256,N/A,118,4
10,N/A,N/A,N/A,1222,1232,N/A,122,2
10,N/A,N/A,N/A,1212,1222,N/A,128,2
29,N/A,N/A,N/A,1183,1212,N/A,132,6
42,N/A,N/A,N/A,1141,1183,N/A,137,5
11,N/A,N/A,N/A,667,678,N/A,4,2
32,N/A,N/A,N/A,635,667,N/A,7,5
30,N/A,N/A,N/A,605,635,N/A,13,5
28,N/A,N/A,N/A,577,605,N/A,18,4
23,N/A,N/A,N/A,554,577,N/A,24,4
13,N/A,N/A,N/A,541,554,N/A,30,4
10,N/A,N/A,N/A,531,541,N/A,34,2
35,N/A,N/A,N/A,496,531,N/A,37,5
7,N/A,N/A,N/A,489,496,N/A,40,2
47,N/A,N/A,N/A,442,489,N/A,43,5
7,N/A,N/A,N/A,435,442,N/A,47,3
7,N/A,N/A,N/A,428,435,N/A,52,2
9,N/A,N/A,N/A,419,428,N/A,58,2
28,N/A,N/A,N/A,391,419,N/A,62,6
5,N/A,N/A,N/A,386,391,N/A,68,0
28,N/A,N/A,N/A,358,386,N/A,73,5
12,N/A,N/A,N/A,346,358,N/A,78,4
11,N/A,N/A,N/A,335,346,N/A,82,2
7,N/A,N/A,N/A,328,335,N/A,88,2
8,N/A,N/A,N/A,320,328,N/A,93,1
44,N/A,N/A,N/A,276,320,N/A,98,6
11,N/A,N/A,N/A,265,276,N/A,102,4
24,N/A,N/A,N/A,241,265,N/A,108,4
8,N/A,N/A,N/A,233,241,N/A,112,2
45,N/A,N/A,N/A,188,233,N/A,116,6
25,N/A,N/A,N/A,163,188,N/A,121,5
42,N/A,N/A,N/A,121,163,N/A,127,5
11,N/A,N/A,N/A,110,121,N/A,131,3
7,N/A,N/A,N/A,103,110,N/A,137,3
41,N/A,N/A,N/A,62,103,N/A,140,6
42,N/A,N/A,N/A,473,515,N/A,3,6
8,N/A,N/A,N/A,465,473,N/A,6,3
29,N/A,N/A,N/A,436,465,N/A,9,6
17,N/A,N/A,N/A,419,436,N/A,13,4
18,N/A,N/A,N/A,401,419,N/A,19,4
8,N/A,N/A,N/A,393,401,N/A,24,3
8,N/A,N/A,N/A,385,393,N/A,28,1
24,N/A,N/A,N/A,361,385,N/A,31,4
7,N/A,N/A,N/A,354,361,N/A,35,2
8,N/A,N/A,N/A,346,354,N/A,41,2
8,N/A,N/A,N/A,338,346,N/A,47,2
42,N/A,N/A,N/A,296,338,N/A,50,5
15,N/A,N/A,N/A,281,296,N/A,55,4
17,N/A,N/A,N/A,264,281,N/A,61,4
7,N/A,N/A,N/A,257,264,N/A,65,2
40,N/A,N/A,N/A,217,257,N/A,69,6
16,N/A,N/A,N/A,201,217,N/A,73,4
11,N/A,N/A,N/A,190,201,N/A,78,3
33,N/A,N/A,N/A,157,190,N/A,81,6
38,N/A,N/A,N/A,119,157,N/A,86,5
9,N/A,N/A,N/A,110,119,N/A,89,2
25,N/A,N/A,N/A,85,110,N/A,92,5
8,N/A,N/A,N/A,77,85,N/A,95,2
49,N/A,N/A,N/A,28,77,N/A,99,6
48,N/A,N/A,N/A,-20,28,N/A,104,5
29,N/A,N/A,N/A,726,755,N/A,6,4
8,N/A,N/A,N/A,718,726,N/A,11,3
36,N/A,N/A,N/A,682,718,N/A,14,6
5,N/A,N/A,N/A,677,682,N/A,20,0
24,N/A,N/A,N/A,653,677,N/A,24,4
9,N/A,N/A,N/A,644,653,N/A,29,3
29,N/A,N/A,N/A,615,644,N/A,32,6
10,N/A,N/A,N/A,605,615,N/A,35,3
25,N/A,N/A,N/A,580,605,N/A,38,6
8,N/A,N/A,N/A,572,580,N/A,44,0
26,N/A,N/A,N/A,546,572,N/A,49,5
27,N/A,N/A,N/A,519,546,N/A,54,4
8,N/A,N/A,N/A,511,519,N/A,57,1
42,N/A,N/A,N/A,469,511,N/A,62,6
27,N/A,N/A,N/A,442,469,N/A,66,4
9,N/A,N/A,N/A,433,442,N/A,71,3
9,N/A,N/A,N/A,424,433,N/A,76,2
41,N/A,N/A,N/A,383,424,N/A,80,6
7,N/A,N/A,N/A,376,383,N/A,83,3
7,N/A,N/A,N/A,369,376,N/A,89,3
5,N/A,N/A,N/A,364,369,N/A,93,1
47,N/A,N/A,N/A,317,364,N/A,97,5
9,N/A,N/A,N/A,308,317,N/A,101,3
42,N/A,N/A,N/A,266,308,N/A,104,6
7,N/A,N/A,N/A,259,266,N/A,107,3
38,N/A,N/A,N/A,221,259,N/A,110,6
7,N/A,N/A,N/A,214,221,N/A,113,3
10,N/A,N/A,N/A,204,214,N/A,119,3
49,N/A,N/A,N/A,155,204,N/A,122,6
8,N/A,N/A,N/A,147,155,N/A,128,0
14,N/A,N/A,N/A,1506,1520,N/A,4,4
12,N/A,N/A,N/A,1494,1506,N/A,10,4
9,N/A,N/A,N/A,1485,1494,N/A,14,2
11,N/A,N/A,N/A,1474,1485,N/A,20,2
9,N/A,N/A,N/A,1465,1474,N/A,25,1
14,N/A,N/A,N/A,1451,1465,N/A,28,4
8,N/A,N/A,N/A,1443,1451,N/A,31,1
16,N/A,N/A,N/A,1427,1443,N/A,34,4
9,N/A,N/A,N/A,1418,1427,N/A,38,2
33,N/A,N/A,N/A,1385,1418,N/A,41,5
39,N/A,N/A,N/A,1346,1385,N/A,47,5
36,N/A,N/A,N/A,1310,1346,N/A,53,5
17,N/A,N/A,N/A,1293,1310,N/A,58,4
7,N/A,N/A,N/A,1286,1293,N/A,63,3
7,N/A,N/A,N/A,1279,1286,N/A,69,3
6,N/A,N/A,N/A,1273,1279,N/A,73,1
41,N/A,N/A,N/A,1232,1273,N/A,78,6
40,N/A,N/A,N/A,1192,1232,N/A,83,5
21,N/A,N/A,N/A,1171,1192,N/A,88,4
8,N/A,N/A,N/A,1163,1171,N/A,91,1
37,N/A,N/A,N/A,1126,1163,N/A,96,6
7,N/A,N/A,N/A,1119,1126,N/A,99,3
7,N/A,N/A,N/A,1112,1119,N/A,105,3
7,N/A,N/A,N/A,1105,1112,N/A,111,3
11,N/A,N/A,N/A,1094,1105,N/A,116,2
9,N/A,N/A,N/A,1085,1094,N/A,122,2
7,N/A,N/A,N/A,1078,1085,N/A,127,1
34,N/A,N/A,N/A,1044,1078,N/A,131,5
11,N/A,N/A,N/A,1033,1044,N/A,136,4
11,N/A,N/A,N/A,1022,1033,N/A,141,3
43,N/A,N/A,N/A,1321,1364,N/A,5,5
8,N/A,N/A,N/A,1313,1321,N/A,8,2
48,N/A,N/A,N/A,1265,1313,N/A,11,5
11,N/A,N/A,N/A,1254,1265,N/A,15,3
9,N/A,N/A,N/A,1245,1254,N/A,20,2
7,N/A,N/A,N/A,1238,1245,N/A,26,2
7,N/A,N/A,N/A,1231,1238,N/A,31,1
43,N/A,N/A,N/A,1188,1231,N/A,36,6
25,N/A,N/A,N/A,1163,1188,N/A,41,5
12,N/A,N/A,N/A,1151,1163,N/A,46,4
10,N/A,N/A,N/A,1141,1151,N/A,51,3
9,N/A,N/A,N/A,1132,1141,N/A,57,3
49,N/A,N/A,N/A,1083,1132,N/A,60,6
6,N/A,N/A,N/A,1077,1083,N/A,66,0
42,N/A,N/A,N/A,1035,1077,N/A,72,6
17,N/A,N/A,N/A,1018,1035,N/A,76,4
10,N/A,N/A,N/A,1008,1018,N/A,80,2
6,N/A,N/A,N/A,1002,1008,N/A,85,1
38,N/A,N/A,N/A,964,1002,N/A,90,6
43,N/A,N/A,N/A,921,964,N/A,95,5
19,N/A,N/A,N/A,902,921,N/A,100,4
25,N/A,N/A,N/A,877,902,N/A,106,4
22,N/A,N/A,N/A,855,877,N/A,112,4
8,N/A,N/A,N/A,847,855,N/A,115,1
12,N/A,N/A,N/A,835,847,N/A,118,4
8,N/A,N/A,N/A,827,835,N/A,122,2
8,N/A,N/A,N/A,819,827,N/A,127,1
35,N/A,N/A,N/A,784,819,N/A,131,5
22,N/A,N/A,N/A,762,784,N/A,136,4
9,N/A,N/A,N/A,753,762,N/A,141,3
9,N/A,N/A,N/A,925,934,N/A,4,2
30,N/A,N/A,N/A,895,925,N/A,7,5
9,N/A,N/A,N/A,886,895,N/A,10,2
7,N/A,N/A,N/A,879,886,N/A,15,1
47,N/A,N/A,N/A,832,879,N/A,19,5
32,N/A,N/A,N/A,800,832,N/A,25,5
7,N/A,N/A,N/A,793,800,N/A,28,2
8,N/A,N/A,N/A,785,793,N/A,33,1
49,N/A,N/A,N/A,736,785,N/A,38,6
11,N/A,N/A,N/A,725,736,N/A,41,3
11,N/A,N/A,N/A,714,725,N/A,47,3
11,N/A,N/A,N/A,703,714,N/A,53,3
7,N/A,N/A,N/A,696,703,N/A,58,2
38,N/A,N/A,N/A,658,696,N/A,62,6
7,N/A,N/A,N/A,651,658,N/A,65,3
9,N/A,N/A,N/A,642,651,N/A,70,2
8,N/A,N/A,N/A,634,642,N/A,75,1
24,N/A,N/A,N/A,610,634,N/A,78,4
8,N/A,N/A,N/A,602,610,N/A,83,3
7,N/A,N/A,N/A,595,602,N/A,88,2
8,N/A,N/A,N/A,587,595,N/A,94,2
5,N/A,N/A,N/A,582,587,N/A,99,1
26,N/A,N/A,N/A,556,582,N/A,103,5
9,N/A,N/A,N/A,547,556,N/A,106,2
6,N/A,N/A,N/A,541,547,N/A,111,1
28,N/A,N/A,N/A,513,541,N/A,114,4
11,N/A,N/A,N/A,502,513,N/A,119,3
7,N/A,N/A,N/A,495,502,N/A,123,1
43,N/A,N/A,N/A,452,495,N/A,127,5
8,N/A,N/A,N/A,444,452,N/A,130,2
8,N/A,N/A,N/A,442,450,N/A,3,2
49,N/A,N/A,N/A,393,442,N/A,7,6
38,N/A,N/A,N/A,355,393,N/A,12,5
7,N/A,N/A,N/A,348,355,N/A,16,3
39,N/A,N/A,N/A,309,348,N/A,19,6
15,N/A,N/A,N/A,294,309,N/A,23,4
11,N/A,N/A,N/A,283,294,N/A,27,2
6,N/A,N/A,N/A,277,283,N/A,32,1
25,N/A,N/A,N/A,252,277,N/A,37,6
5,N/A,N/A,N/A,247,252,N/A,43,0
26,N/A,N/A,N/A,221,247,N/A,48,5
8,N/A,N/A,N/A,213,221,N/A,52,3
9,N/A,N/A,N/A,204,213,N/A,57,2
30,N/A,N/A,N/A,174,204,N/A,60,5
10,N/A,N/A,N/A,164,174,N/A,64,3
42,N/A,N/A,N/A,122,164,N/A,67,6
30,N/A,N/A,N/A,92,122,N/A,72,5
33,N/A,N/A,N/A,59,92,N/A,78,5
31,N/A,N/A,N/A,28,59,N/A,84,5
8,N/A,N/A,N/A,20,28,N/A,87,2
8,N/A,N/A,N/A,12,20,N/A,92,1
15,N/A,N/A,N/A,-3,12,N/A,95,4
32,N/A,N/A,N/A,1245,1277,N/A,4,6
9,N/A,N/A,N/A,1236,1245,N/A,7,3
9,N/A,N/A,N/A,1227,1236,N/A,11,1
27,N/A,N/A,N/A,1200,1227,N/A,14,4
11,N/A,N/A,N/A,1189,1200,N/A,18,2
42,N/A,N/A,N/A,1147,1189,N/A,21,5
39,N/A,N/A,N/A,1108,1147,N/A,27,5
38,N/A,N/A,N/A,1070,1108,N/A,33,5
9,N/A,N/A,N/A,1061,1070,N/A,36,2
36,N/A,N/A,N/A,1025,1061,N/A,40,6
8,N/A,N/A,N/A,1017,1025,N/A,43,3
8,N/A,N/A,N/A,1009,1017,N/A,47,1
7,N/A,N/A,N/A,1002,1009,N/A,53,1
30,N/A,N/A,N/A,972,1002,N/A,58,6
22,N/A,N/A,N/A,950,972,N/A,62,4
8,N/A,N/A,N/A,942,950,N/A,67,3
27,N/A,N/A,N/A,915,942,N/A,70,6
41,N/A,N/A,N/A,874,915,N/A,75,5
13,N/A,N/A,N/A,861,874,N/A,80,4
11,N/A,N/A,N/A,850,861,N/A,85,3
44,N/A,N/A,N/A,806,850,N/A,88,6
29,N/A,N/A,N/A,777,806,N/A,92,4
5,N/A,N/A,N/A,772,777,N/A,95,1
7,N/A,N/A,N/A,765,772,N/A,101,1
7,N/A,N/A,N/A,758,765,N/A,107,1
6,N/A,N/A,N/A,752,758,N/A,113,1
26,N/A,N/A,N/A,726,752,N/A,118,6
49,N/A,N/A,N/A,677,726,N/A,123,5
45,N/A,N/A,N/A,632,677,N/A,129,5
25,N/A,N/A,N/A,607,632,N/A,135,5
9,N/A,N/A,N/A,506,515,N/A,5,1
40,N/A,N/A,N/A,466,506,N/A,10,6
38,N/A,N/A,N/A,428,466,N/A,15,5
10,N/A,N/A,N/A,418,428,N/A,18,2
8,N/A,N/A,N/A,410,418,N/A,23,1
32,N/A,N/A,N/A,378,410,N/A,27,5
10,N/A,N/A,N/A,368,378,N/A,30,2
5,N/A,N/A,N/A,363,368,N/A,35,1
5,N/A,N/A,N/A,358,363,N/A,41,1
23,N/A,N/A,N/A,335,358,N/A,44,4
10,N/A,N/A,N/A,325,335,N/A,48,2
8,N/A,N/A,N/A,317,325,N/A,54,2
10,N/A,N/A,N/A,307,317,N/A,60,2
6,N/A,N/A,N/A,301,307,N/A,65,1
13,N/A,N/A,N/A,288,301,N/A,68,4
23,N/A,N/A,N/A,265,288,N/A,74,4
27,N/A,N/A,N/A,238,265,N/A,80,4
11,N/A,N/A,N/A,227,238,N/A,85,3
10,N/A,N/A,N/A,217,227,N/A,91,3
9,N/A,N/A,N/A,208,217,N/A,96,2
9,N/A,N/A,N/A,199,208,N/A,101,1
38,N/A,N/A,N/A,161,199,N/A,105,5
10,N/A,N/A,N/A,151,161,N/A,109,3
32,N/A,N/A,N/A,119,151,N/A,112,6
8,N/A,N/A,N/A,111,119,N/A,118,0
25,N/A,N/A,N/A,86,111,N/A,122,4
5,N/A,N/A,N/A,81,86,N/A,125,1
18,N/A,N/A,N/A,63,81,N/A,128,4
12,N/A,N/A,N/A,51,63,N/A,134,4
18,N/A,N/A,N/A,33,51,N/A,140,4
7,N/A,N/A,N/A,702,709,N/A,6,1
40,N/A,N/A,N/A,662,702,N/A,10,5
7,N/A,N/A,N/A,655,662,N/A,13,2
37,N/A,N/A,N/A,618,655,N/A,16,5
11,N/A,N/A,N/A,607,618,N/A,20,3
9,N/A,N/A,N/A,598,607,N/A,24,1
33,N/A,N/A,N/A,565,598,N/A,29,6
7,N/A,N/A,N/A,558,565,N/A,32,3
8,N/A,N/A,N/A,550,558,N/A,37,2
34,N/A,N/A,N/A,516,550,N/A,41,6
38,N/A,N/A,N/A,478,516,N/A,46,5
11,N/A,N/A,N/A,467,478,N/A,49,2
47,N/A,N/A,N/A,420,467,N/A,53,6
45,N/A,N/A,N/A,375,420,N/A,58,5
7,N/A,N/A,N/A,368,375,N/A,61,2
43,N/A,N/A,N/A,325,368,N/A,64,5
9,N/A,N/A,N/A,316,325,N/A,68,3
27,N/A,N/A,N/A,289,316,N/A,71,6
12,N/A,N/A,N/A,277,289,N/A,75,4
6,N/A,N/A,N/A,271,277,N/A,78,1
15,N/A,N/A,N/A,256,271,N/A,81,4
13,N/A,N/A,N/A,243,256,N/A,87,4
19,N/A,N/A,N/A,224,243,N/A,93,4
7,N/A,N/A,N/A,217,224,N/A,96,1
48,N/A,N/A,N/A,169,217,N/A,100,5
19,N/A,N/A,N/A,150,169,N/A,105,4
10,N/A,N/A,N/A,140,150,N/A,109,2
6,N/A,N/A,N/A,134,140,N/A,114,1
43,N/A,N/A,N/A,91,134,N/A,119,6
30,N/A,N/A,N/A,61,91,N/A,124,5
49,N/A,N/A,N/A,1184,1233,N/A,3,6
8,N/A,N/A,N/A,1176,1184,N/A,6,3
7,N/A,N/A,N/A,1169,1176,N/A,12,3
8,N/A,N/A,N/A,1161,1169,N/A,17,2
42,N/A,N/A,N/A,1119,1161,N/A,21,6
17,N/A,N/A,N/A,1102,1119,N/A,25,4
7,N/A,N/A,N/A,1095,1102,N/A,29,2
9,N/A,N/A,N/A,1086,1095,N/A,35,2
44,N/A,N/A,N/A,1042,1086,N/A,38,5
11,N/A,N/A,N/A,1031,1042,N/A,41,2
35,N/A,N/A,N/A,996,1031,N/A,45,6
8,N/A,N/A,N/A,988,996,N/A,48,3
11,N/A,N/A,N/A,977,988,N/A,53,2
47,N/A,N/A,N/A,930,977,N/A,56,5
9,N/A,N/A,N/A,921,930,N/A,59,2
9,N/A,N/A,N/A,912,921,N/A,64,1
26,N/A,N/A,N/A,886,912,N/A,67,4
8,N/A,N/A,N/A,878,886,N/A,70,1
8,N/A,N/A,N/A,870,878,N/A,76,1
7,N/A,N/A,N/A,863,870,N/A,82,1
34,N/A,N/A,N/A,829,863,N/A,86,5
46,N/A,N/A,N/A,783,829,N/A,92,5
27,N/A,N/A,N/A,756,783,N/A,98,5
49,N/A,N/A,N/A,707,756,N/A,104,5
32,N/A,N/A,N/A,675,707,N/A,110,5
34,N/A,N/A,N/A,641,675,N/A,116,5
32,N/A,N/A,N/A,609,641,N/A,122,5
18,N/A,N/A,N/A,591,609,N/A,127,4
23,N/A,N/A,N/A,568,591,N/A,133,4
9,N/A,N/A,N/A,559,568,N/A,137,2
10,N/A,N/A,N/A,757,767,N/A,3,2
11,N/A,N/A,N/A,746,757,N/A,9,2
47,N/A,N/A,N/A,699,746,N/A,12,5
11,N/A,N/A,N/A,688,699,N/A,16,3
9,N/A,N/A,N/A,679,688,N/A,22,3
9,N/A,N/A,N/A,670,679,N/A,28,3
37,N/A,N/A,N/A,633,670,N/A,31,6
16,N/A,N/A,N/A,617,633,N/A,35,4
9,N/A,N/A,N/A,608,617,N/A,38,1
42,N/A,N/A,N/A,566,608,N/A,43,6
11,N/A,N/A,N/A,555,566,N/A,46,3
9,N/A,N/A,N/A,546,555,N/A,51,2
29,N/A,N/A,N/A,517,546,N/A,55,6
8,N/A,N/A,N/A,509,517,N/A,61,0
29,N/A,N/A,N/A,480,509,N/A,66,5
39,N/A,N/A,N/A,441,480,N/A,72,5
32,N/A,N/A,N/A,409,441,N/A,78,5
9,N/A,N/A,N/A,400,409,N/A,81,2
36,N/A,N/A,N/A,364,400,N/A,85,6
30,N/A,N/A,N/A,334,364,N/A,90,5
9,N/A,N/A,N/A,325,334,N/A,93,2
7,N/A,N/A,N/A,318,325,N/A,98,1
43,N/A,N/A,N/A,275,318,N/A,102,5
24,N/A,N/A,N/A,251,275,N/A,107,4
6,N/A,N/A,N/A,245,251,N/A,110,1
41,N/A,N/A,N/A,204,245,N/A,115,6
8,N/A,N/A,N/A,196,204,N/A,118,3
39,N/A,N/A,N/A,157,196,N/A,121,6
14,N/A,N/A,N/A,143,157,N/A,125,4
29,N/A,N/A,N/A,114,143,N/A,131,4
7,N/A,N/A,N/A,940,947,N/A,4,3
5,N/A,N/A,N/A,935,940,N/A,8,1
45,N/A,N/A,N/A,890,935,N/A,12,5
8,N/A,N/A,N/A,882,890,N/A,16,3
7,N/A,N/A,N/A,875,882,N/A,21,2
30,N/A,N/A,N/A,845,875,N/A,24,5
9,N/A,N/A,N/A,836,845,N/A,27,2
37,N/A,N/A,N/A,799,836,N/A,30,5
8,N/A,N/A,N/A,791,799,N/A,33,2
7,N/A,N/A,N/A,784,791,N/A,39,2
41,N/A,N/A,N/A,743,784,N/A,43,6
31,N/A,N/A,N/A,712,743,N/A,48,5
44,N/A,N/A,N/A,668,712,N/A,54,5
11,N/A,N/A,N/A,657,668,N/A,57,2
39,N/A,N/A,N/A,618,657,N/A,60,5
26,N/A,N/A,N/A,592,618,N/A,65,4
11,N/A,N/A,N/A,581,592,N/A,70,3
9,N/A,N/A,N/A,572,581,N/A,75,2
30,N/A,N/A,N/A,542,572,N/A,79,6
11,N/A,N/A,N/A,531,542,N/A,82,3
32,N/A,N/A,N/A,499,531,N/A,85,6
31,N/A,N/A,N/A,468,499,N/A,90,5
9,N/A,N/A,N/A,459,468,N/A,93,2
6,N/A,N/A,N/A,453,459,N/A,98,1
6,N/A,N/A,N/A,447,453,N/A,104,1
8,N/A,N/A,N/A,439,447,N/A,110,1
27,N/A,N/A,N/A,412,439,N/A,113,4
11,N/A,N/A,N/A,401,412,N/A,117,2
9,N/A,N/A,N/A,392,401,N/A,123,2
11,N/A,N/A,N/A,381,392,N/A,129,2
8,N/A,N/A,N/A,547,555,N/A,5,1
42,N/A,N/A,N/A,505,547,N/A,9,5
11,N/A,N/A,N/A,494,505,N/A,13,3
7,N/A,N/A,N/A,487,494,N/A,19,3
8,N/A,N/A,N/A,479,487,N/A,24,2
48,N/A,N/A,N/A,431,479,N/A,27,5
7,N/A,N/A,N/A,424,431,N/A,30,2
7,N/A,N/A,N/A,417,424,N/A,35,1
5,N/A,N/A,N/A,412,417,N/A,41,1
34,N/A,N/A,N/A,378,412,N/A,45,5
14,N/A,N/A,N/A,364,378,N/A,50,4
9,N/A,N/A,N/A,355,364,N/A,55,3
9,N/A,N/A,N/A,346,355,N/A,60,2
40,N/A,N/A,N/A,306,346,N/A,64,6
10,N/A,N/A,N/A,296,306,N/A,67,3
9,N/A,N/A,N/A,287,296,N/A,71,1
24,N/A,N/A,N/A,263,287,N/A,74,4
10,N/A,N/A,N/A,253,263,N/A,79,3
7,N/A,N/A,N/A,246,253,N/A,85,3
8,N/A,N/A,N/A,238,246,N/A,90,2
9,N/A,N/A,N/A,229,238,N/A,96,2
44,N/A,N/A,N/A,185,229,N/A,99,5
21,N/A,N/A,N/A,164,185,N/A,104,4
9,N/A,N/A,N/A,155,164,N/A,108,2
40,N/A,N/A,N/A,115,155,N/A,111,5
9,N/A,N/A,N/A,106,115,N/A,115,3
8,N/A,N/A,N/A,98,106,N/A,120,2
8,N/A,N/A,N/A,90,98,N/A,126,2
7,N/A,N/A,N/A,83,90,N/A,132,2
36,N/A,N/A,N/A,47,83,N/A,135,5
25,N/A,N/A,N/A,1252,1277,N/A,6,4
8,N/A,N/A,N/A,1244,1252,N/A,9,1
7,N/A,N/A,N/A,1237,1244,N/A,15,1
14,N/A,N/A,N/A,1223,1237,N/A,18,4
10,N/A,N/A,N/A,1213,1223,N/A,22,2
45,N/A,N/A,N/A,1168,1213,N/A,25,5
40,N/A,N/A,N/A,1128,1168,N/A,31,5
16,N/A,N/A,N/A,1112,1128,N/A,36,4
17,N/A,N/A,N/A,1095,1112,N/A,42,4
10,N/A,N/A,N/A,1085,1095,N/A,47,3
7,N/A,N/A,N/A,1078,1085,N/A,53,3
10,N/A,N/A,N/A,1068,1078,N/A,58,2
7,N/A,N/A,N/A,1061,1068,N/A,64,2
7,N/A,N/A,N/A,1054,1061,N/A,70,2
5,N/A,N/A,N/A,1049,1054,N/A,75,1
7,N/A,N/A,N/A,1042,1049,N/A,81,1
14,N/A,N/A,N/A,1028,1042,N/A,84,4
7,N/A,N/A,N/A,1021,1028,N/A,87,1
22,N/A,N/A,N/A,999,1021,N/A,90,4
8,N/A,N/A,N/A,991,999,N/A,94,2
44,N/A,N/A,N/A,947,991,N/A,98,6
6,N/A,N/A,N/A,941,947,N/A,104,0
13,N/A,N/A,N/A,928,941,N/A,108,4
8,N/A,N/A,N/A,920,928,N/A,113,3
8,N/A,N/A,N/A,912,920,N/A,118,2
10,N/A,N/A,N/A,902,912,N/A,124,2
27,N/A,N/A,N/A,875,902,N/A,128,6
41,N/A,N/A,N/A,834,875,N/A,133,5
28,N/A,N/A,N/A,806,834,N/A,139,5
36,N/A,N/A,N/A,770,806,N/A,145,5
7,N/A,N/A,N/A,1949,1956,N/A,5,2
31,N/A,N/A,N/A,1918,1949,N/A,8,5
10,N/A,N/A,N/A,1908,1918,N/A,11,2
31,N/A,N/A,N/A,1877,1908,N/A,14,5
9,N/A,N/A,N/A,1868,1877,N/A,17,2
46,N/A,N/A,N/A,1822,1868,N/A,21,6
9,N/A,N/A,N/A,1813,1822,N/A,27,0
43,N/A,N/A,N/A,1770,1813,N/A,33,6
47,N/A,N/A,N/A,1723,1770,N/A,38,5
8,N/A,N/A,N/A,1715,1723,N/A,42,3
38,N/A,N/A,N/A,1677,1715,N/A,45,6
5,N/A,N/A,N/A,1672,1677,N/A,51,0
15,N/A,N/A,N/A,1657,1672,N/A,55,4
10,N/A,N/A,N/A,1647,1657,N/A,60,3
7,N/A,N/A,N/A,1640,1647,N/A,64,1
42,N/A,N/A,N/A,1598,1640,N/A,69,6
24,N/A,N/A,N/A,1574,1598,N/A,73,4
17,N/A,N/A,N/A,1557,1574,N/A,79,4
11,N/A,N/A,N/A,1546,1557,N/A,84,3
44,N/A,N/A,N/A,1502,1546,N/A,87,6
7,N/A,N/A,N/A,1495,1502,N/A,93,0
41,N/A,N/A,N/A,1454,1495,N/A,98,5
20,N/A,N/A,N/A,1434,1454,N/A,103,4
23,N/A,N/A,N/A,1411,1434,N/A,109,4
8,N/A,N/A,N/A,1403,1411,N/A,113,2
49,N/A,N/A,N/A,1354,1403,N/A,116,5
10,N/A,N/A,N/A,1344,1354,N/A,120,3
48,N/A,N/A,N/A,1296,1344,N/A,123,6
5,N/A,N/A,N/A,1291,1296,N/A,129,0
34,N/A,N/A,N/A,1257,1291,N/A,134,5
7,N/A,N/A,N/A,956,963,N/A,6,1
27,N/A,N/A,N/A,929,956,N/A,11,6
8,N/A,N/A,N/A,921,929,N/A,17,0
27,N/A,N/A,N/A,894,921,N/A,21,4
7,N/A,N/A,N/A,887,894,N/A,26,3
5,N/A,N/A,N/A,882,887,N/A,30,1
39,N/A,N/A,N/A,843,882,N/A,35,6
29,N/A,N/A,N/A,814,843,N/A,39,4
7,N/A,N/A,N/A,807,814,N/A,43,2
40,N/A,N/A,N/A,767,807,N/A,46,5
26,N/A,N/A,N/A,741,767,N/A,52,5
38,N/A,N/A,N/A,703,741,N/A,58,5
8,N/A,N/A,N/A,695,703,N/A,61,2
46,N/A,N/A,N/A,649,695,N/A,64,5
29,N/A,N/A,N/A,620,649,N/A,69,4
7,N/A,N/A,N/A,613,620,N/A,72,1
8,N/A,N/A,N/A,605,613,N/A,78,1
17,N/A,N/A,N/A,588,605,N/A,81,4
16,N/A,N/A,N/A,572,588,N/A,87,4
14,N/A,N/A,N/A,558,572,N/A,93,4
9,N/A,N/A,N/A,549,558,N/A,98,3
5,N/A,N/A,N/A,544,549,N/A,102,1
5,N/A,N/A,N/A,539,544,N/A,108,1
42,N/A,N/A,N/A,497,539,N/A,112,5
25,N/A,N/A,N/A,472,497,N/A,118,5
19,N/A,N/A,N/A,453,472,N/A,123,4
8,N/A,N/A,N/A,445,453,N/A,127,2
5,N/A,N/A,N/A,440,445,N/A,132,1
26,N/A,N/A,N/A,414,440,N/A,137,6
8,N/A,N/A,N/A,406,414,N/A,143,0
8,N/A,N/A,N/A,770,778,N/A,3,3
8,N/A,N/A,N/A,762,770,N/A,7,1
34,N/A,N/A,N/A,728,762,N/A,12,6
6,N/A,N/A,N/A,722,728,N/A,18,0
39,N/A,N/A,N/A,683,722,N/A,24,6
27,N/A,N/A,N/A,656,683,N/A,29,5
11,N/A,N/A,N/A,645,656,N/A,33,3
27,N/A,N/A,N/A,618,645,N/A,36,6
7,N/A,N/A,N/A,611,618,N/A,42,0
14,N/A,N/A,N/A,597,611,N/A,46,4
7,N/A,N/A,N/A,590,597,N/A,49,1
42,N/A,N/A,N/A,548,590,N/A,53,5
11,N/A,N/A,N/A,537,548,N/A,56,2
11,N/A,N/A,N/A,526,537,N/A,62,2
6,N/A,N/A,N/A,520,526,N/A,67,1
30,N/A,N/A,N/A,490,520,N/A,71,5
8,N/A,N/A,N/A,482,490,N/A,75,3
28,N/A,N/A,N/A,454,482,N/A,78,6
29,N/A,N/A,N/A,425,454,N/A,83,5
43,N/A,N/A,N/A,382,425,N/A,89,5
20,N/A,N/A,N/A,362,382,N/A,94,4
19,N/A,N/A,N/A,343,362,N/A,100,4
10,N/A,N/A,N/A,333,343,N/A,104,2
36,N/A,N/A,N/A,297,333,N/A,108,6
6,N/A,N/A,N/A,291,297,N/A,114,0
44,N/A,N/A,N/A,247,291,N/A,120,6
9,N/A,N/A,N/A,238,247,N/A,126,0
38,N/A,N/A,N/A,200,238,N/A,131,5
43,N/A,N/A,N/A,157,200,N/A,137,5
48,N/A,N/A,N/A,109,157,N/A,143,5
20,N/A,N/A,N/A,370,390,N/A,5,4
11,N/A,N/A,N/A,359,370,N/A,10,3
49,N/A,N/A,N/A,310,359,N/A,13,6
5,N/A,N/A,N/A,305,310,N/A,19,0
17,N/A,N/A,N/A,288,305,N/A,23,4
10,N/A,N/A,N/A,278,288,N/A,27,2
25,N/A,N/A,N/A,253,278,N/A,30,5
8,N/A,N/A,N/A,245,253,N/A,34,3
5,N/A,N/A,N/A,240,245,N/A,38,1
48,N/A,N/A,N/A,192,240,N/A,42,5
7,N/A,N/A,N/A,185,192,N/A,46,3
8,N/A,N/A,N/A,177,185,N/A,50,1
22,N/A,N/A,N/A,155,177,N/A,53,4
9,N/A,N/A,N/A,146,155,N/A,57,2
10,N/A,N/A,N/A,136,146,N/A,63,2
42,N/A,N/A,N/A,94,136,N/A,67,6
33,N/A,N/A,N/A,61,94,N/A,72,5
26,N/A,N/A,N/A,35,61,N/A,78,5
21,N/A,N/A,N/A,14,35,N/A,83,4
11,N/A,N/A,N/A,3,14,N/A,89,4
22,N/A,N/A,N/A,-19,3,N/A,95,4
37,N/A,N/A,N/A,581,618,N/A,3,5
28,N/A,N/A,N/A,553,581,N/A,9,5
23,N/A,N/A,N/A,530,553,N/A,14,4
28,N/A,N/A,N/A,502,530,N/A,20,4
7,N/A,N/A,N/A,495,502,N/A,25,3
7,N/A,N/A,N/A,488,495,N/A,30,2
44,N/A,N/A,N/A,444,488,N/A,34,6
28,N/A,N/A,N/A,416,444,N/A,38,4
7,N/A,N/A,N/A,409,416,N/A,41,1
32,N/A,N/A,N/A,377,409,N/A,45,5
9,N/A,N/A,N/A,368,377,N/A,48,2
29,N/A,N/A,N/A,339,368,N/A,51,5
10,N/A,N/A,N/A,329,339,N/A,55,3
35,N/A,N/A,N/A,294,329,N/A,58,6
15,N/A,N/A,N/A,279,294,N/A,62,4
9,N/A,N/A,N/A,270,279,N/A,67,3
10,N/A,N/A,N/A,260,270,N/A,72,2
43,N/A,N/A,N/A,217,260,N/A,75,5
28,N/A,N/A,N/A,189,217,N/A,80,4
8,N/A,N/A,N/A,181,189,N/A,85,3
8,N/A,N/A,N/A,173,181,N/A,89,1
9,N/A,N/A,N/A,164,173,N/A,95,1
22,N/A,N/A,N/A,142,164,N/A,98,4
7,N/A,N/A,N/A,135,142,N/A,101,1
33,N/A,N/A,N/A,102,135,N/A,105,5
10,N/A,N/A,N/A,92,102,N/A,110,4
5,N/A,N/A,N/A,87,92,N/A,113,1
8,N/A,N/A,N/A,79,87,N/A,119,1
29,N/A,N/A,N/A,50,79,N/A,122,4
24,N/A,N/A,N/A,26,50,N/A,128,4
10,N/A,N/A,N/A,1303,1313,N/A,5,2
7,N/A,N/A,N/A,1296,1303,N/A,11,2
7,N/A,N/A,N/A,1289,1296,N/A,17,2
25,N/A,N/A,N/A,1264,1289,N/A,21,6
6,N/A,N/A,N/A,1258,1264,N/A,27,0
10,N/A,N/A,N/A,1248,1258,N/A,30,3
42,N/A,N/A,N/A,1206,1248,N/A,33,6
46,N/A,N/A,N/A,1160,1206,N/A,38,5
23,N/A,N/A,N/A,1137,1160,N/A,43,4
8,N/A,N/A,N/A,1129,1137,N/A,46,1
36,N/A,N/A,N/A,1093,1129,N/A,50,5
8,N/A,N/A,N/A,1085,1093,N/A,54,3
8,N/A,N/A,N/A,1077,1085,N/A,59,2
7,N/A,N/A,N/A,1070,1077,N/A,65,2
8,N/A,N/A,N/A,1062,1070,N/A,71,2
49,N/A,N/A,N/A,1013,1062,N/A,74,5
10,N/A,N/A,N/A,1003,1013,N/A,77,2
7,N/A,N/A,N/A,996,1003,N/A,83,2
9,N/A,N/A,N/A,987,996,N/A,89,2
33,N/A,N/A,N/A,954,987,N/A,93,6
9,N/A,N/A,N/A,945,954,N/A,96,3
7,N/A,N/A,N/A,938,945,N/A,102,3
11,N/A,N/A,N/A,927,938,N/A,107,2
48,N/A,N/A,N/A,879,927,N/A,110,5
9,N/A,N/A,N/A,870,879,N/A,113,2
49,N/A,N/A,N/A,821,870,N/A,117,6
9,N/A,N/A,N/A,812,821,N/A,123,0
17,N/A,N/A,N/A,795,812,N/A,127,4
16,N/A,N/A,N/A,779,795,N/A,133,4
10,N/A,N/A,N/A,769,779,N/A,137,2
48,N/A,N/A,N/A,1758,1806,N/A,3,6
32,N/A,N/A,N/A,1726,1758,N/A,8,5
9,N/A,N/A,N/A,1717,1726,N/A,12,3
9,N/A,N/A,N/A,1708,1717,N/A,16,1
30,N/A,N/A,N/A,1678,1708,N/A,20,5
18,N/A,N/A,N/A,1660,1678,N/A,25,4
8,N/A,N/A,N/A,1652,1660,N/A,30,3
44,N/A,N/A,N/A,1608,1652,N/A,33,6
10,N/A,N/A,N/A,1598,1608,N/A,36,3
7,N/A,N/A,N/A,1591,1598,N/A,40,1
21,N/A,N/A,N/A,1570,1591,N/A,43,4
7,N/A,N/A,N/A,1563,1570,N/A,48,3
39,N/A,N/A,N/A,1524,1563,N/A,51,6
9,N/A,N/A,N/A,1515,1524,N/A,54,3
7,N/A,N/A,N/A,1508,1515,N/A,58,1
27,N/A,N/A,N/A,1481,1508,N/A,62,5
9,N/A,N/A,N/A,1472,1481,N/A,65,2
11,N/A,N/A,N/A,1461,1472,N/A,71,2
33,N/A,N/A,N/A,1428,1461,N/A,74,5
48,N/A,N/A,N/A,1380,1428,N/A,80,5
45,N/A,N/A,N/A,1335,1380,N/A,86,5
9,N/A,N/A,N/A,1326,1335,N/A,89,2
44,N/A,N/A,N/A,1282,1326,N/A,93,6
6,N/A,N/A,N/A,1276,1282,N/A,99,0
7,N/A,N/A,N/A,1269,1276,N/A,102,3
44,N/A,N/A,N/A,1225,1269,N/A,105,6
25,N/A,N/A,N/A,1200,1225,N/A,109,4
9,N/A,N/A,N/A,1191,1200,N/A,114,3
5,N/A,N/A,N/A,1186,1191,N/A,118,1
7,N/A,N/A,N/A,1179,1186,N/A,124,1
9,N/A,N/A,N/A,1065,1074,N/A,3,2
9,N/A,N/A,N/A,1056,1065,N/A,8,1
23,N/A,N/A,N/A,1033,1056,N/A,11,4
9,N/A,N/A,N/A,1024,1033,N/A,16,3
10,N/A,N/A,N/A,1014,1024,N/A,22,3
7,N/A,N/A,N/A,1007,1014,N/A,27,2
9,N/A,N/A,N/A,998,1007,N/A,32,1
8,N/A,N/A,N/A,990,998,N/A,38,1
23,N/A,N/A,N/A,967,990,N/A,41,4
5,N/A,N/A,N/A,962,967,N/A,44,1
25,N/A,N/A,N/A,937,962,N/A,48,5
11,N/A,N/A,N/A,926,937,N/A,51,2
8,N/A,N/A,N/A,918,926,N/A,56,1
14,N/A,N/A,N/A,904,918,N/A,59,4
10,N/A,N/A,N/A,894,904,N/A,65,4
8,N/A,N/A,N/A,886,894,N/A,68,1
7,N/A,N/A,N/A,879,886,N/A,74,1
35,N/A,N/A,N/A,844,879,N/A,78,5
8,N/A,N/A,N/A,836,844,N/A,81,2
25,N/A,N/A,N/A,811,836,N/A,85,6
11,N/A,N/A,N/A,800,811,N/A,88,3
49,N/A,N/A,N/A,751,800,N/A,91,6
9,N/A,N/A,N/A,742,751,N/A,97,0
45,N/A,N/A,N/A,697,742,N/A,102,5
11,N/A,N/A,N/A,686,697,N/A,106,3
9,N/A,N/A,N/A,677,686,N/A,112,3
9,N/A,N/A,N/A,668,677,N/A,118,3
34,N/A,N/A,N/A,634,668,N/A,121,6
9,N/A,N/A,N/A,625,634,N/A,124,3
7,N/A,N/A,N/A,618,625,N/A,129,2
35,N/A,N/A,N/A,1909,1944,N/A,4,6
40,N/A,N/A,N/A,1869,1909,N/A,9,5
11,N/A,N/A,N/A,1858,1869,N/A,14,4
11,N/A,N/A,N/A,1847,1858,N/A,19,3
5,N/A,N/A,N/A,1842,1847,N/A,23,1
8,N/A,N/A,N/A,1834,1842,N/A,29,1
6,N/A,N/A,N/A,1828,1834,N/A,35,1
26,N/A,N/A,N/A,1802,1828,N/A,40,6
21,N/A,N/A,N/A,1781,1802,N/A,44,4
19,N/A,N/A,N/A,1762,1781,N/A,50,4
10,N/A,N/A,N/A,1752,1762,N/A,54,2
9,N/A,N/A,N/A,1743,1752,N/A,60,2
40,N/A,N/A,N/A,1703,1743,N/A,64,6
8,N/A,N/A,N/A,1695,1703,N/A,70,0
9,N/A,N/A,N/A,1686,1695,N/A,73,3
27,N/A,N/A,N/A,1659,1686,N/A,76,6
14,N/A,N/A,N/A,1645,1659,N/A,80,4
7,N/A,N/A,N/A,1638,1645,N/A,84,2
9,N/A,N/A,N/A,1629,1638,N/A,89,1
27,N/A,N/A,N/A,1602,1629,N/A,93,5
33,N/A,N/A,N/A,1569,1602,N/A,99,5
16,N/A,N/A,N/A,1553,1569,N/A,104,4
11,N/A,N/A,N/A,1542,1553,N/A,109,3
7,N/A,N/A,N/A,1535,1542,N/A,114,2
35,N/A,N/A,N/A,1500,1535,N/A,117,5
10,N/A,N/A,N/A,1490,1500,N/A,121,3
40,N/A,N/A,N/A,1450,1490,N/A,124,6
7,N/A,N/A,N/A,1443,1450,N/A,127,3
5,N/A,N/A,N/A,1438,1443,N/A,131,1
7,N/A,N/A,N/A,1431,1438,N/A,137,1
40,N/A,N/A,N/A,1419,1459,N/A,5,5
11,N/A,N/A,N/A,1408,1419,N/A,9,3
9,N/A,N/A,N/A,1399,1408,N/A,14,2
5,N/A,N/A,N/A,1394,1399,N/A,19,1
8,N/A,N/A,N/A,1386,1394,N/A,25,1
41,N/A,N/A,N/A,1345,1386,N/A,29,5
11,N/A,N/A,N/A,1334,1345,N/A,33,3
9,N/A,N/A,N/A,1325,1334,N/A,39,3
7,N/A,N/A,N/A,1318,1325,N/A,44,2
7,N/A,N/A,N/A,1311,1318,N/A,49,1
29,N/A,N/A,N/A,1282,1311,N/A,52,4
5,N/A,N/A,N/A,1277,1282,N/A,55,1
7,N/A,N/A,N/A,1270,1277,N/A,61,1
26,N/A,N/A,N/A,1244,1270,N/A,64,4
9,N/A,N/A,N/A,1235,1244,N/A,69,3
8,N/A,N/A,N/A,1227,1235,N/A,74,2
9,N/A,N/A,N/A,1218,1227,N/A,80,2
5,N/A,N/A,N/A,1213,1218,N/A,85,1
47,N/A,N/A,N/A,1166,1213,N/A,90,6
7,N/A,N/A,N/A,1159,1166,N/A,96,0
13,N/A,N/A,N/A,1146,1159,N/A,100,4
7,N/A,N/A,N/A,1139,1146,N/A,103,1
39,N/A,N/A,N/A,1100,1139,N/A,108,6
7,N/A,N/A,N/A,1093,1100,N/A,114,0
37,N/A,N/A,N/A,1056,1093,N/A,120,6
6,N/A,N/A,N/A,1050,1056,N/A,126,0
7,N/A,N/A,N/A,1043,1050,N/A,129,3
10,N/A,N/A,N/A,1033,1043,N/A,134,2
27,N/A,N/A,N/A,1006,1033,N/A,137,5
14,N/A,N/A,N/A,992,1006,N/A,142,4
16,N/A,N/A,N/A,717,733,N/A,3,4
28,N/A,N/A,N/A,689,717,N/A,9,4
14,N/A,N/A,N/A,675,689,N/A,15,4
11,N/A,N/A,N/A,664,675,N/A,20,3
8,N/A,N/A,N/A,656,664,N/A,24,1
45,N/A,N/A,N/A,611,656,N/A,28,5
16,N/A,N/A,N/A,595,611,N/A,33,4
9,N/A,N/A,N/A,586,595,N/A,37,2
37,N/A,N/A,N/A,549,586,N/A,41,6
21,N/A,N/A,N/A,528,549,N/A,45,4
5,N/A,N/A,N/A,523,528,N/A,48,1
7,N/A,N/A,N/A,516,523,N/A,54,1
30,N/A,N/A,N/A,486,516,N/A,58,5
19,N/A,N/A,N/A,467,486,N/A,63,4
29,N/A,N/A,N/A,438,467,N/A,69,4
8,N/A,N/A,N/A,430,438,N/A,72,1
13,N/A,N/A,N/A,417,430,N/A,75,4
9,N/A,N/A,N/A,408,417,N/A,80,3
7,N/A,N/A,N/A,401,408,N/A,84,1
41,N/A,N/A,N/A,360,401,N/A,88,5
36,N/A,N/A,N/A,324,360,N/A,94,5
7,N/A,N/A,N/A,317,324,N/A,97,2
8,N/A,N/A,N/A,309,317,N/A,103,2
46,N/A,N/A,N/A,263,309,N/A,107,6
6,N/A,N/A,N/A,257,263,N/A,113,0
31,N/A,N/A,N/A,226,257,N/A,118,5
8,N/A,N/A,N/A,218,226,N/A,121,2
39,N/A,N/A,N/A,179,218,N/A,124,5
46,N/A,N/A,N/A,133,179,N/A,130,5
45,N/A,N/A,N/A,88,133,N/A,136,5
9,N/A,N/A,N/A,1437,1446,N/A,5,3
9,N/A,N/A,N/A,1428,1437,N/A,9,1
5,N/A,N/A,N/A,1423,1428,N/A,15,1
6,N/A,N/A,N/A,1417,1423,N/A,21,1
46,N/A,N/A,N/A,1371,1417,N/A,26,6
5,N/A,N/A,N/A,1366,1371,N/A,32,0
9,N/A,N/A,N/A,1357,1366,N/A,35,3
11,N/A,N/A,N/A,1346,1357,N/A,40,2
29,N/A,N/A,N/A,1317,1346,N/A,43,5
29,N/A,N/A,N/A,1288,1317,N/A,49,5
20,N/A,N/A,N/A,1268,1288,N/A,54,4
11,N/A,N/A,N/A,1257,1268,N/A,59,3
49,N/A,N/A,N/A,1208,1257,N/A,62,6
48,N/A,N/A,N/A,1160,1208,N/A,67,5
17,N/A,N/A,N/A,1143,1160,N/A,72,4
7,N/A,N/A,N/A,1136,1143,N/A,77,3
7,N/A,N/A,N/A,1129,1136,N/A,81,1
46,N/A,N/A,N/A,1083,1129,N/A,86,6
8,N/A,N/A,N/A,1075,1083,N/A,89,3
48,N/A,N/A,N/A,1027,1075,N/A,92,6
8,N/A,N/A,N/A,1019,1027,N/A,98,0
47,N/A,N/A,N/A,972,1019,N/A,103,5
10,N/A,N/A,N/A,962,972,N/A,106,2
8,N/A,N/A,N/A,954,962,N/A,111,1
9,N/A,N/A,N/A,945,954,N/A,117,1
6,N/A,N/A,N/A,939,945,N/A,123,1
28,N/A,N/A,N/A,911,939,N/A,127,5
8,N/A,N/A,N/A,903,911,N/A,131,3
9,N/A,N/A,N/A,894,903,N/A,135,1
24,N/A,N/A,N/A,870,894,N/A,138,4
40,N/A,N/A,N/A,558,598,N/A,4,6
27,N/A,N/A,N/A,531,558,N/A,8,4
11,N/A,N/A,N/A,520,531,N/A,14,4
8,N/A,N/A,N/A,512,520,N/A,17,1
6,N/A,N/A,N/A,506,512,N/A,23,1
42,N/A,N/A,N/A,464,506,N/A,28,6
11,N/A,N/A,N/A,453,464,N/A,31,3
33,N/A,N/A,N/A,420,453,N/A,34,6
8,N/A,N/A,N/A,412,420,N/A,37,3
48,N/A,N/A,N/A,364,412,N/A,40,6
30,N/A,N/A,N/A,334,364,N/A,45,5
28,N/A,N/A,N/A,306,334,N/A,51,5
11,N/A,N/A,N/A,295,306,N/A,54,2
30,N/A,N/A,N/A,265,295,N/A,58,6
5,N/A,N/A,N/A,260,265,N/A,64,0
28,N/A,N/A,N/A,232,260,N/A,69,5
36,N/A,N/A,N/A,196,232,N/A,75,5
11,N/A,N/A,N/A,185,196,N/A,79,3
8,N/A,N/A,N/A,177,185,N/A,85,3
8,N/A,N/A,N/A,169,177,N/A,91,3
8,N/A,N/A,N/A,161,169,N/A,96,2
6,N/A,N/A,N/A,155,161,N/A,101,1
26,N/A,N/A,N/A,129,155,N/A,105,5
46,N/A,N/A,N/A,83,129,N/A,111,5
39,N/A,N/A,N/A,44,83,N/A,117,5
11,N/A,N/A,N/A,33,44,N/A,120,2
44,N/A,N/A,N/A,-11,33,N/A,123,5
8,N/A,N/A,N/A,1414,1422,N/A,4,3
10,N/A,N/A,N/A,1404,1414,N/A,9,2
7,N/A,N/A,N/A,1397,1404,N/A,14,1
32,N/A,N/A,N/A,1365,1397,N/A,18,5
9,N/A,N/A,N/A,1356,1365,N/A,22,3
11,N/A,N/A,N/A,1345,1356,N/A,28,3
10,N/A,N/A,N/A,1335,1345,N/A,33,2
8,N/A,N/A,N/A,1327,1335,N/A,39,2
7,N/A,N/A,N/A,1320,1327,N/A,45,2
47,N/A,N/A,N/A,1273,1320,N/A,48,5
21,N/A,N/A,N/A,1252,1273,N/A,53,4
9,N/A,N/A,N/A,1243,1252,N/A,56,1
26,N/A,N/A,N/A,1217,1243,N/A,59,4
8,N/A,N/A,N/A,1209,1217,N/A,63,2
26,N/A,N/A,N/A,1183,1209,N/A,66,5
10,N/A,N/A,N/A,1173,1183,N/A,70,3
11,N/A,N/A,N/A,1162,1173,N/A,75,2
37,N/A,N/A,N/A,1125,1162,N/A,79,6
19,N/A,N/A,N/A,1106,1125,N/A,83,4
28,N/A,N/A,N/A,1078,1106,N/A,89,4
8,N/A,N/A,N/A,1070,1078,N/A,94,3
5,N/A,N/A,N/A,1065,1070,N/A,98,1
38,N/A,N/A,N/A,1027,1065,N/A,103,6
10,N/A,N/A,N/A,1017,1027,N/A,106,3
7,N/A,N/A,N/A,1010,1017,N/A,111,2
11,N/A,N/A,N/A,999,1010,N/A,117,2
9,N/A,N/A,N/A,990,999,N/A,122,1
37,N/A,N/A,N/A,953,990,N/A,126,5
10,N/A,N/A,N/A,943,953,N/A,131,4
26,N/A,N/A,N/A,917,943,N/A,137,4
11,N/A,N/A,N/A,1279,1290,N/A,3,4
25,N/A,N/A,N/A,1254,1279,N/A,9,4
10,N/A,N/A,N/A,1244,1254,N/A,14,3
10,N/A,N/A,N/A,1234,1244,N/A,20,3
39,N/A,N/A,N/A,1195,1234,N/A,23,6
21,N/A,N/A,N/A,1174,1195,N/A,27,4
8,N/A,N/A,N/A,1166,1174,N/A,32,3
6,N/A,N/A,N/A,1160,1166,N/A,36,1
48,N/A,N/A,N/A,1112,1160,N/A,41,6
33,N/A,N/A,N/A,1079,1112,N/A,46,5
48,N/A,N/A,N/A,1031,1079,N/A,52,5
49,N/A,N/A,N/A,982,1031,N/A,58,5
27,N/A,N/A,N/A,955,982,N/A,63,4
10,N/A,N/A,N/A,945,955,N/A,69,4
9,N/A,N/A,N/A,936,945,N/A,74,3
9,N/A,N/A,N/A,927,936,N/A,79,2
9,N/A,N/A,N/A,918,927,N/A,85,2
7,N/A,N/A,N/A,911,918,N/A,91,2
5,N/A,N/A,N/A,906,911,N/A,96,1
25,N/A,N/A,N/A,881,906,N/A,99,4
8,N/A,N/A,N/A,873,881,N/A,102,1
48,N/A,N/A,N/A,825,873,N/A,106,5
19,N/A,N/A,N/A,806,825,N/A,111,4
9,N/A,N/A,N/A,797,806,N/A,116,3
8,N/A,N/A,N/A,789,797,N/A,120,1
21,N/A,N/A,N/A,768,789,N/A,123,4
8,N/A,N/A,N/A,760,768,N/A,127,2
26,N/A,N/A,N/A,734,760,N/A,130,5
20,N/A,N/A,N/A,714,734,N/A,135,4
9,N/A,N/A,N/A,705,714,N/A,140,3
8,N/A,N/A,N/A,1468,1476,N/A,4,2
9,N/A,N/A,N/A,1459,1468,N/A,10,2
8,N/A,N/A,N/A,1451,1459,N/A,15,1
40,N/A,N/A,N/A,1411,1451,N/A,19,5
10,N/A,N/A,N/A,1401,1411,N/A,24,4
7,N/A,N/A,N/A,1394,1401,N/A,27,1
42,N/A,N/A,N/A,1352,1394,N/A,32,6
49,N/A,N/A,N/A,1303,1352,N/A,37,5
9,N/A,N/A,N/A,1294,1303,N/A,40,2
47,N/A,N/A,N/A,1247,1294,N/A,43,5
49,N/A,N/A,N/A,1198,1247,N/A,49,5
8,N/A,N/A,N/A,1190,1198,N/A,52,2
6,N/A,N/A,N/A,1184,1190,N/A,57,1
7,N/A,N/A,N/A,1177,1184,N/A,63,1
9,N/A,N/A,N/A,1168,1177,N/A,69,1
29,N/A,N/A,N/A,1139,1168,N/A,72,4
14,N/A,N/A,N/A,1125,1139,N/A,78,4
8,N/A,N/A,N/A,1117,1125,N/A,83,3
48,N/A,N/A,N/A,1069,1117,N/A,86,6
6,N/A,N/A,N/A,1063,1069,N/A,92,0
9,N/A,N/A,N/A,1054,1063,N/A,95,3
5,N/A,N/A,N/A,1049,1054,N/A,99,1
20,N/A,N/A,N/A,1029,1049,N/A,102,4
7,N/A,N/A,N/A,1022,1029,N/A,105,1
9,N/A,N/A,N/A,1013,1022,N/A,111,1
33,N/A,N/A,N/A,980,1013,N/A,116,6
9,N/A,N/A,N/A,971,980,N/A,122,0
7,N/A,N/A,N/A,964,971,N/A,125,3
45,N/A,N/A,N/A,919,964,N/A,128,6
24,N/A,N/A,N/A,895,919,N/A,132,4
28,N/A,N/A,N/A,1235,1263,N/A,3,6
40,N/A,N/A,N/A,1195,1235,N/A,8,5
11,N/A,N/A,N/A,1184,1195,N/A,11,2
42,N/A,N/A,N/A,1142,1184,N/A,15,6
7,N/A,N/A,N/A,1135,1142,N/A,21,0
24,N/A,N/A,N/A,1111,1135,N/A,25,4
11,N/A,N/A,N/A,1100,1111,N/A,30,3
5,N/A,N/A,N/A,1095,1100,N/A,34,1
40,N/A,N/A,N/A,1055,1095,N/A,39,6
26,N/A,N/A,N/A,1029,1055,N/A,43,4
21,N/A,N/A,N/A,1008,1029,N/A,49,4
10,N/A,N/A,N/A,998,1008,N/A,54,3
8,N/A,N/A,N/A,990,998,N/A,58,1
29,N/A,N/A,N/A,961,990,N/A,63,6
8,N/A,N/A,N/A,953,961,N/A,66,3
48,N/A,N/A,N/A,905,953,N/A,69,6
14,N/A,N/A,N/A,891,905,N/A,73,4
9,N/A,N/A,N/A,882,891,N/A,78,3
5,N/A,N/A,N/A,877,882,N/A,82,1
37,N/A,N/A,N/A,840,877,N/A,86,5
11,N/A,N/A,N/A,829,840,N/A,91,4
6,N/A,N/A,N/A,823,829,N/A,94,1
9,N/A,N/A,N/A,814,823,N/A,100,1
34,N/A,N/A,N/A,780,814,N/A,104,5
44,N/A,N/A,N/A,736,780,N/A,110,5
9,N/A,N/A,N/A,727,736,N/A,114,3
8,N/A,N/A,N/A,719,727,N/A,120,3
42,N/A,N/A,N/A,677,719,N/A,123,6
7,N/A,N/A,N/A,670,677,N/A,126,3
9,N/A,N/A,N/A,661,670,N/A,132,3
11,N/A,N/A,N/A,905,916,N/A,6,2
39,N/A,N/A,N/A,866,905,N/A,10,6
11,N/A,N/A,N/A,855,866,N/A,13,3
42,N/A,N/A,N/A,813,855,N/A,16,6
32,N/A,N/A,N/A,781,813,N/A,21,5
9,N/A,N/A,N/A,772,781,N/A,25,3
11,N/A,N/A,N/A,761,772,N/A,31,3
7,N/A,N/A,N/A,754,761,N/A,36,2
6,N/A,N/A,N/A,748,754,N/A,41,1
26,N/A,N/A,N/A,722,748,N/A,44,4
19,N/A,N/A,N/A,703,722,N/A,50,4
8,N/A,N/A,N/A,695,703,N/A,54,2
7,N/A,N/A,N/A,688,695,N/A,59,1
14,N/A,N/A,N/A,674,688,N/A,62,4
7,N/A,N/A,N/A,667,674,N/A,65,1
28,N/A,N/A,N/A,639,667,N/A,69,5
10,N/A,N/A,N/A,629,639,N/A,72,2
43,N/A,N/A,N/A,586,629,N/A,76,6
8,N/A,N/A,N/A,578,586,N/A,82,0
33,N/A,N/A,N/A,545,578,N/A,88,6
16,N/A,N/A,N/A,529,545,N/A,92,4
11,N/A,N/A,N/A,518,529,N/A,96,2
7,N/A,N/A,N/A,511,518,N/A,102,2
31,N/A,N/A,N/A,480,511,N/A,105,5
8,N/A,N/A,N/A,472,480,N/A,108,2
11,N/A,N/A,N/A,461,472,N/A,114,2
37,N/A,N/A,N/A,424,461,N/A,118,6
9,N/A,N/A,N/A,415,424,N/A,124,0
29,N/A,N/A,N/A,386,415,N/A,128,4
9,N/A,N/A,N/A,377,386,N/A,131,1
43,N/A,N/A,N/A,1477,1520,N/A,6,6
33,N/A,N/A,N/A,1444,1477,N/A,11,5
28,N/A,N/A,N/A,1416,1444,N/A,17,5
15,N/A,N/A,N/A,1401,1416,N/A,22,4
11,N/A,N/A,N/A,1390,1401,N/A,27,3
9,N/A,N/A,N/A,1381,1390,N/A,32,2
48,N/A,N/A,N/A,1333,1381,N/A,35,5
23,N/A,N/A,N/A,1310,1333,N/A,40,4
11,N/A,N/A,N/A,1299,1310,N/A,45,3
9,N/A,N/A,N/A,1290,1299,N/A,49,1
43,N/A,N/A,N/A,1247,1290,N/A,54,6
9,N/A,N/A,N/A,1238,1247,N/A,60,0
43,N/A,N/A,N/A,1195,1238,N/A,66,6
8,N/A,N/A,N/A,1187,1195,N/A,72,0
45,N/A,N/A,N/A,1142,1187,N/A,77,5
7,N/A,N/A,N/A,1135,1142,N/A,81,3
8,N/A,N/A,N/A,1127,1135,N/A,86,2
30,N/A,N/A,N/A,1097,1127,N/A,90,6
5,N/A,N/A,N/A,1092,1097,N/A,96,0
10,N/A,N/A,N/A,1082,1092,N/A,99,3
34,N/A,N/A,N/A,1048,1082,N/A,102,6
36,N/A,N/A,N/A,1012,1048,N/A,107,5
9,N/A,N/A,N/A,1003,1012,N/A,110,2
9,N/A,N/A,N/A,994,1003,N/A,115,1
29,N/A,N/A,N/A,965,994,N/A,118,4
15,N/A,N/A,N/A,950,965,N/A,124,4
7,N/A,N/A,N/A,943,950,N/A,127,1
42,N/A,N/A,N/A,901,943,N/A,132,6
5,N/A,N/A,N/A,896,901,N/A,138,0
10,N/A,N/A,N/A,886,896,N/A,141,3
27,N/A,N/A,N/A,1490,1517,N/A,5,5
30,N/A,N/A,N/A,1460,1490,N/A,11,5
9,N/A,N/A,N/A,1451,1460,N/A,14,2
10,N/A,N/A,N/A,1441,1451,N/A,20,2
38,N/A,N/A,N/A,1403,1441,N/A,24,6
29,N/A,N/A,N/A,1374,1403,N/A,29,5
35,N/A,N/A,N/A,1339,1374,N/A,35,5
10,N/A,N/A,N/A,1329,1339,N/A,39,3
5,N/A,N/A,N/A,1324,1329,N/A,43,1
8,N/A,N/A,N/A,1316,1324,N/A,49,1
8,N/A,N/A,N/A,1308,1316,N/A,55,1
17,N/A,N/A,N/A,1291,1308,N/A,58,4
8,N/A,N/A,N/A,1283,1291,N/A,63,3
9,N/A,N/A,N/A,1274,1283,N/A,67,1
9,N/A,N/A,N/A,1265,1274,N/A,73,1
12,N/A,N/A,N/A,1253,1265,N/A,76,4
11,N/A,N/A,N/A,1242,1253,N/A,80,2
9,N/A,N/A,N/A,1233,1242,N/A,86,2
8,N/A,N/A,N/A,1225,1233,N/A,92,2
8,N/A,N/A,N/A,1217,1225,N/A,97,1
36,N/A,N/A,N/A,1181,1217,N/A,101,5
27,N/A,N/A,N/A,1154,1181,N/A,107,5
36,N/A,N/A,N/A,1118,1154,N/A,113,5
8,N/A,N/A,N/A,1110,1118,N/A,116,2
34,N/A,N/A,N/A,1076,1110,N/A,120,6
7,N/A,N/A,N/A,1069,1076,N/A,123,3
9,N/A,N/A,N/A,1060,1069,N/A,127,1
11,N/A,N/A,N/A,1049,1060,N/A,130,4
8,N/A,N/A,N/A,1041,1049,N/A,135,3
43,N/A,N/A,N/A,998,1041,N/A,138,6
42,N/A,N/A,N/A,851,893,N/A,3,5
9,N/A,N/A,N/A,842,851,N/A,7,3
7,N/A,N/A,N/A,835,842,N/A,12,2
46,N/A,N/A,N/A,789,835,N/A,16,6
18,N/A,N/A,N/A,771,789,N/A,20,4
7,N/A,N/A,N/A,764,771,N/A,24,2
8,N/A,N/A,N/A,756,764,N/A,30,2
8,N/A,N/A,N/A,748,756,N/A,35,1
29,N/A,N/A,N/A,719,748,N/A,40,6
8,N/A,N/A,N/A,711,719,N/A,43,3
10,N/A,N/A,N/A,701,711,N/A,48,2
8,N/A,N/A,N/A,693,701,N/A,54,2
47,N/A,N/A,N/A,646,693,N/A,57,5
9,N/A,N/A,N/A,637,646,N/A,60,2
9,N/A,N/A,N/A,628,637,N/A,66,2
7,N/A,N/A,N/A,621,628,N/A,72,2
8,N/A,N/A,N/A,613,621,N/A,78,2
49,N/A,N/A,N/A,564,613,N/A,82,6
9,N/A,N/A,N/A,555,564,N/A,88,0
34,N/A,N/A,N/A,521,555,N/A,94,6
7,N/A,N/A,N/A,514,521,N/A,100,0
26,N/A,N/A,N/A,488,514,N/A,106,6
15,N/A,N/A,N/A,473,488,N/A,110,4
11,N/A,N/A,N/A,462,473,N/A,116,4
6,N/A,N/A,N/A,456,462,N/A,119,1
18,N/A,N/A,N/A,438,456,N/A,122,4
8,N/A,N/A,N/A,430,438,N/A,127,3
10,N/A,N/A,N/A,420,430,N/A,132,2
32,N/A,N/A,N/A,388,420,N/A,136,6
41,N/A,N/A,N/A,347,388,N/A,141,5
37,N/A,N/A,N/A,397,434,N/A,6,5
8,N/A,N/A,N/A,389,397,N/A,10,3
6,N/A,N/A,N/A,383,389,N/A,14,1
25,N/A,N/A,N/A,358,383,N/A,17,4
27,N/A,N/A,N/A,331,358,N/A,23,4
9,N/A,N/A,N/A,322,331,N/A,28,3
7,N/A,N/A,N/A,315,322,N/A,33,2
48,N/A,N/A,N/A,267,315,N/A,36,5
8,N/A,N/A,N/A,259,267,N/A,39,2
11,N/A,N/A,N/A,248,259,N/A,45,2
9,N/A,N/A,N/A,239,248,N/A,50,1
19,N/A,N/A,N/A,220,239,N/A,53,4
16,N/A,N/A,N/A,204,220,N/A,59,4
7,N/A,N/A,N/A,197,204,N/A,62,1
5,N/A,N/A,N/A,192,197,N/A,68,1
45,N/A,N/A,N/A,147,192,N/A,72,5
28,N/A,N/A,N/A,119,147,N/A,77,4
9,N/A,N/A,N/A,110,119,N/A,80,1
6,N/A,N/A,N/A,104,110,N/A,86,1
32,N/A,N/A,N/A,72,104,N/A,90,5
37,N/A,N/A,N/A,35,72,N/A,96,5
8,N/A,N/A,N/A,27,35,N/A,99,2
38,N/A,N/A,N/A,-11,27,N/A,103,6
8,N/A,N/A,N/A,1313,1321,N/A,3,3
9,N/A,N/A,N/A,1304,1313,N/A,9,3
9,N/A,N/A,N/A,1295,1304,N/A,14,2
8,N/A,N/A,N/A,1287,1295,N/A,20,2
30,N/A,N/A,N/A,1257,1287,N/A,24,6
9,N/A,N/A,N/A,1248,1257,N/A,30,0
33,N/A,N/A,N/A,1215,1248,N/A,36,6
6,N/A,N/A,N/A,1209,1215,N/A,42,0
48,N/A,N/A,N/A,1161,1209,N/A,47,5
36,N/A,N/A,N/A,1125,1161,N/A,53,5
8,N/A,N/A,N/A,1117,1125,N/A,57,3
10,N/A,N/A,N/A,1107,1117,N/A,62,2
36,N/A,N/A,N/A,1071,1107,N/A,66,6
45,N/A,N/A,N/A,1026,1071,N/A,71,5
49,N/A,N/A,N/A,977,1026,N/A,77,5
9,N/A,N/A,N/A,968,977,N/A,81,3
10,N/A,N/A,N/A,958,968,N/A,87,3
6,N/A,N/A,N/A,952,958,N/A,91,1
32,N/A,N/A,N/A,920,952,N/A,96,6
10,N/A,N/A,N/A,910,920,N/A,99,3
26,N/A,N/A,N/A,884,910,N/A,102,6
9,N/A,N/A,N/A,875,884,N/A,105,3
7,N/A,N/A,N/A,868,875,N/A,111,3
8,N/A,N/A,N/A,860,868,N/A,115,1
39,N/A,N/A,N/A,821,860,N/A,120,6
8,N/A,N/A,N/A,813,821,N/A,123,3
10,N/A,N/A,N/A,803,813,N/A,129,3
7,N/A,N/A,N/A,796,803,N/A,134,2
32,N/A,N/A,N/A,764,796,N/A,137,5
7,N/A,N/A,N/A,757,764,N/A,141,3
25,N/A,N/A,N/A,368,393,N/A,5,6
8,N/A,N/A,N/A,360,368,N/A,8,3
11,N/A,N/A,N/A,349,360,N/A,14,3
41,N/A,N/A,N/A,308,349,N/A,17,6
8,N/A,N/A,N/A,300,308,N/A,20,3
7,N/A,N/A,N/A,293,300,N/A,25,2
34,N/A,N/A,N/A,259,293,N/A,28,5
24,N/A,N/A,N/A,235,259,N/A,33,4
10,N/A,N/A,N/A,225,235,N/A,38,3
11,N/A,N/A,N/A,214,225,N/A,43,2
37,N/A,N/A,N/A,177,214,N/A,46,5
16,N/A,N/A,N/A,161,177,N/A,51,4
7,N/A,N/A,N/A,154,161,N/A,54,1
15,N/A,N/A,N/A,139,154,N/A,57,4
6,N/A,N/A,N/A,133,139,N/A,60,1
5,N/A,N/A,N/A,128,133,N/A,66,1
6,N/A,N/A,N/A,122,128,N/A,72,1
26,N/A,N/A,N/A,96,122,N/A,76,5
10,N/A,N/A,N/A,86,96,N/A,81,4
10,N/A,N/A,N/A,76,86,N/A,87,4
7,N/A,N/A,N/A,69,76,N/A,90,1
5,N/A,N/A,N/A,64,69,N/A,96,1
43,N/A,N/A,N/A,21,64,N/A,100,5
19,N/A,N/A,N/A,2,21,N/A,105,4
11,N/A,N/A,N/A,-9,2,N/A,110,3
9,N/A,N/A,N/A,1039,1048,N/A,4,1
37,N/A,N/A,N/A,1002,1039,N/A,9,6
38,N/A,N/A,N/A,964,1002,N/A,14,5
47,N/A,N/A,N/A,917,964,N/A,20,5
29,N/A,N/A,N/A,888,917,N/A,25,4
10,N/A,N/A,N/A,878,888,N/A,29,2
5,N/A,N/A,N/A,873,878,N/A,34,1
49,N/A,N/A,N/A,824,873,N/A,38,5
19,N/A,N/A,N/A,805,824,N/A,43,4
11,N/A,N/A,N/A,794,805,N/A,47,2
25,N/A,N/A,N/A,769,794,N/A,50,5
27,N/A,N/A,N/A,742,769,N/A,56,5
8,N/A,N/A,N/A,734,742,N/A,60,3
10,N/A,N/A,N/A,724,734,N/A,65,2
7,N/A,N/A,N/A,717,724,N/A,70,1
32,N/A,N/A,N/A,685,717,N/A,75,6
7,N/A,N/A,N/A,678,685,N/A,78,3
8,N/A,N/A,N/A,670,678,N/A,83,2
27,N/A,N/A,N/A,643,670,N/A,86,5
13,N/A,N/A,N/A,630,643,N/A,91,4
11,N/A,N/A,N/A,619,630,N/A,95,2
44,N/A,N/A,N/A,575,619,N/A,98,5
8,N/A,N/A,N/A,567,575,N/A,102,3
36,N/A,N/A,N/A,531,567,N/A,105,6
25,N/A,N/A,N/A,506,531,N/A,110,5
7,N/A,N/A,N/A,499,506,N/A,113,2
26,N/A,N/A,N/A,473,499,N/A,116,5
7,N/A,N/A,N/A,466,473,N/A,120,3
30,N/A,N/A,N/A,436,466,N/A,123,6
6,N/A,N/A,N/A,430,436,N/A,129,0
41,N/A,N/A,N/A,1949,1990,N/A,3,5
8,N/A,N/A,N/A,1941,1949,N/A,6,2
25,N/A,N/A,N/A,1916,1941,N/A,10,6
47,N/A,N/A,N/A,1869,1916,N/A,15,5
8,N/A,N/A,N/A,1861,1869,N/A,18,2
7,N/A,N/A,N/A,1854,1861,N/A,24,2
8,N/A,N/A,N/A,1846,1854,N/A,30,2
48,N/A,N/A,N/A,1798,1846,N/A,33,5
23,N/A,N/A,N/A,1775,1798,N/A,38,4
9,N/A,N/A,N/A,1766,1775,N/A,42,2
11,N/A,N/A,N/A,1755,1766,N/A,48,2
40,N/A,N/A,N/A,1715,1755,N/A,51,5
9,N/A,N/A,N/A,1706,1715,N/A,55,3
5,N/A,N/A,N/A,1701,1706,N/A,59,1
28,N/A,N/A,N/A,1673,1701,N/A,63,5
9,N/A,N/A,N/A,1664,1673,N/A,66,2
26,N/A,N/A,N/A,1638,1664,N/A,70,6
34,N/A,N/A,N/A,1604,1638,N/A,75,5
10,N/A,N/A,N/A,1594,1604,N/A,79,3
37,N/A,N/A,N/A,1557,1594,N/A,82,6
15,N/A,N/A,N/A,1542,1557,N/A,86,4
11,N/A,N/A,N/A,1531,1542,N/A,91,3
10,N/A,N/A,N/A,1521,1531,N/A,96,2
43,N/A,N/A,N/A,1478,1521,N/A,99,5
10,N/A,N/A,N/A,1468,1478,N/A,104,4
8,N/A,N/A,N/A,1460,1468,N/A,109,3
7,N/A,N/A,N/A,1453,1460,N/A,115,3
8,N/A,N/A,N/A,1445,1453,N/A,120,2
11,N/A,N/A,N/A,1434,1445,N/A,126,2
42,N/A,N/A,N/A,1392,1434,N/A,129,5
9,N/A,N/A,N/A,373,382,N/A,5,3
6,N/A,N/A,N/A,367,373,N/A,9,1
35,N/A,N/A,N/A,332,367,N/A,13,5
37,N/A,N/A,N/A,295,332,N/A,19,5
11,N/A,N/A,N/A,284,295,N/A,22,2
10,N/A,N/A,N/A,274,284,N/A,28,2
8,N/A,N/A,N/A,266,274,N/A,34,2
10,N/A,N/A,N/A,256,266,N/A,40,2
11,N/A,N/A,N/A,245,256,N/A,46,2
45,N/A,N/A,N/A,200,245,N/A,49,5
36,N/A,N/A,N/A,164,200,N/A,55,5
25,N/A,N/A,N/A,139,164,N/A,61,5
8,N/A,N/A,N/A,131,139,N/A,65,3
9,N/A,N/A,N/A,122,131,N/A,71,3
8,N/A,N/A,N/A,114,122,N/A,75,1
46,N/A,N/A,N/A,68,114,N/A,79,5
9,N/A,N/A,N/A,59,68,N/A,83,3
9,N/A,N/A,N/A,50,59,N/A,89,3
48,N/A,N/A,N/A,2,50,N/A,92,6
28,N/A,N/A,N/A,-26,2,N/A,97,5
7,N/A,N/A,N/A,575,582,N/A,6,3
8,N/A,N/A,N/A,567,575,N/A,12,3
7,N/A,N/A,N/A,560,567,N/A,16,1
47,N/A,N/A,N/A,513,560,N/A,21,6
17,N/A,N/A,N/A,496,513,N/A,25,4
7,N/A,N/A,N/A,489,496,N/A,29,2
27,N/A,N/A,N/A,462,489,N/A,32,5
10,N/A,N/A,N/A,452,462,N/A,35,2
26,N/A,N/A,N/A,426,452,N/A,39,6
35,N/A,N/A,N/A,391,426,N/A,44,5
7,N/A,N/A,N/A,384,391,N/A,47,2
44,N/A,N/A,N/A,340,384,N/A,50,5
8,N/A,N/A,N/A,332,340,N/A,53,2
7,N/A,N/A,N/A,325,332,N/A,58,1
5,N/A,N/A,N/A,320,325,N/A,64,1
42,N/A,N/A,N/A,278,320,N/A,68,5
11,N/A,N/A,N/A,267,278,N/A,71,2
43,N/A,N/A,N/A,224,267,N/A,74,5
11,N/A,N/A,N/A,213,224,N/A,78,3
7,N/A,N/A,N/A,206,213,N/A,84,3
10,N/A,N/A,N/A,196,206,N/A,89,2
35,N/A,N/A,N/A,161,196,N/A,93,6
44,N/A,N/A,N/A,117,161,N/A,98,5
10,N/A,N/A,N/A,107,117,N/A,102,3
9,N/A,N/A,N/A,98,107,N/A,107,2
38,N/A,N/A,N/A,60,98,N/A,111,6
10,N/A,N/A,N/A,50,60,N/A,114,3
10,N/A,N/A,N/A,40,50,N/A,120,3
9,N/A,N/A,N/A,31,40,N/A,125,2
26,N/A,N/A,N/A,5,31,N/A,128,5
36,N/A,N/A,N/A,1452,1488,N/A,3,6
31,N/A,N/A,N/A,1421,1452,N/A,8,5
8,N/A,N/A,N/A,1413,1421,N/A,12,3
9,N/A,N/A,N/A,1404,1413,N/A,17,2
9,N/A,N/A,N/A,1395,1404,N/A,23,2
29,N/A,N/A,N/A,1366,1395,N/A,26,5
11,N/A,N/A,N/A,1355,1366,N/A,30,3
8,N/A,N/A,N/A,1347,1355,N/A,36,3
8,N/A,N/A,N/A,1339,1347,N/A,42,3
7,N/A,N/A,N/A,1332,1339,N/A,48,3
43,N/A,N/A,N/A,1289,1332,N/A,51,6
42,N/A,N/A,N/A,1247,1289,N/A,56,5
7,N/A,N/A,N/A,1240,1247,N/A,60,3
7,N/A,N/A,N/A,1233,1240,N/A,64,1
7,N/A,N/A,N/A,1226,1233,N/A,70,1
17,N/A,N/A,N/A,1209,1226,N/A,73,4
13,N/A,N/A,N/A,1196,1209,N/A,79,4
6,N/A,N/A,N/A,1190,1196,N/A,82,1
8,N/A,N/A,N/A,1182,1190,N/A,88,1
20,N/A,N/A,N/A,1162,1182,N/A,91,4
24,N/A,N/A,N/A,1138,1162,N/A,97,4
8,N/A,N/A,N/A,1130,1138,N/A,101,2
6,N/A,N/A,N/A,1124,1130,N/A,106,1
5,N/A,N/A,N/A,1119,1124,N/A,112,1
42,N/A,N/A,N/A,1077,1119,N/A,116,5
7,N/A,N/A,N/A,1070,1077,N/A,120,3
29,N/A,N/A,N/A,1041,1070,N/A,123,6
27,N/A,N/A,N/A,1014,1041,N/A,127,4
6,N/A,N/A,N/A,1008,1014,N/A,130,1
31,N/A,N/A,N/A,977,1008,N/A,134,5
10,N/A,N/A,N/A,915,925,N/A,4,2
6,N/A,N/A,N/A,909,915,N/A,9,1
41,N/A,N/A,N/A,868,909,N/A,14,6
12,N/A,N/A,N/A,856,868,N/A,18,4
10,N/A,N/A,N/A,846,856,N/A,22,2
32,N/A,N/A,N/A,814,846,N/A,26,6
11,N/A,N/A,N/A,803,814,N/A,29,3
10,N/A,N/A,N/A,793,803,N/A,35,3
11,N/A,N/A,N/A,782,793,N/A,40,2
30,N/A,N/A,N/A,752,782,N/A,43,5
21,N/A,N/A,N/A,731,752,N/A,48,4
11,N/A,N/A,N/A,720,731,N/A,53,3
9,N/A,N/A,N/A,711,720,N/A,59,3
6,N/A,N/A,N/A,705,711,N/A,63,1
24,N/A,N/A,N/A,681,705,N/A,66,4
11,N/A,N/A,N/A,670,681,N/A,70,2
5,N/A,N/A,N/A,665,670,N/A,75,1
5,N/A,N/A,N/A,660,665,N/A,81,1
10,N/A,N/A,N/A,650,660,N/A,84,4
10,N/A,N/A,N/A,640,650,N/A,88,2
30,N/A,N/A,N/A,610,640,N/A,92,6
11,N/A,N/A,N/A,599,610,N/A,95,3
6,N/A,N/A,N/A,593,599,N/A,99,1
9,N/A,N/A,N/A,584,593,N/A,105,1
25,N/A,N/A,N/A,559,584,N/A,109,5
12,N/A,N/A,N/A,547,559,N/A,114,4
17,N/A,N/A,N/A,530,547,N/A,120,4
9,N/A,N/A,N/A,521,530,N/A,124,2
41,N/A,N/A,N/A,480,521,N/A,127,5
43,N/A,N/A,N/A,437,480,N/A,133,5
9,N/A,N/A,N/A,551,560,N/A,4,1
30,N/A,N/A,N/A,521,551,N/A,9,6
7,N/A,N/A,N/A,514,521,N/A,12,3
11,N/A,N/A,N/A,503,514,N/A,17,2
10,N/A,N/A,N/A,493,503,N/A,23,2
44,N/A,N/A,N/A,449,493,N/A,26,5
30,N/A,N/A,N/A,419,449,N/A,32,5
9,N/A,N/A,N/A,410,419,N/A,36,3
8,N/A,N/A,N/A,402,410,N/A,41,2
7,N/A,N/A,N/A,395,402,N/A,47,2
37,N/A,N/A,N/A,358,395,N/A,50,5
37,N/A,N/A,N/A,321,358,N/A,56,5
48,N/A,N/A,N/A,273,321,N/A,62,5
37,N/A,N/A,N/A,236,273,N/A,68,5
8,N/A,N/A,N/A,228,236,N/A,71,2
7,N/A,N/A,N/A,221,228,N/A,76,1
28,N/A,N/A,N/A,193,221,N/A,80,5
34,N/A,N/A,N/A,159,193,N/A,86,5
10,N/A,N/A,N/A,149,159,N/A,91,4
5,N/A,N/A,N/A,144,149,N/A,94,1
25,N/A,N/A,N/A,119,144,N/A,99,6
6,N/A,N/A,N/A,113,119,N/A,105,0
30,N/A,N/A,N/A,83,113,N/A,111,6
6,N/A,N/A,N/A,77,83,N/A,117,0
10,N/A,N/A,N/A,67,77,N/A,120,3
8,N/A,N/A,N/A,59,67,N/A,126,3
6,N/A,N/A,N/A,53,59,N/A,130,1
5,N/A,N/A,N/A,48,53,N/A,136,1
39,N/A,N/A,N/A,9,48,N/A,140,5
35,N/A,N/A,N/A,-26,9,N/A,146,5
39,N/A,N/A,N/A,1034,1073,N/A,6,6
41,N/A,N/A,N/A,993,1034,N/A,11,5
7,N/A,N/A,N/A,986,993,N/A,15,3
10,N/A,N/A,N/A,976,986,N/A,20,2
6,N/A,N/A,N/A,970,976,N/A,25,1
28,N/A,N/A,N/A,942,970,N/A,28,4
7,N/A,N/A,N/A,935,942,N/A,33,3
11,N/A,N/A,N/A,924,935,N/A,39,3
9,N/A,N/A,N/A,915,924,N/A,45,3
9,N/A,N/A,N/A,906,915,N/A,51,3
34,N/A,N/A,N/A,872,906,N/A,54,6
35,N/A,N/A,N/A,837,872,N/A,59,5
21,N/A,N/A,N/A,816,837,N/A,64,4
6,N/A,N/A,N/A,810,816,N/A,67,1
5,N/A,N/A,N/A,805,810,N/A,73,1
40,N/A,N/A,N/A,765,805,N/A,78,6
17,N/A,N/A,N/A,748,765,N/A,82,4
11,N/A,N/A,N/A,737,748,N/A,86,2
5,N/A,N/A,N/A,732,737,N/A,91,1
33,N/A,N/A,N/A,699,732,N/A,96,6
33,N/A,N/A,N/A,666,699,N/A,101,5
7,N/A,N/A,N/A,659,666,N/A,105,3
39,N/A,N/A,N/A,620,659,N/A,108,6
11,N/A,N/A,N/A,609,620,N/A,111,3
9,N/A,N/A,N/A,600,609,N/A,116,2
8,N/A,N/A,N/A,592,600,N/A,122,2
28,N/A,N/A,N/A,564,592,N/A,125,5
45,N/A,N/A,N/A,519,564,N/A,131,5
37,N/A,N/A,N/A,482,519,N/A,137,5
21,N/A,N/A,N/A,461,482,N/A,142,4
47,N/A,N/A,N/A,1313,1360,N/A,3,6
7,N/A,N/A,N/A,1306,1313,N/A,6,3
9,N/A,N/A,N/A,1297,1306,N/A,12,3
36,N/A,N/A,N/A,1261,1297,N/A,15,6
5,N/A,N/A,N/A,1256,1261,N/A,21,0
25,N/A,N/A,N/A,1231,1256,N/A,26,5
7,N/A,N/A,N/A,1224,1231,N/A,29,2
9,N/A,N/A,N/A,1215,1224,N/A,35,2
31,N/A,N/A,N/A,1184,1215,N/A,38,5
10,N/A,N/A,N/A,1174,1184,N/A,42,3
8,N/A,N/A,N/A,1166,1174,N/A,46,1
5,N/A,N/A,N/A,1161,1166,N/A,52,1
19,N/A,N/A,N/A,1142,1161,N/A,55,4
9,N/A,N/A,N/A,1133,1142,N/A,60,3
31,N/A,N/A,N/A,1102,1133,N/A,63,6
34,N/A,N/A,N/A,1068,1102,N/A,68,5
25,N/A,N/A,N/A,1043,1068,N/A,73,4
8,N/A,N/A,N/A,1035,1043,N/A,76,1
31,N/A,N/A,N/A,1004,1035,N/A,80,5
9,N/A,N/A,N/A,995,1004,N/A,83,2
5,N/A,N/A,N/A,990,995,N/A,88,1
5,N/A,N/A,N/A,985,990,N/A,94,1
8,N/A,N/A,N/A,977,985,N/A,100,1
19,N/A,N/A,N/A,958,977,N/A,103,4
22,N/A,N/A,N/A,936,958,N/A,109,4
9,N/A,N/A,N/A,927,936,N/A,112,1
48,N/A,N/A,N/A,879,927,N/A,116,5
8,N/A,N/A,N/A,871,879,N/A,119,2
7,N/A,N/A,N/A,864,871,N/A,124,1
7,N/A,N/A,N/A,857,864,N/A,130,1
25,N/A,N/A,N/A,1113,1138,N/A,4,6
5,N/A,N/A,N/A,1108,1113,N/A,10,0
7,N/A,N/A,N/A,1101,1108,N/A,13,3
36,N/A,N/A,N/A,1065,1101,N/A,16,6
26,N/A,N/A,N/A,1039,1065,N/A,21,5
11,N/A,N/A,N/A,1028,1039,N/A,25,3
5,N/A,N/A,N/A,1023,1028,N/A,29,1
42,N/A,N/A,N/A,981,1023,N/A,33,5
23,N/A,N/A,N/A,958,981,N/A,38,4
7,N/A,N/A,N/A,951,958,N/A,42,2
8,N/A,N/A,N/A,943,951,N/A,48,2
41,N/A,N/A,N/A,902,943,N/A,52,6
29,N/A,N/A,N/A,873,902,N/A,56,4
26,N/A,N/A,N/A,847,873,N/A,62,4
7,N/A,N/A,N/A,840,847,N/A,67,3
45,N/A,N/A,N/A,795,840,N/A,70,6
23,N/A,N/A,N/A,772,795,N/A,74,4
9,N/A,N/A,N/A,763,772,N/A,78,2
28,N/A,N/A,N/A,735,763,N/A,82,6
44,N/A,N/A,N/A,691,735,N/A,87,5
39,N/A,N/A,N/A,652,691,N/A,93,5
32,N/A,N/A,N/A,620,652,N/A,99,5
10,N/A,N/A,N/A,610,620,N/A,102,2
49,N/A,N/A,N/A,561,610,N/A,106,6
28,N/A,N/A,N/A,533,561,N/A,110,4
23,N/A,N/A,N/A,510,533,N/A,116,4
11,N/A,N/A,N/A,499,510,N/A,120,2
30,N/A,N/A,N/A,469,499,N/A,123,5
27,N/A,N/A,N/A,442,469,N/A,129,5
7,N/A,N/A,N/A,435,442,N/A,132,2
45,N/A,N/A,N/A,1621,1666,N/A,3,6
8,N/A,N/A,N/A,1613,1621,N/A,6,3
26,N/A,N/A,N/A,1587,1613,N/A,9,6
28,N/A,N/A,N/A,1559,1587,N/A,14,5
10,N/A,N/A,N/A,1549,1559,N/A,17,2
6,N/A,N/A,N/A,1543,1549,N/A,22,1
26,N/A,N/A,N/A,1517,1543,N/A,27,6
42,N/A,N/A,N/A,1475,1517,N/A,32,5
8,N/A,N/A,N/A,1467,1475,N/A,35,2
11,N/A,N/A,N/A,1456,1467,N/A,41,2
25,N/A,N/A,N/A,1431,1456,N/A,45,6
7,N/A,N/A,N/A,1424,1431,N/A,48,3
8,N/A,N/A,N/A,1416,1424,N/A,52,1
19,N/A,N/A,N/A,1397,1416,N/A,55,4
9,N/A,N/A,N/A,1388,1397,N/A,59,2
10,N/A,N/A,N/A,1378,1388,N/A,65,2
38,N/A,N/A,N/A,1340,1378,N/A,69,6
48,N/A,N/A,N/A,1292,1340,N/A,74,5
11,N/A,N/A,N/A,1281,1292,N/A,78,3
6,N/A,N/A,N/A,1275,1281,N/A,82,1
5,N/A,N/A,N/A,1270,1275,N/A,88,1
42,N/A,N/A,N/A,1228,1270,N/A,92,5
9,N/A,N/A,N/A,1219,1228,N/A,96,3
44,N/A,N/A,N/A,1175,1219,N/A,99,6
11,N/A,N/A,N/A,1164,1175,N/A,102,3
49,N/A,N/A,N/A,1115,1164,N/A,105,6
40,N/A,N/A,N/A,1075,1115,N/A,110,5
43,N/A,N/A,N/A,1032,1075,N/A,116,5
39,N/A,N/A,N/A,993,1032,N/A,122,5
11,N/A,N/A,N/A,982,993,N/A,126,3
5,N/A,N/A,N/A,1249,1254,N/A,3,1
5,N/A,N/A,N/A,1244,1249,N/A,9,1
7,N/A,N/A,N/A,1237,1244,N/A,15,1
18,N/A,N/A,N/A,1219,1237,N/A,18,4
11,N/A,N/A,N/A,1208,1219,N/A,22,2
9,N/A,N/A,N/A,1199,1208,N/A,28,2
5,N/A,N/A,N/A,1194,1199,N/A,33,1
43,N/A,N/A,N/A,1151,1194,N/A,37,5
24,N/A,N/A,N/A,1127,1151,N/A,42,4
7,N/A,N/A,N/A,1120,1127,N/A,45,1
23,N/A,N/A,N/A,1097,1120,N/A,48,4
26,N/A,N/A,N/A,1071,1097,N/A,54,4
8,N/A,N/A,N/A,1063,1071,N/A,59,3
8,N/A,N/A,N/A,1055,1063,N/A,65,3
35,N/A,N/A,N/A,1020,1055,N/A,68,6
19,N/A,N/A,N/A,1001,1020,N/A,72,4
15,N/A,N/A,N/A,986,1001,N/A,78,4
6,N/A,N/A,N/A,980,986,N/A,81,1
28,N/A,N/A,N/A,952,980,N/A,84,4
11,N/A,N/A,N/A,941,952,N/A,88,2
7,N/A,N/A,N/A,934,941,N/A,94,2
8,N/A,N/A,N/A,926,934,N/A,100,2
8,N/A,N/A,N/A,918,926,N/A,106,2
38,N/A,N/A,N/A,880,918,N/A,110,6
6,N/A,N/A,N/A,874,880,N/A,116,0
42,N/A,N/A,N/A,832,874,N/A,121,5
10,N/A,N/A,N/A,822,832,N/A,124,2
10,N/A,N/A,N/A,812,822,N/A,130,2
7,N/A,N/A,N/A,805,812,N/A,135,1
12,N/A,N/A,N/A,793,805,N/A,138,4
45,N/A,N/A,N/A,1850,1895,N/A,6,5
18,N/A,N/A,N/A,1832,1850,N/A,11,4
18,N/A,N/A,N/A,1814,1832,N/A,17,4
10,N/A,N/A,N/A,1804,1814,N/A,23,4
11,N/A,N/A,N/A,1793,1804,N/A,28,3
5,N/A,N/A,N/A,1788,1793,N/A,32,1
44,N/A,N/A,N/A,1744,1788,N/A,37,6
49,N/A,N/A,N/A,1695,1744,N/A,42,5
23,N/A,N/A,N/A,1672,1695,N/A,47,4
11,N/A,N/A,N/A,1661,1672,N/A,52,3
11,N/A,N/A,N/A,1650,1661,N/A,58,3
9,N/A,N/A,N/A,1641,1650,N/A,63,2
11,N/A,N/A,N/A,1630,1641,N/A,69,2
35,N/A,N/A,N/A,1595,1630,N/A,73,6
40,N/A,N/A,N/A,1555,1595,N/A,78,5
42,N/A,N/A,N/A,1513,1555,N/A,84,5
7,N/A,N/A,N/A,1506,1513,N/A,88,3
9,N/A,N/A,N/A,1497,1506,N/A,94,3
9,N/A,N/A,N/A,1488,1497,N/A,100,3
8,N/A,N/A,N/A,1480,1488,N/A,104,1
43,N/A,N/A,N/A,1437,1480,N/A,108,5
44,N/A,N/A,N/A,1393,1437,N/A,114,5
13,N/A,N/A,N/A,1380,1393,N/A,119,4
8,N/A,N/A,N/A,1372,1380,N/A,123,2
48,N/A,N/A,N/A,1324,1372,N/A,127,6
47,N/A,N/A,N/A,1277,1324,N/A,132,5
10,N/A,N/A,N/A,1267,1277,N/A,136,3
7,N/A,N/A,N/A,1260,1267,N/A,142,3
7,N/A,N/A,N/A,1253,1260,N/A,148,3
8,N/A,N/A,N/A,1245,1253,N/A,154,3
14,N/A,N/A,N/A,1568,1582,N/A,3,4
8,N/A,N/A,N/A,1560,1568,N/A,7,2
9,N/A,N/A,N/A,1551,1560,N/A,13,2
11,N/A,N/A,N/A,1540,1551,N/A,19,2
8,N/A,N/A,N/A,1532,1540,N/A,25,2
8,N/A,N/A,N/A,1524,1532,N/A,30,1
36,N/A,N/A,N/A,1488,1524,N/A,34,5
16,N/A,N/A,N/A,1472,1488,N/A,39,4
9,N/A,N/A,N/A,1463,1472,N/A,43,2
7,N/A,N/A,N/A,1456,1463,N/A,48,1
26,N/A,N/A,N/A,1430,1456,N/A,53,6
27,N/A,N/A,N/A,1403,1430,N/A,57,4
8,N/A,N/A,N/A,1395,1403,N/A,60,1
19,N/A,N/A,N/A,1376,1395,N/A,63,4
11,N/A,N/A,N/A,1365,1376,N/A,67,2
39,N/A,N/A,N/A,1326,1365,N/A,70,5
35,N/A,N/A,N/A,1291,1326,N/A,76,5
10,N/A,N/A,N/A,1281,1291,N/A,79,2
37,N/A,N/A,N/A,1244,1281,N/A,82,5
8,N/A,N/A,N/A,1236,1244,N/A,86,3
9,N/A,N/A,N/A,1227,1236,N/A,92,3
9,N/A,N/A,N/A,1218,1227,N/A,97,2
34,N/A,N/A,N/A,1184,1218,N/A,100,5
20,N/A,N/A,N/A,1164,1184,N/A,105,4
9,N/A,N/A,N/A,1155,1164,N/A,109,2
36,N/A,N/A,N/A,1119,1155,N/A,112,5
15,N/A,N/A,N/A,1104,1119,N/A,117,4
9,N/A,N/A,N/A,1095,1104,N/A,121,2
36,N/A,N/A,N/A,1059,1095,N/A,125,6
13,N/A,N/A,N/A,1046,1059,N/A,129,4
8,N/A,N/A,N/A,413,421,N/A,3,1
14,N/A,N/A,N/A,399,413,N/A,6,4
13,N/A,N/A,N/A,386,399,N/A,12,4
7,N/A,N/A,N/A,379,386,N/A,17,3
11,N/A,N/A,N/A,368,379,N/A,22,2
27,N/A,N/A,N/A,341,368,N/A,25,5
41,N/A,N/A,N/A,300,341,N/A,31,5
16,N/A,N/A,N/A,284,300,N/A,36,4
8,N/A,N/A,N/A,276,284,N/A,41,3
34,N/A,N/A,N/A,242,276,N/A,44,6
37,N/A,N/A,N/A,205,242,N/A,49,5
7,N/A,N/A,N/A,198,205,N/A,53,3
8,N/A,N/A,N/A,190,198,N/A,57,1
12,N/A,N/A,N/A,178,190,N/A,60,4
25,N/A,N/A,N/A,153,178,N/A,66,4
9,N/A,N/A,N/A,144,153,N/A,69,1
27,N/A,N/A,N/A,117,144,N/A,72,4
7,N/A,N/A,N/A,110,117,N/A,76,2
9,N/A,N/A,N/A,101,110,N/A,81,1
6,N/A,N/A,N/A,95,101,N/A,87,1
26,N/A,N/A,N/A,69,95,N/A,90,4
21,N/A,N/A,N/A,48,69,N/A,96,4
7,N/A,N/A,N/A,41,48,N/A,101,3
43,N/A,N/A,N/A,-2,41,N/A,104,6
9,N/A,N/A,N/A,1744,1753,N/A,3,2
45,N/A,N/A,N/A,1699,1744,N/A,7,6
39,N/A,N/A,N/A,1660,1699,N/A,12,5
11,N/A,N/A,N/A,1649,1660,N/A,16,3
47,N/A,N/A,N/A,1602,1649,N/A,19,6
6,N/A,N/A,N/A,1596,1602,N/A,25,0
9,N/A,N/A,N/A,1587,1596,N/A,28,3
47,N/A,N/A,N/A,1540,1587,N/A,31,6
12,N/A,N/A,N/A,1528,1540,N/A,35,4
25,N/A,N/A,N/A,1503,1528,N/A,41,4
8,N/A,N/A,N/A,1495,1503,N/A,45,2
39,N/A,N/A,N/A,1456,1495,N/A,49,6
15,N/A,N/A,N/A,1441,1456,N/A,53,4
12,N/A,N/A,N/A,1429,1441,N/A,59,4
11,N/A,N/A,N/A,1418,1429,N/A,64,3
8,N/A,N/A,N/A,1410,1418,N/A,70,3
8,N/A,N/A,N/A,1402,1410,N/A,75,2
11,N/A,N/A,N/A,1391,1402,N/A,81,2
9,N/A,N/A,N/A,1382,1391,N/A,87,2
29,N/A,N/A,N/A,1353,1382,N/A,91,6
7,N/A,N/A,N/A,1346,1353,N/A,94,3
40,N/A,N/A,N/A,1306,1346,N/A,97,6
43,N/A,N/A,N/A,1263,1306,N/A,102,5
43,N/A,N/A,N/A,1220,1263,N/A,108,5
18,N/A,N/A,N/A,1202,1220,N/A,113,4
5,N/A,N/A,N/A,1197,1202,N/A,116,1
45,N/A,N/A,N/A,1152,1197,N/A,121,6
23,N/A,N/A,N/A,1129,1152,N/A,125,4
8,N/A,N/A,N/A,1121,1129,N/A,129,2
29,N/A,N/A,N/A,1092,1121,N/A,133,6
