amount,category,date,name,newBalance,previousBalance,reference,timeDiff,dayOfWeek
1675,N/A,N/A,N/A,-1112,563,N/A,102,1
1694,N/A,N/A,N/A,-554,1140,N/A,117,3
1603,N/A,N/A,N/A,-1291,312,N/A,118,3
1645,N/A,N/A,N/A,-1247,398,N/A,114,4
1601,N/A,N/A,N/A,-144,1457,N/A,116,1
1704,N/A,N/A,N/A,259,1963,N/A,129,3
1646,N/A,N/A,N/A,-1387,259,N/A,257,5
1745,N/A,N/A,N/A,-37,1708,N/A,110,4
1713,N/A,N/A,N/A,-1071,642,N/A,128,0
1661,N/A,N/A,N/A,-623,1038,N/A,128,0
1682,N/A,N/A,N/A,-436,1246,N/A,113,4
1649,N/A,N/A,N/A,-262,1387,N/A,121,5
1676,N/A,N/A,N/A,-906,770,N/A,102,1
1633,N/A,N/A,N/A,-351,1282,N/A,121,5
1637,N/A,N/A,N/A,-48,1589,N/A,125,1
1672,N/A,N/A,N/A,190,1862,N/A,112,2
1675,N/A,N/A,N/A,-1485,190,N/A,234,4
1729,N/A,N/A,N/A,-1217,512,N/A,110,2
1697,N/A,N/A,N/A,-1144,553,N/A,105,4
1640,N/A,N/A,N/A,135,1775,N/A,117,0
1688,N/A,N/A,N/A,-1553,135,N/A,246,3
1623,N/A,N/A,N/A,-99,1524,N/A,106,0
1720,N/A,N/A,N/A,-581,1139,N/A,112,1
1739,N/A,N/A,N/A,-1323,416,N/A,117,1
1625,N/A,N/A,N/A,-224,1401,N/A,122,5
1711,N/A,N/A,N/A,-670,1041,N/A,115,2
1713,N/A,N/A,N/A,-1020,693,N/A,108,1
1741,N/A,N/A,N/A,-870,871,N/A,127,5
1725,N/A,N/A,N/A,-379,1346,N/A,119,1
1697,N/A,N/A,N/A,-941,756,N/A,115,3
1684,N/A,N/A,N/A,-52,1632,N/A,105,2
1635,N/A,N/A,N/A,-1119,516,N/A,117,3
1693,N/A,N/A,N/A,-215,1478,N/A,107,3
1742,N/A,N/A,N/A,-1020,722,N/A,113,4
1622,N/A,N/A,N/A,-514,1108,N/A,106,0
1636,N/A,N/A,N/A,-270,1366,N/A,124,4
1623,N/A,N/A,N/A,-281,1342,N/A,124,1
1700,N/A,N/A,N/A,-1275,425,N/A,118,2
1638,N/A,N/A,N/A,-842,796,N/A,122,4
1649,N/A,N/A,N/A,63,1712,N/A,117,5
1624,N/A,N/A,N/A,-1561,63,N/A,219,5
1631,N/A,N/A,N/A,249,1880,N/A,127,0
1613,N/A,N/A,N/A,-1364,249,N/A,244,3
1651,N/A,N/A,N/A,-329,1322,N/A,111,5
1690,N/A,N/A,N/A,-372,1318,N/A,125,5
1605,N/A,N/A,N/A,63,1668,N/A,111,4
1654,N/A,N/A,N/A,-1591,63,N/A,235,2
1720,N/A,N/A,N/A,114,1834,N/A,107,5
1640,N/A,N/A,N/A,-1526,114,N/A,207,3
1658,N/A,N/A,N/A,-982,676,N/A,128,1
1639,N/A,N/A,N/A,-1242,397,N/A,113,4
1739,N/A,N/A,N/A,-1349,390,N/A,117,1
1655,N/A,N/A,N/A,-697,958,N/A,127,0
1603,N/A,N/A,N/A,-369,1234,N/A,113,1
1669,N/A,N/A,N/A,-611,1058,N/A,125,1
1681,N/A,N/A,N/A,192,1873,N/A,109,0
1677,N/A,N/A,N/A,-1485,192,N/A,222,5
1647,N/A,N/A,N/A,-1026,621,N/A,120,5
1683,N/A,N/A,N/A,287,1970,N/A,104,3
1616,N/A,N/A,N/A,-1329,287,N/A,229,2
1698,N/A,N/A,N/A,-702,996,N/A,123,3
1662,N/A,N/A,N/A,-1123,539,N/A,110,5
1727,N/A,N/A,N/A,-389,1338,N/A,107,1
1734,N/A,N/A,N/A,-1332,402,N/A,101,4
1693,N/A,N/A,N/A,-1391,302,N/A,120,3
1668,N/A,N/A,N/A,19,1687,N/A,116,5
1616,N/A,N/A,N/A,-1597,19,N/A,242,5
1611,N/A,N/A,N/A,-686,925,N/A,125,4
1687,N/A,N/A,N/A,-438,1249,N/A,127,2
1624,N/A,N/A,N/A,-301,1323,N/A,126,4
1665,N/A,N/A,N/A,-401,1264,N/A,106,3
1682,N/A,N/A,N/A,-1116,566,N/A,115,2
1736,N/A,N/A,N/A,91,1827,N/A,124,2
1729,N/A,N/A,N/A,-1638,91,N/A,240,4
1728,N/A,N/A,N/A,-431,1297,N/A,126,2
1661,N/A,N/A,N/A,-386,1275,N/A,101,2
1711,N/A,N/A,N/A,-608,1103,N/A,125,5
1608,N/A,N/A,N/A,-947,661,N/A,120,0
1728,N/A,N/A,N/A,-399,1329,N/A,100,0
1692,N/A,N/A,N/A,-719,973,N/A,126,1
1720,N/A,N/A,N/A,-1333,387,N/A,122,4
1662,N/A,N/A,N/A,-75,1587,N/A,122,2
1631,N/A,N/A,N/A,159,1790,N/A,105,1
1697,N/A,N/A,N/A,-1538,159,N/A,233,3
1731,N/A,N/A,N/A,-1235,496,N/A,104,3
1636,N/A,N/A,N/A,-545,1091,N/A,111,1
1730,N/A,N/A,N/A,144,1874,N/A,100,0
1722,N/A,N/A,N/A,-1578,144,N/A,207,5
1748,N/A,N/A,N/A,78,1826,N/A,102,2
1714,N/A,N/A,N/A,-1636,78,N/A,211,3
1607,N/A,N/A,N/A,256,1863,N/A,107,5
1711,N/A,N/A,N/A,-1455,256,N/A,226,4
1625,N/A,N/A,N/A,128,1753,N/A,107,5
1618,N/A,N/A,N/A,-1490,128,N/A,228,0
1627,N/A,N/A,N/A,-601,1026,N/A,101,3
1649,N/A,N/A,N/A,82,1731,N/A,119,2
1729,N/A,N/A,N/A,-1647,82,N/A,229,4
1601,N/A,N/A,N/A,-652,949,N/A,109,1
1641,N/A,N/A,N/A,-1102,539,N/A,103,4
1666,N/A,N/A,N/A,-1152,514,N/A,112,1
1707,N/A,N/A,N/A,144,1851,N/A,114,1
1652,N/A,N/A,N/A,-1508,144,N/A,228,1
1637,N/A,N/A,N/A,284,1921,N/A,121,1
1684,N/A,N/A,N/A,-1400,284,N/A,226,4
1729,N/A,N/A,N/A,-1054,675,N/A,100,0
1687,N/A,N/A,N/A,-913,774,N/A,114,2
1676,N/A,N/A,N/A,159,1835,N/A,115,4
1749,N/A,N/A,N/A,-1590,159,N/A,225,0
1636,N/A,N/A,N/A,316,1952,N/A,105,2
1650,N/A,N/A,N/A,-1334,316,N/A,217,0
1698,N/A,N/A,N/A,-1061,637,N/A,128,3
1701,N/A,N/A,N/A,-187,1514,N/A,119,3
1669,N/A,N/A,N/A,-220,1449,N/A,113,5
1623,N/A,N/A,N/A,-594,1029,N/A,112,3
1712,N/A,N/A,N/A,155,1867,N/A,108,1
1638,N/A,N/A,N/A,-1483,155,N/A,218,3
1739,N/A,N/A,N/A,-152,1587,N/A,110,3
1731,N/A,N/A,N/A,-834,897,N/A,128,2
1738,N/A,N/A,N/A,66,1804,N/A,125,0
1653,N/A,N/A,N/A,-1587,66,N/A,233,0
1656,N/A,N/A,N/A,-338,1318,N/A,109,1
1628,N/A,N/A,N/A,-539,1089,N/A,128,2
1615,N/A,N/A,N/A,-1078,537,N/A,125,1
1680,N/A,N/A,N/A,197,1877,N/A,109,0
1713,N/A,N/A,N/A,-1516,197,N/A,209,4
1623,N/A,N/A,N/A,-35,1588,N/A,124,1
1709,N/A,N/A,N/A,-894,815,N/A,120,3
1680,N/A,N/A,N/A,-574,1106,N/A,118,4
1726,N/A,N/A,N/A,-1209,517,N/A,117,3
1644,N/A,N/A,N/A,324,1968,N/A,105,3
1742,N/A,N/A,N/A,-1418,324,N/A,227,5
1603,N/A,N/A,N/A,326,1929,N/A,108,3
1604,N/A,N/A,N/A,-1278,326,N/A,213,0
1650,N/A,N/A,N/A,-318,1332,N/A,111,3
1715,N/A,N/A,N/A,-1126,589,N/A,107,3
1705,N/A,N/A,N/A,-235,1470,N/A,100,4
1712,N/A,N/A,N/A,-1116,596,N/A,112,2
1711,N/A,N/A,N/A,-800,911,N/A,117,5
1604,N/A,N/A,N/A,-1083,521,N/A,119,2
1720,N/A,N/A,N/A,-578,1142,N/A,100,1
1746,N/A,N/A,N/A,-1332,414,N/A,106,3
1691,N/A,N/A,N/A,-259,1432,N/A,110,3
1665,N/A,N/A,N/A,-968,697,N/A,100,2
1640,N/A,N/A,N/A,-40,1600,N/A,124,1
1615,N/A,N/A,N/A,227,1842,N/A,129,5
1725,N/A,N/A,N/A,-1498,227,N/A,233,1
1739,N/A,N/A,N/A,-824,915,N/A,119,4
1666,N/A,N/A,N/A,-1032,634,N/A,116,5
1656,N/A,N/A,N/A,-1339,317,N/A,125,1
1669,N/A,N/A,N/A,-689,980,N/A,103,1
1631,N/A,N/A,N/A,363,1994,N/A,111,3
1656,N/A,N/A,N/A,-1293,363,N/A,224,2
1640,N/A,N/A,N/A,19,1659,N/A,114,2
1608,N/A,N/A,N/A,-1589,19,N/A,235,3
1728,N/A,N/A,N/A,-505,1223,N/A,122,5
1663,N/A,N/A,N/A,-872,791,N/A,121,3
1746,N/A,N/A,N/A,-319,1427,N/A,101,5
1664,N/A,N/A,N/A,-22,1642,N/A,109,3
1746,N/A,N/A,N/A,-251,1495,N/A,108,5
1608,N/A,N/A,N/A,-548,1060,N/A,112,0
1738,N/A,N/A,N/A,-800,938,N/A,128,2
1723,N/A,N/A,N/A,-47,1676,N/A,122,3
1635,N/A,N/A,N/A,317,1952,N/A,129,1
1637,N/A,N/A,N/A,-1320,317,N/A,232,2
1661,N/A,N/A,N/A,-700,961,N/A,107,3
1628,N/A,N/A,N/A,-278,1350,N/A,100,1
1622,N/A,N/A,N/A,196,1818,N/A,129,5
1651,N/A,N/A,N/A,-1455,196,N/A,255,5
1628,N/A,N/A,N/A,-1035,593,N/A,105,3
1627,N/A,N/A,N/A,-684,943,N/A,103,4
1665,N/A,N/A,N/A,-1075,590,N/A,129,2
1680,N/A,N/A,N/A,-59,1621,N/A,122,1
1601,N/A,N/A,N/A,-674,927,N/A,126,5
1744,N/A,N/A,N/A,-1304,440,N/A,129,2
1695,N/A,N/A,N/A,-928,767,N/A,114,1
1617,N/A,N/A,N/A,-273,1344,N/A,117,3
1702,N/A,N/A,N/A,-262,1440,N/A,105,0
1736,N/A,N/A,N/A,-130,1606,N/A,108,1
1731,N/A,N/A,N/A,-99,1632,N/A,107,4
1619,N/A,N/A,N/A,-870,749,N/A,111,2
1612,N/A,N/A,N/A,-394,1218,N/A,101,3
1604,N/A,N/A,N/A,190,1794,N/A,102,5
1663,N/A,N/A,N/A,-1473,190,N/A,219,2
1734,N/A,N/A,N/A,-36,1698,N/A,129,0
1694,N/A,N/A,N/A,275,1969,N/A,105,0
1698,N/A,N/A,N/A,-1423,275,N/A,208,1
1601,N/A,N/A,N/A,-874,727,N/A,114,5
1688,N/A,N/A,N/A,153,1841,N/A,100,5
1707,N/A,N/A,N/A,-1554,153,N/A,202,5
1744,N/A,N/A,N/A,-950,794,N/A,126,2
1660,N/A,N/A,N/A,-620,1040,N/A,102,3
1614,N/A,N/A,N/A,340,1954,N/A,110,4
1635,N/A,N/A,N/A,-1295,340,N/A,228,2
1614,N/A,N/A,N/A,-203,1411,N/A,118,5
1686,N/A,N/A,N/A,-15,1671,N/A,119,4
1741,N/A,N/A,N/A,-1371,370,N/A,128,5
1710,N/A,N/A,N/A,-1189,521,N/A,107,3
1708,N/A,N/A,N/A,-318,1390,N/A,100,3
1702,N/A,N/A,N/A,-581,1121,N/A,123,2
1697,N/A,N/A,N/A,-1112,585,N/A,102,3
1716,N/A,N/A,N/A,-997,719,N/A,105,1
1704,N/A,N/A,N/A,-956,748,N/A,125,3
1685,N/A,N/A,N/A,-839,846,N/A,116,5
1726,N/A,N/A,N/A,-1194,532,N/A,101,2
1698,N/A,N/A,N/A,-750,948,N/A,129,3
1715,N/A,N/A,N/A,-137,1578,N/A,116,3
1688,N/A,N/A,N/A,168,1856,N/A,103,5
1644,N/A,N/A,N/A,-1476,168,N/A,207,1
1670,N/A,N/A,N/A,-997,673,N/A,104,4
1693,N/A,N/A,N/A,-852,841,N/A,117,2
1724,N/A,N/A,N/A,-614,1110,N/A,117,5
1747,N/A,N/A,N/A,116,1863,N/A,110,0
1611,N/A,N/A,N/A,-1495,116,N/A,238,2
1747,N/A,N/A,N/A,-1099,648,N/A,121,0
1666,N/A,N/A,N/A,-1049,617,N/A,122,3
1661,N/A,N/A,N/A,81,1742,N/A,105,5
1748,N/A,N/A,N/A,-1667,81,N/A,212,4
1611,N/A,N/A,N/A,-612,999,N/A,102,0
1701,N/A,N/A,N/A,-1338,363,N/A,101,2
1698,N/A,N/A,N/A,297,1995,N/A,114,2
1699,N/A,N/A,N/A,-1402,297,N/A,220,0
1625,N/A,N/A,N/A,187,1812,N/A,124,0
1700,N/A,N/A,N/A,-1513,187,N/A,232,0
1603,N/A,N/A,N/A,275,1878,N/A,123,4
1624,N/A,N/A,N/A,-1349,275,N/A,228,1
1739,N/A,N/A,N/A,-302,1437,N/A,119,4
1635,N/A,N/A,N/A,-635,1000,N/A,122,3
1619,N/A,N/A,N/A,71,1690,N/A,121,0
1683,N/A,N/A,N/A,-1612,71,N/A,227,4
1699,N/A,N/A,N/A,-1399,300,N/A,107,4
1618,N/A,N/A,N/A,-110,1508,N/A,114,4
1629,N/A,N/A,N/A,-695,934,N/A,124,4
1627,N/A,N/A,N/A,-482,1145,N/A,127,2
1641,N/A,N/A,N/A,-1150,491,N/A,103,2
1675,N/A,N/A,N/A,202,1877,N/A,105,3
1652,N/A,N/A,N/A,-1450,202,N/A,232,4
1656,N/A,N/A,N/A,-508,1148,N/A,125,0
1661,N/A,N/A,N/A,68,1729,N/A,123,2
1696,N/A,N/A,N/A,-1628,68,N/A,244,3
1638,N/A,N/A,N/A,-26,1612,N/A,126,3
1690,N/A,N/A,N/A,167,1857,N/A,113,1
1725,N/A,N/A,N/A,-1558,167,N/A,232,0
1613,N/A,N/A,N/A,-355,1258,N/A,120,5
1747,N/A,N/A,N/A,-661,1086,N/A,127,3
1731,N/A,N/A,N/A,-1023,708,N/A,115,2
1649,N/A,N/A,N/A,313,1962,N/A,100,0
1748,N/A,N/A,N/A,-1435,313,N/A,223,3
1615,N/A,N/A,N/A,-1265,350,N/A,114,3
1647,N/A,N/A,N/A,-964,683,N/A,115,2
1639,N/A,N/A,N/A,-226,1413,N/A,129,4
1702,N/A,N/A,N/A,116,1818,N/A,109,4
1674,N/A,N/A,N/A,-1558,116,N/A,222,3
1714,N/A,N/A,N/A,-721,993,N/A,117,2
1637,N/A,N/A,N/A,-1289,348,N/A,117,1
1718,N/A,N/A,N/A,95,1813,N/A,114,1
1627,N/A,N/A,N/A,-1532,95,N/A,221,0
1614,N/A,N/A,N/A,383,1997,N/A,104,2
1600,N/A,N/A,N/A,-1217,383,N/A,217,1
1691,N/A,N/A,N/A,-1178,513,N/A,101,3
1677,N/A,N/A,N/A,-1199,478,N/A,117,1
1656,N/A,N/A,N/A,-318,1338,N/A,105,1
1749,N/A,N/A,N/A,-1107,642,N/A,115,0
1738,N/A,N/A,N/A,-67,1671,N/A,104,0
1732,N/A,N/A,N/A,-1091,641,N/A,113,1
1717,N/A,N/A,N/A,-296,1421,N/A,109,0
1690,N/A,N/A,N/A,17,1707,N/A,114,1
1626,N/A,N/A,N/A,-1609,17,N/A,229,2
1720,N/A,N/A,N/A,-174,1546,N/A,103,1
1641,N/A,N/A,N/A,-477,1164,N/A,108,0
1606,N/A,N/A,N/A,-462,1144,N/A,121,2
1679,N/A,N/A,N/A,-1200,479,N/A,123,2
1672,N/A,N/A,N/A,-1313,359,N/A,125,1
1616,N/A,N/A,N/A,-420,1196,N/A,109,4
1728,N/A,N/A,N/A,-1426,302,N/A,124,1
1658,N/A,N/A,N/A,-845,813,N/A,122,2
1604,N/A,N/A,N/A,-913,691,N/A,106,5
1618,N/A,N/A,N/A,-611,1007,N/A,121,5
1698,N/A,N/A,N/A,-1267,431,N/A,105,5
1648,N/A,N/A,N/A,-239,1409,N/A,116,4
1632,N/A,N/A,N/A,161,1793,N/A,129,2
1630,N/A,N/A,N/A,-1469,161,N/A,247,0
1660,N/A,N/A,N/A,-21,1639,N/A,111,2
1650,N/A,N/A,N/A,174,1824,N/A,111,2
1724,N/A,N/A,N/A,-1550,174,N/A,224,1
1725,N/A,N/A,N/A,-110,1615,N/A,102,5
1735,N/A,N/A,N/A,-517,1218,N/A,110,4
1695,N/A,N/A,N/A,-285,1410,N/A,107,1
1634,N/A,N/A,N/A,-280,1354,N/A,113,2
1627,N/A,N/A,N/A,-362,1265,N/A,128,5
1609,N/A,N/A,N/A,-669,940,N/A,112,2
1710,N/A,N/A,N/A,-453,1257,N/A,102,3
1639,N/A,N/A,N/A,24,1663,N/A,121,0
1740,N/A,N/A,N/A,-1716,24,N/A,244,3
1659,N/A,N/A,N/A,77,1736,N/A,120,0
1672,N/A,N/A,N/A,-1595,77,N/A,226,4
1651,N/A,N/A,N/A,-485,1166,N/A,100,4
1621,N/A,N/A,N/A,-1208,413,N/A,102,0
1718,N/A,N/A,N/A,-621,1097,N/A,115,5
1638,N/A,N/A,N/A,-244,1394,N/A,100,4
1720,N/A,N/A,N/A,-821,899,N/A,103,2
1667,N/A,N/A,N/A,-1118,549,N/A,111,4
1628,N/A,N/A,N/A,-618,1010,N/A,104,4
1729,N/A,N/A,N/A,-385,1344,N/A,124,5
1600,N/A,N/A,N/A,252,1852,N/A,119,0
1610,N/A,N/A,N/A,-1358,252,N/A,226,5
1625,N/A,N/A,N/A,258,1883,N/A,109,1
1640,N/A,N/A,N/A,-1382,258,N/A,213,3
1738,N/A,N/A,N/A,-1209,529,N/A,112,5
1682,N/A,N/A,N/A,-648,1034,N/A,124,1
1649,N/A,N/A,N/A,-829,820,N/A,107,1
1654,N/A,N/A,N/A,-123,1531,N/A,112,5
1678,N/A,N/A,N/A,123,1801,N/A,126,5
1627,N/A,N/A,N/A,-1504,123,N/A,229,0
1685,N/A,N/A,N/A,-698,987,N/A,111,1
1653,N/A,N/A,N/A,-1336,317,N/A,106,4
1670,N/A,N/A,N/A,-1153,517,N/A,119,2
1631,N/A,N/A,N/A,-352,1279,N/A,121,5
1701,N/A,N/A,N/A,-988,713,N/A,102,3
1704,N/A,N/A,N/A,-630,1074,N/A,127,5
1661,N/A,N/A,N/A,-892,769,N/A,102,3
1616,N/A,N/A,N/A,-271,1345,N/A,105,1
1739,N/A,N/A,N/A,-521,1218,N/A,126,3
1649,N/A,N/A,N/A,-602,1047,N/A,101,2
1696,N/A,N/A,N/A,-189,1507,N/A,122,4
1703,N/A,N/A,N/A,-127,1576,N/A,108,2
1740,N/A,N/A,N/A,148,1888,N/A,106,1
1726,N/A,N/A,N/A,-1578,148,N/A,230,5
1706,N/A,N/A,N/A,215,1921,N/A,111,3
1686,N/A,N/A,N/A,-1471,215,N/A,214,4
1651,N/A,N/A,N/A,141,1792,N/A,108,0
1647,N/A,N/A,N/A,-1506,141,N/A,231,3
1740,N/A,N/A,N/A,-1101,639,N/A,127,3
1680,N/A,N/A,N/A,135,1815,N/A,126,1
1607,N/A,N/A,N/A,-1472,135,N/A,234,1
1728,N/A,N/A,N/A,-689,1039,N/A,103,3
1726,N/A,N/A,N/A,-1038,688,N/A,119,3
1695,N/A,N/A,N/A,-168,1527,N/A,102,0
1667,N/A,N/A,N/A,-1079,588,N/A,127,3
1689,N/A,N/A,N/A,-23,1666,N/A,120,3
1607,N/A,N/A,N/A,-1102,505,N/A,118,0
1697,N/A,N/A,N/A,-1003,694,N/A,113,1
1638,N/A,N/A,N/A,-138,1500,N/A,113,0
1715,N/A,N/A,N/A,-248,1467,N/A,112,5
1637,N/A,N/A,N/A,-106,1531,N/A,121,2
1644,N/A,N/A,N/A,-168,1476,N/A,123,1
1637,N/A,N/A,N/A,-426,1211,N/A,113,4
1682,N/A,N/A,N/A,-730,952,N/A,118,5
1609,N/A,N/A,N/A,-129,1480,N/A,128,5
1676,N/A,N/A,N/A,204,1880,N/A,121,3
1735,N/A,N/A,N/A,-1531,204,N/A,227,1
1666,N/A,N/A,N/A,-200,1466,N/A,102,1
1711,N/A,N/A,N/A,-500,1211,N/A,118,3
1706,N/A,N/A,N/A,-1366,340,N/A,111,4
1627,N/A,N/A,N/A,-424,1203,N/A,105,0
1728,N/A,N/A,N/A,-438,1290,N/A,126,4
1744,N/A,N/A,N/A,-711,1033,N/A,107,5
1625,N/A,N/A,N/A,-568,1057,N/A,104,5
1705,N/A,N/A,N/A,-1241,464,N/A,100,5
1609,N/A,N/A,N/A,-83,1526,N/A,114,1
1608,N/A,N/A,N/A,-876,732,N/A,104,2
1628,N/A,N/A,N/A,231,1859,N/A,114,0
1656,N/A,N/A,N/A,-1425,231,N/A,236,2
1660,N/A,N/A,N/A,-549,1111,N/A,107,3
1693,N/A,N/A,N/A,-707,986,N/A,114,3
1682,N/A,N/A,N/A,-926,756,N/A,122,2
1641,N/A,N/A,N/A,-894,747,N/A,115,4
1705,N/A,N/A,N/A,-647,1058,N/A,118,0
1709,N/A,N/A,N/A,192,1901,N/A,109,2
1639,N/A,N/A,N/A,-1447,192,N/A,224,3
1666,N/A,N/A,N/A,167,1833,N/A,125,3
1684,N/A,N/A,N/A,-1517,167,N/A,244,2
1625,N/A,N/A,N/A,-668,957,N/A,110,3
1666,N/A,N/A,N/A,-492,1174,N/A,122,4
1749,N/A,N/A,N/A,-1409,340,N/A,112,0
1695,N/A,N/A,N/A,-1101,594,N/A,118,4
1712,N/A,N/A,N/A,268,1980,N/A,113,0
1685,N/A,N/A,N/A,-1417,268,N/A,223,2
1604,N/A,N/A,N/A,-1224,380,N/A,105,0
1668,N/A,N/A,N/A,-299,1369,N/A,124,5
1665,N/A,N/A,N/A,-234,1431,N/A,101,3
1658,N/A,N/A,N/A,-880,778,N/A,114,5
1674,N/A,N/A,N/A,-924,750,N/A,119,4
1738,N/A,N/A,N/A,230,1968,N/A,111,3
1677,N/A,N/A,N/A,-1447,230,N/A,220,4
1673,N/A,N/A,N/A,-797,876,N/A,117,4
1738,N/A,N/A,N/A,-21,1717,N/A,110,3
1653,N/A,N/A,N/A,-659,994,N/A,104,5
1710,N/A,N/A,N/A,-681,1029,N/A,112,1
1738,N/A,N/A,N/A,-601,1137,N/A,105,3
1623,N/A,N/A,N/A,342,1965,N/A,105,2
1670,N/A,N/A,N/A,-1328,342,N/A,219,2
1665,N/A,N/A,N/A,-851,814,N/A,117,1
1689,N/A,N/A,N/A,-209,1480,N/A,128,3
1633,N/A,N/A,N/A,-886,747,N/A,113,2
1725,N/A,N/A,N/A,-490,1235,N/A,111,0
1632,N/A,N/A,N/A,-501,1131,N/A,119,4
1683,N/A,N/A,N/A,-1191,492,N/A,102,0
1743,N/A,N/A,N/A,-1083,660,N/A,100,5
1732,N/A,N/A,N/A,-880,852,N/A,112,0
1626,N/A,N/A,N/A,-333,1293,N/A,127,5
1601,N/A,N/A,N/A,-671,930,N/A,128,4
1607,N/A,N/A,N/A,-192,1415,N/A,113,4
1620,N/A,N/A,N/A,-3,1617,N/A,111,4
1611,N/A,N/A,N/A,-1305,306,N/A,108,2
1615,N/A,N/A,N/A,253,1868,N/A,124,4
1705,N/A,N/A,N/A,-1452,253,N/A,228,0
1646,N/A,N/A,N/A,-911,735,N/A,109,5
1729,N/A,N/A,N/A,-1350,379,N/A,103,2
1728,N/A,N/A,N/A,-711,1017,N/A,127,5
1708,N/A,N/A,N/A,-208,1500,N/A,115,3
1672,N/A,N/A,N/A,-633,1039,N/A,123,1
1637,N/A,N/A,N/A,-794,843,N/A,118,1
1660,N/A,N/A,N/A,261,1921,N/A,129,3
1675,N/A,N/A,N/A,-1414,261,N/A,242,2
1661,N/A,N/A,N/A,-1003,658,N/A,108,3
1704,N/A,N/A,N/A,-1355,349,N/A,121,4
1605,N/A,N/A,N/A,-1279,326,N/A,107,0
1616,N/A,N/A,N/A,238,1854,N/A,109,3
1628,N/A,N/A,N/A,-1390,238,N/A,226,0
1739,N/A,N/A,N/A,-1142,597,N/A,115,0
1629,N/A,N/A,N/A,205,1834,N/A,109,0
1634,N/A,N/A,N/A,-1429,205,N/A,226,3
1709,N/A,N/A,N/A,-274,1435,N/A,129,5
1664,N/A,N/A,N/A,-414,1250,N/A,113,3
1708,N/A,N/A,N/A,-984,724,N/A,106,0
1672,N/A,N/A,N/A,-1060,612,N/A,127,3
1675,N/A,N/A,N/A,-677,998,N/A,120,0
1675,N/A,N/A,N/A,-9,1666,N/A,104,2
1689,N/A,N/A,N/A,-370,1319,N/A,117,3
1708,N/A,N/A,N/A,-397,1311,N/A,124,5
1737,N/A,N/A,N/A,-1048,689,N/A,109,4
1661,N/A,N/A,N/A,-737,924,N/A,125,2
1635,N/A,N/A,N/A,232,1867,N/A,123,1
1688,N/A,N/A,N/A,-1456,232,N/A,244,2
1738,N/A,N/A,N/A,-286,1452,N/A,110,1
1657,N/A,N/A,N/A,-10,1647,N/A,113,2
1684,N/A,N/A,N/A,-916,768,N/A,123,5
1643,N/A,N/A,N/A,-126,1517,N/A,113,1
1674,N/A,N/A,N/A,165,1839,N/A,111,4
1621,N/A,N/A,N/A,-1456,165,N/A,212,3
1657,N/A,N/A,N/A,-1285,372,N/A,108,0
1663,N/A,N/A,N/A,-1128,535,N/A,121,1
1644,N/A,N/A,N/A,-638,1006,N/A,118,4
1636,N/A,N/A,N/A,-435,1201,N/A,110,3
1646,N/A,N/A,N/A,-1129,517,N/A,124,1
1704,N/A,N/A,N/A,-1236,468,N/A,117,4
1650,N/A,N/A,N/A,-938,712,N/A,104,5
1702,N/A,N/A,N/A,-929,773,N/A,113,2
1624,N/A,N/A,N/A,-1177,447,N/A,104,0
1741,N/A,N/A,N/A,-578,1163,N/A,101,1
1724,N/A,N/A,N/A,-96,1628,N/A,114,4
1612,N/A,N/A,N/A,-77,1535,N/A,116,4
1641,N/A,N/A,N/A,-922,719,N/A,117,1
1707,N/A,N/A,N/A,-1372,335,N/A,106,5
1650,N/A,N/A,N/A,-366,1284,N/A,124,0
1616,N/A,N/A,N/A,0,1616,N/A,127,3
1681,N/A,N/A,N/A,-307,1374,N/A,128,3
1733,N/A,N/A,N/A,-366,1367,N/A,125,1
1610,N/A,N/A,N/A,-424,1186,N/A,113,5
1683,N/A,N/A,N/A,-1194,489,N/A,114,2
1610,N/A,N/A,N/A,-319,1291,N/A,127,5
1650,N/A,N/A,N/A,-832,818,N/A,103,3
1714,N/A,N/A,N/A,165,1879,N/A,126,3
1692,N/A,N/A,N/A,-1527,165,N/A,252,3
1747,N/A,N/A,N/A,-494,1253,N/A,116,1
1700,N/A,N/A,N/A,-215,1485,N/A,100,4
1669,N/A,N/A,N/A,-284,1385,N/A,113,1
1741,N/A,N/A,N/A,-314,1427,N/A,103,5
1661,N/A,N/A,N/A,-1309,352,N/A,103,5
1714,N/A,N/A,N/A,-349,1365,N/A,114,4
1640,N/A,N/A,N/A,-1062,578,N/A,114,2
1728,N/A,N/A,N/A,-434,1294,N/A,124,1
1744,N/A,N/A,N/A,153,1897,N/A,126,3
1623,N/A,N/A,N/A,-1470,153,N/A,252,3
1700,N/A,N/A,N/A,-417,1283,N/A,113,0
1639,N/A,N/A,N/A,-526,1113,N/A,102,5
1726,N/A,N/A,N/A,-742,984,N/A,128,1
1644,N/A,N/A,N/A,-1085,559,N/A,117,1
1607,N/A,N/A,N/A,-781,826,N/A,124,2
1667,N/A,N/A,N/A,-1292,375,N/A,115,4
1642,N/A,N/A,N/A,-304,1338,N/A,114,4
1736,N/A,N/A,N/A,-446,1290,N/A,120,0
1647,N/A,N/A,N/A,-1289,358,N/A,123,1
1619,N/A,N/A,N/A,-141,1478,N/A,129,3
1603,N/A,N/A,N/A,-322,1281,N/A,123,1
1629,N/A,N/A,N/A,-242,1387,N/A,109,0
1741,N/A,N/A,N/A,174,1915,N/A,115,2
1678,N/A,N/A,N/A,-1504,174,N/A,223,2
1734,N/A,N/A,N/A,-1294,440,N/A,123,4
1743,N/A,N/A,N/A,-720,1023,N/A,101,0
1636,N/A,N/A,N/A,363,1999,N/A,128,3
1614,N/A,N/A,N/A,-1251,363,N/A,246,1
1679,N/A,N/A,N/A,-405,1274,N/A,114,5
1642,N/A,N/A,N/A,-29,1613,N/A,107,3
1677,N/A,N/A,N/A,318,1995,N/A,117,1
1732,N/A,N/A,N/A,-1414,318,N/A,221,3
1688,N/A,N/A,N/A,-445,1243,N/A,102,2
1602,N/A,N/A,N/A,-985,617,N/A,101,2
1652,N/A,N/A,N/A,-373,1279,N/A,118,0
1737,N/A,N/A,N/A,-417,1320,N/A,106,4
1629,N/A,N/A,N/A,356,1985,N/A,114,2
1691,N/A,N/A,N/A,-1335,356,N/A,229,3
1655,N/A,N/A,N/A,300,1955,N/A,104,4
1700,N/A,N/A,N/A,-1400,300,N/A,221,1
1627,N/A,N/A,N/A,-4,1623,N/A,120,2
1699,N/A,N/A,N/A,-943,756,N/A,114,5
1633,N/A,N/A,N/A,-955,678,N/A,105,0
1704,N/A,N/A,N/A,-1019,685,N/A,126,1
1622,N/A,N/A,N/A,-582,1040,N/A,124,0
1634,N/A,N/A,N/A,-185,1449,N/A,114,3
1745,N/A,N/A,N/A,-657,1088,N/A,107,4
1660,N/A,N/A,N/A,-1024,636,N/A,118,2
1637,N/A,N/A,N/A,-1240,397,N/A,105,2
1681,N/A,N/A,N/A,-1348,333,N/A,108,3
1651,N/A,N/A,N/A,71,1722,N/A,125,1
1734,N/A,N/A,N/A,-1663,71,N/A,233,1
1653,N/A,N/A,N/A,-968,685,N/A,127,1
1666,N/A,N/A,N/A,-366,1300,N/A,122,4
1651,N/A,N/A,N/A,-971,680,N/A,102,2
1732,N/A,N/A,N/A,-720,1012,N/A,103,1
1738,N/A,N/A,N/A,-976,762,N/A,113,0
1736,N/A,N/A,N/A,-472,1264,N/A,125,3
1645,N/A,N/A,N/A,-1183,462,N/A,121,1
1668,N/A,N/A,N/A,122,1790,N/A,109,1
1707,N/A,N/A,N/A,-1585,122,N/A,212,2
1707,N/A,N/A,N/A,-987,720,N/A,123,1
1630,N/A,N/A,N/A,-600,1030,N/A,113,1
1741,N/A,N/A,N/A,-583,1158,N/A,120,2
1626,N/A,N/A,N/A,-995,631,N/A,126,3
1680,N/A,N/A,N/A,-307,1373,N/A,123,3
1609,N/A,N/A,N/A,-827,782,N/A,100,1
1683,N/A,N/A,N/A,-384,1299,N/A,127,4
1609,N/A,N/A,N/A,-285,1324,N/A,118,2
1675,N/A,N/A,N/A,-152,1523,N/A,103,2
1742,N/A,N/A,N/A,-1041,701,N/A,102,5
1674,N/A,N/A,N/A,148,1822,N/A,125,2
1711,N/A,N/A,N/A,-1563,148,N/A,244,1
1602,N/A,N/A,N/A,-808,794,N/A,110,1
1662,N/A,N/A,N/A,-642,1020,N/A,106,2
1695,N/A,N/A,N/A,-224,1471,N/A,127,0
1702,N/A,N/A,N/A,-1349,353,N/A,115,1
1735,N/A,N/A,N/A,-70,1665,N/A,104,0
1613,N/A,N/A,N/A,28,1641,N/A,110,5
1669,N/A,N/A,N/A,-1641,28,N/A,220,1
1667,N/A,N/A,N/A,219,1886,N/A,109,2
1687,N/A,N/A,N/A,-1468,219,N/A,236,3
1658,N/A,N/A,N/A,-474,1184,N/A,114,2
1650,N/A,N/A,N/A,-1159,491,N/A,121,2
1612,N/A,N/A,N/A,-499,1113,N/A,107,5
1744,N/A,N/A,N/A,-478,1266,N/A,121,1
1656,N/A,N/A,N/A,-428,1228,N/A,114,3
1629,N/A,N/A,N/A,-277,1352,N/A,112,1
1728,N/A,N/A,N/A,152,1880,N/A,129,4
1725,N/A,N/A,N/A,-1573,152,N/A,232,5
1609,N/A,N/A,N/A,-619,990,N/A,128,0
1701,N/A,N/A,N/A,-234,1467,N/A,128,3
1659,N/A,N/A,N/A,-1215,444,N/A,103,5
1747,N/A,N/A,N/A,-423,1324,N/A,119,0
1714,N/A,N/A,N/A,152,1866,N/A,117,1
1688,N/A,N/A,N/A,-1536,152,N/A,236,0
1613,N/A,N/A,N/A,-739,874,N/A,101,5
1663,N/A,N/A,N/A,-519,1144,N/A,125,0
1675,N/A,N/A,N/A,54,1729,N/A,126,5
1669,N/A,N/A,N/A,-1615,54,N/A,249,2
1605,N/A,N/A,N/A,-177,1428,N/A,118,5
1662,N/A,N/A,N/A,31,1693,N/A,119,5
1709,N/A,N/A,N/A,-1678,31,N/A,245,5
1690,N/A,N/A,N/A,-972,718,N/A,117,3
1626,N/A,N/A,N/A,-1292,334,N/A,110,3
1708,N/A,N/A,N/A,-1394,314,N/A,101,2
1711,N/A,N/A,N/A,-119,1592,N/A,123,4
1681,N/A,N/A,N/A,-1091,590,N/A,121,3
1660,N/A,N/A,N/A,-71,1589,N/A,115,4
1677,N/A,N/A,N/A,-1032,645,N/A,109,2
1678,N/A,N/A,N/A,-1075,603,N/A,112,5
1694,N/A,N/A,N/A,194,1888,N/A,106,0
1740,N/A,N/A,N/A,-1546,194,N/A,223,3
1679,N/A,N/A,N/A,-677,1002,N/A,128,0
1728,N/A,N/A,N/A,-383,1345,N/A,119,0
1718,N/A,N/A,N/A,-1192,526,N/A,102,3
1677,N/A,N/A,N/A,-203,1474,N/A,115,1
1670,N/A,N/A,N/A,9,1679,N/A,124,1
1715,N/A,N/A,N/A,-1706,9,N/A,228,3
1605,N/A,N/A,N/A,342,1947,N/A,113,5
1624,N/A,N/A,N/A,-1282,342,N/A,221,5
1691,N/A,N/A,N/A,-1360,331,N/A,109,2
1676,N/A,N/A,N/A,-17,1659,N/A,127,5
1715,N/A,N/A,N/A,-743,972,N/A,122,0
1732,N/A,N/A,N/A,-46,1686,N/A,122,5
1680,N/A,N/A,N/A,-138,1542,N/A,114,0
1722,N/A,N/A,N/A,-323,1399,N/A,121,3
1704,N/A,N/A,N/A,-114,1590,N/A,119,0
1651,N/A,N/A,N/A,-447,1204,N/A,118,4
