amount,category,date,name,newBalance,previousBalance,reference,timeDiff,dayOfWeek
8,N/A,N/A,N/A,1236,1244,N/A,5,4
8,N/A,N/A,N/A,1228,1236,N/A,11,4
6,N/A,N/A,N/A,1222,1228,N/A,15,2
12,N/A,N/A,N/A,1210,1222,N/A,19,6
4,N/A,N/A,N/A,1206,1210,N/A,25,0
12,N/A,N/A,N/A,1194,1206,N/A,30,5
4,N/A,N/A,N/A,1190,1194,N/A,34,3
7,N/A,N/A,N/A,1183,1190,N/A,39,2
4,N/A,N/A,N/A,1179,1183,N/A,44,1
12,N/A,N/A,N/A,1167,1179,N/A,48,5
7,N/A,N/A,N/A,1160,1167,N/A,51,2
16,N/A,N/A,N/A,1144,1160,N/A,55,6
8,N/A,N/A,N/A,1136,1144,N/A,59,4
5,N/A,N/A,N/A,1131,1136,N/A,64,3
4,N/A,N/A,N/A,1127,1131,N/A,68,1
5,N/A,N/A,N/A,1122,1127,N/A,74,1
11,N/A,N/A,N/A,1111,1122,N/A,78,5
8,N/A,N/A,N/A,1103,1111,N/A,83,4
7,N/A,N/A,N/A,1096,1103,N/A,88,3
4,N/A,N/A,N/A,1092,1096,N/A,92,1
12,N/A,N/A,N/A,1080,1092,N/A,96,5
9,N/A,N/A,N/A,1071,1080,N/A,102,5
6,N/A,N/A,N/A,1065,1071,N/A,105,2
6,N/A,N/A,N/A,1059,1065,N/A,111,2
19,N/A,N/A,N/A,1040,1059,N/A,115,6
5,N/A,N/A,N/A,1035,1040,N/A,119,4
8,N/A,N/A,N/A,1027,1035,N/A,125,4
4,N/A,N/A,N/A,1023,1027,N/A,129,2
4,N/A,N/A,N/A,1019,1023,N/A,134,1
8,N/A,N/A,N/A,1011,1019,N/A,137,4
5,N/A,N/A,N/A,1203,1208,N/A,5,4
6,N/A,N/A,N/A,1197,1203,N/A,9,2
5,N/A,N/A,N/A,1192,1197,N/A,14,1
7,N/A,N/A,N/A,1185,1192,N/A,17,4
4,N/A,N/A,N/A,1181,1185,N/A,21,2
6,N/A,N/A,N/A,1175,1181,N/A,27,2
12,N/A,N/A,N/A,1163,1175,N/A,30,5
6,N/A,N/A,N/A,1157,1163,N/A,35,4
4,N/A,N/A,N/A,1153,1157,N/A,38,1
4,N/A,N/A,N/A,1149,1153,N/A,44,1
19,N/A,N/A,N/A,1130,1149,N/A,49,6
7,N/A,N/A,N/A,1123,1130,N/A,53,4
7,N/A,N/A,N/A,1116,1123,N/A,57,2
5,N/A,N/A,N/A,1111,1116,N/A,63,2
4,N/A,N/A,N/A,1107,1111,N/A,68,1
10,N/A,N/A,N/A,1097,1107,N/A,72,5
5,N/A,N/A,N/A,1092,1097,N/A,77,4
6,N/A,N/A,N/A,1086,1092,N/A,83,4
7,N/A,N/A,N/A,1079,1086,N/A,89,4
5,N/A,N/A,N/A,1074,1079,N/A,92,1
5,N/A,N/A,N/A,1069,1074,N/A,98,1
13,N/A,N/A,N/A,1056,1069,N/A,103,6
7,N/A,N/A,N/A,1049,1056,N/A,107,4
4,N/A,N/A,N/A,1045,1049,N/A,112,3
7,N/A,N/A,N/A,1038,1045,N/A,117,2
12,N/A,N/A,N/A,1026,1038,N/A,120,5
5,N/A,N/A,N/A,1021,1026,N/A,124,3
5,N/A,N/A,N/A,1016,1021,N/A,128,1
8,N/A,N/A,N/A,1008,1016,N/A,131,4
5,N/A,N/A,N/A,1003,1008,N/A,135,2
4,N/A,N/A,N/A,1130,1134,N/A,3,1
6,N/A,N/A,N/A,1124,1130,N/A,6,4
6,N/A,N/A,N/A,1118,1124,N/A,12,4
4,N/A,N/A,N/A,1114,1118,N/A,15,1
8,N/A,N/A,N/A,1106,1114,N/A,18,4
5,N/A,N/A,N/A,1101,1106,N/A,22,2
4,N/A,N/A,N/A,1097,1101,N/A,27,1
5,N/A,N/A,N/A,1092,1097,N/A,33,1
8,N/A,N/A,N/A,1084,1092,N/A,36,4
4,N/A,N/A,N/A,1080,1084,N/A,41,3
7,N/A,N/A,N/A,1073,1080,N/A,46,2
9,N/A,N/A,N/A,1064,1073,N/A,49,5
4,N/A,N/A,N/A,1060,1064,N/A,53,3
5,N/A,N/A,N/A,1055,1060,N/A,57,1
6,N/A,N/A,N/A,1049,1055,N/A,60,4
4,N/A,N/A,N/A,1045,1049,N/A,63,1
5,N/A,N/A,N/A,1040,1045,N/A,69,1
5,N/A,N/A,N/A,1035,1040,N/A,75,1
11,N/A,N/A,N/A,1024,1035,N/A,79,5
7,N/A,N/A,N/A,1017,1024,N/A,84,4
5,N/A,N/A,N/A,1012,1017,N/A,89,3
5,N/A,N/A,N/A,1007,1012,N/A,93,1
5,N/A,N/A,N/A,1002,1007,N/A,96,4
4,N/A,N/A,N/A,998,1002,N/A,100,2
12,N/A,N/A,N/A,986,998,N/A,103,5
6,N/A,N/A,N/A,980,986,N/A,106,2
15,N/A,N/A,N/A,965,980,N/A,110,6
8,N/A,N/A,N/A,957,965,N/A,114,4
5,N/A,N/A,N/A,952,957,N/A,117,1
4,N/A,N/A,N/A,948,952,N/A,123,1
13,N/A,N/A,N/A,1294,1307,N/A,5,6
4,N/A,N/A,N/A,1290,1294,N/A,11,0
7,N/A,N/A,N/A,1283,1290,N/A,14,3
7,N/A,N/A,N/A,1276,1283,N/A,20,3
6,N/A,N/A,N/A,1270,1276,N/A,25,2
19,N/A,N/A,N/A,1251,1270,N/A,29,6
4,N/A,N/A,N/A,1247,1251,N/A,35,0
6,N/A,N/A,N/A,1241,1247,N/A,39,4
5,N/A,N/A,N/A,1236,1241,N/A,43,2
17,N/A,N/A,N/A,1219,1236,N/A,47,6
5,N/A,N/A,N/A,1214,1219,N/A,50,3
4,N/A,N/A,N/A,1210,1214,N/A,54,1
5,N/A,N/A,N/A,1205,1210,N/A,60,1
12,N/A,N/A,N/A,1193,1205,N/A,65,6
9,N/A,N/A,N/A,1184,1193,N/A,70,5
8,N/A,N/A,N/A,1176,1184,N/A,75,4
7,N/A,N/A,N/A,1169,1176,N/A,81,4
4,N/A,N/A,N/A,1165,1169,N/A,84,1
12,N/A,N/A,N/A,1153,1165,N/A,88,5
11,N/A,N/A,N/A,1142,1153,N/A,94,5
4,N/A,N/A,N/A,1138,1142,N/A,97,2
6,N/A,N/A,N/A,1132,1138,N/A,103,2
12,N/A,N/A,N/A,1120,1132,N/A,106,5
7,N/A,N/A,N/A,1113,1120,N/A,110,3
12,N/A,N/A,N/A,1101,1113,N/A,113,6
4,N/A,N/A,N/A,1097,1101,N/A,119,0
10,N/A,N/A,N/A,1087,1097,N/A,124,5
5,N/A,N/A,N/A,1082,1087,N/A,127,2
4,N/A,N/A,N/A,1078,1082,N/A,133,2
5,N/A,N/A,N/A,1073,1078,N/A,138,1
10,N/A,N/A,N/A,1895,1905,N/A,6,5
10,N/A,N/A,N/A,1885,1895,N/A,12,5
6,N/A,N/A,N/A,1879,1885,N/A,17,4
4,N/A,N/A,N/A,1875,1879,N/A,20,1
16,N/A,N/A,N/A,1859,1875,N/A,25,6
10,N/A,N/A,N/A,1849,1859,N/A,30,5
12,N/A,N/A,N/A,1837,1849,N/A,36,5
7,N/A,N/A,N/A,1830,1837,N/A,39,2
19,N/A,N/A,N/A,1811,1830,N/A,43,6
5,N/A,N/A,N/A,1806,1811,N/A,46,3
5,N/A,N/A,N/A,1801,1806,N/A,50,1
13,N/A,N/A,N/A,1788,1801,N/A,55,6
5,N/A,N/A,N/A,1783,1788,N/A,61,0
7,N/A,N/A,N/A,1776,1783,N/A,65,4
5,N/A,N/A,N/A,1771,1776,N/A,69,2
4,N/A,N/A,N/A,1767,1771,N/A,75,2
10,N/A,N/A,N/A,1757,1767,N/A,78,5
6,N/A,N/A,N/A,1751,1757,N/A,81,2
11,N/A,N/A,N/A,1740,1751,N/A,84,5
6,N/A,N/A,N/A,1734,1740,N/A,88,3
4,N/A,N/A,N/A,1730,1734,N/A,93,2
14,N/A,N/A,N/A,1716,1730,N/A,97,6
7,N/A,N/A,N/A,1709,1716,N/A,101,4
4,N/A,N/A,N/A,1705,1709,N/A,104,1
18,N/A,N/A,N/A,1687,1705,N/A,109,6
5,N/A,N/A,N/A,1682,1687,N/A,115,0
5,N/A,N/A,N/A,1677,1682,N/A,118,3
12,N/A,N/A,N/A,1665,1677,N/A,121,6
8,N/A,N/A,N/A,1657,1665,N/A,125,4
5,N/A,N/A,N/A,1652,1657,N/A,128,1
9,N/A,N/A,N/A,1006,1015,N/A,3,5
6,N/A,N/A,N/A,1000,1006,N/A,6,2
11,N/A,N/A,N/A,989,1000,N/A,9,5
7,N/A,N/A,N/A,982,989,N/A,14,4
6,N/A,N/A,N/A,976,982,N/A,19,3
6,N/A,N/A,N/A,970,976,N/A,25,3
7,N/A,N/A,N/A,963,970,N/A,31,3
7,N/A,N/A,N/A,956,963,N/A,36,2
10,N/A,N/A,N/A,946,956,N/A,39,5
12,N/A,N/A,N/A,934,946,N/A,45,5
5,N/A,N/A,N/A,929,934,N/A,50,4
8,N/A,N/A,N/A,921,929,N/A,56,4
5,N/A,N/A,N/A,916,921,N/A,61,3
4,N/A,N/A,N/A,912,916,N/A,65,1
6,N/A,N/A,N/A,906,912,N/A,68,4
4,N/A,N/A,N/A,902,906,N/A,71,1
4,N/A,N/A,N/A,898,902,N/A,77,1
12,N/A,N/A,N/A,886,898,N/A,81,5
11,N/A,N/A,N/A,875,886,N/A,87,5
11,N/A,N/A,N/A,864,875,N/A,93,5
8,N/A,N/A,N/A,856,864,N/A,98,4
7,N/A,N/A,N/A,849,856,N/A,104,4
6,N/A,N/A,N/A,843,849,N/A,109,3
7,N/A,N/A,N/A,836,843,N/A,115,3
7,N/A,N/A,N/A,829,836,N/A,120,2
11,N/A,N/A,N/A,818,829,N/A,123,5
4,N/A,N/A,N/A,814,818,N/A,127,3
5,N/A,N/A,N/A,809,814,N/A,131,1
12,N/A,N/A,N/A,797,809,N/A,136,6
12,N/A,N/A,N/A,785,797,N/A,141,5
15,N/A,N/A,N/A,1282,1297,N/A,4,6
4,N/A,N/A,N/A,1278,1282,N/A,10,0
8,N/A,N/A,N/A,1270,1278,N/A,14,4
5,N/A,N/A,N/A,1265,1270,N/A,17,1
5,N/A,N/A,N/A,1260,1265,N/A,20,4
4,N/A,N/A,N/A,1256,1260,N/A,23,1
15,N/A,N/A,N/A,1241,1256,N/A,28,6
6,N/A,N/A,N/A,1235,1241,N/A,32,4
8,N/A,N/A,N/A,1227,1235,N/A,38,4
4,N/A,N/A,N/A,1223,1227,N/A,41,1
12,N/A,N/A,N/A,1211,1223,N/A,45,5
6,N/A,N/A,N/A,1205,1211,N/A,50,4
6,N/A,N/A,N/A,1199,1205,N/A,54,2
5,N/A,N/A,N/A,1194,1199,N/A,60,2
5,N/A,N/A,N/A,1189,1194,N/A,66,2
9,N/A,N/A,N/A,1180,1189,N/A,69,5
11,N/A,N/A,N/A,1169,1180,N/A,75,5
10,N/A,N/A,N/A,1159,1169,N/A,81,5
8,N/A,N/A,N/A,1151,1159,N/A,86,4
8,N/A,N/A,N/A,1143,1151,N/A,92,4
5,N/A,N/A,N/A,1138,1143,N/A,95,1
4,N/A,N/A,N/A,1134,1138,N/A,101,1
18,N/A,N/A,N/A,1116,1134,N/A,106,6
5,N/A,N/A,N/A,1111,1116,N/A,112,0
7,N/A,N/A,N/A,1104,1111,N/A,116,4
5,N/A,N/A,N/A,1099,1104,N/A,120,2
13,N/A,N/A,N/A,1086,1099,N/A,124,6
5,N/A,N/A,N/A,1081,1086,N/A,127,3
4,N/A,N/A,N/A,1077,1081,N/A,131,1
8,N/A,N/A,N/A,1069,1077,N/A,134,4
7,N/A,N/A,N/A,1340,1347,N/A,6,4
4,N/A,N/A,N/A,1336,1340,N/A,10,2
4,N/A,N/A,N/A,1332,1336,N/A,16,2
7,N/A,N/A,N/A,1325,1332,N/A,22,2
19,N/A,N/A,N/A,1306,1325,N/A,26,6
7,N/A,N/A,N/A,1299,1306,N/A,29,3
12,N/A,N/A,N/A,1287,1299,N/A,32,6
5,N/A,N/A,N/A,1282,1287,N/A,36,4
7,N/A,N/A,N/A,1275,1282,N/A,40,2
12,N/A,N/A,N/A,1263,1275,N/A,43,5
6,N/A,N/A,N/A,1257,1263,N/A,48,4
4,N/A,N/A,N/A,1253,1257,N/A,51,1
5,N/A,N/A,N/A,1248,1253,N/A,54,4
4,N/A,N/A,N/A,1244,1248,N/A,57,1
16,N/A,N/A,N/A,1228,1244,N/A,62,6
4,N/A,N/A,N/A,1224,1228,N/A,68,0
7,N/A,N/A,N/A,1217,1224,N/A,72,4
4,N/A,N/A,N/A,1213,1217,N/A,75,1
6,N/A,N/A,N/A,1207,1213,N/A,78,4
6,N/A,N/A,N/A,1201,1207,N/A,82,2
4,N/A,N/A,N/A,1197,1201,N/A,88,2
10,N/A,N/A,N/A,1187,1197,N/A,91,5
4,N/A,N/A,N/A,1183,1187,N/A,95,3
15,N/A,N/A,N/A,1168,1183,N/A,98,6
4,N/A,N/A,N/A,1164,1168,N/A,104,0
7,N/A,N/A,N/A,1157,1164,N/A,108,4
4,N/A,N/A,N/A,1153,1157,N/A,111,1
4,N/A,N/A,N/A,1149,1153,N/A,117,1
7,N/A,N/A,N/A,1142,1149,N/A,120,4
5,N/A,N/A,N/A,1137,1142,N/A,123,1
6,N/A,N/A,N/A,1219,1225,N/A,5,2
5,N/A,N/A,N/A,1214,1219,N/A,11,2
11,N/A,N/A,N/A,1203,1214,N/A,14,5
6,N/A,N/A,N/A,1197,1203,N/A,17,2
5,N/A,N/A,N/A,1192,1197,N/A,22,1
5,N/A,N/A,N/A,1187,1192,N/A,25,4
4,N/A,N/A,N/A,1183,1187,N/A,30,3
14,N/A,N/A,N/A,1169,1183,N/A,33,6
6,N/A,N/A,N/A,1163,1169,N/A,36,3
4,N/A,N/A,N/A,1159,1163,N/A,40,1
10,N/A,N/A,N/A,1149,1159,N/A,45,6
9,N/A,N/A,N/A,1140,1149,N/A,50,5
5,N/A,N/A,N/A,1135,1140,N/A,54,3
4,N/A,N/A,N/A,1131,1135,N/A,59,2
6,N/A,N/A,N/A,1125,1131,N/A,65,2
4,N/A,N/A,N/A,1121,1125,N/A,70,1
8,N/A,N/A,N/A,1113,1121,N/A,73,4
7,N/A,N/A,N/A,1106,1113,N/A,77,2
18,N/A,N/A,N/A,1088,1106,N/A,81,6
12,N/A,N/A,N/A,1076,1088,N/A,86,5
9,N/A,N/A,N/A,1067,1076,N/A,92,5
5,N/A,N/A,N/A,1062,1067,N/A,96,3
17,N/A,N/A,N/A,1045,1062,N/A,99,6
7,N/A,N/A,N/A,1038,1045,N/A,102,3
5,N/A,N/A,N/A,1033,1038,N/A,107,2
12,N/A,N/A,N/A,1021,1033,N/A,111,6
5,N/A,N/A,N/A,1016,1021,N/A,115,4
5,N/A,N/A,N/A,1011,1016,N/A,118,1
9,N/A,N/A,N/A,1002,1011,N/A,122,5
6,N/A,N/A,N/A,996,1002,N/A,125,2
5,N/A,N/A,N/A,952,957,N/A,3,4
7,N/A,N/A,N/A,945,952,N/A,8,3
4,N/A,N/A,N/A,941,945,N/A,12,1
14,N/A,N/A,N/A,927,941,N/A,17,6
5,N/A,N/A,N/A,922,927,N/A,21,4
4,N/A,N/A,N/A,918,922,N/A,25,2
10,N/A,N/A,N/A,908,918,N/A,29,6
4,N/A,N/A,N/A,904,908,N/A,32,3
7,N/A,N/A,N/A,897,904,N/A,38,3
6,N/A,N/A,N/A,891,897,N/A,43,2
19,N/A,N/A,N/A,872,891,N/A,47,6
9,N/A,N/A,N/A,863,872,N/A,52,5
11,N/A,N/A,N/A,852,863,N/A,58,5
6,N/A,N/A,N/A,846,852,N/A,62,3
13,N/A,N/A,N/A,833,846,N/A,65,6
4,N/A,N/A,N/A,829,833,N/A,68,3
15,N/A,N/A,N/A,814,829,N/A,71,6
9,N/A,N/A,N/A,805,814,N/A,76,5
6,N/A,N/A,N/A,799,805,N/A,81,4
8,N/A,N/A,N/A,791,799,N/A,87,4
4,N/A,N/A,N/A,787,791,N/A,90,1
10,N/A,N/A,N/A,777,787,N/A,95,6
10,N/A,N/A,N/A,767,777,N/A,100,5
5,N/A,N/A,N/A,762,767,N/A,105,4
8,N/A,N/A,N/A,754,762,N/A,111,4
5,N/A,N/A,N/A,749,754,N/A,117,4
4,N/A,N/A,N/A,745,749,N/A,120,1
5,N/A,N/A,N/A,740,745,N/A,126,1
12,N/A,N/A,N/A,728,740,N/A,130,5
4,N/A,N/A,N/A,724,728,N/A,133,2
19,N/A,N/A,N/A,385,404,N/A,5,6
6,N/A,N/A,N/A,379,385,N/A,9,4
5,N/A,N/A,N/A,374,379,N/A,12,1
10,N/A,N/A,N/A,364,374,N/A,16,5
9,N/A,N/A,N/A,355,364,N/A,22,5
10,N/A,N/A,N/A,345,355,N/A,28,5
7,N/A,N/A,N/A,338,345,N/A,32,3
18,N/A,N/A,N/A,320,338,N/A,35,6
12,N/A,N/A,N/A,308,320,N/A,40,5
4,N/A,N/A,N/A,304,308,N/A,43,2
7,N/A,N/A,N/A,297,304,N/A,49,2
9,N/A,N/A,N/A,288,297,N/A,52,5
6,N/A,N/A,N/A,282,288,N/A,55,2
14,N/A,N/A,N/A,268,282,N/A,59,6
7,N/A,N/A,N/A,261,268,N/A,62,3
15,N/A,N/A,N/A,246,261,N/A,65,6
5,N/A,N/A,N/A,241,246,N/A,69,4
5,N/A,N/A,N/A,236,241,N/A,75,4
4,N/A,N/A,N/A,232,236,N/A,78,1
4,N/A,N/A,N/A,228,232,N/A,84,1
9,N/A,N/A,N/A,219,228,N/A,88,5
8,N/A,N/A,N/A,211,219,N/A,93,4
5,N/A,N/A,N/A,206,211,N/A,98,3
5,N/A,N/A,N/A,201,206,N/A,103,2
6,N/A,N/A,N/A,195,201,N/A,109,2
7,N/A,N/A,N/A,188,195,N/A,115,2
9,N/A,N/A,N/A,179,188,N/A,118,5
11,N/A,N/A,N/A,168,179,N/A,124,5
12,N/A,N/A,N/A,156,168,N/A,130,5
8,N/A,N/A,N/A,148,156,N/A,135,4
5,N/A,N/A,N/A,598,603,N/A,5,2
11,N/A,N/A,N/A,587,598,N/A,9,6
4,N/A,N/A,N/A,583,587,N/A,12,3
7,N/A,N/A,N/A,576,583,N/A,18,3
15,N/A,N/A,N/A,561,576,N/A,21,6
6,N/A,N/A,N/A,555,561,N/A,24,3
4,N/A,N/A,N/A,551,555,N/A,28,1
8,N/A,N/A,N/A,543,551,N/A,31,4
7,N/A,N/A,N/A,536,543,N/A,35,2
17,N/A,N/A,N/A,519,536,N/A,39,6
5,N/A,N/A,N/A,514,519,N/A,45,0
12,N/A,N/A,N/A,502,514,N/A,50,5
6,N/A,N/A,N/A,496,502,N/A,55,4
4,N/A,N/A,N/A,492,496,N/A,60,3
16,N/A,N/A,N/A,476,492,N/A,63,6
6,N/A,N/A,N/A,470,476,N/A,66,3
6,N/A,N/A,N/A,464,470,N/A,71,2
4,N/A,N/A,N/A,460,464,N/A,77,2
11,N/A,N/A,N/A,449,460,N/A,81,6
5,N/A,N/A,N/A,444,449,N/A,84,3
4,N/A,N/A,N/A,440,444,N/A,89,2
9,N/A,N/A,N/A,431,440,N/A,92,5
9,N/A,N/A,N/A,422,431,N/A,98,5
7,N/A,N/A,N/A,415,422,N/A,102,3
6,N/A,N/A,N/A,409,415,N/A,108,3
5,N/A,N/A,N/A,404,409,N/A,114,3
5,N/A,N/A,N/A,399,404,N/A,118,1
5,N/A,N/A,N/A,394,399,N/A,121,4
5,N/A,N/A,N/A,389,394,N/A,124,1
8,N/A,N/A,N/A,381,389,N/A,127,4
17,N/A,N/A,N/A,1378,1395,N/A,6,6
5,N/A,N/A,N/A,1373,1378,N/A,10,4
5,N/A,N/A,N/A,1368,1373,N/A,13,1
6,N/A,N/A,N/A,1362,1368,N/A,16,4
6,N/A,N/A,N/A,1356,1362,N/A,20,2
5,N/A,N/A,N/A,1351,1356,N/A,25,1
4,N/A,N/A,N/A,1347,1351,N/A,31,1
19,N/A,N/A,N/A,1328,1347,N/A,36,6
4,N/A,N/A,N/A,1324,1328,N/A,39,3
4,N/A,N/A,N/A,1320,1324,N/A,44,2
4,N/A,N/A,N/A,1316,1320,N/A,49,1
11,N/A,N/A,N/A,1305,1316,N/A,54,6
5,N/A,N/A,N/A,1300,1305,N/A,60,0
18,N/A,N/A,N/A,1282,1300,N/A,66,6
12,N/A,N/A,N/A,1270,1282,N/A,71,5
4,N/A,N/A,N/A,1266,1270,N/A,74,2
10,N/A,N/A,N/A,1256,1266,N/A,78,6
7,N/A,N/A,N/A,1249,1256,N/A,82,4
6,N/A,N/A,N/A,1243,1249,N/A,87,3
5,N/A,N/A,N/A,1238,1243,N/A,93,3
5,N/A,N/A,N/A,1233,1238,N/A,97,1
10,N/A,N/A,N/A,1223,1233,N/A,101,5
7,N/A,N/A,N/A,1216,1223,N/A,104,2
5,N/A,N/A,N/A,1211,1216,N/A,109,1
16,N/A,N/A,N/A,1195,1211,N/A,114,6
4,N/A,N/A,N/A,1191,1195,N/A,120,0
19,N/A,N/A,N/A,1172,1191,N/A,126,6
6,N/A,N/A,N/A,1166,1172,N/A,130,4
4,N/A,N/A,N/A,1162,1166,N/A,133,1
8,N/A,N/A,N/A,1154,1162,N/A,136,4
6,N/A,N/A,N/A,1301,1307,N/A,5,4
6,N/A,N/A,N/A,1295,1301,N/A,9,2
7,N/A,N/A,N/A,1288,1295,N/A,15,2
5,N/A,N/A,N/A,1283,1288,N/A,21,2
13,N/A,N/A,N/A,1270,1283,N/A,25,6
12,N/A,N/A,N/A,1258,1270,N/A,30,5
11,N/A,N/A,N/A,1247,1258,N/A,36,5
10,N/A,N/A,N/A,1237,1247,N/A,42,5
8,N/A,N/A,N/A,1229,1237,N/A,47,4
4,N/A,N/A,N/A,1225,1229,N/A,50,1
6,N/A,N/A,N/A,1219,1225,N/A,53,4
5,N/A,N/A,N/A,1214,1219,N/A,59,4
6,N/A,N/A,N/A,1208,1214,N/A,64,3
10,N/A,N/A,N/A,1198,1208,N/A,67,6
7,N/A,N/A,N/A,1191,1198,N/A,71,4
6,N/A,N/A,N/A,1185,1191,N/A,76,3
14,N/A,N/A,N/A,1171,1185,N/A,79,6
5,N/A,N/A,N/A,1166,1171,N/A,85,0
9,N/A,N/A,N/A,1157,1166,N/A,90,5
10,N/A,N/A,N/A,1147,1157,N/A,96,5
7,N/A,N/A,N/A,1140,1147,N/A,100,3
18,N/A,N/A,N/A,1122,1140,N/A,103,6
4,N/A,N/A,N/A,1118,1122,N/A,109,0
10,N/A,N/A,N/A,1108,1118,N/A,114,5
8,N/A,N/A,N/A,1100,1108,N/A,119,4
4,N/A,N/A,N/A,1096,1100,N/A,122,1
17,N/A,N/A,N/A,1079,1096,N/A,127,6
5,N/A,N/A,N/A,1074,1079,N/A,131,4
7,N/A,N/A,N/A,1067,1074,N/A,137,4
5,N/A,N/A,N/A,1062,1067,N/A,142,3
12,N/A,N/A,N/A,1421,1433,N/A,6,5
5,N/A,N/A,N/A,1416,1421,N/A,9,2
11,N/A,N/A,N/A,1405,1416,N/A,12,5
10,N/A,N/A,N/A,1395,1405,N/A,18,5
6,N/A,N/A,N/A,1389,1395,N/A,23,4
7,N/A,N/A,N/A,1382,1389,N/A,29,4
5,N/A,N/A,N/A,1377,1382,N/A,34,3
4,N/A,N/A,N/A,1373,1377,N/A,38,1
4,N/A,N/A,N/A,1369,1373,N/A,44,1
7,N/A,N/A,N/A,1362,1369,N/A,47,4
5,N/A,N/A,N/A,1357,1362,N/A,50,1
5,N/A,N/A,N/A,1352,1357,N/A,56,1
12,N/A,N/A,N/A,1340,1352,N/A,60,5
6,N/A,N/A,N/A,1334,1340,N/A,64,3
5,N/A,N/A,N/A,1329,1334,N/A,70,3
5,N/A,N/A,N/A,1324,1329,N/A,74,1
8,N/A,N/A,N/A,1316,1324,N/A,77,4
4,N/A,N/A,N/A,1312,1316,N/A,80,1
6,N/A,N/A,N/A,1306,1312,N/A,83,4
4,N/A,N/A,N/A,1302,1306,N/A,86,1
10,N/A,N/A,N/A,1292,1302,N/A,91,6
9,N/A,N/A,N/A,1283,1292,N/A,96,5
9,N/A,N/A,N/A,1274,1283,N/A,102,5
7,N/A,N/A,N/A,1267,1274,N/A,105,2
6,N/A,N/A,N/A,1261,1267,N/A,111,2
5,N/A,N/A,N/A,1256,1261,N/A,116,1
15,N/A,N/A,N/A,1241,1256,N/A,121,6
7,N/A,N/A,N/A,1234,1241,N/A,124,3
5,N/A,N/A,N/A,1229,1234,N/A,129,2
5,N/A,N/A,N/A,1224,1229,N/A,134,1
4,N/A,N/A,N/A,821,825,N/A,5,1
10,N/A,N/A,N/A,811,821,N/A,9,5
5,N/A,N/A,N/A,806,811,N/A,12,2
17,N/A,N/A,N/A,789,806,N/A,16,6
12,N/A,N/A,N/A,777,789,N/A,21,5
5,N/A,N/A,N/A,772,777,N/A,25,3
11,N/A,N/A,N/A,761,772,N/A,28,6
9,N/A,N/A,N/A,752,761,N/A,33,5
11,N/A,N/A,N/A,741,752,N/A,39,5
12,N/A,N/A,N/A,729,741,N/A,45,5
6,N/A,N/A,N/A,723,729,N/A,50,4
6,N/A,N/A,N/A,717,723,N/A,55,3
4,N/A,N/A,N/A,713,717,N/A,61,3
4,N/A,N/A,N/A,709,713,N/A,66,2
16,N/A,N/A,N/A,693,709,N/A,70,6
6,N/A,N/A,N/A,687,693,N/A,74,4
6,N/A,N/A,N/A,681,687,N/A,80,4
5,N/A,N/A,N/A,676,681,N/A,84,2
5,N/A,N/A,N/A,671,676,N/A,89,1
11,N/A,N/A,N/A,660,671,N/A,93,5
7,N/A,N/A,N/A,653,660,N/A,98,4
5,N/A,N/A,N/A,648,653,N/A,101,1
6,N/A,N/A,N/A,642,648,N/A,104,4
6,N/A,N/A,N/A,636,642,N/A,110,4
4,N/A,N/A,N/A,632,636,N/A,115,3
7,N/A,N/A,N/A,625,632,N/A,120,2
17,N/A,N/A,N/A,608,625,N/A,124,6
4,N/A,N/A,N/A,604,608,N/A,130,0
17,N/A,N/A,N/A,587,604,N/A,136,6
10,N/A,N/A,N/A,577,587,N/A,141,5
7,N/A,N/A,N/A,1925,1932,N/A,3,3
6,N/A,N/A,N/A,1919,1925,N/A,8,2
7,N/A,N/A,N/A,1912,1919,N/A,14,2
7,N/A,N/A,N/A,1905,1912,N/A,20,2
16,N/A,N/A,N/A,1889,1905,N/A,24,6
4,N/A,N/A,N/A,1885,1889,N/A,30,0
7,N/A,N/A,N/A,1878,1885,N/A,34,4
4,N/A,N/A,N/A,1874,1878,N/A,37,1
9,N/A,N/A,N/A,1865,1874,N/A,41,5
6,N/A,N/A,N/A,1859,1865,N/A,44,2
4,N/A,N/A,N/A,1855,1859,N/A,49,1
10,N/A,N/A,N/A,1845,1855,N/A,53,5
12,N/A,N/A,N/A,1833,1845,N/A,59,5
6,N/A,N/A,N/A,1827,1833,N/A,62,2
14,N/A,N/A,N/A,1813,1827,N/A,66,6
5,N/A,N/A,N/A,1808,1813,N/A,72,0
19,N/A,N/A,N/A,1789,1808,N/A,78,6
8,N/A,N/A,N/A,1781,1789,N/A,82,4
4,N/A,N/A,N/A,1777,1781,N/A,86,2
12,N/A,N/A,N/A,1765,1777,N/A,90,6
4,N/A,N/A,N/A,1761,1765,N/A,96,0
5,N/A,N/A,N/A,1756,1761,N/A,100,4
5,N/A,N/A,N/A,1751,1756,N/A,105,3
5,N/A,N/A,N/A,1746,1751,N/A,109,1
5,N/A,N/A,N/A,1741,1746,N/A,115,1
11,N/A,N/A,N/A,1730,1741,N/A,120,6
10,N/A,N/A,N/A,1720,1730,N/A,125,5
7,N/A,N/A,N/A,1713,1720,N/A,130,4
6,N/A,N/A,N/A,1707,1713,N/A,135,3
5,N/A,N/A,N/A,1702,1707,N/A,141,3
11,N/A,N/A,N/A,1713,1724,N/A,6,5
12,N/A,N/A,N/A,1701,1713,N/A,12,5
5,N/A,N/A,N/A,1696,1701,N/A,16,3
18,N/A,N/A,N/A,1678,1696,N/A,19,6
6,N/A,N/A,N/A,1672,1678,N/A,22,3
5,N/A,N/A,N/A,1667,1672,N/A,26,1
15,N/A,N/A,N/A,1652,1667,N/A,31,6
12,N/A,N/A,N/A,1640,1652,N/A,36,5
4,N/A,N/A,N/A,1636,1640,N/A,39,2
15,N/A,N/A,N/A,1621,1636,N/A,43,6
8,N/A,N/A,N/A,1613,1621,N/A,47,4
6,N/A,N/A,N/A,1607,1613,N/A,53,4
4,N/A,N/A,N/A,1603,1607,N/A,56,1
4,N/A,N/A,N/A,1599,1603,N/A,62,1
5,N/A,N/A,N/A,1594,1599,N/A,68,1
7,N/A,N/A,N/A,1587,1594,N/A,71,4
6,N/A,N/A,N/A,1581,1587,N/A,77,4
5,N/A,N/A,N/A,1576,1581,N/A,82,3
7,N/A,N/A,N/A,1569,1576,N/A,88,3
4,N/A,N/A,N/A,1565,1569,N/A,94,3
13,N/A,N/A,N/A,1552,1565,N/A,97,6
8,N/A,N/A,N/A,1544,1552,N/A,101,4
4,N/A,N/A,N/A,1540,1544,N/A,104,1
6,N/A,N/A,N/A,1534,1540,N/A,107,4
5,N/A,N/A,N/A,1529,1534,N/A,110,1
8,N/A,N/A,N/A,1521,1529,N/A,113,4
5,N/A,N/A,N/A,1516,1521,N/A,117,2
11,N/A,N/A,N/A,1505,1516,N/A,121,6
12,N/A,N/A,N/A,1493,1505,N/A,126,5
10,N/A,N/A,N/A,1483,1493,N/A,132,5
11,N/A,N/A,N/A,1400,1411,N/A,6,5
5,N/A,N/A,N/A,1395,1400,N/A,11,4
5,N/A,N/A,N/A,1390,1395,N/A,14,1
18,N/A,N/A,N/A,1372,1390,N/A,19,6
5,N/A,N/A,N/A,1367,1372,N/A,23,4
4,N/A,N/A,N/A,1363,1367,N/A,28,3
5,N/A,N/A,N/A,1358,1363,N/A,33,2
5,N/A,N/A,N/A,1353,1358,N/A,38,1
8,N/A,N/A,N/A,1345,1353,N/A,41,4
7,N/A,N/A,N/A,1338,1345,N/A,45,2
9,N/A,N/A,N/A,1329,1338,N/A,48,5
4,N/A,N/A,N/A,1325,1329,N/A,51,2
15,N/A,N/A,N/A,1310,1325,N/A,55,6
6,N/A,N/A,N/A,1304,1310,N/A,59,4
4,N/A,N/A,N/A,1300,1304,N/A,62,1
8,N/A,N/A,N/A,1292,1300,N/A,65,4
4,N/A,N/A,N/A,1288,1292,N/A,68,1
4,N/A,N/A,N/A,1284,1288,N/A,74,1
12,N/A,N/A,N/A,1272,1284,N/A,78,5
7,N/A,N/A,N/A,1265,1272,N/A,81,2
18,N/A,N/A,N/A,1247,1265,N/A,85,6
11,N/A,N/A,N/A,1236,1247,N/A,90,5
7,N/A,N/A,N/A,1229,1236,N/A,93,2
5,N/A,N/A,N/A,1224,1229,N/A,98,1
7,N/A,N/A,N/A,1217,1224,N/A,101,4
4,N/A,N/A,N/A,1213,1217,N/A,105,2
16,N/A,N/A,N/A,1197,1213,N/A,109,6
11,N/A,N/A,N/A,1186,1197,N/A,114,5
5,N/A,N/A,N/A,1181,1186,N/A,118,3
15,N/A,N/A,N/A,1166,1181,N/A,121,6
5,N/A,N/A,N/A,1344,1349,N/A,3,1
5,N/A,N/A,N/A,1339,1344,N/A,9,1
9,N/A,N/A,N/A,1330,1339,N/A,13,5
7,N/A,N/A,N/A,1323,1330,N/A,18,4
5,N/A,N/A,N/A,1318,1323,N/A,21,1
8,N/A,N/A,N/A,1310,1318,N/A,24,4
5,N/A,N/A,N/A,1305,1310,N/A,29,3
5,N/A,N/A,N/A,1300,1305,N/A,33,1
12,N/A,N/A,N/A,1288,1300,N/A,38,6
11,N/A,N/A,N/A,1277,1288,N/A,43,5
6,N/A,N/A,N/A,1271,1277,N/A,48,4
6,N/A,N/A,N/A,1265,1271,N/A,54,4
7,N/A,N/A,N/A,1258,1265,N/A,60,4
6,N/A,N/A,N/A,1252,1258,N/A,65,3
6,N/A,N/A,N/A,1246,1252,N/A,71,3
12,N/A,N/A,N/A,1234,1246,N/A,74,6
5,N/A,N/A,N/A,1229,1234,N/A,80,0
12,N/A,N/A,N/A,1217,1229,N/A,85,5
6,N/A,N/A,N/A,1211,1217,N/A,89,3
6,N/A,N/A,N/A,1205,1211,N/A,94,2
5,N/A,N/A,N/A,1200,1205,N/A,100,2
4,N/A,N/A,N/A,1196,1200,N/A,106,2
10,N/A,N/A,N/A,1186,1196,N/A,109,5
8,N/A,N/A,N/A,1178,1186,N/A,114,4
4,N/A,N/A,N/A,1174,1178,N/A,118,2
11,N/A,N/A,N/A,1163,1174,N/A,121,5
4,N/A,N/A,N/A,1159,1163,N/A,124,2
4,N/A,N/A,N/A,1155,1159,N/A,130,2
9,N/A,N/A,N/A,1146,1155,N/A,133,5
9,N/A,N/A,N/A,1137,1146,N/A,139,5
4,N/A,N/A,N/A,1141,1145,N/A,5,1
4,N/A,N/A,N/A,1137,1141,N/A,11,1
8,N/A,N/A,N/A,1129,1137,N/A,14,4
4,N/A,N/A,N/A,1125,1129,N/A,17,1
12,N/A,N/A,N/A,1113,1125,N/A,21,5
6,N/A,N/A,N/A,1107,1113,N/A,25,3
5,N/A,N/A,N/A,1102,1107,N/A,29,1
17,N/A,N/A,N/A,1085,1102,N/A,34,6
5,N/A,N/A,N/A,1080,1085,N/A,40,0
7,N/A,N/A,N/A,1073,1080,N/A,44,4
7,N/A,N/A,N/A,1066,1073,N/A,48,2
5,N/A,N/A,N/A,1061,1066,N/A,54,2
4,N/A,N/A,N/A,1057,1061,N/A,59,1
4,N/A,N/A,N/A,1053,1057,N/A,65,1
13,N/A,N/A,N/A,1040,1053,N/A,70,6
9,N/A,N/A,N/A,1031,1040,N/A,75,5
7,N/A,N/A,N/A,1024,1031,N/A,80,4
4,N/A,N/A,N/A,1020,1024,N/A,85,3
7,N/A,N/A,N/A,1013,1020,N/A,90,2
5,N/A,N/A,N/A,1008,1013,N/A,96,2
5,N/A,N/A,N/A,1003,1008,N/A,101,1
5,N/A,N/A,N/A,998,1003,N/A,104,4
5,N/A,N/A,N/A,993,998,N/A,107,1
6,N/A,N/A,N/A,987,993,N/A,110,4
5,N/A,N/A,N/A,982,987,N/A,115,3
5,N/A,N/A,N/A,977,982,N/A,120,2
4,N/A,N/A,N/A,973,977,N/A,125,1
5,N/A,N/A,N/A,968,973,N/A,128,4
7,N/A,N/A,N/A,961,968,N/A,134,4
7,N/A,N/A,N/A,954,961,N/A,138,2
10,N/A,N/A,N/A,460,470,N/A,4,5
4,N/A,N/A,N/A,456,460,N/A,7,2
16,N/A,N/A,N/A,440,456,N/A,11,6
5,N/A,N/A,N/A,435,440,N/A,14,3
7,N/A,N/A,N/A,428,435,N/A,19,2
13,N/A,N/A,N/A,415,428,N/A,23,6
9,N/A,N/A,N/A,406,415,N/A,28,5
9,N/A,N/A,N/A,397,406,N/A,34,5
5,N/A,N/A,N/A,392,397,N/A,38,3
5,N/A,N/A,N/A,387,392,N/A,42,1
9,N/A,N/A,N/A,378,387,N/A,46,5
7,N/A,N/A,N/A,371,378,N/A,50,3
4,N/A,N/A,N/A,367,371,N/A,54,1
8,N/A,N/A,N/A,359,367,N/A,57,4
5,N/A,N/A,N/A,354,359,N/A,63,4
4,N/A,N/A,N/A,350,354,N/A,66,1
8,N/A,N/A,N/A,342,350,N/A,69,4
5,N/A,N/A,N/A,337,342,N/A,73,2
12,N/A,N/A,N/A,325,337,N/A,76,5
10,N/A,N/A,N/A,315,325,N/A,82,5
7,N/A,N/A,N/A,308,315,N/A,87,4
7,N/A,N/A,N/A,301,308,N/A,91,2
10,N/A,N/A,N/A,291,301,N/A,94,5
4,N/A,N/A,N/A,287,291,N/A,97,2
12,N/A,N/A,N/A,275,287,N/A,101,6
7,N/A,N/A,N/A,268,275,N/A,104,3
19,N/A,N/A,N/A,249,268,N/A,107,6
7,N/A,N/A,N/A,242,249,N/A,110,3
5,N/A,N/A,N/A,237,242,N/A,114,1
8,N/A,N/A,N/A,229,237,N/A,117,4
4,N/A,N/A,N/A,1873,1877,N/A,4,1
6,N/A,N/A,N/A,1867,1873,N/A,7,4
7,N/A,N/A,N/A,1860,1867,N/A,13,4
5,N/A,N/A,N/A,1855,1860,N/A,16,1
7,N/A,N/A,N/A,1848,1855,N/A,19,4
8,N/A,N/A,N/A,1840,1848,N/A,25,4
5,N/A,N/A,N/A,1835,1840,N/A,28,1
5,N/A,N/A,N/A,1830,1835,N/A,34,1
7,N/A,N/A,N/A,1823,1830,N/A,37,4
6,N/A,N/A,N/A,1817,1823,N/A,43,4
4,N/A,N/A,N/A,1813,1817,N/A,46,1
5,N/A,N/A,N/A,1808,1813,N/A,49,4
4,N/A,N/A,N/A,1804,1808,N/A,52,1
12,N/A,N/A,N/A,1792,1804,N/A,56,5
5,N/A,N/A,N/A,1787,1792,N/A,60,3
6,N/A,N/A,N/A,1781,1787,N/A,66,3
16,N/A,N/A,N/A,1765,1781,N/A,69,6
7,N/A,N/A,N/A,1758,1765,N/A,73,4
6,N/A,N/A,N/A,1752,1758,N/A,78,3
4,N/A,N/A,N/A,1748,1752,N/A,83,2
15,N/A,N/A,N/A,1733,1748,N/A,87,6
7,N/A,N/A,N/A,1726,1733,N/A,91,4
6,N/A,N/A,N/A,1720,1726,N/A,95,2
9,N/A,N/A,N/A,1711,1720,N/A,98,5
6,N/A,N/A,N/A,1705,1711,N/A,102,3
13,N/A,N/A,N/A,1692,1705,N/A,105,6
4,N/A,N/A,N/A,1688,1692,N/A,111,0
7,N/A,N/A,N/A,1681,1688,N/A,115,4
6,N/A,N/A,N/A,1675,1681,N/A,119,2
16,N/A,N/A,N/A,1659,1675,N/A,123,6
5,N/A,N/A,N/A,1110,1115,N/A,3,3
7,N/A,N/A,N/A,1103,1110,N/A,8,2
10,N/A,N/A,N/A,1093,1103,N/A,11,5
12,N/A,N/A,N/A,1081,1093,N/A,17,5
7,N/A,N/A,N/A,1074,1081,N/A,21,3
6,N/A,N/A,N/A,1068,1074,N/A,27,3
5,N/A,N/A,N/A,1063,1068,N/A,31,1
7,N/A,N/A,N/A,1056,1063,N/A,34,4
7,N/A,N/A,N/A,1049,1056,N/A,39,3
14,N/A,N/A,N/A,1035,1049,N/A,42,6
5,N/A,N/A,N/A,1030,1035,N/A,45,3
7,N/A,N/A,N/A,1023,1030,N/A,50,2
10,N/A,N/A,N/A,1013,1023,N/A,53,5
6,N/A,N/A,N/A,1007,1013,N/A,58,4
5,N/A,N/A,N/A,1002,1007,N/A,62,2
5,N/A,N/A,N/A,997,1002,N/A,68,2
4,N/A,N/A,N/A,993,997,N/A,73,1
14,N/A,N/A,N/A,979,993,N/A,78,6
5,N/A,N/A,N/A,974,979,N/A,84,0
9,N/A,N/A,N/A,965,974,N/A,89,5
6,N/A,N/A,N/A,959,965,N/A,94,4
5,N/A,N/A,N/A,954,959,N/A,100,4
8,N/A,N/A,N/A,946,954,N/A,106,4
5,N/A,N/A,N/A,941,946,N/A,111,3
6,N/A,N/A,N/A,935,941,N/A,117,3
5,N/A,N/A,N/A,930,935,N/A,121,1
8,N/A,N/A,N/A,922,930,N/A,124,4
6,N/A,N/A,N/A,916,922,N/A,129,3
6,N/A,N/A,N/A,910,916,N/A,134,2
10,N/A,N/A,N/A,900,910,N/A,137,5
5,N/A,N/A,N/A,989,994,N/A,3,2
11,N/A,N/A,N/A,978,989,N/A,6,5
7,N/A,N/A,N/A,971,978,N/A,11,4
6,N/A,N/A,N/A,965,971,N/A,16,3
12,N/A,N/A,N/A,953,965,N/A,19,6
6,N/A,N/A,N/A,947,953,N/A,22,3
4,N/A,N/A,N/A,943,947,N/A,28,3
5,N/A,N/A,N/A,938,943,N/A,34,3
7,N/A,N/A,N/A,931,938,N/A,39,2
10,N/A,N/A,N/A,921,931,N/A,42,5
11,N/A,N/A,N/A,910,921,N/A,48,5
11,N/A,N/A,N/A,899,910,N/A,54,5
4,N/A,N/A,N/A,895,899,N/A,58,3
4,N/A,N/A,N/A,891,895,N/A,63,2
18,N/A,N/A,N/A,873,891,N/A,67,6
12,N/A,N/A,N/A,861,873,N/A,72,5
4,N/A,N/A,N/A,857,861,N/A,76,3
14,N/A,N/A,N/A,843,857,N/A,79,6
12,N/A,N/A,N/A,831,843,N/A,84,5
7,N/A,N/A,N/A,824,831,N/A,87,2
4,N/A,N/A,N/A,820,824,N/A,93,2
13,N/A,N/A,N/A,807,820,N/A,97,6
8,N/A,N/A,N/A,799,807,N/A,101,4
7,N/A,N/A,N/A,792,799,N/A,105,2
9,N/A,N/A,N/A,783,792,N/A,108,5
9,N/A,N/A,N/A,774,783,N/A,114,5
8,N/A,N/A,N/A,766,774,N/A,119,4
7,N/A,N/A,N/A,759,766,N/A,123,2
7,N/A,N/A,N/A,752,759,N/A,129,2
5,N/A,N/A,N/A,747,752,N/A,134,1
6,N/A,N/A,N/A,295,301,N/A,6,4
5,N/A,N/A,N/A,290,295,N/A,9,1
10,N/A,N/A,N/A,280,290,N/A,14,6
6,N/A,N/A,N/A,274,280,N/A,18,4
5,N/A,N/A,N/A,269,274,N/A,22,2
9,N/A,N/A,N/A,260,269,N/A,25,5
5,N/A,N/A,N/A,255,260,N/A,29,3
6,N/A,N/A,N/A,249,255,N/A,34,2
4,N/A,N/A,N/A,245,249,N/A,40,2
13,N/A,N/A,N/A,232,245,N/A,44,6
6,N/A,N/A,N/A,226,232,N/A,48,4
7,N/A,N/A,N/A,219,226,N/A,54,4
4,N/A,N/A,N/A,215,219,N/A,57,1
14,N/A,N/A,N/A,201,215,N/A,62,6
5,N/A,N/A,N/A,196,201,N/A,68,0
5,N/A,N/A,N/A,191,196,N/A,71,3
7,N/A,N/A,N/A,184,191,N/A,77,3
5,N/A,N/A,N/A,179,184,N/A,83,3
4,N/A,N/A,N/A,175,179,N/A,87,1
11,N/A,N/A,N/A,164,175,N/A,91,5
7,N/A,N/A,N/A,157,164,N/A,96,4
4,N/A,N/A,N/A,153,157,N/A,100,2
10,N/A,N/A,N/A,143,153,N/A,104,6
7,N/A,N/A,N/A,136,143,N/A,108,4
4,N/A,N/A,N/A,132,136,N/A,112,2
11,N/A,N/A,N/A,121,132,N/A,115,5
7,N/A,N/A,N/A,114,121,N/A,119,3
5,N/A,N/A,N/A,109,114,N/A,125,3
7,N/A,N/A,N/A,102,109,N/A,130,2
5,N/A,N/A,N/A,97,102,N/A,136,2
6,N/A,N/A,N/A,1754,1760,N/A,6,2
15,N/A,N/A,N/A,1739,1754,N/A,10,6
5,N/A,N/A,N/A,1734,1739,N/A,13,3
6,N/A,N/A,N/A,1728,1734,N/A,18,2
12,N/A,N/A,N/A,1716,1728,N/A,21,5
6,N/A,N/A,N/A,1710,1716,N/A,25,3
16,N/A,N/A,N/A,1694,1710,N/A,28,6
7,N/A,N/A,N/A,1687,1694,N/A,31,3
4,N/A,N/A,N/A,1683,1687,N/A,35,1
10,N/A,N/A,N/A,1673,1683,N/A,39,5
6,N/A,N/A,N/A,1667,1673,N/A,43,3
4,N/A,N/A,N/A,1663,1667,N/A,47,1
12,N/A,N/A,N/A,1651,1663,N/A,51,5
6,N/A,N/A,N/A,1645,1651,N/A,55,3
6,N/A,N/A,N/A,1639,1645,N/A,61,3
5,N/A,N/A,N/A,1634,1639,N/A,67,3
10,N/A,N/A,N/A,1624,1634,N/A,70,6
11,N/A,N/A,N/A,1613,1624,N/A,75,5
5,N/A,N/A,N/A,1608,1613,N/A,78,2
12,N/A,N/A,N/A,1596,1608,N/A,81,5
7,N/A,N/A,N/A,1589,1596,N/A,86,4
5,N/A,N/A,N/A,1584,1589,N/A,92,4
8,N/A,N/A,N/A,1576,1584,N/A,98,4
8,N/A,N/A,N/A,1568,1576,N/A,104,4
4,N/A,N/A,N/A,1564,1568,N/A,108,2
5,N/A,N/A,N/A,1559,1564,N/A,113,1
10,N/A,N/A,N/A,1549,1559,N/A,117,5
10,N/A,N/A,N/A,1539,1549,N/A,123,5
12,N/A,N/A,N/A,1527,1539,N/A,129,5
11,N/A,N/A,N/A,1516,1527,N/A,135,5
6,N/A,N/A,N/A,383,389,N/A,5,2
5,N/A,N/A,N/A,378,383,N/A,10,1
4,N/A,N/A,N/A,374,378,N/A,16,1
16,N/A,N/A,N/A,358,374,N/A,21,6
5,N/A,N/A,N/A,353,358,N/A,24,3
4,N/A,N/A,N/A,349,353,N/A,28,1
5,N/A,N/A,N/A,344,349,N/A,34,1
5,N/A,N/A,N/A,339,344,N/A,37,4
8,N/A,N/A,N/A,331,339,N/A,43,4
5,N/A,N/A,N/A,326,331,N/A,46,1
12,N/A,N/A,N/A,314,326,N/A,50,5
5,N/A,N/A,N/A,309,314,N/A,55,4
7,N/A,N/A,N/A,302,309,N/A,59,2
10,N/A,N/A,N/A,292,302,N/A,62,5
5,N/A,N/A,N/A,287,292,N/A,65,2
5,N/A,N/A,N/A,282,287,N/A,70,1
8,N/A,N/A,N/A,274,282,N/A,73,4
7,N/A,N/A,N/A,267,274,N/A,79,4
7,N/A,N/A,N/A,260,267,N/A,83,2
10,N/A,N/A,N/A,250,260,N/A,86,5
5,N/A,N/A,N/A,245,250,N/A,89,2
4,N/A,N/A,N/A,241,245,N/A,94,1
4,N/A,N/A,N/A,237,241,N/A,100,1
5,N/A,N/A,N/A,232,237,N/A,103,4
6,N/A,N/A,N/A,226,232,N/A,109,4
5,N/A,N/A,N/A,221,226,N/A,114,3
5,N/A,N/A,N/A,216,221,N/A,119,2
19,N/A,N/A,N/A,197,216,N/A,123,6
4,N/A,N/A,N/A,193,197,N/A,126,3
4,N/A,N/A,N/A,189,193,N/A,130,1
11,N/A,N/A,N/A,1658,1669,N/A,6,6
5,N/A,N/A,N/A,1653,1658,N/A,12,0
9,N/A,N/A,N/A,1644,1653,N/A,17,5
4,N/A,N/A,N/A,1640,1644,N/A,21,3
5,N/A,N/A,N/A,1635,1640,N/A,25,1
9,N/A,N/A,N/A,1626,1635,N/A,29,5
5,N/A,N/A,N/A,1621,1626,N/A,32,2
7,N/A,N/A,N/A,1614,1621,N/A,38,2
4,N/A,N/A,N/A,1610,1614,N/A,43,1
6,N/A,N/A,N/A,1604,1610,N/A,46,4
5,N/A,N/A,N/A,1599,1604,N/A,50,2
11,N/A,N/A,N/A,1588,1599,N/A,53,5
6,N/A,N/A,N/A,1582,1588,N/A,57,3
5,N/A,N/A,N/A,1577,1582,N/A,61,1
6,N/A,N/A,N/A,1571,1577,N/A,64,4
4,N/A,N/A,N/A,1567,1571,N/A,67,1
8,N/A,N/A,N/A,1559,1567,N/A,70,4
6,N/A,N/A,N/A,1553,1559,N/A,75,3
7,N/A,N/A,N/A,1546,1553,N/A,80,2
10,N/A,N/A,N/A,1536,1546,N/A,83,5
5,N/A,N/A,N/A,1531,1536,N/A,86,2
7,N/A,N/A,N/A,1524,1531,N/A,92,2
9,N/A,N/A,N/A,1515,1524,N/A,95,5
5,N/A,N/A,N/A,1510,1515,N/A,98,2
4,N/A,N/A,N/A,1506,1510,N/A,103,1
7,N/A,N/A,N/A,1499,1506,N/A,106,4
4,N/A,N/A,N/A,1495,1499,N/A,109,1
11,N/A,N/A,N/A,1484,1495,N/A,114,6
4,N/A,N/A,N/A,1480,1484,N/A,120,0
19,N/A,N/A,N/A,1461,1480,N/A,126,6
5,N/A,N/A,N/A,329,334,N/A,3,1
9,N/A,N/A,N/A,320,329,N/A,7,5
7,N/A,N/A,N/A,313,320,N/A,11,3
6,N/A,N/A,N/A,307,313,N/A,17,3
12,N/A,N/A,N/A,295,307,N/A,20,6
6,N/A,N/A,N/A,289,295,N/A,24,4
8,N/A,N/A,N/A,281,289,N/A,30,4
6,N/A,N/A,N/A,275,281,N/A,35,3
4,N/A,N/A,N/A,271,275,N/A,39,1
5,N/A,N/A,N/A,266,271,N/A,42,4
4,N/A,N/A,N/A,262,266,N/A,46,2
5,N/A,N/A,N/A,257,262,N/A,51,1
10,N/A,N/A,N/A,247,257,N/A,55,5
4,N/A,N/A,N/A,243,247,N/A,58,2
4,N/A,N/A,N/A,239,243,N/A,63,1
6,N/A,N/A,N/A,233,239,N/A,66,4
6,N/A,N/A,N/A,227,233,N/A,71,3
5,N/A,N/A,N/A,222,227,N/A,76,2
5,N/A,N/A,N/A,217,222,N/A,81,1
12,N/A,N/A,N/A,205,217,N/A,85,5
6,N/A,N/A,N/A,199,205,N/A,88,2
5,N/A,N/A,N/A,194,199,N/A,93,1
16,N/A,N/A,N/A,178,194,N/A,98,6
8,N/A,N/A,N/A,170,178,N/A,102,4
4,N/A,N/A,N/A,166,170,N/A,105,1
11,N/A,N/A,N/A,155,166,N/A,109,5
7,N/A,N/A,N/A,148,155,N/A,114,4
7,N/A,N/A,N/A,141,148,N/A,119,3
6,N/A,N/A,N/A,135,141,N/A,125,3
14,N/A,N/A,N/A,121,135,N/A,128,6
4,N/A,N/A,N/A,1936,1940,N/A,4,2
4,N/A,N/A,N/A,1932,1936,N/A,10,2
4,N/A,N/A,N/A,1928,1932,N/A,15,1
9,N/A,N/A,N/A,1919,1928,N/A,19,5
7,N/A,N/A,N/A,1912,1919,N/A,23,3
5,N/A,N/A,N/A,1907,1912,N/A,27,1
4,N/A,N/A,N/A,1903,1907,N/A,33,1
6,N/A,N/A,N/A,1897,1903,N/A,36,4
7,N/A,N/A,N/A,1890,1897,N/A,40,2
16,N/A,N/A,N/A,1874,1890,N/A,44,6
12,N/A,N/A,N/A,1862,1874,N/A,49,5
4,N/A,N/A,N/A,1858,1862,N/A,52,2
5,N/A,N/A,N/A,1853,1858,N/A,57,1
15,N/A,N/A,N/A,1838,1853,N/A,62,6
7,N/A,N/A,N/A,1831,1838,N/A,66,4
4,N/A,N/A,N/A,1827,1831,N/A,69,1
4,N/A,N/A,N/A,1823,1827,N/A,75,1
12,N/A,N/A,N/A,1811,1823,N/A,79,5
8,N/A,N/A,N/A,1803,1811,N/A,84,4
7,N/A,N/A,N/A,1796,1803,N/A,89,3
4,N/A,N/A,N/A,1792,1796,N/A,95,3
5,N/A,N/A,N/A,1787,1792,N/A,99,1
5,N/A,N/A,N/A,1782,1787,N/A,102,4
5,N/A,N/A,N/A,1777,1782,N/A,107,3
11,N/A,N/A,N/A,1766,1777,N/A,110,6
10,N/A,N/A,N/A,1756,1766,N/A,115,5
7,N/A,N/A,N/A,1749,1756,N/A,118,2
4,N/A,N/A,N/A,1745,1749,N/A,123,1
5,N/A,N/A,N/A,1740,1745,N/A,126,4
5,N/A,N/A,N/A,1735,1740,N/A,130,2
6,N/A,N/A,N/A,991,997,N/A,4,3
5,N/A,N/A,N/A,986,991,N/A,8,1
8,N/A,N/A,N/A,978,986,N/A,11,4
6,N/A,N/A,N/A,972,978,N/A,15,2
15,N/A,N/A,N/A,957,972,N/A,19,6
11,N/A,N/A,N/A,946,957,N/A,24,5
11,N/A,N/A,N/A,935,946,N/A,30,5
9,N/A,N/A,N/A,926,935,N/A,36,5
12,N/A,N/A,N/A,914,926,N/A,42,5
8,N/A,N/A,N/A,906,914,N/A,47,4
7,N/A,N/A,N/A,899,906,N/A,52,3
5,N/A,N/A,N/A,894,899,N/A,56,1
9,N/A,N/A,N/A,885,894,N/A,60,5
4,N/A,N/A,N/A,881,885,N/A,64,3
5,N/A,N/A,N/A,876,881,N/A,68,1
6,N/A,N/A,N/A,870,876,N/A,71,4
4,N/A,N/A,N/A,866,870,N/A,74,1
12,N/A,N/A,N/A,854,866,N/A,79,6
7,N/A,N/A,N/A,847,854,N/A,83,4
4,N/A,N/A,N/A,843,847,N/A,86,1
16,N/A,N/A,N/A,827,843,N/A,91,6
4,N/A,N/A,N/A,823,827,N/A,97,0
5,N/A,N/A,N/A,818,823,N/A,101,4
6,N/A,N/A,N/A,812,818,N/A,107,4
5,N/A,N/A,N/A,807,812,N/A,110,1
4,N/A,N/A,N/A,803,807,N/A,116,1
6,N/A,N/A,N/A,797,803,N/A,119,4
4,N/A,N/A,N/A,793,797,N/A,124,3
4,N/A,N/A,N/A,789,793,N/A,128,1
11,N/A,N/A,N/A,778,789,N/A,132,5
6,N/A,N/A,N/A,973,979,N/A,6,4
5,N/A,N/A,N/A,968,973,N/A,10,2
12,N/A,N/A,N/A,956,968,N/A,13,5
6,N/A,N/A,N/A,950,956,N/A,18,4
5,N/A,N/A,N/A,945,950,N/A,22,2
5,N/A,N/A,N/A,940,945,N/A,28,2
5,N/A,N/A,N/A,935,940,N/A,34,2
6,N/A,N/A,N/A,929,935,N/A,40,2
11,N/A,N/A,N/A,918,929,N/A,44,6
5,N/A,N/A,N/A,913,918,N/A,48,4
7,N/A,N/A,N/A,906,913,N/A,52,2
17,N/A,N/A,N/A,889,906,N/A,56,6
5,N/A,N/A,N/A,884,889,N/A,62,0
12,N/A,N/A,N/A,872,884,N/A,67,5
12,N/A,N/A,N/A,860,872,N/A,73,5
7,N/A,N/A,N/A,853,860,N/A,77,3
10,N/A,N/A,N/A,843,853,N/A,80,6
5,N/A,N/A,N/A,838,843,N/A,86,0
4,N/A,N/A,N/A,834,838,N/A,89,3
5,N/A,N/A,N/A,829,834,N/A,93,1
16,N/A,N/A,N/A,813,829,N/A,98,6
9,N/A,N/A,N/A,804,813,N/A,103,5
6,N/A,N/A,N/A,798,804,N/A,108,4
4,N/A,N/A,N/A,794,798,N/A,111,1
4,N/A,N/A,N/A,790,794,N/A,117,1
4,N/A,N/A,N/A,786,790,N/A,123,1
10,N/A,N/A,N/A,776,786,N/A,127,5
5,N/A,N/A,N/A,771,776,N/A,131,3
4,N/A,N/A,N/A,767,771,N/A,137,3
5,N/A,N/A,N/A,762,767,N/A,141,1
14,N/A,N/A,N/A,741,755,N/A,6,6
5,N/A,N/A,N/A,736,741,N/A,12,0
9,N/A,N/A,N/A,727,736,N/A,17,5
5,N/A,N/A,N/A,722,727,N/A,21,3
4,N/A,N/A,N/A,718,722,N/A,25,1
9,N/A,N/A,N/A,709,718,N/A,29,5
11,N/A,N/A,N/A,698,709,N/A,35,5
6,N/A,N/A,N/A,692,698,N/A,40,4
5,N/A,N/A,N/A,687,692,N/A,45,3
7,N/A,N/A,N/A,680,687,N/A,51,3
7,N/A,N/A,N/A,673,680,N/A,56,2
10,N/A,N/A,N/A,663,673,N/A,59,5
7,N/A,N/A,N/A,656,663,N/A,63,3
4,N/A,N/A,N/A,652,656,N/A,69,3
4,N/A,N/A,N/A,648,652,N/A,74,2
9,N/A,N/A,N/A,639,648,N/A,77,5
7,N/A,N/A,N/A,632,639,N/A,80,2
12,N/A,N/A,N/A,620,632,N/A,84,6
4,N/A,N/A,N/A,616,620,N/A,90,0
13,N/A,N/A,N/A,603,616,N/A,96,6
7,N/A,N/A,N/A,596,603,N/A,100,4
5,N/A,N/A,N/A,591,596,N/A,106,4
6,N/A,N/A,N/A,585,591,N/A,112,4
5,N/A,N/A,N/A,580,585,N/A,116,2
19,N/A,N/A,N/A,561,580,N/A,120,6
5,N/A,N/A,N/A,556,561,N/A,124,4
6,N/A,N/A,N/A,550,556,N/A,129,3
12,N/A,N/A,N/A,538,550,N/A,132,6
5,N/A,N/A,N/A,533,538,N/A,138,0
4,N/A,N/A,N/A,529,533,N/A,141,3
5,N/A,N/A,N/A,1796,1801,N/A,6,1
12,N/A,N/A,N/A,1784,1796,N/A,10,5
12,N/A,N/A,N/A,1772,1784,N/A,16,5
10,N/A,N/A,N/A,1762,1772,N/A,22,5
7,N/A,N/A,N/A,1755,1762,N/A,25,2
4,N/A,N/A,N/A,1751,1755,N/A,30,1
16,N/A,N/A,N/A,1735,1751,N/A,35,6
5,N/A,N/A,N/A,1730,1735,N/A,41,0
19,N/A,N/A,N/A,1711,1730,N/A,47,6
5,N/A,N/A,N/A,1706,1711,N/A,53,0
12,N/A,N/A,N/A,1694,1706,N/A,58,5
10,N/A,N/A,N/A,1684,1694,N/A,64,5
5,N/A,N/A,N/A,1679,1684,N/A,68,3
10,N/A,N/A,N/A,1669,1679,N/A,71,6
5,N/A,N/A,N/A,1664,1669,N/A,75,4
5,N/A,N/A,N/A,1659,1664,N/A,79,2
5,N/A,N/A,N/A,1654,1659,N/A,84,1
5,N/A,N/A,N/A,1649,1654,N/A,90,1
12,N/A,N/A,N/A,1637,1649,N/A,94,5
7,N/A,N/A,N/A,1630,1637,N/A,99,4
4,N/A,N/A,N/A,1626,1630,N/A,104,3
7,N/A,N/A,N/A,1619,1626,N/A,109,2
4,N/A,N/A,N/A,1615,1619,N/A,115,2
15,N/A,N/A,N/A,1600,1615,N/A,119,6
5,N/A,N/A,N/A,1595,1600,N/A,125,0
12,N/A,N/A,N/A,1583,1595,N/A,130,5
8,N/A,N/A,N/A,1575,1583,N/A,135,4
7,N/A,N/A,N/A,1568,1575,N/A,140,3
5,N/A,N/A,N/A,1563,1568,N/A,145,2
10,N/A,N/A,N/A,1553,1563,N/A,148,5
4,N/A,N/A,N/A,713,717,N/A,5,1
19,N/A,N/A,N/A,694,713,N/A,10,6
9,N/A,N/A,N/A,685,694,N/A,15,5
8,N/A,N/A,N/A,677,685,N/A,20,4
5,N/A,N/A,N/A,672,677,N/A,25,3
7,N/A,N/A,N/A,665,672,N/A,30,2
12,N/A,N/A,N/A,653,665,N/A,33,5
5,N/A,N/A,N/A,648,653,N/A,37,3
5,N/A,N/A,N/A,643,648,N/A,41,1
6,N/A,N/A,N/A,637,643,N/A,44,4
4,N/A,N/A,N/A,633,637,N/A,49,3
6,N/A,N/A,N/A,627,633,N/A,54,2
7,N/A,N/A,N/A,620,627,N/A,60,2
12,N/A,N/A,N/A,608,620,N/A,63,5
6,N/A,N/A,N/A,602,608,N/A,67,3
4,N/A,N/A,N/A,598,602,N/A,72,2
7,N/A,N/A,N/A,591,598,N/A,78,2
4,N/A,N/A,N/A,587,591,N/A,84,2
16,N/A,N/A,N/A,571,587,N/A,88,6
6,N/A,N/A,N/A,565,571,N/A,92,4
5,N/A,N/A,N/A,560,565,N/A,95,1
7,N/A,N/A,N/A,553,560,N/A,98,4
5,N/A,N/A,N/A,548,553,N/A,101,1
4,N/A,N/A,N/A,544,548,N/A,107,1
18,N/A,N/A,N/A,526,544,N/A,112,6
4,N/A,N/A,N/A,522,526,N/A,118,0
18,N/A,N/A,N/A,504,522,N/A,124,6
8,N/A,N/A,N/A,496,504,N/A,128,4
5,N/A,N/A,N/A,491,496,N/A,133,3
11,N/A,N/A,N/A,480,491,N/A,136,6
17,N/A,N/A,N/A,1729,1746,N/A,3,6
11,N/A,N/A,N/A,1718,1729,N/A,8,5
11,N/A,N/A,N/A,1707,1718,N/A,14,5
5,N/A,N/A,N/A,1702,1707,N/A,18,3
5,N/A,N/A,N/A,1697,1702,N/A,22,1
9,N/A,N/A,N/A,1688,1697,N/A,26,5
10,N/A,N/A,N/A,1678,1688,N/A,32,5
4,N/A,N/A,N/A,1674,1678,N/A,36,3
6,N/A,N/A,N/A,1668,1674,N/A,41,2
4,N/A,N/A,N/A,1664,1668,N/A,46,1
6,N/A,N/A,N/A,1658,1664,N/A,49,4
5,N/A,N/A,N/A,1653,1658,N/A,53,2
5,N/A,N/A,N/A,1648,1653,N/A,59,2
7,N/A,N/A,N/A,1641,1648,N/A,65,2
18,N/A,N/A,N/A,1623,1641,N/A,69,6
4,N/A,N/A,N/A,1619,1623,N/A,72,3
18,N/A,N/A,N/A,1601,1619,N/A,75,6
6,N/A,N/A,N/A,1595,1601,N/A,78,3
4,N/A,N/A,N/A,1591,1595,N/A,82,1
10,N/A,N/A,N/A,1581,1591,N/A,86,5
6,N/A,N/A,N/A,1575,1581,N/A,91,4
6,N/A,N/A,N/A,1569,1575,N/A,95,2
12,N/A,N/A,N/A,1557,1569,N/A,98,5
5,N/A,N/A,N/A,1552,1557,N/A,101,2
12,N/A,N/A,N/A,1540,1552,N/A,104,5
9,N/A,N/A,N/A,1531,1540,N/A,110,5
8,N/A,N/A,N/A,1523,1531,N/A,115,4
5,N/A,N/A,N/A,1518,1523,N/A,118,1
7,N/A,N/A,N/A,1511,1518,N/A,121,4
7,N/A,N/A,N/A,1504,1511,N/A,125,2
10,N/A,N/A,N/A,1946,1956,N/A,4,5
5,N/A,N/A,N/A,1941,1946,N/A,8,3
11,N/A,N/A,N/A,1930,1941,N/A,11,6
4,N/A,N/A,N/A,1926,1930,N/A,17,0
17,N/A,N/A,N/A,1909,1926,N/A,23,6
4,N/A,N/A,N/A,1905,1909,N/A,26,3
5,N/A,N/A,N/A,1900,1905,N/A,31,2
7,N/A,N/A,N/A,1893,1900,N/A,37,2
18,N/A,N/A,N/A,1875,1893,N/A,41,6
9,N/A,N/A,N/A,1866,1875,N/A,46,5
9,N/A,N/A,N/A,1857,1866,N/A,52,5
5,N/A,N/A,N/A,1852,1857,N/A,57,4
6,N/A,N/A,N/A,1846,1852,N/A,62,3
6,N/A,N/A,N/A,1840,1846,N/A,67,2
12,N/A,N/A,N/A,1828,1840,N/A,70,5
8,N/A,N/A,N/A,1820,1828,N/A,75,4
4,N/A,N/A,N/A,1816,1820,N/A,78,1
5,N/A,N/A,N/A,1811,1816,N/A,84,1
7,N/A,N/A,N/A,1804,1811,N/A,87,4
5,N/A,N/A,N/A,1799,1804,N/A,92,3
4,N/A,N/A,N/A,1795,1799,N/A,96,1
14,N/A,N/A,N/A,1781,1795,N/A,101,6
9,N/A,N/A,N/A,1772,1781,N/A,106,5
8,N/A,N/A,N/A,1764,1772,N/A,111,4
4,N/A,N/A,N/A,1760,1764,N/A,115,2
12,N/A,N/A,N/A,1748,1760,N/A,118,5
7,N/A,N/A,N/A,1741,1748,N/A,122,3
5,N/A,N/A,N/A,1736,1741,N/A,126,1
9,N/A,N/A,N/A,1727,1736,N/A,130,5
11,N/A,N/A,N/A,1716,1727,N/A,136,5
14,N/A,N/A,N/A,780,794,N/A,5,6
8,N/A,N/A,N/A,772,780,N/A,9,4
7,N/A,N/A,N/A,765,772,N/A,15,4
7,N/A,N/A,N/A,758,765,N/A,21,4
8,N/A,N/A,N/A,750,758,N/A,27,4
5,N/A,N/A,N/A,745,750,N/A,30,1
9,N/A,N/A,N/A,736,745,N/A,34,5
4,N/A,N/A,N/A,732,736,N/A,38,3
13,N/A,N/A,N/A,719,732,N/A,41,6
6,N/A,N/A,N/A,713,719,N/A,44,3
7,N/A,N/A,N/A,706,713,N/A,50,3
5,N/A,N/A,N/A,701,706,N/A,54,1
7,N/A,N/A,N/A,694,701,N/A,57,4
5,N/A,N/A,N/A,689,694,N/A,60,1
10,N/A,N/A,N/A,679,689,N/A,64,5
10,N/A,N/A,N/A,669,679,N/A,70,5
5,N/A,N/A,N/A,664,669,N/A,75,4
5,N/A,N/A,N/A,659,664,N/A,81,4
6,N/A,N/A,N/A,653,659,N/A,85,2
5,N/A,N/A,N/A,648,653,N/A,90,1
12,N/A,N/A,N/A,636,648,N/A,94,5
9,N/A,N/A,N/A,627,636,N/A,100,5
7,N/A,N/A,N/A,620,627,N/A,103,2
4,N/A,N/A,N/A,616,620,N/A,109,2
9,N/A,N/A,N/A,607,616,N/A,112,5
5,N/A,N/A,N/A,602,607,N/A,116,3
4,N/A,N/A,N/A,598,602,N/A,120,1
14,N/A,N/A,N/A,584,598,N/A,125,6
12,N/A,N/A,N/A,572,584,N/A,130,5
6,N/A,N/A,N/A,566,572,N/A,135,4
13,N/A,N/A,N/A,679,692,N/A,4,6
10,N/A,N/A,N/A,669,679,N/A,9,5
7,N/A,N/A,N/A,662,669,N/A,12,2
9,N/A,N/A,N/A,653,662,N/A,15,5
8,N/A,N/A,N/A,645,653,N/A,20,4
4,N/A,N/A,N/A,641,645,N/A,25,3
7,N/A,N/A,N/A,634,641,N/A,31,3
5,N/A,N/A,N/A,629,634,N/A,36,2
4,N/A,N/A,N/A,625,629,N/A,41,1
14,N/A,N/A,N/A,611,625,N/A,46,6
7,N/A,N/A,N/A,604,611,N/A,50,4
5,N/A,N/A,N/A,599,604,N/A,53,1
7,N/A,N/A,N/A,592,599,N/A,56,4
6,N/A,N/A,N/A,586,592,N/A,61,3
4,N/A,N/A,N/A,582,586,N/A,66,2
5,N/A,N/A,N/A,577,582,N/A,71,1
18,N/A,N/A,N/A,559,577,N/A,76,6
6,N/A,N/A,N/A,553,559,N/A,79,3
5,N/A,N/A,N/A,548,553,N/A,84,2
5,N/A,N/A,N/A,543,548,N/A,89,1
8,N/A,N/A,N/A,535,543,N/A,92,4
5,N/A,N/A,N/A,530,535,N/A,95,1
5,N/A,N/A,N/A,525,530,N/A,101,1
13,N/A,N/A,N/A,512,525,N/A,106,6
10,N/A,N/A,N/A,502,512,N/A,111,5
5,N/A,N/A,N/A,497,502,N/A,116,4
4,N/A,N/A,N/A,493,497,N/A,119,1
17,N/A,N/A,N/A,476,493,N/A,124,6
8,N/A,N/A,N/A,468,476,N/A,128,4
6,N/A,N/A,N/A,462,468,N/A,133,3
5,N/A,N/A,N/A,1138,1143,N/A,3,1
12,N/A,N/A,N/A,1126,1138,N/A,7,5
12,N/A,N/A,N/A,1114,1126,N/A,13,5
6,N/A,N/A,N/A,1108,1114,N/A,18,4
8,N/A,N/A,N/A,1100,1108,N/A,24,4
6,N/A,N/A,N/A,1094,1100,N/A,29,3
17,N/A,N/A,N/A,1077,1094,N/A,32,6
9,N/A,N/A,N/A,1068,1077,N/A,37,5
5,N/A,N/A,N/A,1063,1068,N/A,40,2
4,N/A,N/A,N/A,1059,1063,N/A,45,1
10,N/A,N/A,N/A,1049,1059,N/A,49,5
6,N/A,N/A,N/A,1043,1049,N/A,52,2
4,N/A,N/A,N/A,1039,1043,N/A,57,1
11,N/A,N/A,N/A,1028,1039,N/A,61,5
6,N/A,N/A,N/A,1022,1028,N/A,65,3
19,N/A,N/A,N/A,1003,1022,N/A,68,6
7,N/A,N/A,N/A,996,1003,N/A,72,4
7,N/A,N/A,N/A,989,996,N/A,78,4
5,N/A,N/A,N/A,984,989,N/A,81,1
10,N/A,N/A,N/A,974,984,N/A,85,5
7,N/A,N/A,N/A,967,974,N/A,90,4
5,N/A,N/A,N/A,962,967,N/A,95,3
4,N/A,N/A,N/A,958,962,N/A,101,3
15,N/A,N/A,N/A,943,958,N/A,104,6
5,N/A,N/A,N/A,938,943,N/A,108,4
4,N/A,N/A,N/A,934,938,N/A,113,3
15,N/A,N/A,N/A,919,934,N/A,116,6
5,N/A,N/A,N/A,914,919,N/A,122,0
10,N/A,N/A,N/A,904,914,N/A,127,5
5,N/A,N/A,N/A,899,904,N/A,132,4
12,N/A,N/A,N/A,1111,1123,N/A,5,6
4,N/A,N/A,N/A,1107,1111,N/A,11,0
8,N/A,N/A,N/A,1099,1107,N/A,15,4
5,N/A,N/A,N/A,1094,1099,N/A,21,4
7,N/A,N/A,N/A,1087,1094,N/A,26,3
5,N/A,N/A,N/A,1082,1087,N/A,32,3
7,N/A,N/A,N/A,1075,1082,N/A,37,2
4,N/A,N/A,N/A,1071,1075,N/A,43,2
5,N/A,N/A,N/A,1066,1071,N/A,49,2
5,N/A,N/A,N/A,1061,1066,N/A,55,2
11,N/A,N/A,N/A,1050,1061,N/A,58,5
6,N/A,N/A,N/A,1044,1050,N/A,61,2
4,N/A,N/A,N/A,1040,1044,N/A,66,1
18,N/A,N/A,N/A,1022,1040,N/A,71,6
4,N/A,N/A,N/A,1018,1022,N/A,77,0
17,N/A,N/A,N/A,1001,1018,N/A,83,6
5,N/A,N/A,N/A,996,1001,N/A,89,0
12,N/A,N/A,N/A,984,996,N/A,94,5
4,N/A,N/A,N/A,980,984,N/A,97,2
4,N/A,N/A,N/A,976,980,N/A,102,1
11,N/A,N/A,N/A,965,976,N/A,107,6
11,N/A,N/A,N/A,954,965,N/A,112,5
4,N/A,N/A,N/A,950,954,N/A,115,2
5,N/A,N/A,N/A,945,950,N/A,120,1
8,N/A,N/A,N/A,937,945,N/A,123,4
6,N/A,N/A,N/A,931,937,N/A,127,2
4,N/A,N/A,N/A,927,931,N/A,132,1
12,N/A,N/A,N/A,915,927,N/A,136,5
4,N/A,N/A,N/A,911,915,N/A,140,3
6,N/A,N/A,N/A,905,911,N/A,146,3
6,N/A,N/A,N/A,656,662,N/A,4,4
4,N/A,N/A,N/A,652,656,N/A,7,1
10,N/A,N/A,N/A,642,652,N/A,11,5
6,N/A,N/A,N/A,636,642,N/A,14,2
11,N/A,N/A,N/A,625,636,N/A,18,6
8,N/A,N/A,N/A,617,625,N/A,22,4
5,N/A,N/A,N/A,612,617,N/A,28,4
8,N/A,N/A,N/A,604,612,N/A,34,4
4,N/A,N/A,N/A,600,604,N/A,39,3
4,N/A,N/A,N/A,596,600,N/A,45,3
17,N/A,N/A,N/A,579,596,N/A,48,6
5,N/A,N/A,N/A,574,579,N/A,54,0
4,N/A,N/A,N/A,570,574,N/A,57,3
6,N/A,N/A,N/A,564,570,N/A,62,2
10,N/A,N/A,N/A,554,564,N/A,66,6
5,N/A,N/A,N/A,549,554,N/A,72,0
14,N/A,N/A,N/A,535,549,N/A,78,6
7,N/A,N/A,N/A,528,535,N/A,81,3
13,N/A,N/A,N/A,515,528,N/A,84,6
7,N/A,N/A,N/A,508,515,N/A,88,4
6,N/A,N/A,N/A,502,508,N/A,93,3
18,N/A,N/A,N/A,484,502,N/A,96,6
6,N/A,N/A,N/A,478,484,N/A,99,3
4,N/A,N/A,N/A,474,478,N/A,103,1
14,N/A,N/A,N/A,460,474,N/A,108,6
6,N/A,N/A,N/A,454,460,N/A,112,4
7,N/A,N/A,N/A,447,454,N/A,117,3
7,N/A,N/A,N/A,440,447,N/A,123,3
5,N/A,N/A,N/A,435,440,N/A,127,1
12,N/A,N/A,N/A,423,435,N/A,132,6
5,N/A,N/A,N/A,456,461,N/A,6,3
4,N/A,N/A,N/A,452,456,N/A,11,2
9,N/A,N/A,N/A,443,452,N/A,14,5
5,N/A,N/A,N/A,438,443,N/A,19,4
5,N/A,N/A,N/A,433,438,N/A,22,1
5,N/A,N/A,N/A,428,433,N/A,28,1
16,N/A,N/A,N/A,412,428,N/A,33,6
5,N/A,N/A,N/A,407,412,N/A,39,0
6,N/A,N/A,N/A,401,407,N/A,43,4
5,N/A,N/A,N/A,396,401,N/A,47,2
6,N/A,N/A,N/A,390,396,N/A,53,2
12,N/A,N/A,N/A,378,390,N/A,57,6
6,N/A,N/A,N/A,372,378,N/A,61,4
7,N/A,N/A,N/A,365,372,N/A,66,3
4,N/A,N/A,N/A,361,365,N/A,70,1
5,N/A,N/A,N/A,356,361,N/A,76,1
16,N/A,N/A,N/A,340,356,N/A,81,6
12,N/A,N/A,N/A,328,340,N/A,86,5
7,N/A,N/A,N/A,321,328,N/A,91,4
8,N/A,N/A,N/A,313,321,N/A,97,4
5,N/A,N/A,N/A,308,313,N/A,103,4
7,N/A,N/A,N/A,301,308,N/A,107,2
11,N/A,N/A,N/A,290,301,N/A,110,5
4,N/A,N/A,N/A,286,290,N/A,113,2
16,N/A,N/A,N/A,270,286,N/A,117,6
4,N/A,N/A,N/A,266,270,N/A,120,3
17,N/A,N/A,N/A,249,266,N/A,123,6
10,N/A,N/A,N/A,239,249,N/A,128,5
5,N/A,N/A,N/A,234,239,N/A,132,3
4,N/A,N/A,N/A,230,234,N/A,136,1
5,N/A,N/A,N/A,606,611,N/A,4,1
7,N/A,N/A,N/A,599,606,N/A,7,4
4,N/A,N/A,N/A,595,599,N/A,12,3
5,N/A,N/A,N/A,590,595,N/A,16,1
10,N/A,N/A,N/A,580,590,N/A,20,5
12,N/A,N/A,N/A,568,580,N/A,26,5
7,N/A,N/A,N/A,561,568,N/A,31,4
4,N/A,N/A,N/A,557,561,N/A,34,1
18,N/A,N/A,N/A,539,557,N/A,39,6
5,N/A,N/A,N/A,534,539,N/A,45,0
6,N/A,N/A,N/A,528,534,N/A,49,4
4,N/A,N/A,N/A,524,528,N/A,52,1
5,N/A,N/A,N/A,519,524,N/A,58,1
9,N/A,N/A,N/A,510,519,N/A,62,5
6,N/A,N/A,N/A,504,510,N/A,65,2
4,N/A,N/A,N/A,500,504,N/A,70,1
5,N/A,N/A,N/A,495,500,N/A,76,1
11,N/A,N/A,N/A,484,495,N/A,80,5
6,N/A,N/A,N/A,478,484,N/A,85,4
6,N/A,N/A,N/A,472,478,N/A,89,2
12,N/A,N/A,N/A,460,472,N/A,93,6
5,N/A,N/A,N/A,455,460,N/A,99,0
11,N/A,N/A,N/A,444,455,N/A,105,6
11,N/A,N/A,N/A,433,444,N/A,110,5
9,N/A,N/A,N/A,424,433,N/A,116,5
8,N/A,N/A,N/A,416,424,N/A,121,4
5,N/A,N/A,N/A,411,416,N/A,124,1
12,N/A,N/A,N/A,399,411,N/A,128,5
6,N/A,N/A,N/A,393,399,N/A,133,4
4,N/A,N/A,N/A,389,393,N/A,136,1
4,N/A,N/A,N/A,1937,1941,N/A,5,1
7,N/A,N/A,N/A,1930,1937,N/A,8,4
4,N/A,N/A,N/A,1926,1930,N/A,13,3
14,N/A,N/A,N/A,1912,1926,N/A,16,6
10,N/A,N/A,N/A,1902,1912,N/A,21,5
7,N/A,N/A,N/A,1895,1902,N/A,25,3
18,N/A,N/A,N/A,1877,1895,N/A,28,6
5,N/A,N/A,N/A,1872,1877,N/A,34,0
4,N/A,N/A,N/A,1868,1872,N/A,37,3
18,N/A,N/A,N/A,1850,1868,N/A,40,6
12,N/A,N/A,N/A,1838,1850,N/A,45,5
4,N/A,N/A,N/A,1834,1838,N/A,49,3
5,N/A,N/A,N/A,1829,1834,N/A,55,3
18,N/A,N/A,N/A,1811,1829,N/A,58,6
11,N/A,N/A,N/A,1800,1811,N/A,63,5
6,N/A,N/A,N/A,1794,1800,N/A,66,2
11,N/A,N/A,N/A,1783,1794,N/A,69,5
12,N/A,N/A,N/A,1771,1783,N/A,75,5
4,N/A,N/A,N/A,1767,1771,N/A,79,3
4,N/A,N/A,N/A,1763,1767,N/A,83,1
14,N/A,N/A,N/A,1749,1763,N/A,88,6
11,N/A,N/A,N/A,1738,1749,N/A,93,5
8,N/A,N/A,N/A,1730,1738,N/A,98,4
5,N/A,N/A,N/A,1725,1730,N/A,101,1
5,N/A,N/A,N/A,1720,1725,N/A,104,4
6,N/A,N/A,N/A,1714,1720,N/A,108,2
4,N/A,N/A,N/A,1710,1714,N/A,113,1
7,N/A,N/A,N/A,1703,1710,N/A,116,4
7,N/A,N/A,N/A,1696,1703,N/A,120,2
5,N/A,N/A,N/A,1691,1696,N/A,125,1
6,N/A,N/A,N/A,1004,1010,N/A,4,2
17,N/A,N/A,N/A,987,1004,N/A,8,6
4,N/A,N/A,N/A,983,987,N/A,14,0
6,N/A,N/A,N/A,977,983,N/A,18,4
7,N/A,N/A,N/A,970,977,N/A,23,3
5,N/A,N/A,N/A,965,970,N/A,27,1
12,N/A,N/A,N/A,953,965,N/A,32,6
4,N/A,N/A,N/A,949,953,N/A,38,0
8,N/A,N/A,N/A,941,949,N/A,42,4
5,N/A,N/A,N/A,936,941,N/A,47,3
4,N/A,N/A,N/A,932,936,N/A,53,3
7,N/A,N/A,N/A,925,932,N/A,58,2
6,N/A,N/A,N/A,919,925,N/A,64,2
4,N/A,N/A,N/A,915,919,N/A,69,1
8,N/A,N/A,N/A,907,915,N/A,72,4
5,N/A,N/A,N/A,902,907,N/A,77,3
5,N/A,N/A,N/A,897,902,N/A,82,2
11,N/A,N/A,N/A,886,897,N/A,85,5
7,N/A,N/A,N/A,879,886,N/A,89,3
4,N/A,N/A,N/A,875,879,N/A,95,3
7,N/A,N/A,N/A,868,875,N/A,100,2
12,N/A,N/A,N/A,856,868,N/A,103,5
11,N/A,N/A,N/A,845,856,N/A,109,5
7,N/A,N/A,N/A,838,845,N/A,113,3
4,N/A,N/A,N/A,834,838,N/A,118,2
18,N/A,N/A,N/A,816,834,N/A,122,6
5,N/A,N/A,N/A,811,816,N/A,128,0
11,N/A,N/A,N/A,800,811,N/A,134,6
6,N/A,N/A,N/A,794,800,N/A,137,3
6,N/A,N/A,N/A,788,794,N/A,142,2
4,N/A,N/A,N/A,1827,1831,N/A,6,3
6,N/A,N/A,N/A,1821,1827,N/A,12,3
16,N/A,N/A,N/A,1805,1821,N/A,15,6
4,N/A,N/A,N/A,1801,1805,N/A,21,0
10,N/A,N/A,N/A,1791,1801,N/A,26,5
4,N/A,N/A,N/A,1787,1791,N/A,29,2
5,N/A,N/A,N/A,1782,1787,N/A,34,1
12,N/A,N/A,N/A,1770,1782,N/A,38,5
6,N/A,N/A,N/A,1764,1770,N/A,41,2
12,N/A,N/A,N/A,1752,1764,N/A,45,6
4,N/A,N/A,N/A,1748,1752,N/A,51,0
11,N/A,N/A,N/A,1737,1748,N/A,57,6
5,N/A,N/A,N/A,1732,1737,N/A,63,0
7,N/A,N/A,N/A,1725,1732,N/A,66,3
4,N/A,N/A,N/A,1721,1725,N/A,72,3
4,N/A,N/A,N/A,1717,1721,N/A,77,2
12,N/A,N/A,N/A,1705,1717,N/A,81,6
7,N/A,N/A,N/A,1698,1705,N/A,84,3
16,N/A,N/A,N/A,1682,1698,N/A,87,6
5,N/A,N/A,N/A,1677,1682,N/A,91,4
5,N/A,N/A,N/A,1672,1677,N/A,95,2
10,N/A,N/A,N/A,1662,1672,N/A,98,5
6,N/A,N/A,N/A,1656,1662,N/A,103,4
5,N/A,N/A,N/A,1651,1656,N/A,107,2
5,N/A,N/A,N/A,1646,1651,N/A,112,1
6,N/A,N/A,N/A,1640,1646,N/A,115,4
6,N/A,N/A,N/A,1634,1640,N/A,121,4
5,N/A,N/A,N/A,1629,1634,N/A,124,1
11,N/A,N/A,N/A,1618,1629,N/A,129,6
5,N/A,N/A,N/A,1613,1618,N/A,135,0
4,N/A,N/A,N/A,607,611,N/A,3,1
16,N/A,N/A,N/A,591,607,N/A,8,6
7,N/A,N/A,N/A,584,591,N/A,11,3
13,N/A,N/A,N/A,571,584,N/A,14,6
8,N/A,N/A,N/A,563,571,N/A,18,4
6,N/A,N/A,N/A,557,563,N/A,22,2
12,N/A,N/A,N/A,545,557,N/A,25,5
5,N/A,N/A,N/A,540,545,N/A,29,3
4,N/A,N/A,N/A,536,540,N/A,34,2
10,N/A,N/A,N/A,526,536,N/A,38,6
4,N/A,N/A,N/A,522,526,N/A,41,3
6,N/A,N/A,N/A,516,522,N/A,46,2
19,N/A,N/A,N/A,497,516,N/A,50,6
11,N/A,N/A,N/A,486,497,N/A,55,5
7,N/A,N/A,N/A,479,486,N/A,58,2
7,N/A,N/A,N/A,472,479,N/A,64,2
18,N/A,N/A,N/A,454,472,N/A,68,6
7,N/A,N/A,N/A,447,454,N/A,71,3
5,N/A,N/A,N/A,442,447,N/A,75,1
5,N/A,N/A,N/A,437,442,N/A,78,4
7,N/A,N/A,N/A,430,437,N/A,82,2
9,N/A,N/A,N/A,421,430,N/A,85,5
4,N/A,N/A,N/A,417,421,N/A,89,3
12,N/A,N/A,N/A,405,417,N/A,92,6
6,N/A,N/A,N/A,399,405,N/A,95,3
5,N/A,N/A,N/A,394,399,N/A,100,2
4,N/A,N/A,N/A,390,394,N/A,105,1
5,N/A,N/A,N/A,385,390,N/A,108,4
7,N/A,N/A,N/A,378,385,N/A,113,3
19,N/A,N/A,N/A,359,378,N/A,116,6
11,N/A,N/A,N/A,644,655,N/A,3,5
9,N/A,N/A,N/A,635,644,N/A,9,5
5,N/A,N/A,N/A,630,635,N/A,13,3
5,N/A,N/A,N/A,625,630,N/A,17,1
13,N/A,N/A,N/A,612,625,N/A,22,6
11,N/A,N/A,N/A,601,612,N/A,27,5
9,N/A,N/A,N/A,592,601,N/A,33,5
12,N/A,N/A,N/A,580,592,N/A,39,5
10,N/A,N/A,N/A,570,580,N/A,45,5
7,N/A,N/A,N/A,563,570,N/A,50,4
4,N/A,N/A,N/A,559,563,N/A,55,3
7,N/A,N/A,N/A,552,559,N/A,60,2
9,N/A,N/A,N/A,543,552,N/A,63,5
11,N/A,N/A,N/A,532,543,N/A,69,5
5,N/A,N/A,N/A,527,532,N/A,74,4
7,N/A,N/A,N/A,520,527,N/A,80,4
4,N/A,N/A,N/A,516,520,N/A,84,2
18,N/A,N/A,N/A,498,516,N/A,88,6
7,N/A,N/A,N/A,491,498,N/A,91,3
16,N/A,N/A,N/A,475,491,N/A,94,6
11,N/A,N/A,N/A,464,475,N/A,99,5
7,N/A,N/A,N/A,457,464,N/A,103,3
5,N/A,N/A,N/A,452,457,N/A,109,3
5,N/A,N/A,N/A,447,452,N/A,115,3
18,N/A,N/A,N/A,429,447,N/A,118,6
12,N/A,N/A,N/A,417,429,N/A,123,5
4,N/A,N/A,N/A,413,417,N/A,126,2
6,N/A,N/A,N/A,407,413,N/A,132,2
11,N/A,N/A,N/A,396,407,N/A,135,5
6,N/A,N/A,N/A,390,396,N/A,138,2
16,N/A,N/A,N/A,1634,1650,N/A,4,6
4,N/A,N/A,N/A,1630,1634,N/A,10,0
10,N/A,N/A,N/A,1620,1630,N/A,16,6
5,N/A,N/A,N/A,1615,1620,N/A,22,0
11,N/A,N/A,N/A,1604,1615,N/A,27,5
9,N/A,N/A,N/A,1595,1604,N/A,33,5
7,N/A,N/A,N/A,1588,1595,N/A,36,2
7,N/A,N/A,N/A,1581,1588,N/A,42,2
5,N/A,N/A,N/A,1576,1581,N/A,48,2
4,N/A,N/A,N/A,1572,1576,N/A,53,1
10,N/A,N/A,N/A,1562,1572,N/A,57,5
11,N/A,N/A,N/A,1551,1562,N/A,63,5
7,N/A,N/A,N/A,1544,1551,N/A,67,3
5,N/A,N/A,N/A,1539,1544,N/A,71,1
4,N/A,N/A,N/A,1535,1539,N/A,77,1
5,N/A,N/A,N/A,1530,1535,N/A,83,1
4,N/A,N/A,N/A,1526,1530,N/A,89,1
17,N/A,N/A,N/A,1509,1526,N/A,94,6
5,N/A,N/A,N/A,1504,1509,N/A,97,3
4,N/A,N/A,N/A,1500,1504,N/A,102,2
15,N/A,N/A,N/A,1485,1500,N/A,106,6
11,N/A,N/A,N/A,1474,1485,N/A,111,5
6,N/A,N/A,N/A,1468,1474,N/A,114,2
11,N/A,N/A,N/A,1457,1468,N/A,117,5
4,N/A,N/A,N/A,1453,1457,N/A,121,3
4,N/A,N/A,N/A,1449,1453,N/A,126,2
7,N/A,N/A,N/A,1442,1449,N/A,132,2
6,N/A,N/A,N/A,1436,1442,N/A,138,2
7,N/A,N/A,N/A,1429,1436,N/A,144,2
12,N/A,N/A,N/A,1417,1429,N/A,147,5
6,N/A,N/A,N/A,353,359,N/A,5,3
5,N/A,N/A,N/A,348,353,N/A,10,2
5,N/A,N/A,N/A,343,348,N/A,15,1
10,N/A,N/A,N/A,333,343,N/A,19,5
10,N/A,N/A,N/A,323,333,N/A,25,5
4,N/A,N/A,N/A,319,323,N/A,28,2
10,N/A,N/A,N/A,309,319,N/A,32,6
6,N/A,N/A,N/A,303,309,N/A,35,3
16,N/A,N/A,N/A,287,303,N/A,38,6
8,N/A,N/A,N/A,279,287,N/A,42,4
5,N/A,N/A,N/A,274,279,N/A,48,4
5,N/A,N/A,N/A,269,274,N/A,51,1
4,N/A,N/A,N/A,265,269,N/A,57,1
7,N/A,N/A,N/A,258,265,N/A,60,4
5,N/A,N/A,N/A,253,258,N/A,63,1
9,N/A,N/A,N/A,244,253,N/A,67,5
10,N/A,N/A,N/A,234,244,N/A,73,5
4,N/A,N/A,N/A,230,234,N/A,77,3
4,N/A,N/A,N/A,226,230,N/A,81,1
8,N/A,N/A,N/A,218,226,N/A,84,4
7,N/A,N/A,N/A,211,218,N/A,90,4
6,N/A,N/A,N/A,205,211,N/A,96,4
4,N/A,N/A,N/A,201,205,N/A,101,3
12,N/A,N/A,N/A,189,201,N/A,104,6
5,N/A,N/A,N/A,184,189,N/A,110,0
11,N/A,N/A,N/A,173,184,N/A,115,5
7,N/A,N/A,N/A,166,173,N/A,119,3
4,N/A,N/A,N/A,162,166,N/A,123,1
9,N/A,N/A,N/A,153,162,N/A,127,5
6,N/A,N/A,N/A,147,153,N/A,132,4
6,N/A,N/A,N/A,658,664,N/A,3,4
5,N/A,N/A,N/A,653,658,N/A,7,2
12,N/A,N/A,N/A,641,653,N/A,10,5
4,N/A,N/A,N/A,637,641,N/A,14,3
4,N/A,N/A,N/A,633,637,N/A,20,3
5,N/A,N/A,N/A,628,633,N/A,25,2
11,N/A,N/A,N/A,617,628,N/A,29,6
5,N/A,N/A,N/A,612,617,N/A,33,4
4,N/A,N/A,N/A,608,612,N/A,37,2
9,N/A,N/A,N/A,599,608,N/A,40,5
5,N/A,N/A,N/A,594,599,N/A,45,4
6,N/A,N/A,N/A,588,594,N/A,49,2
5,N/A,N/A,N/A,583,588,N/A,55,2
16,N/A,N/A,N/A,567,583,N/A,59,6
11,N/A,N/A,N/A,556,567,N/A,64,5
12,N/A,N/A,N/A,544,556,N/A,70,5
5,N/A,N/A,N/A,539,544,N/A,74,3
6,N/A,N/A,N/A,533,539,N/A,80,3
6,N/A,N/A,N/A,527,533,N/A,86,3
7,N/A,N/A,N/A,520,527,N/A,91,2
12,N/A,N/A,N/A,508,520,N/A,94,5
6,N/A,N/A,N/A,502,508,N/A,97,2
12,N/A,N/A,N/A,490,502,N/A,101,6
5,N/A,N/A,N/A,485,490,N/A,105,4
6,N/A,N/A,N/A,479,485,N/A,109,2
11,N/A,N/A,N/A,468,479,N/A,112,5
4,N/A,N/A,N/A,464,468,N/A,115,2
12,N/A,N/A,N/A,452,464,N/A,118,5
8,N/A,N/A,N/A,444,452,N/A,123,4
5,N/A,N/A,N/A,439,444,N/A,128,3
4,N/A,N/A,N/A,1733,1737,N/A,3,1
4,N/A,N/A,N/A,1729,1733,N/A,9,1
7,N/A,N/A,N/A,1722,1729,N/A,12,4
5,N/A,N/A,N/A,1717,1722,N/A,18,4
4,N/A,N/A,N/A,1713,1717,N/A,21,1
12,N/A,N/A,N/A,1701,1713,N/A,26,6
4,N/A,N/A,N/A,1697,1701,N/A,29,3
10,N/A,N/A,N/A,1687,1697,N/A,32,6
5,N/A,N/A,N/A,1682,1687,N/A,38,0
18,N/A,N/A,N/A,1664,1682,N/A,44,6
12,N/A,N/A,N/A,1652,1664,N/A,49,5
6,N/A,N/A,N/A,1646,1652,N/A,52,2
7,N/A,N/A,N/A,1639,1646,N/A,58,2
5,N/A,N/A,N/A,1634,1639,N/A,64,2
17,N/A,N/A,N/A,1617,1634,N/A,68,6
10,N/A,N/A,N/A,1607,1617,N/A,73,5
4,N/A,N/A,N/A,1603,1607,N/A,76,2
10,N/A,N/A,N/A,1593,1603,N/A,79,5
7,N/A,N/A,N/A,1586,1593,N/A,83,3
13,N/A,N/A,N/A,1573,1586,N/A,86,6
7,N/A,N/A,N/A,1566,1573,N/A,89,3
7,N/A,N/A,N/A,1559,1566,N/A,94,2
16,N/A,N/A,N/A,1543,1559,N/A,98,6
5,N/A,N/A,N/A,1538,1543,N/A,104,0
9,N/A,N/A,N/A,1529,1538,N/A,109,5
7,N/A,N/A,N/A,1522,1529,N/A,113,3
11,N/A,N/A,N/A,1511,1522,N/A,116,6
9,N/A,N/A,N/A,1502,1511,N/A,121,5
10,N/A,N/A,N/A,1492,1502,N/A,127,5
4,N/A,N/A,N/A,1488,1492,N/A,130,2
4,N/A,N/A,N/A,1420,1424,N/A,6,2
10,N/A,N/A,N/A,1410,1420,N/A,9,5
4,N/A,N/A,N/A,1406,1410,N/A,13,3
14,N/A,N/A,N/A,1392,1406,N/A,16,6
4,N/A,N/A,N/A,1388,1392,N/A,19,3
4,N/A,N/A,N/A,1384,1388,N/A,24,2
4,N/A,N/A,N/A,1380,1384,N/A,30,2
4,N/A,N/A,N/A,1376,1380,N/A,36,2
11,N/A,N/A,N/A,1365,1376,N/A,39,5
12,N/A,N/A,N/A,1353,1365,N/A,45,5
5,N/A,N/A,N/A,1348,1353,N/A,49,3
5,N/A,N/A,N/A,1343,1348,N/A,53,1
10,N/A,N/A,N/A,1333,1343,N/A,57,5
4,N/A,N/A,N/A,1329,1333,N/A,61,3
5,N/A,N/A,N/A,1324,1329,N/A,65,1
10,N/A,N/A,N/A,1314,1324,N/A,69,5
6,N/A,N/A,N/A,1308,1314,N/A,72,2
4,N/A,N/A,N/A,1304,1308,N/A,77,1
11,N/A,N/A,N/A,1293,1304,N/A,81,5
10,N/A,N/A,N/A,1283,1293,N/A,87,5
6,N/A,N/A,N/A,1277,1283,N/A,90,2
4,N/A,N/A,N/A,1273,1277,N/A,95,1
10,N/A,N/A,N/A,1263,1273,N/A,100,6
5,N/A,N/A,N/A,1258,1263,N/A,103,3
4,N/A,N/A,N/A,1254,1258,N/A,109,3
5,N/A,N/A,N/A,1249,1254,N/A,115,3
4,N/A,N/A,N/A,1245,1249,N/A,120,2
10,N/A,N/A,N/A,1235,1245,N/A,123,5
12,N/A,N/A,N/A,1223,1235,N/A,129,5
12,N/A,N/A,N/A,1211,1223,N/A,135,5
8,N/A,N/A,N/A,405,413,N/A,4,4
6,N/A,N/A,N/A,399,405,N/A,9,3
6,N/A,N/A,N/A,393,399,N/A,14,2
4,N/A,N/A,N/A,389,393,N/A,19,1
12,N/A,N/A,N/A,377,389,N/A,23,5
4,N/A,N/A,N/A,373,377,N/A,27,3
5,N/A,N/A,N/A,368,373,N/A,31,1
5,N/A,N/A,N/A,363,368,N/A,37,1
10,N/A,N/A,N/A,353,363,N/A,41,5
6,N/A,N/A,N/A,347,353,N/A,45,3
4,N/A,N/A,N/A,343,347,N/A,50,2
7,N/A,N/A,N/A,336,343,N/A,56,2
6,N/A,N/A,N/A,330,336,N/A,62,2
5,N/A,N/A,N/A,325,330,N/A,68,2
4,N/A,N/A,N/A,321,325,N/A,73,1
4,N/A,N/A,N/A,317,321,N/A,79,1
11,N/A,N/A,N/A,306,317,N/A,83,5
4,N/A,N/A,N/A,302,306,N/A,86,2
5,N/A,N/A,N/A,297,302,N/A,92,2
10,N/A,N/A,N/A,287,297,N/A,95,5
5,N/A,N/A,N/A,282,287,N/A,99,3
5,N/A,N/A,N/A,277,282,N/A,104,2
5,N/A,N/A,N/A,272,277,N/A,109,1
4,N/A,N/A,N/A,268,272,N/A,115,1
12,N/A,N/A,N/A,256,268,N/A,119,5
6,N/A,N/A,N/A,250,256,N/A,122,2
12,N/A,N/A,N/A,238,250,N/A,125,5
4,N/A,N/A,N/A,234,238,N/A,129,3
5,N/A,N/A,N/A,229,234,N/A,133,1
10,N/A,N/A,N/A,219,229,N/A,138,6
7,N/A,N/A,N/A,879,886,N/A,6,4
4,N/A,N/A,N/A,875,879,N/A,9,1
10,N/A,N/A,N/A,865,875,N/A,13,5
7,N/A,N/A,N/A,858,865,N/A,18,4
8,N/A,N/A,N/A,850,858,N/A,24,4
6,N/A,N/A,N/A,844,850,N/A,28,2
14,N/A,N/A,N/A,830,844,N/A,32,6
7,N/A,N/A,N/A,823,830,N/A,35,3
7,N/A,N/A,N/A,816,823,N/A,41,3
7,N/A,N/A,N/A,809,816,N/A,47,3
6,N/A,N/A,N/A,803,809,N/A,53,3
7,N/A,N/A,N/A,796,803,N/A,59,3
13,N/A,N/A,N/A,783,796,N/A,62,6
4,N/A,N/A,N/A,779,783,N/A,65,3
7,N/A,N/A,N/A,772,779,N/A,71,3
11,N/A,N/A,N/A,761,772,N/A,74,6
4,N/A,N/A,N/A,757,761,N/A,80,0
5,N/A,N/A,N/A,752,757,N/A,84,4
6,N/A,N/A,N/A,746,752,N/A,89,3
11,N/A,N/A,N/A,735,746,N/A,92,6
7,N/A,N/A,N/A,728,735,N/A,95,3
5,N/A,N/A,N/A,723,728,N/A,99,1
9,N/A,N/A,N/A,714,723,N/A,103,5
5,N/A,N/A,N/A,709,714,N/A,106,2
5,N/A,N/A,N/A,704,709,N/A,112,2
19,N/A,N/A,N/A,685,704,N/A,116,6
7,N/A,N/A,N/A,678,685,N/A,120,4
5,N/A,N/A,N/A,673,678,N/A,125,3
7,N/A,N/A,N/A,666,673,N/A,130,2
5,N/A,N/A,N/A,661,666,N/A,136,2
6,N/A,N/A,N/A,1557,1563,N/A,4,3
4,N/A,N/A,N/A,1553,1557,N/A,8,1
5,N/A,N/A,N/A,1548,1553,N/A,14,1
9,N/A,N/A,N/A,1539,1548,N/A,18,5
6,N/A,N/A,N/A,1533,1539,N/A,21,2
5,N/A,N/A,N/A,1528,1533,N/A,26,1
4,N/A,N/A,N/A,1524,1528,N/A,32,1
9,N/A,N/A,N/A,1515,1524,N/A,36,5
7,N/A,N/A,N/A,1508,1515,N/A,39,2
7,N/A,N/A,N/A,1501,1508,N/A,45,2
5,N/A,N/A,N/A,1496,1501,N/A,51,2
10,N/A,N/A,N/A,1486,1496,N/A,54,5
4,N/A,N/A,N/A,1482,1486,N/A,57,2
11,N/A,N/A,N/A,1471,1482,N/A,60,5
8,N/A,N/A,N/A,1463,1471,N/A,65,4
4,N/A,N/A,N/A,1459,1463,N/A,68,1
10,N/A,N/A,N/A,1449,1459,N/A,73,6
5,N/A,N/A,N/A,1444,1449,N/A,79,0
12,N/A,N/A,N/A,1432,1444,N/A,84,5
5,N/A,N/A,N/A,1427,1432,N/A,87,2
9,N/A,N/A,N/A,1418,1427,N/A,90,5
11,N/A,N/A,N/A,1407,1418,N/A,96,5
5,N/A,N/A,N/A,1402,1407,N/A,100,3
6,N/A,N/A,N/A,1396,1402,N/A,105,2
10,N/A,N/A,N/A,1386,1396,N/A,109,6
8,N/A,N/A,N/A,1378,1386,N/A,113,4
5,N/A,N/A,N/A,1373,1378,N/A,119,4
4,N/A,N/A,N/A,1369,1373,N/A,123,2
18,N/A,N/A,N/A,1351,1369,N/A,127,6
8,N/A,N/A,N/A,1343,1351,N/A,131,4
19,N/A,N/A,N/A,322,341,N/A,4,6
9,N/A,N/A,N/A,313,322,N/A,9,5
6,N/A,N/A,N/A,307,313,N/A,12,2
4,N/A,N/A,N/A,303,307,N/A,17,1
6,N/A,N/A,N/A,297,303,N/A,20,4
7,N/A,N/A,N/A,290,297,N/A,25,3
7,N/A,N/A,N/A,283,290,N/A,30,2
4,N/A,N/A,N/A,279,283,N/A,36,2
5,N/A,N/A,N/A,274,279,N/A,41,1
6,N/A,N/A,N/A,268,274,N/A,44,4
8,N/A,N/A,N/A,260,268,N/A,50,4
4,N/A,N/A,N/A,256,260,N/A,55,3
4,N/A,N/A,N/A,252,256,N/A,59,1
6,N/A,N/A,N/A,246,252,N/A,62,4
4,N/A,N/A,N/A,242,246,N/A,65,1
4,N/A,N/A,N/A,238,242,N/A,71,1
9,N/A,N/A,N/A,229,238,N/A,75,5
5,N/A,N/A,N/A,224,229,N/A,80,4
5,N/A,N/A,N/A,219,224,N/A,83,1
5,N/A,N/A,N/A,214,219,N/A,89,1
17,N/A,N/A,N/A,197,214,N/A,94,6
5,N/A,N/A,N/A,192,197,N/A,100,0
12,N/A,N/A,N/A,180,192,N/A,106,6
10,N/A,N/A,N/A,170,180,N/A,111,5
4,N/A,N/A,N/A,166,170,N/A,115,3
5,N/A,N/A,N/A,161,166,N/A,119,1
4,N/A,N/A,N/A,157,161,N/A,125,1
5,N/A,N/A,N/A,152,157,N/A,131,1
5,N/A,N/A,N/A,147,152,N/A,137,1
8,N/A,N/A,N/A,139,147,N/A,140,4
4,N/A,N/A,N/A,1714,1718,N/A,5,2
11,N/A,N/A,N/A,1703,1714,N/A,8,5
4,N/A,N/A,N/A,1699,1703,N/A,12,3
12,N/A,N/A,N/A,1687,1699,N/A,15,6
7,N/A,N/A,N/A,1680,1687,N/A,18,3
4,N/A,N/A,N/A,1676,1680,N/A,24,3
17,N/A,N/A,N/A,1659,1676,N/A,27,6
4,N/A,N/A,N/A,1655,1659,N/A,33,0
5,N/A,N/A,N/A,1650,1655,N/A,37,4
4,N/A,N/A,N/A,1646,1650,N/A,41,2
10,N/A,N/A,N/A,1636,1646,N/A,44,5
5,N/A,N/A,N/A,1631,1636,N/A,48,3
7,N/A,N/A,N/A,1624,1631,N/A,53,2
11,N/A,N/A,N/A,1613,1624,N/A,56,5
9,N/A,N/A,N/A,1604,1613,N/A,62,5
6,N/A,N/A,N/A,1598,1604,N/A,67,4
6,N/A,N/A,N/A,1592,1598,N/A,71,2
19,N/A,N/A,N/A,1573,1592,N/A,75,6
12,N/A,N/A,N/A,1561,1573,N/A,80,5
6,N/A,N/A,N/A,1555,1561,N/A,85,4
7,N/A,N/A,N/A,1548,1555,N/A,91,4
6,N/A,N/A,N/A,1542,1548,N/A,95,2
9,N/A,N/A,N/A,1533,1542,N/A,98,5
5,N/A,N/A,N/A,1528,1533,N/A,103,4
7,N/A,N/A,N/A,1521,1528,N/A,107,2
12,N/A,N/A,N/A,1509,1521,N/A,110,5
7,N/A,N/A,N/A,1502,1509,N/A,115,4
5,N/A,N/A,N/A,1497,1502,N/A,121,4
8,N/A,N/A,N/A,1489,1497,N/A,127,4
5,N/A,N/A,N/A,1484,1489,N/A,131,2
15,N/A,N/A,N/A,1426,1441,N/A,6,6
12,N/A,N/A,N/A,1414,1426,N/A,11,5
10,N/A,N/A,N/A,1404,1414,N/A,17,5
5,N/A,N/A,N/A,1399,1404,N/A,22,4
6,N/A,N/A,N/A,1393,1399,N/A,26,2
4,N/A,N/A,N/A,1389,1393,N/A,31,1
10,N/A,N/A,N/A,1379,1389,N/A,35,5
6,N/A,N/A,N/A,1373,1379,N/A,38,2
4,N/A,N/A,N/A,1369,1373,N/A,43,1
11,N/A,N/A,N/A,1358,1369,N/A,48,6
12,N/A,N/A,N/A,1346,1358,N/A,53,5
5,N/A,N/A,N/A,1341,1346,N/A,56,2
4,N/A,N/A,N/A,1337,1341,N/A,61,1
10,N/A,N/A,N/A,1327,1337,N/A,66,6
5,N/A,N/A,N/A,1322,1327,N/A,72,0
13,N/A,N/A,N/A,1309,1322,N/A,78,6
6,N/A,N/A,N/A,1303,1309,N/A,82,4
6,N/A,N/A,N/A,1297,1303,N/A,86,2
4,N/A,N/A,N/A,1293,1297,N/A,91,1
5,N/A,N/A,N/A,1288,1293,N/A,94,4
7,N/A,N/A,N/A,1281,1288,N/A,100,4
5,N/A,N/A,N/A,1276,1281,N/A,104,2
11,N/A,N/A,N/A,1265,1276,N/A,108,6
7,N/A,N/A,N/A,1258,1265,N/A,112,4
4,N/A,N/A,N/A,1254,1258,N/A,115,1
12,N/A,N/A,N/A,1242,1254,N/A,120,6
8,N/A,N/A,N/A,1234,1242,N/A,124,4
6,N/A,N/A,N/A,1228,1234,N/A,128,2
5,N/A,N/A,N/A,1223,1228,N/A,133,1
6,N/A,N/A,N/A,1217,1223,N/A,136,4
18,N/A,N/A,N/A,891,909,N/A,4,6
9,N/A,N/A,N/A,882,891,N/A,9,5
7,N/A,N/A,N/A,875,882,N/A,13,3
4,N/A,N/A,N/A,871,875,N/A,19,3
6,N/A,N/A,N/A,865,871,N/A,24,2
12,N/A,N/A,N/A,853,865,N/A,27,5
4,N/A,N/A,N/A,849,853,N/A,31,3
7,N/A,N/A,N/A,842,849,N/A,37,3
6,N/A,N/A,N/A,836,842,N/A,43,3
17,N/A,N/A,N/A,819,836,N/A,46,6
10,N/A,N/A,N/A,809,819,N/A,51,5
6,N/A,N/A,N/A,803,809,N/A,56,4
7,N/A,N/A,N/A,796,803,N/A,62,4
4,N/A,N/A,N/A,792,796,N/A,65,1
10,N/A,N/A,N/A,782,792,N/A,70,6
6,N/A,N/A,N/A,776,782,N/A,74,4
6,N/A,N/A,N/A,770,776,N/A,80,4
5,N/A,N/A,N/A,765,770,N/A,83,1
6,N/A,N/A,N/A,759,765,N/A,86,4
5,N/A,N/A,N/A,754,759,N/A,90,2
4,N/A,N/A,N/A,750,754,N/A,95,1
4,N/A,N/A,N/A,746,750,N/A,101,1
12,N/A,N/A,N/A,734,746,N/A,105,5
9,N/A,N/A,N/A,725,734,N/A,111,5
6,N/A,N/A,N/A,719,725,N/A,114,2
19,N/A,N/A,N/A,700,719,N/A,118,6
5,N/A,N/A,N/A,695,700,N/A,124,0
16,N/A,N/A,N/A,679,695,N/A,130,6
4,N/A,N/A,N/A,675,679,N/A,136,0
11,N/A,N/A,N/A,664,675,N/A,141,5
10,N/A,N/A,N/A,1604,1614,N/A,6,5
11,N/A,N/A,N/A,1593,1604,N/A,12,5
6,N/A,N/A,N/A,1587,1593,N/A,15,2
4,N/A,N/A,N/A,1583,1587,N/A,21,2
5,N/A,N/A,N/A,1578,1583,N/A,26,1
5,N/A,N/A,N/A,1573,1578,N/A,32,1
11,N/A,N/A,N/A,1562,1573,N/A,37,6
12,N/A,N/A,N/A,1550,1562,N/A,42,5
9,N/A,N/A,N/A,1541,1550,N/A,48,5
10,N/A,N/A,N/A,1531,1541,N/A,54,5
5,N/A,N/A,N/A,1526,1531,N/A,59,4
5,N/A,N/A,N/A,1521,1526,N/A,62,1
10,N/A,N/A,N/A,1511,1521,N/A,66,5
7,N/A,N/A,N/A,1504,1511,N/A,70,3
7,N/A,N/A,N/A,1497,1504,N/A,76,3
5,N/A,N/A,N/A,1492,1497,N/A,80,1
7,N/A,N/A,N/A,1485,1492,N/A,83,4
8,N/A,N/A,N/A,1477,1485,N/A,89,4
4,N/A,N/A,N/A,1473,1477,N/A,93,2
7,N/A,N/A,N/A,1466,1473,N/A,99,2
9,N/A,N/A,N/A,1457,1466,N/A,102,5
6,N/A,N/A,N/A,1451,1457,N/A,106,3
7,N/A,N/A,N/A,1444,1451,N/A,112,3
4,N/A,N/A,N/A,1440,1444,N/A,117,2
11,N/A,N/A,N/A,1429,1440,N/A,120,5
4,N/A,N/A,N/A,1425,1429,N/A,124,3
5,N/A,N/A,N/A,1420,1425,N/A,128,1
19,N/A,N/A,N/A,1401,1420,N/A,133,6
9,N/A,N/A,N/A,1392,1401,N/A,138,5
7,N/A,N/A,N/A,1385,1392,N/A,141,2
7,N/A,N/A,N/A,1251,1258,N/A,6,3
4,N/A,N/A,N/A,1247,1251,N/A,10,1
5,N/A,N/A,N/A,1242,1247,N/A,16,1
7,N/A,N/A,N/A,1235,1242,N/A,19,4
5,N/A,N/A,N/A,1230,1235,N/A,24,3
7,N/A,N/A,N/A,1223,1230,N/A,30,3
5,N/A,N/A,N/A,1218,1223,N/A,36,3
7,N/A,N/A,N/A,1211,1218,N/A,42,3
4,N/A,N/A,N/A,1207,1211,N/A,47,2
5,N/A,N/A,N/A,1202,1207,N/A,53,2
12,N/A,N/A,N/A,1190,1202,N/A,56,5
9,N/A,N/A,N/A,1181,1190,N/A,62,5
6,N/A,N/A,N/A,1175,1181,N/A,67,4
5,N/A,N/A,N/A,1170,1175,N/A,73,4
7,N/A,N/A,N/A,1163,1170,N/A,77,2
4,N/A,N/A,N/A,1159,1163,N/A,82,1
10,N/A,N/A,N/A,1149,1159,N/A,87,6
5,N/A,N/A,N/A,1144,1149,N/A,93,0
7,N/A,N/A,N/A,1137,1144,N/A,97,4
5,N/A,N/A,N/A,1132,1137,N/A,102,3
4,N/A,N/A,N/A,1128,1132,N/A,107,2
12,N/A,N/A,N/A,1116,1128,N/A,110,5
12,N/A,N/A,N/A,1104,1116,N/A,116,5
7,N/A,N/A,N/A,1097,1104,N/A,121,4
6,N/A,N/A,N/A,1091,1097,N/A,126,3
7,N/A,N/A,N/A,1084,1091,N/A,132,3
7,N/A,N/A,N/A,1077,1084,N/A,137,2
17,N/A,N/A,N/A,1060,1077,N/A,141,6
6,N/A,N/A,N/A,1054,1060,N/A,145,4
7,N/A,N/A,N/A,1047,1054,N/A,150,3
6,N/A,N/A,N/A,1931,1937,N/A,5,3
4,N/A,N/A,N/A,1927,1931,N/A,11,3
4,N/A,N/A,N/A,1923,1927,N/A,16,2
12,N/A,N/A,N/A,1911,1923,N/A,20,6
5,N/A,N/A,N/A,1906,1911,N/A,26,0
6,N/A,N/A,N/A,1900,1906,N/A,29,3
10,N/A,N/A,N/A,1890,1900,N/A,32,6
4,N/A,N/A,N/A,1886,1890,N/A,38,0
19,N/A,N/A,N/A,1867,1886,N/A,44,6
5,N/A,N/A,N/A,1862,1867,N/A,50,0
9,N/A,N/A,N/A,1853,1862,N/A,55,5
6,N/A,N/A,N/A,1847,1853,N/A,60,4
6,N/A,N/A,N/A,1841,1847,N/A,64,2
9,N/A,N/A,N/A,1832,1841,N/A,67,5
4,N/A,N/A,N/A,1828,1832,N/A,70,2
10,N/A,N/A,N/A,1818,1828,N/A,73,5
7,N/A,N/A,N/A,1811,1818,N/A,77,3
6,N/A,N/A,N/A,1805,1811,N/A,82,2
7,N/A,N/A,N/A,1798,1805,N/A,88,2
4,N/A,N/A,N/A,1794,1798,N/A,93,1
4,N/A,N/A,N/A,1790,1794,N/A,99,1
19,N/A,N/A,N/A,1771,1790,N/A,104,6
7,N/A,N/A,N/A,1764,1771,N/A,107,3
4,N/A,N/A,N/A,1760,1764,N/A,112,2
6,N/A,N/A,N/A,1754,1760,N/A,118,2
5,N/A,N/A,N/A,1749,1754,N/A,123,1
5,N/A,N/A,N/A,1744,1749,N/A,129,1
19,N/A,N/A,N/A,1725,1744,N/A,134,6
6,N/A,N/A,N/A,1719,1725,N/A,137,3
4,N/A,N/A,N/A,1715,1719,N/A,141,1
4,N/A,N/A,N/A,1224,1228,N/A,5,2
11,N/A,N/A,N/A,1213,1224,N/A,8,5
8,N/A,N/A,N/A,1205,1213,N/A,13,4
4,N/A,N/A,N/A,1201,1205,N/A,16,1
15,N/A,N/A,N/A,1186,1201,N/A,21,6
6,N/A,N/A,N/A,1180,1186,N/A,24,3
18,N/A,N/A,N/A,1162,1180,N/A,27,6
12,N/A,N/A,N/A,1150,1162,N/A,32,5
6,N/A,N/A,N/A,1144,1150,N/A,37,4
6,N/A,N/A,N/A,1138,1144,N/A,42,3
5,N/A,N/A,N/A,1133,1138,N/A,47,2
7,N/A,N/A,N/A,1126,1133,N/A,53,2
4,N/A,N/A,N/A,1122,1126,N/A,58,1
11,N/A,N/A,N/A,1111,1122,N/A,62,5
12,N/A,N/A,N/A,1099,1111,N/A,68,5
8,N/A,N/A,N/A,1091,1099,N/A,73,4
4,N/A,N/A,N/A,1087,1091,N/A,78,3
4,N/A,N/A,N/A,1083,1087,N/A,83,2
11,N/A,N/A,N/A,1072,1083,N/A,87,6
5,N/A,N/A,N/A,1067,1072,N/A,93,0
7,N/A,N/A,N/A,1060,1067,N/A,97,4
5,N/A,N/A,N/A,1055,1060,N/A,101,2
15,N/A,N/A,N/A,1040,1055,N/A,105,6
10,N/A,N/A,N/A,1030,1040,N/A,110,5
9,N/A,N/A,N/A,1021,1030,N/A,116,5
6,N/A,N/A,N/A,1015,1021,N/A,121,4
8,N/A,N/A,N/A,1007,1015,N/A,127,4
5,N/A,N/A,N/A,1002,1007,N/A,131,2
5,N/A,N/A,N/A,997,1002,N/A,136,1
5,N/A,N/A,N/A,992,997,N/A,142,1
5,N/A,N/A,N/A,1057,1062,N/A,3,1
15,N/A,N/A,N/A,1042,1057,N/A,8,6
10,N/A,N/A,N/A,1032,1042,N/A,13,5
7,N/A,N/A,N/A,1025,1032,N/A,18,4
5,N/A,N/A,N/A,1020,1025,N/A,21,1
8,N/A,N/A,N/A,1012,1020,N/A,24,4
6,N/A,N/A,N/A,1006,1012,N/A,29,3
5,N/A,N/A,N/A,1001,1006,N/A,33,1
7,N/A,N/A,N/A,994,1001,N/A,36,4
5,N/A,N/A,N/A,989,994,N/A,39,1
10,N/A,N/A,N/A,979,989,N/A,44,6
9,N/A,N/A,N/A,970,979,N/A,49,5
6,N/A,N/A,N/A,964,970,N/A,54,4
4,N/A,N/A,N/A,960,964,N/A,57,1
10,N/A,N/A,N/A,950,960,N/A,61,5
5,N/A,N/A,N/A,945,950,N/A,64,2
4,N/A,N/A,N/A,941,945,N/A,69,1
5,N/A,N/A,N/A,936,941,N/A,75,1
5,N/A,N/A,N/A,931,936,N/A,81,1
4,N/A,N/A,N/A,927,931,N/A,87,1
4,N/A,N/A,N/A,923,927,N/A,93,1
9,N/A,N/A,N/A,914,923,N/A,97,5
6,N/A,N/A,N/A,908,914,N/A,100,2
6,N/A,N/A,N/A,902,908,N/A,106,2
14,N/A,N/A,N/A,888,902,N/A,110,6
9,N/A,N/A,N/A,879,888,N/A,115,5
5,N/A,N/A,N/A,874,879,N/A,120,4
4,N/A,N/A,N/A,870,874,N/A,124,2
4,N/A,N/A,N/A,866,870,N/A,130,2
5,N/A,N/A,N/A,861,866,N/A,136,2
5,N/A,N/A,N/A,698,703,N/A,6,1
5,N/A,N/A,N/A,693,698,N/A,9,4
5,N/A,N/A,N/A,688,693,N/A,12,1
7,N/A,N/A,N/A,681,688,N/A,15,4
4,N/A,N/A,N/A,677,681,N/A,18,1
5,N/A,N/A,N/A,672,677,N/A,24,1
10,N/A,N/A,N/A,662,672,N/A,28,5
7,N/A,N/A,N/A,655,662,N/A,33,4
4,N/A,N/A,N/A,651,655,N/A,37,2
6,N/A,N/A,N/A,645,651,N/A,43,2
6,N/A,N/A,N/A,639,645,N/A,49,2
4,N/A,N/A,N/A,635,639,N/A,54,1
11,N/A,N/A,N/A,624,635,N/A,59,6
4,N/A,N/A,N/A,620,624,N/A,62,3
4,N/A,N/A,N/A,616,620,N/A,66,1
5,N/A,N/A,N/A,611,616,N/A,69,4
7,N/A,N/A,N/A,604,611,N/A,75,4
6,N/A,N/A,N/A,598,604,N/A,80,3
16,N/A,N/A,N/A,582,598,N/A,83,6
4,N/A,N/A,N/A,578,582,N/A,89,0
9,N/A,N/A,N/A,569,578,N/A,94,5
6,N/A,N/A,N/A,563,569,N/A,98,3
5,N/A,N/A,N/A,558,563,N/A,102,1
4,N/A,N/A,N/A,554,558,N/A,108,1
5,N/A,N/A,N/A,549,554,N/A,114,1
9,N/A,N/A,N/A,540,549,N/A,118,5
8,N/A,N/A,N/A,532,540,N/A,123,4
4,N/A,N/A,N/A,528,532,N/A,128,3
7,N/A,N/A,N/A,521,528,N/A,134,3
5,N/A,N/A,N/A,516,521,N/A,140,3
7,N/A,N/A,N/A,1134,1141,N/A,4,2
4,N/A,N/A,N/A,1130,1134,N/A,9,1
11,N/A,N/A,N/A,1119,1130,N/A,13,5
6,N/A,N/A,N/A,1113,1119,N/A,17,3
5,N/A,N/A,N/A,1108,1113,N/A,21,1
8,N/A,N/A,N/A,1100,1108,N/A,24,4
7,N/A,N/A,N/A,1093,1100,N/A,30,4
5,N/A,N/A,N/A,1088,1093,N/A,36,4
5,N/A,N/A,N/A,1083,1088,N/A,39,1
16,N/A,N/A,N/A,1067,1083,N/A,44,6
4,N/A,N/A,N/A,1063,1067,N/A,47,3
7,N/A,N/A,N/A,1056,1063,N/A,53,3
5,N/A,N/A,N/A,1051,1056,N/A,59,3
5,N/A,N/A,N/A,1046,1051,N/A,64,2
9,N/A,N/A,N/A,1037,1046,N/A,67,5
7,N/A,N/A,N/A,1030,1037,N/A,72,4
7,N/A,N/A,N/A,1023,1030,N/A,78,4
4,N/A,N/A,N/A,1019,1023,N/A,83,3
5,N/A,N/A,N/A,1014,1019,N/A,88,2
7,N/A,N/A,N/A,1007,1014,N/A,94,2
4,N/A,N/A,N/A,1003,1007,N/A,99,1
4,N/A,N/A,N/A,999,1003,N/A,105,1
5,N/A,N/A,N/A,994,999,N/A,108,4
4,N/A,N/A,N/A,990,994,N/A,112,2
11,N/A,N/A,N/A,979,990,N/A,115,5
12,N/A,N/A,N/A,967,979,N/A,121,5
6,N/A,N/A,N/A,961,967,N/A,126,4
6,N/A,N/A,N/A,955,961,N/A,130,2
10,N/A,N/A,N/A,945,955,N/A,134,6
5,N/A,N/A,N/A,940,945,N/A,138,4
5,N/A,N/A,N/A,315,320,N/A,4,1
10,N/A,N/A,N/A,305,315,N/A,8,5
12,N/A,N/A,N/A,293,305,N/A,14,5
4,N/A,N/A,N/A,289,293,N/A,18,3
13,N/A,N/A,N/A,276,289,N/A,21,6
8,N/A,N/A,N/A,268,276,N/A,25,4
8,N/A,N/A,N/A,260,268,N/A,31,4
5,N/A,N/A,N/A,255,260,N/A,37,4
5,N/A,N/A,N/A,250,255,N/A,43,4
8,N/A,N/A,N/A,242,250,N/A,49,4
5,N/A,N/A,N/A,237,242,N/A,53,2
15,N/A,N/A,N/A,222,237,N/A,57,6
5,N/A,N/A,N/A,217,222,N/A,60,3
5,N/A,N/A,N/A,212,217,N/A,66,3
5,N/A,N/A,N/A,207,212,N/A,72,3
7,N/A,N/A,N/A,200,207,N/A,77,2
4,N/A,N/A,N/A,196,200,N/A,82,1
9,N/A,N/A,N/A,187,196,N/A,86,5
5,N/A,N/A,N/A,182,187,N/A,90,3
5,N/A,N/A,N/A,177,182,N/A,95,2
10,N/A,N/A,N/A,167,177,N/A,98,5
6,N/A,N/A,N/A,161,167,N/A,101,2
9,N/A,N/A,N/A,152,161,N/A,104,5
7,N/A,N/A,N/A,145,152,N/A,108,3
6,N/A,N/A,N/A,139,145,N/A,114,3
5,N/A,N/A,N/A,134,139,N/A,120,3
13,N/A,N/A,N/A,121,134,N/A,123,6
10,N/A,N/A,N/A,111,121,N/A,128,5
6,N/A,N/A,N/A,105,111,N/A,133,4
4,N/A,N/A,N/A,101,105,N/A,136,1
6,N/A,N/A,N/A,767,773,N/A,4,4
4,N/A,N/A,N/A,763,767,N/A,7,1
4,N/A,N/A,N/A,759,763,N/A,13,1
4,N/A,N/A,N/A,755,759,N/A,19,1
11,N/A,N/A,N/A,744,755,N/A,23,5
8,N/A,N/A,N/A,736,744,N/A,28,4
7,N/A,N/A,N/A,729,736,N/A,32,2
12,N/A,N/A,N/A,717,729,N/A,35,5
10,N/A,N/A,N/A,707,717,N/A,41,5
5,N/A,N/A,N/A,702,707,N/A,45,3
7,N/A,N/A,N/A,695,702,N/A,50,2
4,N/A,N/A,N/A,691,695,N/A,55,1
4,N/A,N/A,N/A,687,691,N/A,61,1
15,N/A,N/A,N/A,672,687,N/A,66,6
5,N/A,N/A,N/A,667,672,N/A,72,0
11,N/A,N/A,N/A,656,667,N/A,78,6
5,N/A,N/A,N/A,651,656,N/A,84,0
9,N/A,N/A,N/A,642,651,N/A,89,5
6,N/A,N/A,N/A,636,642,N/A,92,2
9,N/A,N/A,N/A,627,636,N/A,95,5
7,N/A,N/A,N/A,620,627,N/A,100,4
5,N/A,N/A,N/A,615,620,N/A,103,1
4,N/A,N/A,N/A,611,615,N/A,109,1
8,N/A,N/A,N/A,603,611,N/A,112,4
7,N/A,N/A,N/A,596,603,N/A,117,3
6,N/A,N/A,N/A,590,596,N/A,123,3
5,N/A,N/A,N/A,585,590,N/A,128,2
7,N/A,N/A,N/A,578,585,N/A,134,2
4,N/A,N/A,N/A,574,578,N/A,139,1
10,N/A,N/A,N/A,564,574,N/A,143,5
4,N/A,N/A,N/A,1032,1036,N/A,3,3
4,N/A,N/A,N/A,1028,1032,N/A,7,1
5,N/A,N/A,N/A,1023,1028,N/A,13,1
8,N/A,N/A,N/A,1015,1023,N/A,16,4
4,N/A,N/A,N/A,1011,1015,N/A,21,3
19,N/A,N/A,N/A,992,1011,N/A,24,6
6,N/A,N/A,N/A,986,992,N/A,28,4
4,N/A,N/A,N/A,982,986,N/A,31,1
11,N/A,N/A,N/A,971,982,N/A,35,5
10,N/A,N/A,N/A,961,971,N/A,41,5
6,N/A,N/A,N/A,955,961,N/A,45,3
15,N/A,N/A,N/A,940,955,N/A,48,6
4,N/A,N/A,N/A,936,940,N/A,54,0
8,N/A,N/A,N/A,928,936,N/A,58,4
6,N/A,N/A,N/A,922,928,N/A,62,2
9,N/A,N/A,N/A,913,922,N/A,65,5
7,N/A,N/A,N/A,906,913,N/A,69,3
4,N/A,N/A,N/A,902,906,N/A,74,2
16,N/A,N/A,N/A,886,902,N/A,78,6
5,N/A,N/A,N/A,881,886,N/A,82,4
5,N/A,N/A,N/A,876,881,N/A,88,4
7,N/A,N/A,N/A,869,876,N/A,92,2
5,N/A,N/A,N/A,864,869,N/A,97,1
10,N/A,N/A,N/A,854,864,N/A,101,5
6,N/A,N/A,N/A,848,854,N/A,104,2
19,N/A,N/A,N/A,829,848,N/A,108,6
5,N/A,N/A,N/A,824,829,N/A,111,3
5,N/A,N/A,N/A,819,824,N/A,117,3
6,N/A,N/A,N/A,813,819,N/A,122,2
15,N/A,N/A,N/A,798,813,N/A,126,6
4,N/A,N/A,N/A,1719,1723,N/A,6,2
12,N/A,N/A,N/A,1707,1719,N/A,9,5
11,N/A,N/A,N/A,1696,1707,N/A,15,5
5,N/A,N/A,N/A,1691,1696,N/A,20,4
5,N/A,N/A,N/A,1686,1691,N/A,24,2
9,N/A,N/A,N/A,1677,1686,N/A,27,5
12,N/A,N/A,N/A,1665,1677,N/A,33,5
10,N/A,N/A,N/A,1655,1665,N/A,39,5
7,N/A,N/A,N/A,1648,1655,N/A,42,2
4,N/A,N/A,N/A,1644,1648,N/A,48,2
6,N/A,N/A,N/A,1638,1644,N/A,54,2
4,N/A,N/A,N/A,1634,1638,N/A,59,1
7,N/A,N/A,N/A,1627,1634,N/A,62,4
7,N/A,N/A,N/A,1620,1627,N/A,68,4
7,N/A,N/A,N/A,1613,1620,N/A,73,3
5,N/A,N/A,N/A,1608,1613,N/A,79,3
12,N/A,N/A,N/A,1596,1608,N/A,82,6
5,N/A,N/A,N/A,1591,1596,N/A,88,0
6,N/A,N/A,N/A,1585,1591,N/A,92,4
5,N/A,N/A,N/A,1580,1585,N/A,98,4
5,N/A,N/A,N/A,1575,1580,N/A,102,2
4,N/A,N/A,N/A,1571,1575,N/A,107,1
4,N/A,N/A,N/A,1567,1571,N/A,113,1
11,N/A,N/A,N/A,1556,1567,N/A,117,5
5,N/A,N/A,N/A,1551,1556,N/A,122,4
7,N/A,N/A,N/A,1544,1551,N/A,127,3
10,N/A,N/A,N/A,1534,1544,N/A,130,6
11,N/A,N/A,N/A,1523,1534,N/A,135,5
10,N/A,N/A,N/A,1513,1523,N/A,141,5
4,N/A,N/A,N/A,1509,1513,N/A,145,3
10,N/A,N/A,N/A,1162,1172,N/A,6,5
6,N/A,N/A,N/A,1156,1162,N/A,9,2
6,N/A,N/A,N/A,1150,1156,N/A,15,2
5,N/A,N/A,N/A,1145,1150,N/A,20,1
4,N/A,N/A,N/A,1141,1145,N/A,26,1
9,N/A,N/A,N/A,1132,1141,N/A,30,5
12,N/A,N/A,N/A,1120,1132,N/A,36,5
4,N/A,N/A,N/A,1116,1120,N/A,40,3
6,N/A,N/A,N/A,1110,1116,N/A,46,3
4,N/A,N/A,N/A,1106,1110,N/A,50,1
6,N/A,N/A,N/A,1100,1106,N/A,53,4
6,N/A,N/A,N/A,1094,1100,N/A,59,4
5,N/A,N/A,N/A,1089,1094,N/A,62,1
13,N/A,N/A,N/A,1076,1089,N/A,67,6
5,N/A,N/A,N/A,1071,1076,N/A,70,3
4,N/A,N/A,N/A,1067,1071,N/A,76,3
6,N/A,N/A,N/A,1061,1067,N/A,81,2
4,N/A,N/A,N/A,1057,1061,N/A,86,1
5,N/A,N/A,N/A,1052,1057,N/A,92,1
5,N/A,N/A,N/A,1047,1052,N/A,98,1
5,N/A,N/A,N/A,1042,1047,N/A,104,1
8,N/A,N/A,N/A,1034,1042,N/A,107,4
7,N/A,N/A,N/A,1027,1034,N/A,113,4
5,N/A,N/A,N/A,1022,1027,N/A,118,3
6,N/A,N/A,N/A,1016,1022,N/A,123,2
13,N/A,N/A,N/A,1003,1016,N/A,127,6
9,N/A,N/A,N/A,994,1003,N/A,132,5
6,N/A,N/A,N/A,988,994,N/A,137,4
6,N/A,N/A,N/A,982,988,N/A,141,2
7,N/A,N/A,N/A,975,982,N/A,147,2
7,N/A,N/A,N/A,1203,1210,N/A,4,3
5,N/A,N/A,N/A,1198,1203,N/A,8,1
16,N/A,N/A,N/A,1182,1198,N/A,13,6
5,N/A,N/A,N/A,1177,1182,N/A,17,4
4,N/A,N/A,N/A,1173,1177,N/A,20,1
5,N/A,N/A,N/A,1168,1173,N/A,23,4
7,N/A,N/A,N/A,1161,1168,N/A,28,3
6,N/A,N/A,N/A,1155,1161,N/A,34,3
7,N/A,N/A,N/A,1148,1155,N/A,39,2
13,N/A,N/A,N/A,1135,1148,N/A,43,6
7,N/A,N/A,N/A,1128,1135,N/A,47,4
5,N/A,N/A,N/A,1123,1128,N/A,51,2
7,N/A,N/A,N/A,1116,1123,N/A,57,2
6,N/A,N/A,N/A,1110,1116,N/A,63,2
4,N/A,N/A,N/A,1106,1110,N/A,68,1
16,N/A,N/A,N/A,1090,1106,N/A,73,6
7,N/A,N/A,N/A,1083,1090,N/A,77,4
7,N/A,N/A,N/A,1076,1083,N/A,83,4
5,N/A,N/A,N/A,1071,1076,N/A,86,1
5,N/A,N/A,N/A,1066,1071,N/A,92,1
6,N/A,N/A,N/A,1060,1066,N/A,95,4
4,N/A,N/A,N/A,1056,1060,N/A,100,3
6,N/A,N/A,N/A,1050,1056,N/A,105,2
7,N/A,N/A,N/A,1043,1050,N/A,111,2
5,N/A,N/A,N/A,1038,1043,N/A,116,1
5,N/A,N/A,N/A,1033,1038,N/A,119,4
7,N/A,N/A,N/A,1026,1033,N/A,123,2
9,N/A,N/A,N/A,1017,1026,N/A,126,5
9,N/A,N/A,N/A,1008,1017,N/A,132,5
4,N/A,N/A,N/A,1004,1008,N/A,135,2
7,N/A,N/A,N/A,1969,1976,N/A,3,4
7,N/A,N/A,N/A,1962,1969,N/A,7,2
18,N/A,N/A,N/A,1944,1962,N/A,11,6
6,N/A,N/A,N/A,1938,1944,N/A,14,3
4,N/A,N/A,N/A,1934,1938,N/A,18,1
9,N/A,N/A,N/A,1925,1934,N/A,22,5
12,N/A,N/A,N/A,1913,1925,N/A,28,5
12,N/A,N/A,N/A,1901,1913,N/A,34,5
12,N/A,N/A,N/A,1889,1901,N/A,40,5
9,N/A,N/A,N/A,1880,1889,N/A,46,5
10,N/A,N/A,N/A,1870,1880,N/A,52,5
10,N/A,N/A,N/A,1860,1870,N/A,58,5
10,N/A,N/A,N/A,1850,1860,N/A,64,5
6,N/A,N/A,N/A,1844,1850,N/A,69,4
5,N/A,N/A,N/A,1839,1844,N/A,72,1
14,N/A,N/A,N/A,1825,1839,N/A,77,6
7,N/A,N/A,N/A,1818,1825,N/A,80,3
4,N/A,N/A,N/A,1814,1818,N/A,84,1
5,N/A,N/A,N/A,1809,1814,N/A,87,4
5,N/A,N/A,N/A,1804,1809,N/A,92,3
5,N/A,N/A,N/A,1799,1804,N/A,97,2
11,N/A,N/A,N/A,1788,1799,N/A,100,5
7,N/A,N/A,N/A,1781,1788,N/A,104,3
5,N/A,N/A,N/A,1776,1781,N/A,109,2
7,N/A,N/A,N/A,1769,1776,N/A,115,2
12,N/A,N/A,N/A,1757,1769,N/A,118,5
5,N/A,N/A,N/A,1752,1757,N/A,123,4
4,N/A,N/A,N/A,1748,1752,N/A,127,2
6,N/A,N/A,N/A,1742,1748,N/A,133,2
5,N/A,N/A,N/A,1737,1742,N/A,138,1
5,N/A,N/A,N/A,449,454,N/A,3,1
6,N/A,N/A,N/A,443,449,N/A,6,4
4,N/A,N/A,N/A,439,443,N/A,9,1
7,N/A,N/A,N/A,432,439,N/A,12,4
6,N/A,N/A,N/A,426,432,N/A,16,2
11,N/A,N/A,N/A,415,426,N/A,20,6
5,N/A,N/A,N/A,410,415,N/A,26,0
11,N/A,N/A,N/A,399,410,N/A,31,5
6,N/A,N/A,N/A,393,399,N/A,34,2
4,N/A,N/A,N/A,389,393,N/A,39,1
9,N/A,N/A,N/A,380,389,N/A,43,5
5,N/A,N/A,N/A,375,380,N/A,46,2
5,N/A,N/A,N/A,370,375,N/A,52,2
13,N/A,N/A,N/A,357,370,N/A,56,6
5,N/A,N/A,N/A,352,357,N/A,62,0
14,N/A,N/A,N/A,338,352,N/A,68,6
5,N/A,N/A,N/A,333,338,N/A,74,0
18,N/A,N/A,N/A,315,333,N/A,80,6
6,N/A,N/A,N/A,309,315,N/A,84,4
5,N/A,N/A,N/A,304,309,N/A,87,1
4,N/A,N/A,N/A,300,304,N/A,93,1
12,N/A,N/A,N/A,288,300,N/A,98,6
9,N/A,N/A,N/A,279,288,N/A,103,5
5,N/A,N/A,N/A,274,279,N/A,108,4
7,N/A,N/A,N/A,267,274,N/A,113,3
7,N/A,N/A,N/A,260,267,N/A,118,2
12,N/A,N/A,N/A,248,260,N/A,121,5
9,N/A,N/A,N/A,239,248,N/A,127,5
7,N/A,N/A,N/A,232,239,N/A,131,3
5,N/A,N/A,N/A,227,232,N/A,135,1
5,N/A,N/A,N/A,1763,1768,N/A,5,3
5,N/A,N/A,N/A,1758,1763,N/A,9,1
19,N/A,N/A,N/A,1739,1758,N/A,14,6
5,N/A,N/A,N/A,1734,1739,N/A,20,0
10,N/A,N/A,N/A,1724,1734,N/A,25,5
7,N/A,N/A,N/A,1717,1724,N/A,30,4
5,N/A,N/A,N/A,1712,1717,N/A,36,4
5,N/A,N/A,N/A,1707,1712,N/A,41,3
5,N/A,N/A,N/A,1702,1707,N/A,47,3
6,N/A,N/A,N/A,1696,1702,N/A,52,2
12,N/A,N/A,N/A,1684,1696,N/A,56,6
4,N/A,N/A,N/A,1680,1684,N/A,62,0
6,N/A,N/A,N/A,1674,1680,N/A,65,3
12,N/A,N/A,N/A,1662,1674,N/A,68,6
4,N/A,N/A,N/A,1658,1662,N/A,74,0
6,N/A,N/A,N/A,1652,1658,N/A,77,3
5,N/A,N/A,N/A,1647,1652,N/A,81,1
19,N/A,N/A,N/A,1628,1647,N/A,86,6
12,N/A,N/A,N/A,1616,1628,N/A,91,5
8,N/A,N/A,N/A,1608,1616,N/A,96,4
7,N/A,N/A,N/A,1601,1608,N/A,102,4
4,N/A,N/A,N/A,1597,1601,N/A,106,2
4,N/A,N/A,N/A,1593,1597,N/A,112,2
5,N/A,N/A,N/A,1588,1593,N/A,117,1
12,N/A,N/A,N/A,1576,1588,N/A,121,5
4,N/A,N/A,N/A,1572,1576,N/A,124,2
5,N/A,N/A,N/A,1567,1572,N/A,130,2
4,N/A,N/A,N/A,1563,1567,N/A,136,2
4,N/A,N/A,N/A,1559,1563,N/A,141,1
12,N/A,N/A,N/A,1547,1559,N/A,145,5
4,N/A,N/A,N/A,445,449,N/A,5,1
5,N/A,N/A,N/A,440,445,N/A,11,1
14,N/A,N/A,N/A,426,440,N/A,16,6
5,N/A,N/A,N/A,421,426,N/A,19,3
7,N/A,N/A,N/A,414,421,N/A,24,2
5,N/A,N/A,N/A,409,414,N/A,29,1
9,N/A,N/A,N/A,400,409,N/A,33,5
6,N/A,N/A,N/A,394,400,N/A,37,3
4,N/A,N/A,N/A,390,394,N/A,41,1
10,N/A,N/A,N/A,380,390,N/A,45,5
5,N/A,N/A,N/A,375,380,N/A,48,2
12,N/A,N/A,N/A,363,375,N/A,52,6
4,N/A,N/A,N/A,359,363,N/A,58,0
6,N/A,N/A,N/A,353,359,N/A,61,3
4,N/A,N/A,N/A,349,353,N/A,66,2
6,N/A,N/A,N/A,343,349,N/A,72,2
4,N/A,N/A,N/A,339,343,N/A,77,1
4,N/A,N/A,N/A,335,339,N/A,83,1
9,N/A,N/A,N/A,326,335,N/A,87,5
6,N/A,N/A,N/A,320,326,N/A,92,4
6,N/A,N/A,N/A,314,320,N/A,97,3
6,N/A,N/A,N/A,308,314,N/A,102,2
10,N/A,N/A,N/A,298,308,N/A,105,5
6,N/A,N/A,N/A,292,298,N/A,110,4
6,N/A,N/A,N/A,286,292,N/A,115,3
7,N/A,N/A,N/A,279,286,N/A,121,3
13,N/A,N/A,N/A,266,279,N/A,124,6
4,N/A,N/A,N/A,262,266,N/A,130,0
7,N/A,N/A,N/A,255,262,N/A,134,4
5,N/A,N/A,N/A,250,255,N/A,139,3
19,N/A,N/A,N/A,450,469,N/A,6,6
9,N/A,N/A,N/A,441,450,N/A,11,5
7,N/A,N/A,N/A,434,441,N/A,14,2
18,N/A,N/A,N/A,416,434,N/A,18,6
5,N/A,N/A,N/A,411,416,N/A,22,4
4,N/A,N/A,N/A,407,411,N/A,27,3
4,N/A,N/A,N/A,403,407,N/A,32,2
7,N/A,N/A,N/A,396,403,N/A,38,2
4,N/A,N/A,N/A,392,396,N/A,43,1
5,N/A,N/A,N/A,387,392,N/A,49,1
9,N/A,N/A,N/A,378,387,N/A,53,5
8,N/A,N/A,N/A,370,378,N/A,58,4
7,N/A,N/A,N/A,363,370,N/A,62,2
5,N/A,N/A,N/A,358,363,N/A,67,1
9,N/A,N/A,N/A,349,358,N/A,71,5
10,N/A,N/A,N/A,339,349,N/A,77,5
5,N/A,N/A,N/A,334,339,N/A,81,3
5,N/A,N/A,N/A,329,334,N/A,86,2
4,N/A,N/A,N/A,325,329,N/A,91,1
12,N/A,N/A,N/A,313,325,N/A,96,6
7,N/A,N/A,N/A,306,313,N/A,99,3
13,N/A,N/A,N/A,293,306,N/A,102,6
4,N/A,N/A,N/A,289,293,N/A,108,0
10,N/A,N/A,N/A,279,289,N/A,113,5
12,N/A,N/A,N/A,267,279,N/A,119,5
8,N/A,N/A,N/A,259,267,N/A,124,4
5,N/A,N/A,N/A,254,259,N/A,129,3
6,N/A,N/A,N/A,248,254,N/A,134,2
5,N/A,N/A,N/A,243,248,N/A,140,2
4,N/A,N/A,N/A,239,243,N/A,145,1
11,N/A,N/A,N/A,1961,1972,N/A,4,5
8,N/A,N/A,N/A,1953,1961,N/A,9,4
6,N/A,N/A,N/A,1947,1953,N/A,14,3
5,N/A,N/A,N/A,1942,1947,N/A,18,1
5,N/A,N/A,N/A,1937,1942,N/A,21,4
7,N/A,N/A,N/A,1930,1937,N/A,26,3
4,N/A,N/A,N/A,1926,1930,N/A,30,1
14,N/A,N/A,N/A,1912,1926,N/A,35,6
4,N/A,N/A,N/A,1908,1912,N/A,38,3
4,N/A,N/A,N/A,1904,1908,N/A,44,3
17,N/A,N/A,N/A,1887,1904,N/A,47,6
4,N/A,N/A,N/A,1883,1887,N/A,53,0
5,N/A,N/A,N/A,1878,1883,N/A,57,4
6,N/A,N/A,N/A,1872,1878,N/A,63,4
7,N/A,N/A,N/A,1865,1872,N/A,67,2
4,N/A,N/A,N/A,1861,1865,N/A,72,1
4,N/A,N/A,N/A,1857,1861,N/A,78,1
6,N/A,N/A,N/A,1851,1857,N/A,81,4
4,N/A,N/A,N/A,1847,1851,N/A,86,3
5,N/A,N/A,N/A,1842,1847,N/A,90,1
7,N/A,N/A,N/A,1835,1842,N/A,93,4
5,N/A,N/A,N/A,1830,1835,N/A,96,1
9,N/A,N/A,N/A,1821,1830,N/A,100,5
9,N/A,N/A,N/A,1812,1821,N/A,106,5
7,N/A,N/A,N/A,1805,1812,N/A,111,4
5,N/A,N/A,N/A,1800,1805,N/A,115,2
11,N/A,N/A,N/A,1789,1800,N/A,119,6
12,N/A,N/A,N/A,1777,1789,N/A,124,5
4,N/A,N/A,N/A,1773,1777,N/A,128,3
5,N/A,N/A,N/A,1768,1773,N/A,132,1
5,N/A,N/A,N/A,1347,1352,N/A,6,4
7,N/A,N/A,N/A,1340,1347,N/A,10,2
6,N/A,N/A,N/A,1334,1340,N/A,16,2
16,N/A,N/A,N/A,1318,1334,N/A,20,6
11,N/A,N/A,N/A,1307,1318,N/A,25,5
8,N/A,N/A,N/A,1299,1307,N/A,30,4
7,N/A,N/A,N/A,1292,1299,N/A,36,4
4,N/A,N/A,N/A,1288,1292,N/A,39,1
5,N/A,N/A,N/A,1283,1288,N/A,42,4
5,N/A,N/A,N/A,1278,1283,N/A,45,1
5,N/A,N/A,N/A,1273,1278,N/A,51,1
12,N/A,N/A,N/A,1261,1273,N/A,55,5
5,N/A,N/A,N/A,1256,1261,N/A,58,2
4,N/A,N/A,N/A,1252,1256,N/A,63,1
12,N/A,N/A,N/A,1240,1252,N/A,68,6
4,N/A,N/A,N/A,1236,1240,N/A,74,0
5,N/A,N/A,N/A,1231,1236,N/A,78,4
4,N/A,N/A,N/A,1227,1231,N/A,83,3
5,N/A,N/A,N/A,1222,1227,N/A,87,1
5,N/A,N/A,N/A,1217,1222,N/A,90,4
6,N/A,N/A,N/A,1211,1217,N/A,95,3
6,N/A,N/A,N/A,1205,1211,N/A,100,2
16,N/A,N/A,N/A,1189,1205,N/A,104,6
7,N/A,N/A,N/A,1182,1189,N/A,108,4
6,N/A,N/A,N/A,1176,1182,N/A,114,4
7,N/A,N/A,N/A,1169,1176,N/A,119,3
15,N/A,N/A,N/A,1154,1169,N/A,122,6
5,N/A,N/A,N/A,1149,1154,N/A,125,3
4,N/A,N/A,N/A,1145,1149,N/A,129,1
10,N/A,N/A,N/A,1135,1145,N/A,134,6
4,N/A,N/A,N/A,683,687,N/A,3,2
4,N/A,N/A,N/A,679,683,N/A,9,2
5,N/A,N/A,N/A,674,679,N/A,14,1
13,N/A,N/A,N/A,661,674,N/A,19,6
5,N/A,N/A,N/A,656,661,N/A,25,0
18,N/A,N/A,N/A,638,656,N/A,31,6
4,N/A,N/A,N/A,634,638,N/A,34,3
16,N/A,N/A,N/A,618,634,N/A,37,6
7,N/A,N/A,N/A,611,618,N/A,41,4
4,N/A,N/A,N/A,607,611,N/A,46,3
5,N/A,N/A,N/A,602,607,N/A,52,3
11,N/A,N/A,N/A,591,602,N/A,55,6
11,N/A,N/A,N/A,580,591,N/A,60,5
7,N/A,N/A,N/A,573,580,N/A,64,3
5,N/A,N/A,N/A,568,573,N/A,68,1
10,N/A,N/A,N/A,558,568,N/A,72,5
7,N/A,N/A,N/A,551,558,N/A,75,2
5,N/A,N/A,N/A,546,551,N/A,80,1
5,N/A,N/A,N/A,541,546,N/A,83,4
6,N/A,N/A,N/A,535,541,N/A,87,2
7,N/A,N/A,N/A,528,535,N/A,93,2
4,N/A,N/A,N/A,524,528,N/A,99,2
10,N/A,N/A,N/A,514,524,N/A,102,5
5,N/A,N/A,N/A,509,514,N/A,107,4
8,N/A,N/A,N/A,501,509,N/A,113,4
4,N/A,N/A,N/A,497,501,N/A,116,1
12,N/A,N/A,N/A,485,497,N/A,121,6
6,N/A,N/A,N/A,479,485,N/A,124,3
11,N/A,N/A,N/A,468,479,N/A,127,6
6,N/A,N/A,N/A,462,468,N/A,131,4
4,N/A,N/A,N/A,1833,1837,N/A,4,3
6,N/A,N/A,N/A,1827,1833,N/A,10,3
5,N/A,N/A,N/A,1822,1827,N/A,14,1
7,N/A,N/A,N/A,1815,1822,N/A,17,4
4,N/A,N/A,N/A,1811,1815,N/A,20,1
5,N/A,N/A,N/A,1806,1811,N/A,26,1
16,N/A,N/A,N/A,1790,1806,N/A,31,6
7,N/A,N/A,N/A,1783,1790,N/A,34,3
4,N/A,N/A,N/A,1779,1783,N/A,40,3
16,N/A,N/A,N/A,1763,1779,N/A,43,6
5,N/A,N/A,N/A,1758,1763,N/A,49,0
9,N/A,N/A,N/A,1749,1758,N/A,54,5
5,N/A,N/A,N/A,1744,1749,N/A,57,2
10,N/A,N/A,N/A,1734,1744,N/A,61,6
5,N/A,N/A,N/A,1729,1734,N/A,65,4
7,N/A,N/A,N/A,1722,1729,N/A,70,3
5,N/A,N/A,N/A,1717,1722,N/A,74,1
11,N/A,N/A,N/A,1706,1717,N/A,78,5
5,N/A,N/A,N/A,1701,1706,N/A,82,3
17,N/A,N/A,N/A,1684,1701,N/A,85,6
11,N/A,N/A,N/A,1673,1684,N/A,90,5
7,N/A,N/A,N/A,1666,1673,N/A,95,4
4,N/A,N/A,N/A,1662,1666,N/A,98,1
19,N/A,N/A,N/A,1643,1662,N/A,103,6
5,N/A,N/A,N/A,1638,1643,N/A,106,3
6,N/A,N/A,N/A,1632,1638,N/A,111,2
13,N/A,N/A,N/A,1619,1632,N/A,115,6
11,N/A,N/A,N/A,1608,1619,N/A,120,5
5,N/A,N/A,N/A,1603,1608,N/A,123,2
9,N/A,N/A,N/A,1594,1603,N/A,126,5
4,N/A,N/A,N/A,1007,1011,N/A,3,1
5,N/A,N/A,N/A,1002,1007,N/A,6,4
6,N/A,N/A,N/A,996,1002,N/A,11,3
5,N/A,N/A,N/A,991,996,N/A,15,1
11,N/A,N/A,N/A,980,991,N/A,19,5
5,N/A,N/A,N/A,975,980,N/A,24,4
4,N/A,N/A,N/A,971,975,N/A,27,1
10,N/A,N/A,N/A,961,971,N/A,31,5
5,N/A,N/A,N/A,956,961,N/A,36,4
5,N/A,N/A,N/A,951,956,N/A,42,4
6,N/A,N/A,N/A,945,951,N/A,48,4
6,N/A,N/A,N/A,939,945,N/A,54,4
6,N/A,N/A,N/A,933,939,N/A,59,3
19,N/A,N/A,N/A,914,933,N/A,62,6
8,N/A,N/A,N/A,906,914,N/A,66,4
5,N/A,N/A,N/A,901,906,N/A,69,1
18,N/A,N/A,N/A,883,901,N/A,74,6
8,N/A,N/A,N/A,875,883,N/A,78,4
6,N/A,N/A,N/A,869,875,N/A,82,2
19,N/A,N/A,N/A,850,869,N/A,86,6
4,N/A,N/A,N/A,846,850,N/A,92,0
13,N/A,N/A,N/A,833,846,N/A,98,6
4,N/A,N/A,N/A,829,833,N/A,101,3
5,N/A,N/A,N/A,824,829,N/A,107,3
7,N/A,N/A,N/A,817,824,N/A,113,3
5,N/A,N/A,N/A,812,817,N/A,117,1
4,N/A,N/A,N/A,808,812,N/A,123,1
5,N/A,N/A,N/A,803,808,N/A,129,1
5,N/A,N/A,N/A,798,803,N/A,135,1
15,N/A,N/A,N/A,783,798,N/A,140,6
8,N/A,N/A,N/A,1001,1009,N/A,3,4
7,N/A,N/A,N/A,994,1001,N/A,9,4
4,N/A,N/A,N/A,990,994,N/A,14,3
4,N/A,N/A,N/A,986,990,N/A,18,1
16,N/A,N/A,N/A,970,986,N/A,23,6
5,N/A,N/A,N/A,965,970,N/A,27,4
5,N/A,N/A,N/A,960,965,N/A,31,2
5,N/A,N/A,N/A,955,960,N/A,36,1
7,N/A,N/A,N/A,948,955,N/A,39,4
6,N/A,N/A,N/A,942,948,N/A,44,3
4,N/A,N/A,N/A,938,942,N/A,48,1
7,N/A,N/A,N/A,931,938,N/A,51,4
5,N/A,N/A,N/A,926,931,N/A,54,1
6,N/A,N/A,N/A,920,926,N/A,57,4
5,N/A,N/A,N/A,915,920,N/A,62,3
10,N/A,N/A,N/A,905,915,N/A,65,6
9,N/A,N/A,N/A,896,905,N/A,70,5
5,N/A,N/A,N/A,891,896,N/A,74,3
5,N/A,N/A,N/A,886,891,N/A,78,1
4,N/A,N/A,N/A,882,886,N/A,84,1
10,N/A,N/A,N/A,872,882,N/A,88,5
4,N/A,N/A,N/A,868,872,N/A,91,2
10,N/A,N/A,N/A,858,868,N/A,94,5
6,N/A,N/A,N/A,852,858,N/A,99,4
6,N/A,N/A,N/A,846,852,N/A,104,3
5,N/A,N/A,N/A,841,846,N/A,108,1
15,N/A,N/A,N/A,826,841,N/A,113,6
5,N/A,N/A,N/A,821,826,N/A,116,3
4,N/A,N/A,N/A,817,821,N/A,122,3
7,N/A,N/A,N/A,810,817,N/A,128,3
9,N/A,N/A,N/A,1372,1381,N/A,6,5
10,N/A,N/A,N/A,1362,1372,N/A,12,5
11,N/A,N/A,N/A,1351,1362,N/A,18,5
5,N/A,N/A,N/A,1346,1351,N/A,22,3
5,N/A,N/A,N/A,1341,1346,N/A,26,1
4,N/A,N/A,N/A,1337,1341,N/A,32,1
5,N/A,N/A,N/A,1332,1337,N/A,38,1
11,N/A,N/A,N/A,1321,1332,N/A,42,5
10,N/A,N/A,N/A,1311,1321,N/A,48,5
4,N/A,N/A,N/A,1307,1311,N/A,51,2
16,N/A,N/A,N/A,1291,1307,N/A,55,6
12,N/A,N/A,N/A,1279,1291,N/A,60,5
10,N/A,N/A,N/A,1269,1279,N/A,66,5
6,N/A,N/A,N/A,1263,1269,N/A,70,3
5,N/A,N/A,N/A,1258,1263,N/A,75,2
18,N/A,N/A,N/A,1240,1258,N/A,79,6
5,N/A,N/A,N/A,1235,1240,N/A,85,0
15,N/A,N/A,N/A,1220,1235,N/A,91,6
5,N/A,N/A,N/A,1215,1220,N/A,95,4
4,N/A,N/A,N/A,1211,1215,N/A,100,3
5,N/A,N/A,N/A,1206,1211,N/A,104,1
17,N/A,N/A,N/A,1189,1206,N/A,109,6
9,N/A,N/A,N/A,1180,1189,N/A,114,5
11,N/A,N/A,N/A,1169,1180,N/A,120,5
6,N/A,N/A,N/A,1163,1169,N/A,123,2
7,N/A,N/A,N/A,1156,1163,N/A,129,2
5,N/A,N/A,N/A,1151,1156,N/A,134,1
6,N/A,N/A,N/A,1145,1151,N/A,137,4
8,N/A,N/A,N/A,1137,1145,N/A,143,4
7,N/A,N/A,N/A,1130,1137,N/A,148,3
15,N/A,N/A,N/A,1552,1567,N/A,5,6
11,N/A,N/A,N/A,1541,1552,N/A,10,5
12,N/A,N/A,N/A,1529,1541,N/A,16,5
6,N/A,N/A,N/A,1523,1529,N/A,21,4
5,N/A,N/A,N/A,1518,1523,N/A,24,1
5,N/A,N/A,N/A,1513,1518,N/A,30,1
5,N/A,N/A,N/A,1508,1513,N/A,36,1
12,N/A,N/A,N/A,1496,1508,N/A,41,6
5,N/A,N/A,N/A,1491,1496,N/A,45,4
4,N/A,N/A,N/A,1487,1491,N/A,48,1
7,N/A,N/A,N/A,1480,1487,N/A,51,4
7,N/A,N/A,N/A,1473,1480,N/A,56,3
14,N/A,N/A,N/A,1459,1473,N/A,59,6
4,N/A,N/A,N/A,1455,1459,N/A,65,0
11,N/A,N/A,N/A,1444,1455,N/A,71,6
7,N/A,N/A,N/A,1437,1444,N/A,74,3
4,N/A,N/A,N/A,1433,1437,N/A,80,3
6,N/A,N/A,N/A,1427,1433,N/A,86,3
12,N/A,N/A,N/A,1415,1427,N/A,89,6
5,N/A,N/A,N/A,1410,1415,N/A,95,0
6,N/A,N/A,N/A,1404,1410,N/A,98,3
13,N/A,N/A,N/A,1391,1404,N/A,101,6
6,N/A,N/A,N/A,1385,1391,N/A,104,3
14,N/A,N/A,N/A,1371,1385,N/A,107,6
5,N/A,N/A,N/A,1366,1371,N/A,113,0
19,N/A,N/A,N/A,1347,1366,N/A,119,6
4,N/A,N/A,N/A,1343,1347,N/A,125,0
5,N/A,N/A,N/A,1338,1343,N/A,129,4
7,N/A,N/A,N/A,1331,1338,N/A,135,4
7,N/A,N/A,N/A,1324,1331,N/A,140,3
12,N/A,N/A,N/A,1086,1098,N/A,6,6
5,N/A,N/A,N/A,1081,1086,N/A,12,0
9,N/A,N/A,N/A,1072,1081,N/A,17,5
4,N/A,N/A,N/A,1068,1072,N/A,21,3
4,N/A,N/A,N/A,1064,1068,N/A,27,3
5,N/A,N/A,N/A,1059,1064,N/A,31,1
5,N/A,N/A,N/A,1054,1059,N/A,34,4
6,N/A,N/A,N/A,1048,1054,N/A,39,3
5,N/A,N/A,N/A,1043,1048,N/A,44,2
10,N/A,N/A,N/A,1033,1043,N/A,47,5
4,N/A,N/A,N/A,1029,1033,N/A,51,3
6,N/A,N/A,N/A,1023,1029,N/A,57,3
4,N/A,N/A,N/A,1019,1023,N/A,62,2
4,N/A,N/A,N/A,1015,1019,N/A,67,1
5,N/A,N/A,N/A,1010,1015,N/A,70,4
4,N/A,N/A,N/A,1006,1010,N/A,73,1
5,N/A,N/A,N/A,1001,1006,N/A,79,1
4,N/A,N/A,N/A,997,1001,N/A,85,1
5,N/A,N/A,N/A,992,997,N/A,91,1
17,N/A,N/A,N/A,975,992,N/A,96,6
10,N/A,N/A,N/A,965,975,N/A,101,5
11,N/A,N/A,N/A,954,965,N/A,107,5
11,N/A,N/A,N/A,943,954,N/A,113,5
11,N/A,N/A,N/A,932,943,N/A,119,5
5,N/A,N/A,N/A,927,932,N/A,124,4
6,N/A,N/A,N/A,921,927,N/A,130,4
7,N/A,N/A,N/A,914,921,N/A,134,2
4,N/A,N/A,N/A,910,914,N/A,140,2
10,N/A,N/A,N/A,900,910,N/A,144,6
7,N/A,N/A,N/A,893,900,N/A,148,4
5,N/A,N/A,N/A,1405,1410,N/A,4,1
5,N/A,N/A,N/A,1400,1405,N/A,10,1
13,N/A,N/A,N/A,1387,1400,N/A,15,6
5,N/A,N/A,N/A,1382,1387,N/A,18,3
6,N/A,N/A,N/A,1376,1382,N/A,23,2
19,N/A,N/A,N/A,1357,1376,N/A,27,6
6,N/A,N/A,N/A,1351,1357,N/A,30,3
4,N/A,N/A,N/A,1347,1351,N/A,36,3
5,N/A,N/A,N/A,1342,1347,N/A,40,1
9,N/A,N/A,N/A,1333,1342,N/A,44,5
4,N/A,N/A,N/A,1329,1333,N/A,47,2
12,N/A,N/A,N/A,1317,1329,N/A,50,5
6,N/A,N/A,N/A,1311,1317,N/A,54,3
18,N/A,N/A,N/A,1293,1311,N/A,57,6
5,N/A,N/A,N/A,1288,1293,N/A,60,3
11,N/A,N/A,N/A,1277,1288,N/A,63,6
5,N/A,N/A,N/A,1272,1277,N/A,66,3
5,N/A,N/A,N/A,1267,1272,N/A,72,3
4,N/A,N/A,N/A,1263,1267,N/A,78,3
5,N/A,N/A,N/A,1258,1263,N/A,84,3
4,N/A,N/A,N/A,1254,1258,N/A,88,1
12,N/A,N/A,N/A,1242,1254,N/A,92,5
5,N/A,N/A,N/A,1237,1242,N/A,97,4
5,N/A,N/A,N/A,1232,1237,N/A,101,2
5,N/A,N/A,N/A,1227,1232,N/A,106,1
10,N/A,N/A,N/A,1217,1227,N/A,110,5
6,N/A,N/A,N/A,1211,1217,N/A,115,4
5,N/A,N/A,N/A,1206,1211,N/A,118,1
9,N/A,N/A,N/A,1197,1206,N/A,122,5
10,N/A,N/A,N/A,1187,1197,N/A,128,5
4,N/A,N/A,N/A,1804,1808,N/A,4,3
5,N/A,N/A,N/A,1799,1804,N/A,8,1
5,N/A,N/A,N/A,1794,1799,N/A,14,1
10,N/A,N/A,N/A,1784,1794,N/A,19,6
5,N/A,N/A,N/A,1779,1784,N/A,22,3
5,N/A,N/A,N/A,1774,1779,N/A,26,1
17,N/A,N/A,N/A,1757,1774,N/A,31,6
6,N/A,N/A,N/A,1751,1757,N/A,35,4
5,N/A,N/A,N/A,1746,1751,N/A,41,4
5,N/A,N/A,N/A,1741,1746,N/A,46,3
4,N/A,N/A,N/A,1737,1741,N/A,52,3
17,N/A,N/A,N/A,1720,1737,N/A,55,6
4,N/A,N/A,N/A,1716,1720,N/A,61,0
18,N/A,N/A,N/A,1698,1716,N/A,67,6
5,N/A,N/A,N/A,1693,1698,N/A,73,0
7,N/A,N/A,N/A,1686,1693,N/A,77,4
6,N/A,N/A,N/A,1680,1686,N/A,82,3
6,N/A,N/A,N/A,1674,1680,N/A,87,2
4,N/A,N/A,N/A,1670,1674,N/A,93,2
5,N/A,N/A,N/A,1665,1670,N/A,99,2
9,N/A,N/A,N/A,1656,1665,N/A,102,5
8,N/A,N/A,N/A,1648,1656,N/A,107,4
7,N/A,N/A,N/A,1641,1648,N/A,111,2
11,N/A,N/A,N/A,1630,1641,N/A,114,5
5,N/A,N/A,N/A,1625,1630,N/A,119,4
7,N/A,N/A,N/A,1618,1625,N/A,124,3
7,N/A,N/A,N/A,1611,1618,N/A,130,3
5,N/A,N/A,N/A,1606,1611,N/A,134,1
9,N/A,N/A,N/A,1597,1606,N/A,138,5
5,N/A,N/A,N/A,1592,1597,N/A,141,2
11,N/A,N/A,N/A,341,352,N/A,3,5
5,N/A,N/A,N/A,336,341,N/A,8,4
7,N/A,N/A,N/A,329,336,N/A,12,2
4,N/A,N/A,N/A,325,329,N/A,17,1
8,N/A,N/A,N/A,317,325,N/A,20,4
5,N/A,N/A,N/A,312,317,N/A,23,1
6,N/A,N/A,N/A,306,312,N/A,26,4
5,N/A,N/A,N/A,301,306,N/A,29,1
4,N/A,N/A,N/A,297,301,N/A,35,1
9,N/A,N/A,N/A,288,297,N/A,39,5
7,N/A,N/A,N/A,281,288,N/A,42,2
10,N/A,N/A,N/A,271,281,N/A,45,5
6,N/A,N/A,N/A,265,271,N/A,48,2
4,N/A,N/A,N/A,261,265,N/A,54,2
5,N/A,N/A,N/A,256,261,N/A,60,2
4,N/A,N/A,N/A,252,256,N/A,65,1
5,N/A,N/A,N/A,247,252,N/A,71,1
7,N/A,N/A,N/A,240,247,N/A,74,4
4,N/A,N/A,N/A,236,240,N/A,78,2
4,N/A,N/A,N/A,232,236,N/A,84,2
9,N/A,N/A,N/A,223,232,N/A,87,5
9,N/A,N/A,N/A,214,223,N/A,93,5
5,N/A,N/A,N/A,209,214,N/A,97,3
14,N/A,N/A,N/A,195,209,N/A,100,6
9,N/A,N/A,N/A,186,195,N/A,105,5
5,N/A,N/A,N/A,181,186,N/A,110,4
4,N/A,N/A,N/A,177,181,N/A,113,1
5,N/A,N/A,N/A,172,177,N/A,116,4
6,N/A,N/A,N/A,166,172,N/A,121,3
7,N/A,N/A,N/A,159,166,N/A,127,3
7,N/A,N/A,N/A,396,403,N/A,6,4
5,N/A,N/A,N/A,391,396,N/A,10,2
6,N/A,N/A,N/A,385,391,N/A,16,2
10,N/A,N/A,N/A,375,385,N/A,19,5
7,N/A,N/A,N/A,368,375,N/A,23,3
5,N/A,N/A,N/A,363,368,N/A,27,1
7,N/A,N/A,N/A,356,363,N/A,30,4
5,N/A,N/A,N/A,351,356,N/A,36,4
5,N/A,N/A,N/A,346,351,N/A,39,1
11,N/A,N/A,N/A,335,346,N/A,43,5
9,N/A,N/A,N/A,326,335,N/A,49,5
7,N/A,N/A,N/A,319,326,N/A,54,4
6,N/A,N/A,N/A,313,319,N/A,60,4
4,N/A,N/A,N/A,309,313,N/A,64,2
4,N/A,N/A,N/A,305,309,N/A,70,2
6,N/A,N/A,N/A,299,305,N/A,76,2
7,N/A,N/A,N/A,292,299,N/A,82,2
4,N/A,N/A,N/A,288,292,N/A,88,2
15,N/A,N/A,N/A,273,288,N/A,92,6
5,N/A,N/A,N/A,268,273,N/A,98,0
18,N/A,N/A,N/A,250,268,N/A,104,6
5,N/A,N/A,N/A,245,250,N/A,108,4
5,N/A,N/A,N/A,240,245,N/A,111,1
5,N/A,N/A,N/A,235,240,N/A,114,4
6,N/A,N/A,N/A,229,235,N/A,119,3
17,N/A,N/A,N/A,212,229,N/A,122,6
4,N/A,N/A,N/A,208,212,N/A,125,3
4,N/A,N/A,N/A,204,208,N/A,130,2
5,N/A,N/A,N/A,199,204,N/A,136,2
4,N/A,N/A,N/A,195,199,N/A,142,2
10,N/A,N/A,N/A,1386,1396,N/A,3,5
11,N/A,N/A,N/A,1375,1386,N/A,9,5
12,N/A,N/A,N/A,1363,1375,N/A,15,5
5,N/A,N/A,N/A,1358,1363,N/A,20,4
7,N/A,N/A,N/A,1351,1358,N/A,25,3
14,N/A,N/A,N/A,1337,1351,N/A,28,6
8,N/A,N/A,N/A,1329,1337,N/A,32,4
5,N/A,N/A,N/A,1324,1329,N/A,36,2
4,N/A,N/A,N/A,1320,1324,N/A,41,1
14,N/A,N/A,N/A,1306,1320,N/A,46,6
5,N/A,N/A,N/A,1301,1306,N/A,52,0
16,N/A,N/A,N/A,1285,1301,N/A,58,6
6,N/A,N/A,N/A,1279,1285,N/A,61,3
7,N/A,N/A,N/A,1272,1279,N/A,67,3
6,N/A,N/A,N/A,1266,1272,N/A,73,3
5,N/A,N/A,N/A,1261,1266,N/A,79,3
13,N/A,N/A,N/A,1248,1261,N/A,82,6
9,N/A,N/A,N/A,1239,1248,N/A,87,5
8,N/A,N/A,N/A,1231,1239,N/A,92,4
4,N/A,N/A,N/A,1227,1231,N/A,96,2
4,N/A,N/A,N/A,1223,1227,N/A,101,1
6,N/A,N/A,N/A,1217,1223,N/A,104,4
5,N/A,N/A,N/A,1212,1217,N/A,107,1
5,N/A,N/A,N/A,1207,1212,N/A,110,4
7,N/A,N/A,N/A,1200,1207,N/A,115,3
5,N/A,N/A,N/A,1195,1200,N/A,119,1
4,N/A,N/A,N/A,1191,1195,N/A,125,1
5,N/A,N/A,N/A,1186,1191,N/A,131,1
16,N/A,N/A,N/A,1170,1186,N/A,136,6
4,N/A,N/A,N/A,1166,1170,N/A,142,0
4,N/A,N/A,N/A,1150,1154,N/A,5,1
12,N/A,N/A,N/A,1138,1150,N/A,9,5
5,N/A,N/A,N/A,1133,1138,N/A,14,4
7,N/A,N/A,N/A,1126,1133,N/A,20,4
5,N/A,N/A,N/A,1121,1126,N/A,26,4
7,N/A,N/A,N/A,1114,1121,N/A,32,4
4,N/A,N/A,N/A,1110,1114,N/A,36,2
10,N/A,N/A,N/A,1100,1110,N/A,39,5
11,N/A,N/A,N/A,1089,1100,N/A,45,5
6,N/A,N/A,N/A,1083,1089,N/A,49,3
4,N/A,N/A,N/A,1079,1083,N/A,53,1
4,N/A,N/A,N/A,1075,1079,N/A,59,1
5,N/A,N/A,N/A,1070,1075,N/A,65,1
4,N/A,N/A,N/A,1066,1070,N/A,71,1
11,N/A,N/A,N/A,1055,1066,N/A,75,5
8,N/A,N/A,N/A,1047,1055,N/A,80,4
4,N/A,N/A,N/A,1043,1047,N/A,84,2
14,N/A,N/A,N/A,1029,1043,N/A,88,6
9,N/A,N/A,N/A,1020,1029,N/A,93,5
6,N/A,N/A,N/A,1014,1020,N/A,98,4
5,N/A,N/A,N/A,1009,1014,N/A,104,4
5,N/A,N/A,N/A,1004,1009,N/A,109,3
5,N/A,N/A,N/A,999,1004,N/A,113,1
8,N/A,N/A,N/A,991,999,N/A,116,4
5,N/A,N/A,N/A,986,991,N/A,121,3
5,N/A,N/A,N/A,981,986,N/A,125,1
12,N/A,N/A,N/A,969,981,N/A,129,5
5,N/A,N/A,N/A,964,969,N/A,133,3
5,N/A,N/A,N/A,959,964,N/A,137,1
7,N/A,N/A,N/A,952,959,N/A,140,4
10,N/A,N/A,N/A,1408,1418,N/A,5,5
7,N/A,N/A,N/A,1401,1408,N/A,8,2
10,N/A,N/A,N/A,1391,1401,N/A,12,6
9,N/A,N/A,N/A,1382,1391,N/A,17,5
6,N/A,N/A,N/A,1376,1382,N/A,22,4
5,N/A,N/A,N/A,1371,1376,N/A,28,4
5,N/A,N/A,N/A,1366,1371,N/A,33,3
4,N/A,N/A,N/A,1362,1366,N/A,37,1
14,N/A,N/A,N/A,1348,1362,N/A,42,6
4,N/A,N/A,N/A,1344,1348,N/A,48,0
9,N/A,N/A,N/A,1335,1344,N/A,53,5
7,N/A,N/A,N/A,1328,1335,N/A,58,4
7,N/A,N/A,N/A,1321,1328,N/A,64,4
6,N/A,N/A,N/A,1315,1321,N/A,68,2
5,N/A,N/A,N/A,1310,1315,N/A,74,2
4,N/A,N/A,N/A,1306,1310,N/A,79,1
5,N/A,N/A,N/A,1301,1306,N/A,82,4
5,N/A,N/A,N/A,1296,1301,N/A,87,3
4,N/A,N/A,N/A,1292,1296,N/A,91,1
5,N/A,N/A,N/A,1287,1292,N/A,94,4
4,N/A,N/A,N/A,1283,1287,N/A,99,3
5,N/A,N/A,N/A,1278,1283,N/A,103,1
9,N/A,N/A,N/A,1269,1278,N/A,107,5
11,N/A,N/A,N/A,1258,1269,N/A,113,5
5,N/A,N/A,N/A,1253,1258,N/A,117,3
7,N/A,N/A,N/A,1246,1253,N/A,122,2
11,N/A,N/A,N/A,1235,1246,N/A,125,5
5,N/A,N/A,N/A,1230,1235,N/A,130,4
4,N/A,N/A,N/A,1226,1230,N/A,134,2
4,N/A,N/A,N/A,1222,1226,N/A,139,1
5,N/A,N/A,N/A,1364,1369,N/A,3,1
12,N/A,N/A,N/A,1352,1364,N/A,7,5
12,N/A,N/A,N/A,1340,1352,N/A,13,5
12,N/A,N/A,N/A,1328,1340,N/A,19,5
6,N/A,N/A,N/A,1322,1328,N/A,24,4
5,N/A,N/A,N/A,1317,1322,N/A,28,2
12,N/A,N/A,N/A,1305,1317,N/A,31,5
5,N/A,N/A,N/A,1300,1305,N/A,35,3
5,N/A,N/A,N/A,1295,1300,N/A,41,3
16,N/A,N/A,N/A,1279,1295,N/A,44,6
6,N/A,N/A,N/A,1273,1279,N/A,48,4
6,N/A,N/A,N/A,1267,1273,N/A,52,2
10,N/A,N/A,N/A,1257,1267,N/A,55,5
10,N/A,N/A,N/A,1247,1257,N/A,61,5
7,N/A,N/A,N/A,1240,1247,N/A,64,2
6,N/A,N/A,N/A,1234,1240,N/A,70,2
11,N/A,N/A,N/A,1223,1234,N/A,74,6
4,N/A,N/A,N/A,1219,1223,N/A,77,3
6,N/A,N/A,N/A,1213,1219,N/A,83,3
5,N/A,N/A,N/A,1208,1213,N/A,88,2
16,N/A,N/A,N/A,1192,1208,N/A,92,6
9,N/A,N/A,N/A,1183,1192,N/A,97,5
11,N/A,N/A,N/A,1172,1183,N/A,103,5
4,N/A,N/A,N/A,1168,1172,N/A,106,2
14,N/A,N/A,N/A,1154,1168,N/A,110,6
4,N/A,N/A,N/A,1150,1154,N/A,116,0
15,N/A,N/A,N/A,1135,1150,N/A,122,6
5,N/A,N/A,N/A,1130,1135,N/A,128,0
6,N/A,N/A,N/A,1124,1130,N/A,131,3
4,N/A,N/A,N/A,1120,1124,N/A,135,1
5,N/A,N/A,N/A,1400,1405,N/A,6,1
13,N/A,N/A,N/A,1387,1400,N/A,11,6
4,N/A,N/A,N/A,1383,1387,N/A,17,0
10,N/A,N/A,N/A,1373,1383,N/A,22,5
10,N/A,N/A,N/A,1363,1373,N/A,28,5
6,N/A,N/A,N/A,1357,1363,N/A,31,2
6,N/A,N/A,N/A,1351,1357,N/A,37,2
13,N/A,N/A,N/A,1338,1351,N/A,41,6
5,N/A,N/A,N/A,1333,1338,N/A,45,4
6,N/A,N/A,N/A,1327,1333,N/A,51,4
4,N/A,N/A,N/A,1323,1327,N/A,55,2
4,N/A,N/A,N/A,1319,1323,N/A,60,1
5,N/A,N/A,N/A,1314,1319,N/A,63,4
5,N/A,N/A,N/A,1309,1314,N/A,67,2
5,N/A,N/A,N/A,1304,1309,N/A,73,2
5,N/A,N/A,N/A,1299,1304,N/A,78,1
19,N/A,N/A,N/A,1280,1299,N/A,83,6
12,N/A,N/A,N/A,1268,1280,N/A,88,5
4,N/A,N/A,N/A,1264,1268,N/A,91,2
6,N/A,N/A,N/A,1258,1264,N/A,97,2
11,N/A,N/A,N/A,1247,1258,N/A,100,5
5,N/A,N/A,N/A,1242,1247,N/A,104,3
5,N/A,N/A,N/A,1237,1242,N/A,110,3
5,N/A,N/A,N/A,1232,1237,N/A,116,3
13,N/A,N/A,N/A,1219,1232,N/A,119,6
4,N/A,N/A,N/A,1215,1219,N/A,125,0
10,N/A,N/A,N/A,1205,1215,N/A,130,5
7,N/A,N/A,N/A,1198,1205,N/A,135,4
4,N/A,N/A,N/A,1194,1198,N/A,139,2
9,N/A,N/A,N/A,1185,1194,N/A,142,5
11,N/A,N/A,N/A,1018,1029,N/A,5,5
6,N/A,N/A,N/A,1012,1018,N/A,8,2
4,N/A,N/A,N/A,1008,1012,N/A,13,1
7,N/A,N/A,N/A,1001,1008,N/A,16,4
5,N/A,N/A,N/A,996,1001,N/A,19,1
11,N/A,N/A,N/A,985,996,N/A,23,5
12,N/A,N/A,N/A,973,985,N/A,29,5
6,N/A,N/A,N/A,967,973,N/A,34,4
7,N/A,N/A,N/A,960,967,N/A,38,2
7,N/A,N/A,N/A,953,960,N/A,44,2
9,N/A,N/A,N/A,944,953,N/A,47,5
4,N/A,N/A,N/A,940,944,N/A,50,2
11,N/A,N/A,N/A,929,940,N/A,53,5
5,N/A,N/A,N/A,924,929,N/A,57,3
12,N/A,N/A,N/A,912,924,N/A,60,6
6,N/A,N/A,N/A,906,912,N/A,63,3
4,N/A,N/A,N/A,902,906,N/A,67,1
5,N/A,N/A,N/A,897,902,N/A,73,1
9,N/A,N/A,N/A,888,897,N/A,77,5
11,N/A,N/A,N/A,877,888,N/A,83,5
6,N/A,N/A,N/A,871,877,N/A,86,2
5,N/A,N/A,N/A,866,871,N/A,91,1
5,N/A,N/A,N/A,861,866,N/A,94,4
7,N/A,N/A,N/A,854,861,N/A,100,4
5,N/A,N/A,N/A,849,854,N/A,103,1
6,N/A,N/A,N/A,843,849,N/A,106,4
5,N/A,N/A,N/A,838,843,N/A,109,1
12,N/A,N/A,N/A,826,838,N/A,113,5
9,N/A,N/A,N/A,817,826,N/A,119,5
6,N/A,N/A,N/A,811,817,N/A,124,4
7,N/A,N/A,N/A,1770,1777,N/A,4,4
4,N/A,N/A,N/A,1766,1770,N/A,7,1
8,N/A,N/A,N/A,1758,1766,N/A,10,4
5,N/A,N/A,N/A,1753,1758,N/A,15,3
16,N/A,N/A,N/A,1737,1753,N/A,18,6
5,N/A,N/A,N/A,1732,1737,N/A,21,3
5,N/A,N/A,N/A,1727,1732,N/A,26,2
11,N/A,N/A,N/A,1716,1727,N/A,29,5
7,N/A,N/A,N/A,1709,1716,N/A,33,3
4,N/A,N/A,N/A,1705,1709,N/A,37,1
14,N/A,N/A,N/A,1691,1705,N/A,42,6
5,N/A,N/A,N/A,1686,1691,N/A,45,3
4,N/A,N/A,N/A,1682,1686,N/A,51,3
4,N/A,N/A,N/A,1678,1682,N/A,56,2
19,N/A,N/A,N/A,1659,1678,N/A,60,6
8,N/A,N/A,N/A,1651,1659,N/A,64,4
7,N/A,N/A,N/A,1644,1651,N/A,70,4
5,N/A,N/A,N/A,1639,1644,N/A,74,2
16,N/A,N/A,N/A,1623,1639,N/A,78,6
10,N/A,N/A,N/A,1613,1623,N/A,83,5
4,N/A,N/A,N/A,1609,1613,N/A,86,2
10,N/A,N/A,N/A,1599,1609,N/A,89,5
7,N/A,N/A,N/A,1592,1599,N/A,93,3
5,N/A,N/A,N/A,1587,1592,N/A,97,1
4,N/A,N/A,N/A,1583,1587,N/A,103,1
4,N/A,N/A,N/A,1579,1583,N/A,109,1
9,N/A,N/A,N/A,1570,1579,N/A,113,5
6,N/A,N/A,N/A,1564,1570,N/A,117,3
5,N/A,N/A,N/A,1559,1564,N/A,123,3
4,N/A,N/A,N/A,1555,1559,N/A,127,1
6,N/A,N/A,N/A,580,586,N/A,4,3
4,N/A,N/A,N/A,576,580,N/A,8,1
5,N/A,N/A,N/A,571,576,N/A,14,1
11,N/A,N/A,N/A,560,571,N/A,19,6
11,N/A,N/A,N/A,549,560,N/A,24,5
11,N/A,N/A,N/A,538,549,N/A,30,5
5,N/A,N/A,N/A,533,538,N/A,34,3
5,N/A,N/A,N/A,528,533,N/A,39,2
19,N/A,N/A,N/A,509,528,N/A,43,6
5,N/A,N/A,N/A,504,509,N/A,46,3
5,N/A,N/A,N/A,499,504,N/A,52,3
7,N/A,N/A,N/A,492,499,N/A,58,3
12,N/A,N/A,N/A,480,492,N/A,61,6
11,N/A,N/A,N/A,469,480,N/A,66,5
7,N/A,N/A,N/A,462,469,N/A,71,4
7,N/A,N/A,N/A,455,462,N/A,77,4
5,N/A,N/A,N/A,450,455,N/A,82,3
4,N/A,N/A,N/A,446,450,N/A,86,1
4,N/A,N/A,N/A,442,446,N/A,92,1
4,N/A,N/A,N/A,438,442,N/A,98,1
6,N/A,N/A,N/A,432,438,N/A,101,4
7,N/A,N/A,N/A,425,432,N/A,106,3
7,N/A,N/A,N/A,418,425,N/A,112,3
6,N/A,N/A,N/A,412,418,N/A,117,2
11,N/A,N/A,N/A,401,412,N/A,120,5
6,N/A,N/A,N/A,395,401,N/A,124,3
14,N/A,N/A,N/A,381,395,N/A,127,6
7,N/A,N/A,N/A,374,381,N/A,130,3
4,N/A,N/A,N/A,370,374,N/A,136,3
4,N/A,N/A,N/A,366,370,N/A,141,2
16,N/A,N/A,N/A,1140,1156,N/A,5,6
6,N/A,N/A,N/A,1134,1140,N/A,8,3
19,N/A,N/A,N/A,1115,1134,N/A,11,6
6,N/A,N/A,N/A,1109,1115,N/A,14,3
5,N/A,N/A,N/A,1104,1109,N/A,19,2
16,N/A,N/A,N/A,1088,1104,N/A,23,6
7,N/A,N/A,N/A,1081,1088,N/A,26,3
4,N/A,N/A,N/A,1077,1081,N/A,30,1
4,N/A,N/A,N/A,1073,1077,N/A,36,1
10,N/A,N/A,N/A,1063,1073,N/A,41,6
6,N/A,N/A,N/A,1057,1063,N/A,44,3
16,N/A,N/A,N/A,1041,1057,N/A,47,6
6,N/A,N/A,N/A,1035,1041,N/A,50,3
6,N/A,N/A,N/A,1029,1035,N/A,56,3
7,N/A,N/A,N/A,1022,1029,N/A,62,3
4,N/A,N/A,N/A,1018,1022,N/A,67,2
12,N/A,N/A,N/A,1006,1018,N/A,70,5
12,N/A,N/A,N/A,994,1006,N/A,76,5
12,N/A,N/A,N/A,982,994,N/A,82,5
4,N/A,N/A,N/A,978,982,N/A,85,2
11,N/A,N/A,N/A,967,978,N/A,88,5
12,N/A,N/A,N/A,955,967,N/A,94,5
7,N/A,N/A,N/A,948,955,N/A,98,3
4,N/A,N/A,N/A,944,948,N/A,102,1
9,N/A,N/A,N/A,935,944,N/A,106,5
4,N/A,N/A,N/A,931,935,N/A,109,2
12,N/A,N/A,N/A,919,931,N/A,112,5
6,N/A,N/A,N/A,913,919,N/A,115,2
5,N/A,N/A,N/A,908,913,N/A,121,2
17,N/A,N/A,N/A,891,908,N/A,125,6
4,N/A,N/A,N/A,1819,1823,N/A,6,2
9,N/A,N/A,N/A,1810,1819,N/A,9,5
5,N/A,N/A,N/A,1805,1810,N/A,12,2
12,N/A,N/A,N/A,1793,1805,N/A,15,5
6,N/A,N/A,N/A,1787,1793,N/A,19,3
4,N/A,N/A,N/A,1783,1787,N/A,23,1
9,N/A,N/A,N/A,1774,1783,N/A,27,5
6,N/A,N/A,N/A,1768,1774,N/A,31,3
7,N/A,N/A,N/A,1761,1768,N/A,36,2
5,N/A,N/A,N/A,1756,1761,N/A,41,1
5,N/A,N/A,N/A,1751,1756,N/A,47,1
5,N/A,N/A,N/A,1746,1751,N/A,50,4
5,N/A,N/A,N/A,1741,1746,N/A,54,2
5,N/A,N/A,N/A,1736,1741,N/A,59,1
4,N/A,N/A,N/A,1732,1736,N/A,65,1
8,N/A,N/A,N/A,1724,1732,N/A,68,4
5,N/A,N/A,N/A,1719,1724,N/A,74,4
5,N/A,N/A,N/A,1714,1719,N/A,77,1
10,N/A,N/A,N/A,1704,1714,N/A,81,5
7,N/A,N/A,N/A,1697,1704,N/A,84,2
6,N/A,N/A,N/A,1691,1697,N/A,90,2
4,N/A,N/A,N/A,1687,1691,N/A,95,1
16,N/A,N/A,N/A,1671,1687,N/A,100,6
7,N/A,N/A,N/A,1664,1671,N/A,103,3
5,N/A,N/A,N/A,1659,1664,N/A,107,1
6,N/A,N/A,N/A,1653,1659,N/A,110,4
5,N/A,N/A,N/A,1648,1653,N/A,116,4
5,N/A,N/A,N/A,1643,1648,N/A,121,3
7,N/A,N/A,N/A,1636,1643,N/A,126,2
4,N/A,N/A,N/A,1632,1636,N/A,131,1
10,N/A,N/A,N/A,710,720,N/A,4,5
5,N/A,N/A,N/A,705,710,N/A,8,3
5,N/A,N/A,N/A,700,705,N/A,12,1
7,N/A,N/A,N/A,693,700,N/A,15,4
7,N/A,N/A,N/A,686,693,N/A,20,3
12,N/A,N/A,N/A,674,686,N/A,23,6
5,N/A,N/A,N/A,669,674,N/A,29,0
4,N/A,N/A,N/A,665,669,N/A,32,3
15,N/A,N/A,N/A,650,665,N/A,35,6
11,N/A,N/A,N/A,639,650,N/A,40,5
7,N/A,N/A,N/A,632,639,N/A,45,4
7,N/A,N/A,N/A,625,632,N/A,50,3
5,N/A,N/A,N/A,620,625,N/A,56,3
5,N/A,N/A,N/A,615,620,N/A,60,1
13,N/A,N/A,N/A,602,615,N/A,65,6
5,N/A,N/A,N/A,597,602,N/A,71,0
14,N/A,N/A,N/A,583,597,N/A,77,6
6,N/A,N/A,N/A,577,583,N/A,81,4
8,N/A,N/A,N/A,569,577,N/A,87,4
7,N/A,N/A,N/A,562,569,N/A,91,2
11,N/A,N/A,N/A,551,562,N/A,95,6
5,N/A,N/A,N/A,546,551,N/A,99,4
5,N/A,N/A,N/A,541,546,N/A,105,4
6,N/A,N/A,N/A,535,541,N/A,109,2
6,N/A,N/A,N/A,529,535,N/A,115,2
7,N/A,N/A,N/A,522,529,N/A,121,2
12,N/A,N/A,N/A,510,522,N/A,124,5
7,N/A,N/A,N/A,503,510,N/A,127,2
4,N/A,N/A,N/A,499,503,N/A,132,1
4,N/A,N/A,N/A,495,499,N/A,138,1
4,N/A,N/A,N/A,700,704,N/A,4,2
5,N/A,N/A,N/A,695,700,N/A,9,1
5,N/A,N/A,N/A,690,695,N/A,15,1
7,N/A,N/A,N/A,683,690,N/A,18,4
5,N/A,N/A,N/A,678,683,N/A,23,3
5,N/A,N/A,N/A,673,678,N/A,28,2
18,N/A,N/A,N/A,655,673,N/A,32,6
7,N/A,N/A,N/A,648,655,N/A,36,4
5,N/A,N/A,N/A,643,648,N/A,40,2
10,N/A,N/A,N/A,633,643,N/A,43,5
10,N/A,N/A,N/A,623,633,N/A,49,5
9,N/A,N/A,N/A,614,623,N/A,55,5
6,N/A,N/A,N/A,608,614,N/A,59,3
6,N/A,N/A,N/A,602,608,N/A,65,3
4,N/A,N/A,N/A,598,602,N/A,69,1
8,N/A,N/A,N/A,590,598,N/A,72,4
4,N/A,N/A,N/A,586,590,N/A,77,3
13,N/A,N/A,N/A,573,586,N/A,80,6
7,N/A,N/A,N/A,566,573,N/A,84,4
6,N/A,N/A,N/A,560,566,N/A,90,4
7,N/A,N/A,N/A,553,560,N/A,94,2
7,N/A,N/A,N/A,546,553,N/A,100,2
17,N/A,N/A,N/A,529,546,N/A,104,6
6,N/A,N/A,N/A,523,529,N/A,108,4
4,N/A,N/A,N/A,519,523,N/A,111,1
12,N/A,N/A,N/A,507,519,N/A,115,5
8,N/A,N/A,N/A,499,507,N/A,120,4
4,N/A,N/A,N/A,495,499,N/A,125,3
14,N/A,N/A,N/A,481,495,N/A,128,6
5,N/A,N/A,N/A,476,481,N/A,134,0
4,N/A,N/A,N/A,1802,1806,N/A,4,1
10,N/A,N/A,N/A,1792,1802,N/A,8,5
7,N/A,N/A,N/A,1785,1792,N/A,13,4
4,N/A,N/A,N/A,1781,1785,N/A,18,3
16,N/A,N/A,N/A,1765,1781,N/A,21,6
4,N/A,N/A,N/A,1761,1765,N/A,27,0
7,N/A,N/A,N/A,1754,1761,N/A,30,3
4,N/A,N/A,N/A,1750,1754,N/A,34,1
18,N/A,N/A,N/A,1732,1750,N/A,39,6
12,N/A,N/A,N/A,1720,1732,N/A,44,5
7,N/A,N/A,N/A,1713,1720,N/A,49,4
6,N/A,N/A,N/A,1707,1713,N/A,55,4
4,N/A,N/A,N/A,1703,1707,N/A,58,1
9,N/A,N/A,N/A,1694,1703,N/A,62,5
11,N/A,N/A,N/A,1683,1694,N/A,68,5
12,N/A,N/A,N/A,1671,1683,N/A,74,5
5,N/A,N/A,N/A,1666,1671,N/A,77,2
5,N/A,N/A,N/A,1661,1666,N/A,82,1
4,N/A,N/A,N/A,1657,1661,N/A,88,1
18,N/A,N/A,N/A,1639,1657,N/A,93,6
12,N/A,N/A,N/A,1627,1639,N/A,98,5
5,N/A,N/A,N/A,1622,1627,N/A,102,3
5,N/A,N/A,N/A,1617,1622,N/A,106,1
4,N/A,N/A,N/A,1613,1617,N/A,112,1
13,N/A,N/A,N/A,1600,1613,N/A,117,6
12,N/A,N/A,N/A,1588,1600,N/A,122,5
5,N/A,N/A,N/A,1583,1588,N/A,126,3
6,N/A,N/A,N/A,1577,1583,N/A,132,3
4,N/A,N/A,N/A,1573,1577,N/A,136,1
5,N/A,N/A,N/A,1568,1573,N/A,142,1
13,N/A,N/A,N/A,1586,1599,N/A,5,6
7,N/A,N/A,N/A,1579,1586,N/A,9,4
5,N/A,N/A,N/A,1574,1579,N/A,14,3
5,N/A,N/A,N/A,1569,1574,N/A,18,1
8,N/A,N/A,N/A,1561,1569,N/A,21,4
4,N/A,N/A,N/A,1557,1561,N/A,24,1
11,N/A,N/A,N/A,1546,1557,N/A,28,5
5,N/A,N/A,N/A,1541,1546,N/A,32,3
4,N/A,N/A,N/A,1537,1541,N/A,37,2
15,N/A,N/A,N/A,1522,1537,N/A,41,6
6,N/A,N/A,N/A,1516,1522,N/A,45,4
5,N/A,N/A,N/A,1511,1516,N/A,48,1
6,N/A,N/A,N/A,1505,1511,N/A,51,4
4,N/A,N/A,N/A,1501,1505,N/A,54,1
11,N/A,N/A,N/A,1490,1501,N/A,58,5
8,N/A,N/A,N/A,1482,1490,N/A,63,4
6,N/A,N/A,N/A,1476,1482,N/A,69,4
5,N/A,N/A,N/A,1471,1476,N/A,75,4
5,N/A,N/A,N/A,1466,1471,N/A,81,4
5,N/A,N/A,N/A,1461,1466,N/A,84,1
9,N/A,N/A,N/A,1452,1461,N/A,88,5
8,N/A,N/A,N/A,1444,1452,N/A,93,4
6,N/A,N/A,N/A,1438,1444,N/A,99,4
6,N/A,N/A,N/A,1432,1438,N/A,104,3
7,N/A,N/A,N/A,1425,1432,N/A,109,2
4,N/A,N/A,N/A,1421,1425,N/A,114,1
12,N/A,N/A,N/A,1409,1421,N/A,118,5
10,N/A,N/A,N/A,1399,1409,N/A,124,5
7,N/A,N/A,N/A,1392,1399,N/A,128,3
4,N/A,N/A,N/A,1388,1392,N/A,133,2
7,N/A,N/A,N/A,1532,1539,N/A,4,2
12,N/A,N/A,N/A,1520,1532,N/A,7,5
6,N/A,N/A,N/A,1514,1520,N/A,11,3
17,N/A,N/A,N/A,1497,1514,N/A,14,6
7,N/A,N/A,N/A,1490,1497,N/A,18,4
4,N/A,N/A,N/A,1486,1490,N/A,21,1
10,N/A,N/A,N/A,1476,1486,N/A,25,5
6,N/A,N/A,N/A,1470,1476,N/A,28,2
17,N/A,N/A,N/A,1453,1470,N/A,32,6
9,N/A,N/A,N/A,1444,1453,N/A,37,5
5,N/A,N/A,N/A,1439,1444,N/A,40,2
10,N/A,N/A,N/A,1429,1439,N/A,43,5
7,N/A,N/A,N/A,1422,1429,N/A,46,2
9,N/A,N/A,N/A,1413,1422,N/A,49,5
7,N/A,N/A,N/A,1406,1413,N/A,52,2
5,N/A,N/A,N/A,1401,1406,N/A,57,1
5,N/A,N/A,N/A,1396,1401,N/A,60,4
8,N/A,N/A,N/A,1388,1396,N/A,66,4
8,N/A,N/A,N/A,1380,1388,N/A,72,4
5,N/A,N/A,N/A,1375,1380,N/A,75,1
6,N/A,N/A,N/A,1369,1375,N/A,78,4
7,N/A,N/A,N/A,1362,1369,N/A,83,3
19,N/A,N/A,N/A,1343,1362,N/A,86,6
11,N/A,N/A,N/A,1332,1343,N/A,91,5
6,N/A,N/A,N/A,1326,1332,N/A,94,2
5,N/A,N/A,N/A,1321,1326,N/A,100,2
5,N/A,N/A,N/A,1316,1321,N/A,106,2
9,N/A,N/A,N/A,1307,1316,N/A,109,5
4,N/A,N/A,N/A,1303,1307,N/A,112,2
12,N/A,N/A,N/A,1291,1303,N/A,115,5
5,N/A,N/A,N/A,1528,1533,N/A,4,2
11,N/A,N/A,N/A,1517,1528,N/A,7,5
7,N/A,N/A,N/A,1510,1517,N/A,10,2
4,N/A,N/A,N/A,1506,1510,N/A,15,1
19,N/A,N/A,N/A,1487,1506,N/A,20,6
6,N/A,N/A,N/A,1481,1487,N/A,24,4
7,N/A,N/A,N/A,1474,1481,N/A,28,2
5,N/A,N/A,N/A,1469,1474,N/A,34,2
16,N/A,N/A,N/A,1453,1469,N/A,38,6
6,N/A,N/A,N/A,1447,1453,N/A,41,3
4,N/A,N/A,N/A,1443,1447,N/A,45,1
4,N/A,N/A,N/A,1439,1443,N/A,51,1
5,N/A,N/A,N/A,1434,1439,N/A,54,4
7,N/A,N/A,N/A,1427,1434,N/A,59,3
19,N/A,N/A,N/A,1408,1427,N/A,62,6
4,N/A,N/A,N/A,1404,1408,N/A,68,0
9,N/A,N/A,N/A,1395,1404,N/A,73,5
4,N/A,N/A,N/A,1391,1395,N/A,77,3
4,N/A,N/A,N/A,1387,1391,N/A,81,1
5,N/A,N/A,N/A,1382,1387,N/A,84,4
5,N/A,N/A,N/A,1377,1382,N/A,87,1
9,N/A,N/A,N/A,1368,1377,N/A,91,5
6,N/A,N/A,N/A,1362,1368,N/A,95,3
5,N/A,N/A,N/A,1357,1362,N/A,100,2
15,N/A,N/A,N/A,1342,1357,N/A,104,6
5,N/A,N/A,N/A,1337,1342,N/A,108,4
7,N/A,N/A,N/A,1330,1337,N/A,112,2
5,N/A,N/A,N/A,1325,1330,N/A,117,1
6,N/A,N/A,N/A,1319,1325,N/A,120,4
7,N/A,N/A,N/A,1312,1319,N/A,125,3
5,N/A,N/A,N/A,1127,1132,N/A,6,3
6,N/A,N/A,N/A,1121,1127,N/A,11,2
5,N/A,N/A,N/A,1116,1121,N/A,16,1
15,N/A,N/A,N/A,1101,1116,N/A,21,6
7,N/A,N/A,N/A,1094,1101,N/A,24,3
5,N/A,N/A,N/A,1089,1094,N/A,28,1
5,N/A,N/A,N/A,1084,1089,N/A,31,4
7,N/A,N/A,N/A,1077,1084,N/A,37,4
8,N/A,N/A,N/A,1069,1077,N/A,43,4
7,N/A,N/A,N/A,1062,1069,N/A,49,4
6,N/A,N/A,N/A,1056,1062,N/A,53,2
10,N/A,N/A,N/A,1046,1056,N/A,56,5
4,N/A,N/A,N/A,1042,1046,N/A,59,2
10,N/A,N/A,N/A,1032,1042,N/A,63,6
7,N/A,N/A,N/A,1025,1032,N/A,66,3
7,N/A,N/A,N/A,1018,1025,N/A,71,2
5,N/A,N/A,N/A,1013,1018,N/A,76,1
18,N/A,N/A,N/A,995,1013,N/A,81,6
8,N/A,N/A,N/A,987,995,N/A,85,4
5,N/A,N/A,N/A,982,987,N/A,89,2
9,N/A,N/A,N/A,973,982,N/A,92,5
7,N/A,N/A,N/A,966,973,N/A,95,2
11,N/A,N/A,N/A,955,966,N/A,99,6
4,N/A,N/A,N/A,951,955,N/A,102,3
13,N/A,N/A,N/A,938,951,N/A,105,6
5,N/A,N/A,N/A,933,938,N/A,108,3
19,N/A,N/A,N/A,914,933,N/A,111,6
6,N/A,N/A,N/A,908,914,N/A,115,4
5,N/A,N/A,N/A,903,908,N/A,118,1
13,N/A,N/A,N/A,890,903,N/A,123,6
18,N/A,N/A,N/A,604,622,N/A,4,6
4,N/A,N/A,N/A,600,604,N/A,10,0
6,N/A,N/A,N/A,594,600,N/A,13,3
7,N/A,N/A,N/A,587,594,N/A,19,3
4,N/A,N/A,N/A,583,587,N/A,23,1
8,N/A,N/A,N/A,575,583,N/A,26,4
7,N/A,N/A,N/A,568,575,N/A,30,2
5,N/A,N/A,N/A,563,568,N/A,35,1
9,N/A,N/A,N/A,554,563,N/A,39,5
12,N/A,N/A,N/A,542,554,N/A,45,5
5,N/A,N/A,N/A,537,542,N/A,50,4
7,N/A,N/A,N/A,530,537,N/A,54,2
16,N/A,N/A,N/A,514,530,N/A,58,6
8,N/A,N/A,N/A,506,514,N/A,62,4
4,N/A,N/A,N/A,502,506,N/A,66,2
5,N/A,N/A,N/A,497,502,N/A,71,1
4,N/A,N/A,N/A,493,497,N/A,77,1
14,N/A,N/A,N/A,479,493,N/A,82,6
4,N/A,N/A,N/A,475,479,N/A,88,0
10,N/A,N/A,N/A,465,475,N/A,94,6
5,N/A,N/A,N/A,460,465,N/A,100,0
6,N/A,N/A,N/A,454,460,N/A,104,4
4,N/A,N/A,N/A,450,454,N/A,108,2
5,N/A,N/A,N/A,445,450,N/A,113,1
13,N/A,N/A,N/A,432,445,N/A,118,6
10,N/A,N/A,N/A,422,432,N/A,123,5
6,N/A,N/A,N/A,416,422,N/A,128,4
5,N/A,N/A,N/A,411,416,N/A,131,1
11,N/A,N/A,N/A,400,411,N/A,135,5
8,N/A,N/A,N/A,392,400,N/A,140,4
5,N/A,N/A,N/A,1753,1758,N/A,4,4
8,N/A,N/A,N/A,1745,1753,N/A,10,4
4,N/A,N/A,N/A,1741,1745,N/A,13,1
19,N/A,N/A,N/A,1722,1741,N/A,18,6
7,N/A,N/A,N/A,1715,1722,N/A,22,4
4,N/A,N/A,N/A,1711,1715,N/A,25,1
4,N/A,N/A,N/A,1707,1711,N/A,31,1
8,N/A,N/A,N/A,1699,1707,N/A,34,4
4,N/A,N/A,N/A,1695,1699,N/A,39,3
5,N/A,N/A,N/A,1690,1695,N/A,44,2
12,N/A,N/A,N/A,1678,1690,N/A,47,5
7,N/A,N/A,N/A,1671,1678,N/A,50,2
9,N/A,N/A,N/A,1662,1671,N/A,53,5
6,N/A,N/A,N/A,1656,1662,N/A,58,4
5,N/A,N/A,N/A,1651,1656,N/A,61,1
6,N/A,N/A,N/A,1645,1651,N/A,64,4
5,N/A,N/A,N/A,1640,1645,N/A,67,1
10,N/A,N/A,N/A,1630,1640,N/A,71,5
5,N/A,N/A,N/A,1625,1630,N/A,76,4
6,N/A,N/A,N/A,1619,1625,N/A,80,2
4,N/A,N/A,N/A,1615,1619,N/A,85,1
5,N/A,N/A,N/A,1610,1615,N/A,88,4
7,N/A,N/A,N/A,1603,1610,N/A,94,4
5,N/A,N/A,N/A,1598,1603,N/A,99,3
16,N/A,N/A,N/A,1582,1598,N/A,102,6
5,N/A,N/A,N/A,1577,1582,N/A,108,0
4,N/A,N/A,N/A,1573,1577,N/A,111,3
4,N/A,N/A,N/A,1569,1573,N/A,115,1
12,N/A,N/A,N/A,1557,1569,N/A,119,5
7,N/A,N/A,N/A,1550,1557,N/A,124,4
11,N/A,N/A,N/A,891,902,N/A,6,6
12,N/A,N/A,N/A,879,891,N/A,11,5
9,N/A,N/A,N/A,870,879,N/A,17,5
4,N/A,N/A,N/A,866,870,N/A,21,3
7,N/A,N/A,N/A,859,866,N/A,27,3
4,N/A,N/A,N/A,855,859,N/A,31,1
9,N/A,N/A,N/A,846,855,N/A,35,5
11,N/A,N/A,N/A,835,846,N/A,41,5
6,N/A,N/A,N/A,829,835,N/A,44,2
17,N/A,N/A,N/A,812,829,N/A,48,6
10,N/A,N/A,N/A,802,812,N/A,53,5
6,N/A,N/A,N/A,796,802,N/A,57,3
4,N/A,N/A,N/A,792,796,N/A,62,2
12,N/A,N/A,N/A,780,792,N/A,65,5
6,N/A,N/A,N/A,774,780,N/A,70,4
5,N/A,N/A,N/A,769,774,N/A,74,2
7,N/A,N/A,N/A,762,769,N/A,80,2
18,N/A,N/A,N/A,744,762,N/A,84,6
5,N/A,N/A,N/A,739,744,N/A,90,0
10,N/A,N/A,N/A,729,739,N/A,96,6
11,N/A,N/A,N/A,718,729,N/A,101,5
7,N/A,N/A,N/A,711,718,N/A,104,2
9,N/A,N/A,N/A,702,711,N/A,107,5
8,N/A,N/A,N/A,694,702,N/A,112,4
4,N/A,N/A,N/A,690,694,N/A,116,2
18,N/A,N/A,N/A,672,690,N/A,120,6
9,N/A,N/A,N/A,663,672,N/A,125,5
8,N/A,N/A,N/A,655,663,N/A,130,4
5,N/A,N/A,N/A,650,655,N/A,133,1
7,N/A,N/A,N/A,643,650,N/A,136,4
5,N/A,N/A,N/A,617,622,N/A,5,1
5,N/A,N/A,N/A,612,617,N/A,11,1
4,N/A,N/A,N/A,608,612,N/A,17,1
7,N/A,N/A,N/A,601,608,N/A,20,4
5,N/A,N/A,N/A,596,601,N/A,23,1
14,N/A,N/A,N/A,582,596,N/A,28,6
9,N/A,N/A,N/A,573,582,N/A,33,5
8,N/A,N/A,N/A,565,573,N/A,38,4
4,N/A,N/A,N/A,561,565,N/A,42,2
14,N/A,N/A,N/A,547,561,N/A,46,6
10,N/A,N/A,N/A,537,547,N/A,51,5
9,N/A,N/A,N/A,528,537,N/A,57,5
7,N/A,N/A,N/A,521,528,N/A,62,4
7,N/A,N/A,N/A,514,521,N/A,67,3
14,N/A,N/A,N/A,500,514,N/A,70,6
6,N/A,N/A,N/A,494,500,N/A,73,3
12,N/A,N/A,N/A,482,494,N/A,76,6
4,N/A,N/A,N/A,478,482,N/A,82,0
10,N/A,N/A,N/A,468,478,N/A,87,5
6,N/A,N/A,N/A,462,468,N/A,90,2
5,N/A,N/A,N/A,457,462,N/A,95,1
9,N/A,N/A,N/A,448,457,N/A,99,5
7,N/A,N/A,N/A,441,448,N/A,102,2
4,N/A,N/A,N/A,437,441,N/A,108,2
19,N/A,N/A,N/A,418,437,N/A,112,6
5,N/A,N/A,N/A,413,418,N/A,118,0
4,N/A,N/A,N/A,409,413,N/A,121,3
12,N/A,N/A,N/A,397,409,N/A,124,6
6,N/A,N/A,N/A,391,397,N/A,128,4
5,N/A,N/A,N/A,386,391,N/A,132,2
5,N/A,N/A,N/A,1780,1785,N/A,4,4
7,N/A,N/A,N/A,1773,1780,N/A,9,3
7,N/A,N/A,N/A,1766,1773,N/A,14,2
7,N/A,N/A,N/A,1759,1766,N/A,20,2
11,N/A,N/A,N/A,1748,1759,N/A,23,5
7,N/A,N/A,N/A,1741,1748,N/A,28,4
6,N/A,N/A,N/A,1735,1741,N/A,32,2
5,N/A,N/A,N/A,1730,1735,N/A,37,1
11,N/A,N/A,N/A,1719,1730,N/A,42,6
5,N/A,N/A,N/A,1714,1719,N/A,46,4
8,N/A,N/A,N/A,1706,1714,N/A,52,4
5,N/A,N/A,N/A,1701,1706,N/A,56,2
19,N/A,N/A,N/A,1682,1701,N/A,60,6
11,N/A,N/A,N/A,1671,1682,N/A,65,5
6,N/A,N/A,N/A,1665,1671,N/A,70,4
4,N/A,N/A,N/A,1661,1665,N/A,73,1
10,N/A,N/A,N/A,1651,1661,N/A,78,6
5,N/A,N/A,N/A,1646,1651,N/A,81,3
4,N/A,N/A,N/A,1642,1646,N/A,86,2
5,N/A,N/A,N/A,1637,1642,N/A,92,2
5,N/A,N/A,N/A,1632,1637,N/A,97,1
5,N/A,N/A,N/A,1627,1632,N/A,103,1
5,N/A,N/A,N/A,1622,1627,N/A,109,1
10,N/A,N/A,N/A,1612,1622,N/A,113,5
4,N/A,N/A,N/A,1608,1612,N/A,117,3
4,N/A,N/A,N/A,1604,1608,N/A,121,1
6,N/A,N/A,N/A,1598,1604,N/A,124,4
7,N/A,N/A,N/A,1591,1598,N/A,130,4
5,N/A,N/A,N/A,1586,1591,N/A,133,1
4,N/A,N/A,N/A,1582,1586,N/A,139,1
8,N/A,N/A,N/A,1449,1457,N/A,6,4
6,N/A,N/A,N/A,1443,1449,N/A,12,4
6,N/A,N/A,N/A,1437,1443,N/A,17,3
19,N/A,N/A,N/A,1418,1437,N/A,20,6
7,N/A,N/A,N/A,1411,1418,N/A,24,4
7,N/A,N/A,N/A,1404,1411,N/A,29,3
7,N/A,N/A,N/A,1397,1404,N/A,35,3
4,N/A,N/A,N/A,1393,1397,N/A,39,1
8,N/A,N/A,N/A,1385,1393,N/A,42,4
7,N/A,N/A,N/A,1378,1385,N/A,46,2
5,N/A,N/A,N/A,1373,1378,N/A,51,1
16,N/A,N/A,N/A,1357,1373,N/A,56,6
8,N/A,N/A,N/A,1349,1357,N/A,60,4
6,N/A,N/A,N/A,1343,1349,N/A,66,4
5,N/A,N/A,N/A,1338,1343,N/A,69,1
5,N/A,N/A,N/A,1333,1338,N/A,72,4
4,N/A,N/A,N/A,1329,1333,N/A,77,3
6,N/A,N/A,N/A,1323,1329,N/A,83,3
6,N/A,N/A,N/A,1317,1323,N/A,88,2
4,N/A,N/A,N/A,1313,1317,N/A,93,1
9,N/A,N/A,N/A,1304,1313,N/A,97,5
7,N/A,N/A,N/A,1297,1304,N/A,100,2
4,N/A,N/A,N/A,1293,1297,N/A,105,1
7,N/A,N/A,N/A,1286,1293,N/A,108,4
4,N/A,N/A,N/A,1282,1286,N/A,111,1
7,N/A,N/A,N/A,1275,1282,N/A,114,4
4,N/A,N/A,N/A,1271,1275,N/A,117,1
6,N/A,N/A,N/A,1265,1271,N/A,120,4
7,N/A,N/A,N/A,1258,1265,N/A,126,4
4,N/A,N/A,N/A,1254,1258,N/A,129,1
17,N/A,N/A,N/A,817,834,N/A,6,6
7,N/A,N/A,N/A,810,817,N/A,10,4
7,N/A,N/A,N/A,803,810,N/A,14,2
10,N/A,N/A,N/A,793,803,N/A,18,6
4,N/A,N/A,N/A,789,793,N/A,24,0
4,N/A,N/A,N/A,785,789,N/A,27,3
19,N/A,N/A,N/A,766,785,N/A,30,6
6,N/A,N/A,N/A,760,766,N/A,34,4
7,N/A,N/A,N/A,753,760,N/A,40,4
4,N/A,N/A,N/A,749,753,N/A,43,1
9,N/A,N/A,N/A,740,749,N/A,47,5
12,N/A,N/A,N/A,728,740,N/A,53,5
9,N/A,N/A,N/A,719,728,N/A,59,5
5,N/A,N/A,N/A,714,719,N/A,63,3
4,N/A,N/A,N/A,710,714,N/A,67,1
10,N/A,N/A,N/A,700,710,N/A,71,5
7,N/A,N/A,N/A,693,700,N/A,75,3
4,N/A,N/A,N/A,689,693,N/A,80,2
10,N/A,N/A,N/A,679,689,N/A,84,6
10,N/A,N/A,N/A,669,679,N/A,89,5
6,N/A,N/A,N/A,663,669,N/A,92,2
4,N/A,N/A,N/A,659,663,N/A,97,1
5,N/A,N/A,N/A,654,659,N/A,100,4
5,N/A,N/A,N/A,649,654,N/A,106,4
5,N/A,N/A,N/A,644,649,N/A,111,3
7,N/A,N/A,N/A,637,644,N/A,117,3
5,N/A,N/A,N/A,632,637,N/A,122,2
11,N/A,N/A,N/A,621,632,N/A,126,6
5,N/A,N/A,N/A,616,621,N/A,132,0
19,N/A,N/A,N/A,597,616,N/A,138,6
12,N/A,N/A,N/A,492,504,N/A,4,5
6,N/A,N/A,N/A,486,492,N/A,7,2
9,N/A,N/A,N/A,477,486,N/A,10,5
5,N/A,N/A,N/A,472,477,N/A,15,4
5,N/A,N/A,N/A,467,472,N/A,18,1
8,N/A,N/A,N/A,459,467,N/A,21,4
4,N/A,N/A,N/A,455,459,N/A,26,3
5,N/A,N/A,N/A,450,455,N/A,31,2
11,N/A,N/A,N/A,439,450,N/A,34,5
5,N/A,N/A,N/A,434,439,N/A,39,4
5,N/A,N/A,N/A,429,434,N/A,45,4
5,N/A,N/A,N/A,424,429,N/A,48,1
19,N/A,N/A,N/A,405,424,N/A,53,6
10,N/A,N/A,N/A,395,405,N/A,58,5
4,N/A,N/A,N/A,391,395,N/A,62,3
5,N/A,N/A,N/A,386,391,N/A,68,3
4,N/A,N/A,N/A,382,386,N/A,72,1
10,N/A,N/A,N/A,372,382,N/A,76,5
5,N/A,N/A,N/A,367,372,N/A,79,2
4,N/A,N/A,N/A,363,367,N/A,84,1
5,N/A,N/A,N/A,358,363,N/A,90,1
18,N/A,N/A,N/A,340,358,N/A,95,6
5,N/A,N/A,N/A,335,340,N/A,101,0
9,N/A,N/A,N/A,326,335,N/A,106,5
7,N/A,N/A,N/A,319,326,N/A,111,4
6,N/A,N/A,N/A,313,319,N/A,115,2
6,N/A,N/A,N/A,307,313,N/A,121,2
18,N/A,N/A,N/A,289,307,N/A,125,6
8,N/A,N/A,N/A,281,289,N/A,129,4
8,N/A,N/A,N/A,273,281,N/A,135,4
7,N/A,N/A,N/A,1184,1191,N/A,4,2
13,N/A,N/A,N/A,1171,1184,N/A,8,6
10,N/A,N/A,N/A,1161,1171,N/A,13,5
4,N/A,N/A,N/A,1157,1161,N/A,16,2
19,N/A,N/A,N/A,1138,1157,N/A,20,6
9,N/A,N/A,N/A,1129,1138,N/A,25,5
4,N/A,N/A,N/A,1125,1129,N/A,28,2
4,N/A,N/A,N/A,1121,1125,N/A,33,1
8,N/A,N/A,N/A,1113,1121,N/A,36,4
5,N/A,N/A,N/A,1108,1113,N/A,39,1
4,N/A,N/A,N/A,1104,1108,N/A,45,1
15,N/A,N/A,N/A,1089,1104,N/A,50,6
6,N/A,N/A,N/A,1083,1089,N/A,54,4
7,N/A,N/A,N/A,1076,1083,N/A,58,2
11,N/A,N/A,N/A,1065,1076,N/A,61,5
8,N/A,N/A,N/A,1057,1065,N/A,66,4
5,N/A,N/A,N/A,1052,1057,N/A,72,4
8,N/A,N/A,N/A,1044,1052,N/A,78,4
4,N/A,N/A,N/A,1040,1044,N/A,81,1
10,N/A,N/A,N/A,1030,1040,N/A,86,6
5,N/A,N/A,N/A,1025,1030,N/A,92,0
6,N/A,N/A,N/A,1019,1025,N/A,95,3
5,N/A,N/A,N/A,1014,1019,N/A,99,1
12,N/A,N/A,N/A,1002,1014,N/A,104,6
5,N/A,N/A,N/A,997,1002,N/A,110,0
18,N/A,N/A,N/A,979,997,N/A,116,6
5,N/A,N/A,N/A,974,979,N/A,119,3
4,N/A,N/A,N/A,970,974,N/A,123,1
10,N/A,N/A,N/A,960,970,N/A,127,5
8,N/A,N/A,N/A,952,960,N/A,132,4
5,N/A,N/A,N/A,1822,1827,N/A,5,3
5,N/A,N/A,N/A,1817,1822,N/A,9,1
12,N/A,N/A,N/A,1805,1817,N/A,13,5
6,N/A,N/A,N/A,1799,1805,N/A,17,3
7,N/A,N/A,N/A,1792,1799,N/A,22,2
7,N/A,N/A,N/A,1785,1792,N/A,28,2
4,N/A,N/A,N/A,1781,1785,N/A,34,2
5,N/A,N/A,N/A,1776,1781,N/A,39,1
11,N/A,N/A,N/A,1765,1776,N/A,43,5
6,N/A,N/A,N/A,1759,1765,N/A,47,3
4,N/A,N/A,N/A,1755,1759,N/A,51,1
12,N/A,N/A,N/A,1743,1755,N/A,55,5
10,N/A,N/A,N/A,1733,1743,N/A,61,5
12,N/A,N/A,N/A,1721,1733,N/A,67,5
6,N/A,N/A,N/A,1715,1721,N/A,70,2
4,N/A,N/A,N/A,1711,1715,N/A,75,1
17,N/A,N/A,N/A,1694,1711,N/A,80,6
6,N/A,N/A,N/A,1688,1694,N/A,84,4
6,N/A,N/A,N/A,1682,1688,N/A,88,2
10,N/A,N/A,N/A,1672,1682,N/A,92,6
5,N/A,N/A,N/A,1667,1672,N/A,95,3
7,N/A,N/A,N/A,1660,1667,N/A,101,3
4,N/A,N/A,N/A,1656,1660,N/A,106,2
5,N/A,N/A,N/A,1651,1656,N/A,112,2
14,N/A,N/A,N/A,1637,1651,N/A,116,6
5,N/A,N/A,N/A,1632,1637,N/A,122,0
8,N/A,N/A,N/A,1624,1632,N/A,126,4
4,N/A,N/A,N/A,1620,1624,N/A,129,1
7,N/A,N/A,N/A,1613,1620,N/A,132,4
8,N/A,N/A,N/A,1605,1613,N/A,138,4
12,N/A,N/A,N/A,1068,1080,N/A,3,5
5,N/A,N/A,N/A,1063,1068,N/A,6,2
19,N/A,N/A,N/A,1044,1063,N/A,10,6
5,N/A,N/A,N/A,1039,1044,N/A,14,4
5,N/A,N/A,N/A,1034,1039,N/A,20,4
6,N/A,N/A,N/A,1028,1034,N/A,24,2
5,N/A,N/A,N/A,1023,1028,N/A,29,1
11,N/A,N/A,N/A,1012,1023,N/A,33,5
10,N/A,N/A,N/A,1002,1012,N/A,39,5
6,N/A,N/A,N/A,996,1002,N/A,44,4
7,N/A,N/A,N/A,989,996,N/A,48,2
18,N/A,N/A,N/A,971,989,N/A,52,6
5,N/A,N/A,N/A,966,971,N/A,58,0
19,N/A,N/A,N/A,947,966,N/A,64,6
8,N/A,N/A,N/A,939,947,N/A,68,4
5,N/A,N/A,N/A,934,939,N/A,74,4
8,N/A,N/A,N/A,926,934,N/A,80,4
7,N/A,N/A,N/A,919,926,N/A,84,2
12,N/A,N/A,N/A,907,919,N/A,88,6
4,N/A,N/A,N/A,903,907,N/A,91,3
6,N/A,N/A,N/A,897,903,N/A,96,2
11,N/A,N/A,N/A,886,897,N/A,100,6
7,N/A,N/A,N/A,879,886,N/A,103,3
5,N/A,N/A,N/A,874,879,N/A,107,1
10,N/A,N/A,N/A,864,874,N/A,111,5
4,N/A,N/A,N/A,860,864,N/A,115,3
5,N/A,N/A,N/A,855,860,N/A,121,3
7,N/A,N/A,N/A,848,855,N/A,126,2
9,N/A,N/A,N/A,839,848,N/A,129,5
7,N/A,N/A,N/A,832,839,N/A,132,2
4,N/A,N/A,N/A,1080,1084,N/A,5,1
16,N/A,N/A,N/A,1064,1080,N/A,10,6
7,N/A,N/A,N/A,1057,1064,N/A,13,3
7,N/A,N/A,N/A,1050,1057,N/A,18,2
12,N/A,N/A,N/A,1038,1050,N/A,21,5
7,N/A,N/A,N/A,1031,1038,N/A,24,2
10,N/A,N/A,N/A,1021,1031,N/A,28,6
4,N/A,N/A,N/A,1017,1021,N/A,34,0
10,N/A,N/A,N/A,1007,1017,N/A,39,5
6,N/A,N/A,N/A,1001,1007,N/A,43,3
17,N/A,N/A,N/A,984,1001,N/A,46,6
4,N/A,N/A,N/A,980,984,N/A,49,3
4,N/A,N/A,N/A,976,980,N/A,53,1
4,N/A,N/A,N/A,972,976,N/A,59,1
7,N/A,N/A,N/A,965,972,N/A,62,4
6,N/A,N/A,N/A,959,965,N/A,67,3
4,N/A,N/A,N/A,955,959,N/A,72,2
11,N/A,N/A,N/A,944,955,N/A,76,6
11,N/A,N/A,N/A,933,944,N/A,81,5
5,N/A,N/A,N/A,928,933,N/A,85,3
7,N/A,N/A,N/A,921,928,N/A,91,3
6,N/A,N/A,N/A,915,921,N/A,97,3
4,N/A,N/A,N/A,911,915,N/A,101,1
5,N/A,N/A,N/A,906,911,N/A,104,4
4,N/A,N/A,N/A,902,906,N/A,109,3
17,N/A,N/A,N/A,885,902,N/A,112,6
6,N/A,N/A,N/A,879,885,N/A,116,4
5,N/A,N/A,N/A,874,879,N/A,121,3
7,N/A,N/A,N/A,867,874,N/A,126,2
9,N/A,N/A,N/A,858,867,N/A,129,5
8,N/A,N/A,N/A,1204,1212,N/A,4,4
5,N/A,N/A,N/A,1199,1204,N/A,9,3
5,N/A,N/A,N/A,1194,1199,N/A,15,3
7,N/A,N/A,N/A,1187,1194,N/A,21,3
14,N/A,N/A,N/A,1173,1187,N/A,24,6
12,N/A,N/A,N/A,1161,1173,N/A,29,5
6,N/A,N/A,N/A,1155,1161,N/A,32,2
9,N/A,N/A,N/A,1146,1155,N/A,35,5
5,N/A,N/A,N/A,1141,1146,N/A,40,4
5,N/A,N/A,N/A,1136,1141,N/A,43,1
5,N/A,N/A,N/A,1131,1136,N/A,49,1
7,N/A,N/A,N/A,1124,1131,N/A,52,4
6,N/A,N/A,N/A,1118,1124,N/A,57,3
4,N/A,N/A,N/A,1114,1118,N/A,61,1
18,N/A,N/A,N/A,1096,1114,N/A,66,6
5,N/A,N/A,N/A,1091,1096,N/A,72,0
17,N/A,N/A,N/A,1074,1091,N/A,78,6
7,N/A,N/A,N/A,1067,1074,N/A,81,3
7,N/A,N/A,N/A,1060,1067,N/A,87,3
17,N/A,N/A,N/A,1043,1060,N/A,90,6
4,N/A,N/A,N/A,1039,1043,N/A,96,0
12,N/A,N/A,N/A,1027,1039,N/A,101,5
10,N/A,N/A,N/A,1017,1027,N/A,107,5
8,N/A,N/A,N/A,1009,1017,N/A,112,4
7,N/A,N/A,N/A,1002,1009,N/A,117,3
6,N/A,N/A,N/A,996,1002,N/A,123,3
4,N/A,N/A,N/A,992,996,N/A,127,1
10,N/A,N/A,N/A,982,992,N/A,131,5
7,N/A,N/A,N/A,975,982,N/A,135,3
4,N/A,N/A,N/A,971,975,N/A,139,1
19,N/A,N/A,N/A,1675,1694,N/A,4,6
9,N/A,N/A,N/A,1666,1675,N/A,9,5
8,N/A,N/A,N/A,1658,1666,N/A,14,4
6,N/A,N/A,N/A,1652,1658,N/A,19,3
5,N/A,N/A,N/A,1647,1652,N/A,23,1
12,N/A,N/A,N/A,1635,1647,N/A,27,5
10,N/A,N/A,N/A,1625,1635,N/A,33,5
5,N/A,N/A,N/A,1620,1625,N/A,38,4
8,N/A,N/A,N/A,1612,1620,N/A,44,4
5,N/A,N/A,N/A,1607,1612,N/A,47,1
10,N/A,N/A,N/A,1597,1607,N/A,51,5
6,N/A,N/A,N/A,1591,1597,N/A,54,2
19,N/A,N/A,N/A,1572,1591,N/A,58,6
12,N/A,N/A,N/A,1560,1572,N/A,63,5
7,N/A,N/A,N/A,1553,1560,N/A,67,3
4,N/A,N/A,N/A,1549,1553,N/A,72,2
5,N/A,N/A,N/A,1544,1549,N/A,77,1
6,N/A,N/A,N/A,1538,1544,N/A,80,4
4,N/A,N/A,N/A,1534,1538,N/A,85,3
5,N/A,N/A,N/A,1529,1534,N/A,90,2
4,N/A,N/A,N/A,1525,1529,N/A,96,2
9,N/A,N/A,N/A,1516,1525,N/A,99,5
7,N/A,N/A,N/A,1509,1516,N/A,102,2
10,N/A,N/A,N/A,1499,1509,N/A,105,5
5,N/A,N/A,N/A,1494,1499,N/A,108,2
19,N/A,N/A,N/A,1475,1494,N/A,112,6
7,N/A,N/A,N/A,1468,1475,N/A,115,3
7,N/A,N/A,N/A,1461,1468,N/A,121,3
7,N/A,N/A,N/A,1454,1461,N/A,127,3
16,N/A,N/A,N/A,1438,1454,N/A,130,6
6,N/A,N/A,N/A,1059,1065,N/A,5,2
14,N/A,N/A,N/A,1045,1059,N/A,9,6
5,N/A,N/A,N/A,1040,1045,N/A,13,4
4,N/A,N/A,N/A,1036,1040,N/A,16,1
4,N/A,N/A,N/A,1032,1036,N/A,22,1
14,N/A,N/A,N/A,1018,1032,N/A,27,6
10,N/A,N/A,N/A,1008,1018,N/A,32,5
10,N/A,N/A,N/A,998,1008,N/A,38,5
4,N/A,N/A,N/A,994,998,N/A,42,3
4,N/A,N/A,N/A,990,994,N/A,46,1
5,N/A,N/A,N/A,985,990,N/A,52,1
9,N/A,N/A,N/A,976,985,N/A,56,5
5,N/A,N/A,N/A,971,976,N/A,60,3
6,N/A,N/A,N/A,965,971,N/A,65,2
7,N/A,N/A,N/A,958,965,N/A,71,2
5,N/A,N/A,N/A,953,958,N/A,76,1
11,N/A,N/A,N/A,942,953,N/A,81,6
10,N/A,N/A,N/A,932,942,N/A,86,5
5,N/A,N/A,N/A,927,932,N/A,90,3
15,N/A,N/A,N/A,912,927,N/A,93,6
9,N/A,N/A,N/A,903,912,N/A,98,5
6,N/A,N/A,N/A,897,903,N/A,103,4
5,N/A,N/A,N/A,892,897,N/A,106,1
5,N/A,N/A,N/A,887,892,N/A,112,1
8,N/A,N/A,N/A,879,887,N/A,115,4
8,N/A,N/A,N/A,871,879,N/A,121,4
4,N/A,N/A,N/A,867,871,N/A,124,1
7,N/A,N/A,N/A,860,867,N/A,127,4
4,N/A,N/A,N/A,856,860,N/A,131,2
4,N/A,N/A,N/A,852,856,N/A,136,1
5,N/A,N/A,N/A,1882,1887,N/A,5,1
5,N/A,N/A,N/A,1877,1882,N/A,11,1
4,N/A,N/A,N/A,1873,1877,N/A,17,1
7,N/A,N/A,N/A,1866,1873,N/A,20,4
7,N/A,N/A,N/A,1859,1866,N/A,24,2
12,N/A,N/A,N/A,1847,1859,N/A,27,5
11,N/A,N/A,N/A,1836,1847,N/A,33,5
4,N/A,N/A,N/A,1832,1836,N/A,37,3
10,N/A,N/A,N/A,1822,1832,N/A,40,6
4,N/A,N/A,N/A,1818,1822,N/A,46,0
17,N/A,N/A,N/A,1801,1818,N/A,52,6
9,N/A,N/A,N/A,1792,1801,N/A,57,5
10,N/A,N/A,N/A,1782,1792,N/A,63,5
5,N/A,N/A,N/A,1777,1782,N/A,66,2
7,N/A,N/A,N/A,1770,1777,N/A,72,2
12,N/A,N/A,N/A,1758,1770,N/A,75,5
7,N/A,N/A,N/A,1751,1758,N/A,80,4
5,N/A,N/A,N/A,1746,1751,N/A,83,1
4,N/A,N/A,N/A,1742,1746,N/A,89,1
11,N/A,N/A,N/A,1731,1742,N/A,93,5
7,N/A,N/A,N/A,1724,1731,N/A,98,4
7,N/A,N/A,N/A,1717,1724,N/A,104,4
6,N/A,N/A,N/A,1711,1717,N/A,110,4
6,N/A,N/A,N/A,1705,1711,N/A,116,4
6,N/A,N/A,N/A,1699,1705,N/A,120,2
11,N/A,N/A,N/A,1688,1699,N/A,124,6
10,N/A,N/A,N/A,1678,1688,N/A,129,5
7,N/A,N/A,N/A,1671,1678,N/A,133,3
4,N/A,N/A,N/A,1667,1671,N/A,139,3
4,N/A,N/A,N/A,1663,1667,N/A,143,1
5,N/A,N/A,N/A,1576,1581,N/A,3,2
10,N/A,N/A,N/A,1566,1576,N/A,6,5
5,N/A,N/A,N/A,1561,1566,N/A,9,2
7,N/A,N/A,N/A,1554,1561,N/A,15,2
6,N/A,N/A,N/A,1548,1554,N/A,21,2
10,N/A,N/A,N/A,1538,1548,N/A,25,6
9,N/A,N/A,N/A,1529,1538,N/A,30,5
7,N/A,N/A,N/A,1522,1529,N/A,35,4
5,N/A,N/A,N/A,1517,1522,N/A,40,3
5,N/A,N/A,N/A,1512,1517,N/A,46,3
6,N/A,N/A,N/A,1506,1512,N/A,52,3
4,N/A,N/A,N/A,1502,1506,N/A,57,2
6,N/A,N/A,N/A,1496,1502,N/A,63,2
12,N/A,N/A,N/A,1484,1496,N/A,67,6
7,N/A,N/A,N/A,1477,1484,N/A,71,4
7,N/A,N/A,N/A,1470,1477,N/A,77,4
7,N/A,N/A,N/A,1463,1470,N/A,81,2
9,N/A,N/A,N/A,1454,1463,N/A,84,5
5,N/A,N/A,N/A,1449,1454,N/A,89,4
8,N/A,N/A,N/A,1441,1449,N/A,95,4
4,N/A,N/A,N/A,1437,1441,N/A,100,3
7,N/A,N/A,N/A,1430,1437,N/A,106,3
18,N/A,N/A,N/A,1412,1430,N/A,109,6
7,N/A,N/A,N/A,1405,1412,N/A,113,4
5,N/A,N/A,N/A,1400,1405,N/A,116,1
9,N/A,N/A,N/A,1391,1400,N/A,120,5
5,N/A,N/A,N/A,1386,1391,N/A,125,4
7,N/A,N/A,N/A,1379,1386,N/A,130,3
4,N/A,N/A,N/A,1375,1379,N/A,134,1
16,N/A,N/A,N/A,1359,1375,N/A,139,6
10,N/A,N/A,N/A,1171,1181,N/A,6,5
5,N/A,N/A,N/A,1166,1171,N/A,10,3
7,N/A,N/A,N/A,1159,1166,N/A,16,3
6,N/A,N/A,N/A,1153,1159,N/A,21,2
7,N/A,N/A,N/A,1146,1153,N/A,27,2
12,N/A,N/A,N/A,1134,1146,N/A,30,5
4,N/A,N/A,N/A,1130,1134,N/A,34,3
6,N/A,N/A,N/A,1124,1130,N/A,39,2
17,N/A,N/A,N/A,1107,1124,N/A,43,6
9,N/A,N/A,N/A,1098,1107,N/A,48,5
6,N/A,N/A,N/A,1092,1098,N/A,52,3
5,N/A,N/A,N/A,1087,1092,N/A,56,1
12,N/A,N/A,N/A,1075,1087,N/A,60,5
4,N/A,N/A,N/A,1071,1075,N/A,63,2
6,N/A,N/A,N/A,1065,1071,N/A,69,2
18,N/A,N/A,N/A,1047,1065,N/A,73,6
8,N/A,N/A,N/A,1039,1047,N/A,77,4
4,N/A,N/A,N/A,1035,1039,N/A,82,3
7,N/A,N/A,N/A,1028,1035,N/A,88,3
14,N/A,N/A,N/A,1014,1028,N/A,91,6
7,N/A,N/A,N/A,1007,1014,N/A,94,3
4,N/A,N/A,N/A,1003,1007,N/A,99,2
12,N/A,N/A,N/A,991,1003,N/A,102,5
7,N/A,N/A,N/A,984,991,N/A,107,4
7,N/A,N/A,N/A,977,984,N/A,111,2
12,N/A,N/A,N/A,965,977,N/A,114,5
5,N/A,N/A,N/A,960,965,N/A,117,2
5,N/A,N/A,N/A,955,960,N/A,122,1
4,N/A,N/A,N/A,951,955,N/A,128,1
10,N/A,N/A,N/A,941,951,N/A,133,6
4,N/A,N/A,N/A,1163,1167,N/A,4,2
14,N/A,N/A,N/A,1149,1163,N/A,8,6
7,N/A,N/A,N/A,1142,1149,N/A,11,3
4,N/A,N/A,N/A,1138,1142,N/A,15,1
4,N/A,N/A,N/A,1134,1138,N/A,21,1
6,N/A,N/A,N/A,1128,1134,N/A,24,4
4,N/A,N/A,N/A,1124,1128,N/A,28,2
12,N/A,N/A,N/A,1112,1124,N/A,31,5
5,N/A,N/A,N/A,1107,1112,N/A,36,4
7,N/A,N/A,N/A,1100,1107,N/A,40,2
17,N/A,N/A,N/A,1083,1100,N/A,44,6
6,N/A,N/A,N/A,1077,1083,N/A,47,3
15,N/A,N/A,N/A,1062,1077,N/A,50,6
6,N/A,N/A,N/A,1056,1062,N/A,54,4
4,N/A,N/A,N/A,1052,1056,N/A,57,1
12,N/A,N/A,N/A,1040,1052,N/A,62,6
5,N/A,N/A,N/A,1035,1040,N/A,65,3
12,N/A,N/A,N/A,1023,1035,N/A,68,6
8,N/A,N/A,N/A,1015,1023,N/A,72,4
7,N/A,N/A,N/A,1008,1015,N/A,76,2
6,N/A,N/A,N/A,1002,1008,N/A,82,2
7,N/A,N/A,N/A,995,1002,N/A,88,2
9,N/A,N/A,N/A,986,995,N/A,91,5
4,N/A,N/A,N/A,982,986,N/A,94,2
5,N/A,N/A,N/A,977,982,N/A,99,1
12,N/A,N/A,N/A,965,977,N/A,104,6
6,N/A,N/A,N/A,959,965,N/A,108,4
5,N/A,N/A,N/A,954,959,N/A,111,1
12,N/A,N/A,N/A,942,954,N/A,116,6
11,N/A,N/A,N/A,931,942,N/A,121,5
5,N/A,N/A,N/A,381,386,N/A,6,1
12,N/A,N/A,N/A,369,381,N/A,10,5
5,N/A,N/A,N/A,364,369,N/A,15,4
4,N/A,N/A,N/A,360,364,N/A,18,1
12,N/A,N/A,N/A,348,360,N/A,22,5
6,N/A,N/A,N/A,342,348,N/A,27,4
6,N/A,N/A,N/A,336,342,N/A,32,3
5,N/A,N/A,N/A,331,336,N/A,38,3
7,N/A,N/A,N/A,324,331,N/A,44,3
7,N/A,N/A,N/A,317,324,N/A,50,3
4,N/A,N/A,N/A,313,317,N/A,55,2
17,N/A,N/A,N/A,296,313,N/A,59,6
10,N/A,N/A,N/A,286,296,N/A,64,5
4,N/A,N/A,N/A,282,286,N/A,68,3
7,N/A,N/A,N/A,275,282,N/A,74,3
4,N/A,N/A,N/A,271,275,N/A,78,1
6,N/A,N/A,N/A,265,271,N/A,81,4
7,N/A,N/A,N/A,258,265,N/A,85,2
12,N/A,N/A,N/A,246,258,N/A,89,6
6,N/A,N/A,N/A,240,246,N/A,92,3
7,N/A,N/A,N/A,233,240,N/A,97,2
5,N/A,N/A,N/A,228,233,N/A,102,1
12,N/A,N/A,N/A,216,228,N/A,107,6
11,N/A,N/A,N/A,205,216,N/A,112,5
7,N/A,N/A,N/A,198,205,N/A,116,3
16,N/A,N/A,N/A,182,198,N/A,119,6
10,N/A,N/A,N/A,172,182,N/A,124,5
10,N/A,N/A,N/A,162,172,N/A,130,5
11,N/A,N/A,N/A,151,162,N/A,136,5
5,N/A,N/A,N/A,146,151,N/A,140,3
14,N/A,N/A,N/A,1538,1552,N/A,4,6
6,N/A,N/A,N/A,1532,1538,N/A,7,3
16,N/A,N/A,N/A,1516,1532,N/A,10,6
6,N/A,N/A,N/A,1510,1516,N/A,13,3
6,N/A,N/A,N/A,1504,1510,N/A,19,3
5,N/A,N/A,N/A,1499,1504,N/A,23,1
12,N/A,N/A,N/A,1487,1499,N/A,27,5
6,N/A,N/A,N/A,1481,1487,N/A,30,2
9,N/A,N/A,N/A,1472,1481,N/A,33,5
5,N/A,N/A,N/A,1467,1472,N/A,37,3
5,N/A,N/A,N/A,1462,1467,N/A,41,1
12,N/A,N/A,N/A,1450,1462,N/A,45,5
5,N/A,N/A,N/A,1445,1450,N/A,48,2
11,N/A,N/A,N/A,1434,1445,N/A,52,6
8,N/A,N/A,N/A,1426,1434,N/A,56,4
7,N/A,N/A,N/A,1419,1426,N/A,61,3
4,N/A,N/A,N/A,1415,1419,N/A,65,1
5,N/A,N/A,N/A,1410,1415,N/A,68,4
7,N/A,N/A,N/A,1403,1410,N/A,73,3
14,N/A,N/A,N/A,1389,1403,N/A,76,6
4,N/A,N/A,N/A,1385,1389,N/A,82,0
12,N/A,N/A,N/A,1373,1385,N/A,87,5
10,N/A,N/A,N/A,1363,1373,N/A,93,5
4,N/A,N/A,N/A,1359,1363,N/A,97,3
5,N/A,N/A,N/A,1354,1359,N/A,101,1
9,N/A,N/A,N/A,1345,1354,N/A,105,5
7,N/A,N/A,N/A,1338,1345,N/A,109,3
14,N/A,N/A,N/A,1324,1338,N/A,112,6
12,N/A,N/A,N/A,1312,1324,N/A,117,5
9,N/A,N/A,N/A,1303,1312,N/A,123,5
11,N/A,N/A,N/A,1857,1868,N/A,6,5
5,N/A,N/A,N/A,1852,1857,N/A,11,4
5,N/A,N/A,N/A,1847,1852,N/A,16,3
4,N/A,N/A,N/A,1843,1847,N/A,22,3
5,N/A,N/A,N/A,1838,1843,N/A,28,3
5,N/A,N/A,N/A,1833,1838,N/A,32,1
4,N/A,N/A,N/A,1829,1833,N/A,38,1
4,N/A,N/A,N/A,1825,1829,N/A,44,1
9,N/A,N/A,N/A,1816,1825,N/A,48,5
7,N/A,N/A,N/A,1809,1816,N/A,52,3
5,N/A,N/A,N/A,1804,1809,N/A,56,1
10,N/A,N/A,N/A,1794,1804,N/A,60,5
5,N/A,N/A,N/A,1789,1794,N/A,64,3
13,N/A,N/A,N/A,1776,1789,N/A,67,6
11,N/A,N/A,N/A,1765,1776,N/A,72,5
6,N/A,N/A,N/A,1759,1765,N/A,76,3
18,N/A,N/A,N/A,1741,1759,N/A,79,6
7,N/A,N/A,N/A,1734,1741,N/A,83,4
4,N/A,N/A,N/A,1730,1734,N/A,86,1
5,N/A,N/A,N/A,1725,1730,N/A,92,1
10,N/A,N/A,N/A,1715,1725,N/A,96,5
4,N/A,N/A,N/A,1711,1715,N/A,99,2
10,N/A,N/A,N/A,1701,1711,N/A,102,5
4,N/A,N/A,N/A,1697,1701,N/A,106,3
19,N/A,N/A,N/A,1678,1697,N/A,109,6
9,N/A,N/A,N/A,1669,1678,N/A,114,5
11,N/A,N/A,N/A,1658,1669,N/A,120,5
4,N/A,N/A,N/A,1654,1658,N/A,124,3
10,N/A,N/A,N/A,1644,1654,N/A,127,6
4,N/A,N/A,N/A,1640,1644,N/A,130,3
5,N/A,N/A,N/A,515,520,N/A,6,4
6,N/A,N/A,N/A,509,515,N/A,12,4
4,N/A,N/A,N/A,505,509,N/A,15,1
8,N/A,N/A,N/A,497,505,N/A,18,4
4,N/A,N/A,N/A,493,497,N/A,22,2
5,N/A,N/A,N/A,488,493,N/A,27,1
4,N/A,N/A,N/A,484,488,N/A,33,1
6,N/A,N/A,N/A,478,484,N/A,36,4
5,N/A,N/A,N/A,473,478,N/A,39,1
6,N/A,N/A,N/A,467,473,N/A,42,4
5,N/A,N/A,N/A,462,467,N/A,46,2
11,N/A,N/A,N/A,451,462,N/A,49,5
10,N/A,N/A,N/A,441,451,N/A,55,5
7,N/A,N/A,N/A,434,441,N/A,58,2
10,N/A,N/A,N/A,424,434,N/A,61,5
5,N/A,N/A,N/A,419,424,N/A,65,3
17,N/A,N/A,N/A,402,419,N/A,68,6
4,N/A,N/A,N/A,398,402,N/A,74,0
10,N/A,N/A,N/A,388,398,N/A,79,5
6,N/A,N/A,N/A,382,388,N/A,82,2
9,N/A,N/A,N/A,373,382,N/A,85,5
6,N/A,N/A,N/A,367,373,N/A,90,4
4,N/A,N/A,N/A,363,367,N/A,95,3
5,N/A,N/A,N/A,358,363,N/A,100,2
7,N/A,N/A,N/A,351,358,N/A,106,2
18,N/A,N/A,N/A,333,351,N/A,110,6
7,N/A,N/A,N/A,326,333,N/A,114,4
5,N/A,N/A,N/A,321,326,N/A,117,1
4,N/A,N/A,N/A,317,321,N/A,123,1
10,N/A,N/A,N/A,307,317,N/A,127,5
5,N/A,N/A,N/A,934,939,N/A,6,1
4,N/A,N/A,N/A,930,934,N/A,12,1
5,N/A,N/A,N/A,925,930,N/A,18,1
10,N/A,N/A,N/A,915,925,N/A,23,6
10,N/A,N/A,N/A,905,915,N/A,28,5
8,N/A,N/A,N/A,897,905,N/A,33,4
7,N/A,N/A,N/A,890,897,N/A,38,3
17,N/A,N/A,N/A,873,890,N/A,41,6
10,N/A,N/A,N/A,863,873,N/A,46,5
7,N/A,N/A,N/A,856,863,N/A,51,4
7,N/A,N/A,N/A,849,856,N/A,55,2
11,N/A,N/A,N/A,838,849,N/A,58,5
5,N/A,N/A,N/A,833,838,N/A,63,4
5,N/A,N/A,N/A,828,833,N/A,66,1
4,N/A,N/A,N/A,824,828,N/A,72,1
5,N/A,N/A,N/A,819,824,N/A,78,1
4,N/A,N/A,N/A,815,819,N/A,84,1
13,N/A,N/A,N/A,802,815,N/A,89,6
12,N/A,N/A,N/A,790,802,N/A,94,5
6,N/A,N/A,N/A,784,790,N/A,98,3
5,N/A,N/A,N/A,779,784,N/A,102,1
11,N/A,N/A,N/A,768,779,N/A,106,5
7,N/A,N/A,N/A,761,768,N/A,109,2
5,N/A,N/A,N/A,756,761,N/A,114,1
17,N/A,N/A,N/A,739,756,N/A,119,6
4,N/A,N/A,N/A,735,739,N/A,125,0
17,N/A,N/A,N/A,718,735,N/A,131,6
12,N/A,N/A,N/A,706,718,N/A,136,5
6,N/A,N/A,N/A,700,706,N/A,140,3
4,N/A,N/A,N/A,696,700,N/A,146,3
4,N/A,N/A,N/A,1195,1199,N/A,3,2
16,N/A,N/A,N/A,1179,1195,N/A,7,6
5,N/A,N/A,N/A,1174,1179,N/A,13,0
4,N/A,N/A,N/A,1170,1174,N/A,16,3
5,N/A,N/A,N/A,1165,1170,N/A,21,2
5,N/A,N/A,N/A,1160,1165,N/A,26,1
8,N/A,N/A,N/A,1152,1160,N/A,29,4
7,N/A,N/A,N/A,1145,1152,N/A,35,4
7,N/A,N/A,N/A,1138,1145,N/A,39,2
5,N/A,N/A,N/A,1133,1138,N/A,45,2
5,N/A,N/A,N/A,1128,1133,N/A,51,2
4,N/A,N/A,N/A,1124,1128,N/A,56,1
4,N/A,N/A,N/A,1120,1124,N/A,62,1
16,N/A,N/A,N/A,1104,1120,N/A,67,6
8,N/A,N/A,N/A,1096,1104,N/A,71,4
4,N/A,N/A,N/A,1092,1096,N/A,74,1
9,N/A,N/A,N/A,1083,1092,N/A,78,5
7,N/A,N/A,N/A,1076,1083,N/A,83,4
4,N/A,N/A,N/A,1072,1076,N/A,88,3
7,N/A,N/A,N/A,1065,1072,N/A,93,2
16,N/A,N/A,N/A,1049,1065,N/A,97,6
4,N/A,N/A,N/A,1045,1049,N/A,103,0
7,N/A,N/A,N/A,1038,1045,N/A,107,4
5,N/A,N/A,N/A,1033,1038,N/A,111,2
9,N/A,N/A,N/A,1024,1033,N/A,114,5
7,N/A,N/A,N/A,1017,1024,N/A,119,4
7,N/A,N/A,N/A,1010,1017,N/A,123,2
10,N/A,N/A,N/A,1000,1010,N/A,127,6
5,N/A,N/A,N/A,995,1000,N/A,131,4
7,N/A,N/A,N/A,988,995,N/A,137,4
11,N/A,N/A,N/A,1266,1277,N/A,5,5
5,N/A,N/A,N/A,1261,1266,N/A,10,4
4,N/A,N/A,N/A,1257,1261,N/A,13,1
4,N/A,N/A,N/A,1253,1257,N/A,19,1
11,N/A,N/A,N/A,1242,1253,N/A,23,5
10,N/A,N/A,N/A,1232,1242,N/A,29,5
4,N/A,N/A,N/A,1228,1232,N/A,33,3
7,N/A,N/A,N/A,1221,1228,N/A,38,2
6,N/A,N/A,N/A,1215,1221,N/A,44,2
9,N/A,N/A,N/A,1206,1215,N/A,47,5
5,N/A,N/A,N/A,1201,1206,N/A,51,3
6,N/A,N/A,N/A,1195,1201,N/A,57,3
5,N/A,N/A,N/A,1190,1195,N/A,61,1
7,N/A,N/A,N/A,1183,1190,N/A,64,4
4,N/A,N/A,N/A,1179,1183,N/A,68,2
6,N/A,N/A,N/A,1173,1179,N/A,74,2
10,N/A,N/A,N/A,1163,1173,N/A,77,5
11,N/A,N/A,N/A,1152,1163,N/A,83,5
8,N/A,N/A,N/A,1144,1152,N/A,88,4
7,N/A,N/A,N/A,1137,1144,N/A,93,3
4,N/A,N/A,N/A,1133,1137,N/A,98,2
5,N/A,N/A,N/A,1128,1133,N/A,103,1
10,N/A,N/A,N/A,1118,1128,N/A,107,5
6,N/A,N/A,N/A,1112,1118,N/A,112,4
5,N/A,N/A,N/A,1107,1112,N/A,115,1
4,N/A,N/A,N/A,1103,1107,N/A,121,1
4,N/A,N/A,N/A,1099,1103,N/A,127,1
10,N/A,N/A,N/A,1089,1099,N/A,132,6
10,N/A,N/A,N/A,1079,1089,N/A,137,5
5,N/A,N/A,N/A,1074,1079,N/A,141,3
5,N/A,N/A,N/A,593,598,N/A,5,4
4,N/A,N/A,N/A,589,593,N/A,10,3
5,N/A,N/A,N/A,584,589,N/A,16,3
18,N/A,N/A,N/A,566,584,N/A,19,6
9,N/A,N/A,N/A,557,566,N/A,24,5
6,N/A,N/A,N/A,551,557,N/A,27,2
11,N/A,N/A,N/A,540,551,N/A,30,5
11,N/A,N/A,N/A,529,540,N/A,36,5
9,N/A,N/A,N/A,520,529,N/A,42,5
6,N/A,N/A,N/A,514,520,N/A,47,4
4,N/A,N/A,N/A,510,514,N/A,52,3
4,N/A,N/A,N/A,506,510,N/A,57,2
5,N/A,N/A,N/A,501,506,N/A,63,2
11,N/A,N/A,N/A,490,501,N/A,67,6
7,N/A,N/A,N/A,483,490,N/A,71,4
5,N/A,N/A,N/A,478,483,N/A,75,2
4,N/A,N/A,N/A,474,478,N/A,81,2
9,N/A,N/A,N/A,465,474,N/A,84,5
10,N/A,N/A,N/A,455,465,N/A,90,5
4,N/A,N/A,N/A,451,455,N/A,93,2
5,N/A,N/A,N/A,446,451,N/A,98,1
5,N/A,N/A,N/A,441,446,N/A,104,1
5,N/A,N/A,N/A,436,441,N/A,110,1
10,N/A,N/A,N/A,426,436,N/A,114,5
6,N/A,N/A,N/A,420,426,N/A,117,2
15,N/A,N/A,N/A,405,420,N/A,121,6
10,N/A,N/A,N/A,395,405,N/A,126,5
10,N/A,N/A,N/A,385,395,N/A,132,5
7,N/A,N/A,N/A,378,385,N/A,136,3
4,N/A,N/A,N/A,374,378,N/A,140,1
5,N/A,N/A,N/A,1543,1548,N/A,6,2
5,N/A,N/A,N/A,1538,1543,N/A,12,2
5,N/A,N/A,N/A,1533,1538,N/A,18,2
5,N/A,N/A,N/A,1528,1533,N/A,23,1
6,N/A,N/A,N/A,1522,1528,N/A,26,4
5,N/A,N/A,N/A,1517,1522,N/A,30,2
12,N/A,N/A,N/A,1505,1517,N/A,34,6
5,N/A,N/A,N/A,1500,1505,N/A,38,4
5,N/A,N/A,N/A,1495,1500,N/A,43,3
5,N/A,N/A,N/A,1490,1495,N/A,48,2
4,N/A,N/A,N/A,1486,1490,N/A,53,1
5,N/A,N/A,N/A,1481,1486,N/A,56,4
8,N/A,N/A,N/A,1473,1481,N/A,62,4
5,N/A,N/A,N/A,1468,1473,N/A,66,2
5,N/A,N/A,N/A,1463,1468,N/A,71,1
5,N/A,N/A,N/A,1458,1463,N/A,74,4
8,N/A,N/A,N/A,1450,1458,N/A,80,4
5,N/A,N/A,N/A,1445,1450,N/A,83,1
5,N/A,N/A,N/A,1440,1445,N/A,89,1
10,N/A,N/A,N/A,1430,1440,N/A,93,5
6,N/A,N/A,N/A,1424,1430,N/A,96,2
17,N/A,N/A,N/A,1407,1424,N/A,100,6
7,N/A,N/A,N/A,1400,1407,N/A,103,3
13,N/A,N/A,N/A,1387,1400,N/A,106,6
4,N/A,N/A,N/A,1383,1387,N/A,112,0
11,N/A,N/A,N/A,1372,1383,N/A,117,5
5,N/A,N/A,N/A,1367,1372,N/A,121,3
10,N/A,N/A,N/A,1357,1367,N/A,124,6
12,N/A,N/A,N/A,1345,1357,N/A,129,5
6,N/A,N/A,N/A,1339,1345,N/A,132,2
4,N/A,N/A,N/A,1866,1870,N/A,4,2
5,N/A,N/A,N/A,1861,1866,N/A,9,1
5,N/A,N/A,N/A,1856,1861,N/A,15,1
5,N/A,N/A,N/A,1851,1856,N/A,18,4
4,N/A,N/A,N/A,1847,1851,N/A,21,1
12,N/A,N/A,N/A,1835,1847,N/A,25,5
10,N/A,N/A,N/A,1825,1835,N/A,31,5
7,N/A,N/A,N/A,1818,1825,N/A,34,2
4,N/A,N/A,N/A,1814,1818,N/A,39,1
10,N/A,N/A,N/A,1804,1814,N/A,43,5
9,N/A,N/A,N/A,1795,1804,N/A,49,5
11,N/A,N/A,N/A,1784,1795,N/A,55,5
4,N/A,N/A,N/A,1780,1784,N/A,59,3
4,N/A,N/A,N/A,1776,1780,N/A,63,1
10,N/A,N/A,N/A,1766,1776,N/A,67,5
7,N/A,N/A,N/A,1759,1766,N/A,72,4
6,N/A,N/A,N/A,1753,1759,N/A,77,3
7,N/A,N/A,N/A,1746,1753,N/A,82,2
10,N/A,N/A,N/A,1736,1746,N/A,85,5
6,N/A,N/A,N/A,1730,1736,N/A,88,2
4,N/A,N/A,N/A,1726,1730,N/A,93,1
10,N/A,N/A,N/A,1716,1726,N/A,97,5
7,N/A,N/A,N/A,1709,1716,N/A,102,4
4,N/A,N/A,N/A,1705,1709,N/A,107,3
4,N/A,N/A,N/A,1701,1705,N/A,112,2
18,N/A,N/A,N/A,1683,1701,N/A,116,6
5,N/A,N/A,N/A,1678,1683,N/A,122,0
8,N/A,N/A,N/A,1670,1678,N/A,126,4
5,N/A,N/A,N/A,1665,1670,N/A,131,3
5,N/A,N/A,N/A,1660,1665,N/A,136,2
5,N/A,N/A,N/A,901,906,N/A,6,3
11,N/A,N/A,N/A,890,901,N/A,9,6
6,N/A,N/A,N/A,884,890,N/A,12,3
16,N/A,N/A,N/A,868,884,N/A,15,6
4,N/A,N/A,N/A,864,868,N/A,18,3
4,N/A,N/A,N/A,860,864,N/A,24,3
4,N/A,N/A,N/A,856,860,N/A,30,3
7,N/A,N/A,N/A,849,856,N/A,36,3
4,N/A,N/A,N/A,845,849,N/A,40,1
17,N/A,N/A,N/A,828,845,N/A,45,6
11,N/A,N/A,N/A,817,828,N/A,50,5
4,N/A,N/A,N/A,813,817,N/A,53,2
18,N/A,N/A,N/A,795,813,N/A,57,6
4,N/A,N/A,N/A,791,795,N/A,63,0
11,N/A,N/A,N/A,780,791,N/A,69,6
12,N/A,N/A,N/A,768,780,N/A,74,5
9,N/A,N/A,N/A,759,768,N/A,80,5
5,N/A,N/A,N/A,754,759,N/A,84,3
7,N/A,N/A,N/A,747,754,N/A,89,2
4,N/A,N/A,N/A,743,747,N/A,95,2
18,N/A,N/A,N/A,725,743,N/A,99,6
6,N/A,N/A,N/A,719,725,N/A,102,3
4,N/A,N/A,N/A,715,719,N/A,106,1
12,N/A,N/A,N/A,703,715,N/A,110,5
6,N/A,N/A,N/A,697,703,N/A,113,2
7,N/A,N/A,N/A,690,697,N/A,119,2
16,N/A,N/A,N/A,674,690,N/A,123,6
10,N/A,N/A,N/A,664,674,N/A,128,5
6,N/A,N/A,N/A,658,664,N/A,133,4
7,N/A,N/A,N/A,651,658,N/A,137,2
5,N/A,N/A,N/A,644,649,N/A,3,3
16,N/A,N/A,N/A,628,644,N/A,6,6
7,N/A,N/A,N/A,621,628,N/A,10,4
6,N/A,N/A,N/A,615,621,N/A,14,2
9,N/A,N/A,N/A,606,615,N/A,17,5
7,N/A,N/A,N/A,599,606,N/A,21,3
4,N/A,N/A,N/A,595,599,N/A,27,3
4,N/A,N/A,N/A,591,595,N/A,32,2
9,N/A,N/A,N/A,582,591,N/A,35,5
8,N/A,N/A,N/A,574,582,N/A,40,4
5,N/A,N/A,N/A,569,574,N/A,44,2
4,N/A,N/A,N/A,565,569,N/A,50,2
7,N/A,N/A,N/A,558,565,N/A,56,2
9,N/A,N/A,N/A,549,558,N/A,59,5
6,N/A,N/A,N/A,543,549,N/A,62,2
5,N/A,N/A,N/A,538,543,N/A,67,1
11,N/A,N/A,N/A,527,538,N/A,71,5
12,N/A,N/A,N/A,515,527,N/A,77,5
4,N/A,N/A,N/A,511,515,N/A,81,3
5,N/A,N/A,N/A,506,511,N/A,87,3
7,N/A,N/A,N/A,499,506,N/A,92,2
12,N/A,N/A,N/A,487,499,N/A,95,5
6,N/A,N/A,N/A,481,487,N/A,98,2
4,N/A,N/A,N/A,477,481,N/A,104,2
4,N/A,N/A,N/A,473,477,N/A,109,1
4,N/A,N/A,N/A,469,473,N/A,115,1
14,N/A,N/A,N/A,455,469,N/A,120,6
12,N/A,N/A,N/A,443,455,N/A,125,5
8,N/A,N/A,N/A,435,443,N/A,130,4
6,N/A,N/A,N/A,429,435,N/A,135,3
8,N/A,N/A,N/A,703,711,N/A,5,4
4,N/A,N/A,N/A,699,703,N/A,9,2
5,N/A,N/A,N/A,694,699,N/A,15,2
5,N/A,N/A,N/A,689,694,N/A,20,1
14,N/A,N/A,N/A,675,689,N/A,25,6
4,N/A,N/A,N/A,671,675,N/A,31,0
6,N/A,N/A,N/A,665,671,N/A,35,4
7,N/A,N/A,N/A,658,665,N/A,41,4
5,N/A,N/A,N/A,653,658,N/A,46,3
5,N/A,N/A,N/A,648,653,N/A,50,1
4,N/A,N/A,N/A,644,648,N/A,56,1
7,N/A,N/A,N/A,637,644,N/A,59,4
4,N/A,N/A,N/A,633,637,N/A,62,1
17,N/A,N/A,N/A,616,633,N/A,67,6
7,N/A,N/A,N/A,609,616,N/A,71,4
4,N/A,N/A,N/A,605,609,N/A,75,2
5,N/A,N/A,N/A,600,605,N/A,80,1
4,N/A,N/A,N/A,596,600,N/A,86,1
9,N/A,N/A,N/A,587,596,N/A,90,5
11,N/A,N/A,N/A,576,587,N/A,96,5
12,N/A,N/A,N/A,564,576,N/A,102,5
5,N/A,N/A,N/A,559,564,N/A,106,3
5,N/A,N/A,N/A,554,559,N/A,110,1
18,N/A,N/A,N/A,536,554,N/A,115,6
4,N/A,N/A,N/A,532,536,N/A,118,3
6,N/A,N/A,N/A,526,532,N/A,123,2
5,N/A,N/A,N/A,521,526,N/A,128,1
17,N/A,N/A,N/A,504,521,N/A,133,6
6,N/A,N/A,N/A,498,504,N/A,136,3
6,N/A,N/A,N/A,492,498,N/A,141,2
11,N/A,N/A,N/A,929,940,N/A,3,5
6,N/A,N/A,N/A,923,929,N/A,8,4
4,N/A,N/A,N/A,919,923,N/A,12,2
6,N/A,N/A,N/A,913,919,N/A,18,2
4,N/A,N/A,N/A,909,913,N/A,23,1
9,N/A,N/A,N/A,900,909,N/A,27,5
4,N/A,N/A,N/A,896,900,N/A,31,3
4,N/A,N/A,N/A,892,896,N/A,36,2
5,N/A,N/A,N/A,887,892,N/A,42,2
11,N/A,N/A,N/A,876,887,N/A,45,5
6,N/A,N/A,N/A,870,876,N/A,50,4
6,N/A,N/A,N/A,864,870,N/A,55,3
11,N/A,N/A,N/A,853,864,N/A,58,6
4,N/A,N/A,N/A,849,853,N/A,61,3
5,N/A,N/A,N/A,844,849,N/A,66,2
12,N/A,N/A,N/A,832,844,N/A,69,5
6,N/A,N/A,N/A,826,832,N/A,74,4
8,N/A,N/A,N/A,818,826,N/A,80,4
4,N/A,N/A,N/A,814,818,N/A,84,2
4,N/A,N/A,N/A,810,814,N/A,90,2
5,N/A,N/A,N/A,805,810,N/A,95,1
15,N/A,N/A,N/A,790,805,N/A,100,6
11,N/A,N/A,N/A,779,790,N/A,105,5
6,N/A,N/A,N/A,773,779,N/A,108,2
6,N/A,N/A,N/A,767,773,N/A,114,2
14,N/A,N/A,N/A,753,767,N/A,118,6
8,N/A,N/A,N/A,745,753,N/A,122,4
4,N/A,N/A,N/A,741,745,N/A,125,1
7,N/A,N/A,N/A,734,741,N/A,128,4
6,N/A,N/A,N/A,728,734,N/A,134,4
5,N/A,N/A,N/A,590,595,N/A,3,1
10,N/A,N/A,N/A,580,590,N/A,7,5
8,N/A,N/A,N/A,572,580,N/A,12,4
4,N/A,N/A,N/A,568,572,N/A,15,1
8,N/A,N/A,N/A,560,568,N/A,18,4
4,N/A,N/A,N/A,556,560,N/A,21,1
5,N/A,N/A,N/A,551,556,N/A,24,4
5,N/A,N/A,N/A,546,551,N/A,27,1
9,N/A,N/A,N/A,537,546,N/A,31,5
6,N/A,N/A,N/A,531,537,N/A,36,4
5,N/A,N/A,N/A,526,531,N/A,40,2
5,N/A,N/A,N/A,521,526,N/A,45,1
5,N/A,N/A,N/A,516,521,N/A,51,1
11,N/A,N/A,N/A,505,516,N/A,55,5
9,N/A,N/A,N/A,496,505,N/A,61,5
7,N/A,N/A,N/A,489,496,N/A,66,4
4,N/A,N/A,N/A,485,489,N/A,69,1
16,N/A,N/A,N/A,469,485,N/A,74,6
9,N/A,N/A,N/A,460,469,N/A,79,5
7,N/A,N/A,N/A,453,460,N/A,83,3
5,N/A,N/A,N/A,448,453,N/A,88,2
5,N/A,N/A,N/A,443,448,N/A,93,1
11,N/A,N/A,N/A,432,443,N/A,98,6
5,N/A,N/A,N/A,427,432,N/A,104,0
11,N/A,N/A,N/A,416,427,N/A,110,6
6,N/A,N/A,N/A,410,416,N/A,114,4
7,N/A,N/A,N/A,403,410,N/A,119,3
5,N/A,N/A,N/A,398,403,N/A,124,2
7,N/A,N/A,N/A,391,398,N/A,130,2
10,N/A,N/A,N/A,381,391,N/A,133,5
6,N/A,N/A,N/A,556,562,N/A,5,3
15,N/A,N/A,N/A,541,556,N/A,8,6
5,N/A,N/A,N/A,536,541,N/A,14,0
7,N/A,N/A,N/A,529,536,N/A,18,4
6,N/A,N/A,N/A,523,529,N/A,23,3
7,N/A,N/A,N/A,516,523,N/A,28,2
9,N/A,N/A,N/A,507,516,N/A,31,5
10,N/A,N/A,N/A,497,507,N/A,37,5
9,N/A,N/A,N/A,488,497,N/A,43,5
5,N/A,N/A,N/A,483,488,N/A,46,2
4,N/A,N/A,N/A,479,483,N/A,52,2
15,N/A,N/A,N/A,464,479,N/A,56,6
4,N/A,N/A,N/A,460,464,N/A,62,0
14,N/A,N/A,N/A,446,460,N/A,68,6
12,N/A,N/A,N/A,434,446,N/A,73,5
7,N/A,N/A,N/A,427,434,N/A,77,3
12,N/A,N/A,N/A,415,427,N/A,80,6
5,N/A,N/A,N/A,410,415,N/A,84,4
6,N/A,N/A,N/A,404,410,N/A,90,4
8,N/A,N/A,N/A,396,404,N/A,96,4
5,N/A,N/A,N/A,391,396,N/A,100,2
12,N/A,N/A,N/A,379,391,N/A,103,5
4,N/A,N/A,N/A,375,379,N/A,107,3
7,N/A,N/A,N/A,368,375,N/A,112,2
16,N/A,N/A,N/A,352,368,N/A,116,6
10,N/A,N/A,N/A,342,352,N/A,121,5
7,N/A,N/A,N/A,335,342,N/A,125,3
5,N/A,N/A,N/A,330,335,N/A,130,2
15,N/A,N/A,N/A,315,330,N/A,134,6
7,N/A,N/A,N/A,308,315,N/A,138,4
5,N/A,N/A,N/A,1741,1746,N/A,5,3
7,N/A,N/A,N/A,1734,1741,N/A,10,2
6,N/A,N/A,N/A,1728,1734,N/A,16,2
9,N/A,N/A,N/A,1719,1728,N/A,19,5
12,N/A,N/A,N/A,1707,1719,N/A,25,5
5,N/A,N/A,N/A,1702,1707,N/A,30,4
5,N/A,N/A,N/A,1697,1702,N/A,33,1
5,N/A,N/A,N/A,1692,1697,N/A,39,1
17,N/A,N/A,N/A,1675,1692,N/A,44,6
6,N/A,N/A,N/A,1669,1675,N/A,47,3
5,N/A,N/A,N/A,1664,1669,N/A,51,1
10,N/A,N/A,N/A,1654,1664,N/A,55,5
7,N/A,N/A,N/A,1647,1654,N/A,58,2
12,N/A,N/A,N/A,1635,1647,N/A,61,5
11,N/A,N/A,N/A,1624,1635,N/A,67,5
5,N/A,N/A,N/A,1619,1624,N/A,72,4
7,N/A,N/A,N/A,1612,1619,N/A,77,3
12,N/A,N/A,N/A,1600,1612,N/A,80,6
12,N/A,N/A,N/A,1588,1600,N/A,85,5
5,N/A,N/A,N/A,1583,1588,N/A,90,4
4,N/A,N/A,N/A,1579,1583,N/A,94,2
16,N/A,N/A,N/A,1563,1579,N/A,98,6
12,N/A,N/A,N/A,1551,1563,N/A,103,5
11,N/A,N/A,N/A,1540,1551,N/A,109,5
5,N/A,N/A,N/A,1535,1540,N/A,113,3
5,N/A,N/A,N/A,1530,1535,N/A,117,1
5,N/A,N/A,N/A,1525,1530,N/A,123,1
4,N/A,N/A,N/A,1521,1525,N/A,129,1
14,N/A,N/A,N/A,1507,1521,N/A,134,6
4,N/A,N/A,N/A,1503,1507,N/A,140,0
7,N/A,N/A,N/A,1056,1063,N/A,6,3
15,N/A,N/A,N/A,1041,1056,N/A,9,6
6,N/A,N/A,N/A,1035,1041,N/A,13,4
5,N/A,N/A,N/A,1030,1035,N/A,17,2
4,N/A,N/A,N/A,1026,1030,N/A,22,1
5,N/A,N/A,N/A,1021,1026,N/A,28,1
5,N/A,N/A,N/A,1016,1021,N/A,34,1
5,N/A,N/A,N/A,1011,1016,N/A,37,4
7,N/A,N/A,N/A,1004,1011,N/A,42,3
5,N/A,N/A,N/A,999,1004,N/A,46,1
12,N/A,N/A,N/A,987,999,N/A,50,5
5,N/A,N/A,N/A,982,987,N/A,54,3
6,N/A,N/A,N/A,976,982,N/A,60,3
7,N/A,N/A,N/A,969,976,N/A,66,3
4,N/A,N/A,N/A,965,969,N/A,70,1
5,N/A,N/A,N/A,960,965,N/A,73,4
5,N/A,N/A,N/A,955,960,N/A,76,1
12,N/A,N/A,N/A,943,955,N/A,81,6
10,N/A,N/A,N/A,933,943,N/A,86,5
6,N/A,N/A,N/A,927,933,N/A,91,4
8,N/A,N/A,N/A,919,927,N/A,97,4
5,N/A,N/A,N/A,914,919,N/A,102,3
14,N/A,N/A,N/A,900,914,N/A,105,6
7,N/A,N/A,N/A,893,900,N/A,108,3
5,N/A,N/A,N/A,888,893,N/A,114,3
6,N/A,N/A,N/A,882,888,N/A,120,3
4,N/A,N/A,N/A,878,882,N/A,124,1
7,N/A,N/A,N/A,871,878,N/A,127,4
6,N/A,N/A,N/A,865,871,N/A,131,2
19,N/A,N/A,N/A,846,865,N/A,135,6
9,N/A,N/A,N/A,1808,1817,N/A,6,5
9,N/A,N/A,N/A,1799,1808,N/A,12,5
7,N/A,N/A,N/A,1792,1799,N/A,15,2
5,N/A,N/A,N/A,1787,1792,N/A,20,1
7,N/A,N/A,N/A,1780,1787,N/A,23,4
5,N/A,N/A,N/A,1775,1780,N/A,27,2
12,N/A,N/A,N/A,1763,1775,N/A,30,5
7,N/A,N/A,N/A,1756,1763,N/A,35,4
6,N/A,N/A,N/A,1750,1756,N/A,41,4
7,N/A,N/A,N/A,1743,1750,N/A,46,3
4,N/A,N/A,N/A,1739,1743,N/A,51,2
12,N/A,N/A,N/A,1727,1739,N/A,54,5
5,N/A,N/A,N/A,1722,1727,N/A,59,4
6,N/A,N/A,N/A,1716,1722,N/A,63,2
11,N/A,N/A,N/A,1705,1716,N/A,66,5
6,N/A,N/A,N/A,1699,1705,N/A,71,4
4,N/A,N/A,N/A,1695,1699,N/A,74,1
15,N/A,N/A,N/A,1680,1695,N/A,79,6
5,N/A,N/A,N/A,1675,1680,N/A,83,4
4,N/A,N/A,N/A,1671,1675,N/A,86,1
12,N/A,N/A,N/A,1659,1671,N/A,91,6
6,N/A,N/A,N/A,1653,1659,N/A,95,4
7,N/A,N/A,N/A,1646,1653,N/A,101,4
6,N/A,N/A,N/A,1640,1646,N/A,107,4
6,N/A,N/A,N/A,1634,1640,N/A,113,4
5,N/A,N/A,N/A,1629,1634,N/A,116,1
13,N/A,N/A,N/A,1616,1629,N/A,121,6
4,N/A,N/A,N/A,1612,1616,N/A,127,0
5,N/A,N/A,N/A,1607,1612,N/A,130,3
7,N/A,N/A,N/A,1600,1607,N/A,135,2
5,N/A,N/A,N/A,1409,1414,N/A,3,1
16,N/A,N/A,N/A,1393,1409,N/A,8,6
4,N/A,N/A,N/A,1389,1393,N/A,11,3
5,N/A,N/A,N/A,1384,1389,N/A,16,2
12,N/A,N/A,N/A,1372,1384,N/A,20,6
10,N/A,N/A,N/A,1362,1372,N/A,25,5
5,N/A,N/A,N/A,1357,1362,N/A,29,3
5,N/A,N/A,N/A,1352,1357,N/A,33,1
11,N/A,N/A,N/A,1341,1352,N/A,37,5
5,N/A,N/A,N/A,1336,1341,N/A,42,4
7,N/A,N/A,N/A,1329,1336,N/A,47,3
4,N/A,N/A,N/A,1325,1329,N/A,51,1
5,N/A,N/A,N/A,1320,1325,N/A,54,4
7,N/A,N/A,N/A,1313,1320,N/A,60,4
4,N/A,N/A,N/A,1309,1313,N/A,63,1
5,N/A,N/A,N/A,1304,1309,N/A,69,1
10,N/A,N/A,N/A,1294,1304,N/A,74,6
5,N/A,N/A,N/A,1289,1294,N/A,80,0
8,N/A,N/A,N/A,1281,1289,N/A,84,4
4,N/A,N/A,N/A,1277,1281,N/A,89,3
5,N/A,N/A,N/A,1272,1277,N/A,95,3
5,N/A,N/A,N/A,1267,1272,N/A,100,2
5,N/A,N/A,N/A,1262,1267,N/A,105,1
5,N/A,N/A,N/A,1257,1262,N/A,111,1
7,N/A,N/A,N/A,1250,1257,N/A,114,4
6,N/A,N/A,N/A,1244,1250,N/A,118,2
12,N/A,N/A,N/A,1232,1244,N/A,121,5
7,N/A,N/A,N/A,1225,1232,N/A,124,2
12,N/A,N/A,N/A,1213,1225,N/A,127,5
9,N/A,N/A,N/A,1204,1213,N/A,133,5
4,N/A,N/A,N/A,1691,1695,N/A,6,3
6,N/A,N/A,N/A,1685,1691,N/A,12,3
5,N/A,N/A,N/A,1680,1685,N/A,16,1
6,N/A,N/A,N/A,1674,1680,N/A,19,4
7,N/A,N/A,N/A,1667,1674,N/A,24,3
5,N/A,N/A,N/A,1662,1667,N/A,30,3
5,N/A,N/A,N/A,1657,1662,N/A,35,2
16,N/A,N/A,N/A,1641,1657,N/A,39,6
11,N/A,N/A,N/A,1630,1641,N/A,44,5
7,N/A,N/A,N/A,1623,1630,N/A,48,3
12,N/A,N/A,N/A,1611,1623,N/A,51,6
6,N/A,N/A,N/A,1605,1611,N/A,55,4
6,N/A,N/A,N/A,1599,1605,N/A,59,2
4,N/A,N/A,N/A,1595,1599,N/A,64,1
5,N/A,N/A,N/A,1590,1595,N/A,70,1
12,N/A,N/A,N/A,1578,1590,N/A,74,5
4,N/A,N/A,N/A,1574,1578,N/A,78,3
5,N/A,N/A,N/A,1569,1574,N/A,82,1
9,N/A,N/A,N/A,1560,1569,N/A,86,5
4,N/A,N/A,N/A,1556,1560,N/A,89,2
7,N/A,N/A,N/A,1549,1556,N/A,95,2
5,N/A,N/A,N/A,1544,1549,N/A,100,1
5,N/A,N/A,N/A,1539,1544,N/A,106,1
11,N/A,N/A,N/A,1528,1539,N/A,110,5
5,N/A,N/A,N/A,1523,1528,N/A,115,4
4,N/A,N/A,N/A,1519,1523,N/A,118,1
9,N/A,N/A,N/A,1510,1519,N/A,122,5
6,N/A,N/A,N/A,1504,1510,N/A,126,3
4,N/A,N/A,N/A,1500,1504,N/A,130,1
5,N/A,N/A,N/A,1495,1500,N/A,136,1
7,N/A,N/A,N/A,1547,1554,N/A,4,2
7,N/A,N/A,N/A,1540,1547,N/A,10,2
6,N/A,N/A,N/A,1534,1540,N/A,16,2
4,N/A,N/A,N/A,1530,1534,N/A,21,1
5,N/A,N/A,N/A,1525,1530,N/A,24,4
5,N/A,N/A,N/A,1520,1525,N/A,28,2
10,N/A,N/A,N/A,1510,1520,N/A,31,5
6,N/A,N/A,N/A,1504,1510,N/A,34,2
4,N/A,N/A,N/A,1500,1504,N/A,40,2
6,N/A,N/A,N/A,1494,1500,N/A,46,2
15,N/A,N/A,N/A,1479,1494,N/A,50,6
5,N/A,N/A,N/A,1474,1479,N/A,56,0
7,N/A,N/A,N/A,1467,1474,N/A,59,3
14,N/A,N/A,N/A,1453,1467,N/A,62,6
7,N/A,N/A,N/A,1446,1453,N/A,65,3
7,N/A,N/A,N/A,1439,1446,N/A,71,3
7,N/A,N/A,N/A,1432,1439,N/A,76,2
7,N/A,N/A,N/A,1425,1432,N/A,82,2
4,N/A,N/A,N/A,1421,1425,N/A,87,1
5,N/A,N/A,N/A,1416,1421,N/A,90,4
4,N/A,N/A,N/A,1412,1416,N/A,94,2
5,N/A,N/A,N/A,1407,1412,N/A,99,1
12,N/A,N/A,N/A,1395,1407,N/A,103,5
6,N/A,N/A,N/A,1389,1395,N/A,108,4
5,N/A,N/A,N/A,1384,1389,N/A,113,3
16,N/A,N/A,N/A,1368,1384,N/A,116,6
4,N/A,N/A,N/A,1364,1368,N/A,122,0
10,N/A,N/A,N/A,1354,1364,N/A,127,5
7,N/A,N/A,N/A,1347,1354,N/A,132,4
7,N/A,N/A,N/A,1340,1347,N/A,136,2
8,N/A,N/A,N/A,1276,1284,N/A,6,4
7,N/A,N/A,N/A,1269,1276,N/A,12,4
7,N/A,N/A,N/A,1262,1269,N/A,18,4
4,N/A,N/A,N/A,1258,1262,N/A,22,2
5,N/A,N/A,N/A,1253,1258,N/A,27,1
13,N/A,N/A,N/A,1240,1253,N/A,32,6
12,N/A,N/A,N/A,1228,1240,N/A,37,5
4,N/A,N/A,N/A,1224,1228,N/A,40,2
6,N/A,N/A,N/A,1218,1224,N/A,46,2
6,N/A,N/A,N/A,1212,1218,N/A,52,2
12,N/A,N/A,N/A,1200,1212,N/A,56,6
7,N/A,N/A,N/A,1193,1200,N/A,60,4
7,N/A,N/A,N/A,1186,1193,N/A,64,2
5,N/A,N/A,N/A,1181,1186,N/A,70,2
12,N/A,N/A,N/A,1169,1181,N/A,74,6
4,N/A,N/A,N/A,1165,1169,N/A,77,3
4,N/A,N/A,N/A,1161,1165,N/A,82,2
5,N/A,N/A,N/A,1156,1161,N/A,88,2
18,N/A,N/A,N/A,1138,1156,N/A,92,6
8,N/A,N/A,N/A,1130,1138,N/A,96,4
6,N/A,N/A,N/A,1124,1130,N/A,100,2
5,N/A,N/A,N/A,1119,1124,N/A,106,2
7,N/A,N/A,N/A,1112,1119,N/A,112,2
12,N/A,N/A,N/A,1100,1112,N/A,115,5
9,N/A,N/A,N/A,1091,1100,N/A,121,5
6,N/A,N/A,N/A,1085,1091,N/A,125,3
4,N/A,N/A,N/A,1081,1085,N/A,129,1
4,N/A,N/A,N/A,1077,1081,N/A,135,1
10,N/A,N/A,N/A,1067,1077,N/A,139,5
5,N/A,N/A,N/A,1062,1067,N/A,142,2
5,N/A,N/A,N/A,784,789,N/A,5,1
13,N/A,N/A,N/A,771,784,N/A,10,6
6,N/A,N/A,N/A,765,771,N/A,14,4
4,N/A,N/A,N/A,761,765,N/A,19,3
4,N/A,N/A,N/A,757,761,N/A,24,2
7,N/A,N/A,N/A,750,757,N/A,30,2
9,N/A,N/A,N/A,741,750,N/A,33,5
10,N/A,N/A,N/A,731,741,N/A,39,5
11,N/A,N/A,N/A,720,731,N/A,45,5
10,N/A,N/A,N/A,710,720,N/A,51,5
10,N/A,N/A,N/A,700,710,N/A,57,5
11,N/A,N/A,N/A,689,700,N/A,63,5
5,N/A,N/A,N/A,684,689,N/A,67,3
6,N/A,N/A,N/A,678,684,N/A,73,3
5,N/A,N/A,N/A,673,678,N/A,79,3
7,N/A,N/A,N/A,666,673,N/A,84,2
12,N/A,N/A,N/A,654,666,N/A,88,6
4,N/A,N/A,N/A,650,654,N/A,94,0
8,N/A,N/A,N/A,642,650,N/A,98,4
7,N/A,N/A,N/A,635,642,N/A,104,4
6,N/A,N/A,N/A,629,635,N/A,109,3
19,N/A,N/A,N/A,610,629,N/A,112,6
5,N/A,N/A,N/A,605,610,N/A,115,3
5,N/A,N/A,N/A,600,605,N/A,119,1
5,N/A,N/A,N/A,595,600,N/A,122,4
5,N/A,N/A,N/A,590,595,N/A,125,1
10,N/A,N/A,N/A,580,590,N/A,129,5
5,N/A,N/A,N/A,575,580,N/A,133,3
5,N/A,N/A,N/A,570,575,N/A,138,2
4,N/A,N/A,N/A,566,570,N/A,143,1
5,N/A,N/A,N/A,507,512,N/A,3,3
4,N/A,N/A,N/A,503,507,N/A,8,2
5,N/A,N/A,N/A,498,503,N/A,13,1
6,N/A,N/A,N/A,492,498,N/A,16,4
5,N/A,N/A,N/A,487,492,N/A,22,4
5,N/A,N/A,N/A,482,487,N/A,26,2
10,N/A,N/A,N/A,472,482,N/A,29,5
6,N/A,N/A,N/A,466,472,N/A,34,4
4,N/A,N/A,N/A,462,466,N/A,37,1
19,N/A,N/A,N/A,443,462,N/A,42,6
4,N/A,N/A,N/A,439,443,N/A,48,0
6,N/A,N/A,N/A,433,439,N/A,52,4
6,N/A,N/A,N/A,427,433,N/A,56,2
11,N/A,N/A,N/A,416,427,N/A,59,5
5,N/A,N/A,N/A,411,416,N/A,63,3
4,N/A,N/A,N/A,407,411,N/A,68,2
12,N/A,N/A,N/A,395,407,N/A,71,5
5,N/A,N/A,N/A,390,395,N/A,75,3
5,N/A,N/A,N/A,385,390,N/A,80,2
5,N/A,N/A,N/A,380,385,N/A,86,2
15,N/A,N/A,N/A,365,380,N/A,90,6
8,N/A,N/A,N/A,357,365,N/A,94,4
8,N/A,N/A,N/A,349,357,N/A,100,4
5,N/A,N/A,N/A,344,349,N/A,103,1
6,N/A,N/A,N/A,338,344,N/A,106,4
8,N/A,N/A,N/A,330,338,N/A,112,4
5,N/A,N/A,N/A,325,330,N/A,116,2
4,N/A,N/A,N/A,321,325,N/A,122,2
4,N/A,N/A,N/A,317,321,N/A,127,1
11,N/A,N/A,N/A,306,317,N/A,132,6
5,N/A,N/A,N/A,1553,1558,N/A,3,3
4,N/A,N/A,N/A,1549,1553,N/A,7,1
19,N/A,N/A,N/A,1530,1549,N/A,12,6
7,N/A,N/A,N/A,1523,1530,N/A,16,4
6,N/A,N/A,N/A,1517,1523,N/A,22,4
6,N/A,N/A,N/A,1511,1517,N/A,27,3
4,N/A,N/A,N/A,1507,1511,N/A,31,1
4,N/A,N/A,N/A,1503,1507,N/A,37,1
6,N/A,N/A,N/A,1497,1503,N/A,40,4
5,N/A,N/A,N/A,1492,1497,N/A,43,1
9,N/A,N/A,N/A,1483,1492,N/A,47,5
11,N/A,N/A,N/A,1472,1483,N/A,53,5
6,N/A,N/A,N/A,1466,1472,N/A,57,3
4,N/A,N/A,N/A,1462,1466,N/A,61,1
11,N/A,N/A,N/A,1451,1462,N/A,65,5
7,N/A,N/A,N/A,1444,1451,N/A,69,3
14,N/A,N/A,N/A,1430,1444,N/A,72,6
11,N/A,N/A,N/A,1419,1430,N/A,77,5
6,N/A,N/A,N/A,1413,1419,N/A,81,3
4,N/A,N/A,N/A,1409,1413,N/A,85,1
11,N/A,N/A,N/A,1398,1409,N/A,90,6
6,N/A,N/A,N/A,1392,1398,N/A,93,3
4,N/A,N/A,N/A,1388,1392,N/A,97,1
7,N/A,N/A,N/A,1381,1388,N/A,100,4
4,N/A,N/A,N/A,1377,1381,N/A,103,1
5,N/A,N/A,N/A,1372,1377,N/A,106,4
5,N/A,N/A,N/A,1367,1372,N/A,112,4
7,N/A,N/A,N/A,1360,1367,N/A,118,4
7,N/A,N/A,N/A,1353,1360,N/A,123,3
17,N/A,N/A,N/A,1336,1353,N/A,126,6
6,N/A,N/A,N/A,501,507,N/A,3,3
11,N/A,N/A,N/A,490,501,N/A,6,6
7,N/A,N/A,N/A,483,490,N/A,10,4
6,N/A,N/A,N/A,477,483,N/A,14,2
5,N/A,N/A,N/A,472,477,N/A,20,2
6,N/A,N/A,N/A,466,472,N/A,26,2
6,N/A,N/A,N/A,460,466,N/A,32,2
18,N/A,N/A,N/A,442,460,N/A,36,6
7,N/A,N/A,N/A,435,442,N/A,40,4
4,N/A,N/A,N/A,431,435,N/A,43,1
8,N/A,N/A,N/A,423,431,N/A,46,4
5,N/A,N/A,N/A,418,423,N/A,50,2
11,N/A,N/A,N/A,407,418,N/A,53,5
9,N/A,N/A,N/A,398,407,N/A,59,5
7,N/A,N/A,N/A,391,398,N/A,62,2
12,N/A,N/A,N/A,379,391,N/A,65,5
5,N/A,N/A,N/A,374,379,N/A,69,3
15,N/A,N/A,N/A,359,374,N/A,72,6
5,N/A,N/A,N/A,354,359,N/A,78,0
7,N/A,N/A,N/A,347,354,N/A,82,4
4,N/A,N/A,N/A,343,347,N/A,85,1
6,N/A,N/A,N/A,337,343,N/A,88,4
5,N/A,N/A,N/A,332,337,N/A,93,3
16,N/A,N/A,N/A,316,332,N/A,96,6
5,N/A,N/A,N/A,311,316,N/A,102,0
7,N/A,N/A,N/A,304,311,N/A,106,4
5,N/A,N/A,N/A,299,304,N/A,109,1
6,N/A,N/A,N/A,293,299,N/A,112,4
4,N/A,N/A,N/A,289,293,N/A,116,2
14,N/A,N/A,N/A,275,289,N/A,120,6
10,N/A,N/A,N/A,336,346,N/A,4,5
12,N/A,N/A,N/A,324,336,N/A,10,5
12,N/A,N/A,N/A,312,324,N/A,16,5
7,N/A,N/A,N/A,305,312,N/A,19,2
4,N/A,N/A,N/A,301,305,N/A,24,1
10,N/A,N/A,N/A,291,301,N/A,29,6
11,N/A,N/A,N/A,280,291,N/A,34,5
4,N/A,N/A,N/A,276,280,N/A,38,3
6,N/A,N/A,N/A,270,276,N/A,44,3
17,N/A,N/A,N/A,253,270,N/A,47,6
9,N/A,N/A,N/A,244,253,N/A,52,5
6,N/A,N/A,N/A,238,244,N/A,55,2
11,N/A,N/A,N/A,227,238,N/A,58,5
7,N/A,N/A,N/A,220,227,N/A,63,4
5,N/A,N/A,N/A,215,220,N/A,69,4
7,N/A,N/A,N/A,208,215,N/A,73,2
18,N/A,N/A,N/A,190,208,N/A,77,6
5,N/A,N/A,N/A,185,190,N/A,81,4
7,N/A,N/A,N/A,178,185,N/A,86,3
4,N/A,N/A,N/A,174,178,N/A,90,1
5,N/A,N/A,N/A,169,174,N/A,96,1
4,N/A,N/A,N/A,165,169,N/A,102,1
17,N/A,N/A,N/A,148,165,N/A,107,6
10,N/A,N/A,N/A,138,148,N/A,112,5
10,N/A,N/A,N/A,128,138,N/A,118,5
5,N/A,N/A,N/A,123,128,N/A,123,4
7,N/A,N/A,N/A,116,123,N/A,127,2
10,N/A,N/A,N/A,106,116,N/A,130,5
8,N/A,N/A,N/A,98,106,N/A,135,4
5,N/A,N/A,N/A,93,98,N/A,138,1
16,N/A,N/A,N/A,798,814,N/A,3,6
5,N/A,N/A,N/A,793,798,N/A,9,0
12,N/A,N/A,N/A,781,793,N/A,14,5
10,N/A,N/A,N/A,771,781,N/A,20,5
4,N/A,N/A,N/A,767,771,N/A,23,2
4,N/A,N/A,N/A,763,767,N/A,28,1
5,N/A,N/A,N/A,758,763,N/A,34,1
8,N/A,N/A,N/A,750,758,N/A,37,4
7,N/A,N/A,N/A,743,750,N/A,42,3
14,N/A,N/A,N/A,729,743,N/A,45,6
5,N/A,N/A,N/A,724,729,N/A,48,3
17,N/A,N/A,N/A,707,724,N/A,51,6
11,N/A,N/A,N/A,696,707,N/A,56,5
11,N/A,N/A,N/A,685,696,N/A,62,5
5,N/A,N/A,N/A,680,685,N/A,67,4
8,N/A,N/A,N/A,672,680,N/A,73,4
7,N/A,N/A,N/A,665,672,N/A,78,3
16,N/A,N/A,N/A,649,665,N/A,81,6
6,N/A,N/A,N/A,643,649,N/A,84,3
6,N/A,N/A,N/A,637,643,N/A,89,2
4,N/A,N/A,N/A,633,637,N/A,95,2
16,N/A,N/A,N/A,617,633,N/A,99,6
7,N/A,N/A,N/A,610,617,N/A,103,4
8,N/A,N/A,N/A,602,610,N/A,109,4
5,N/A,N/A,N/A,597,602,N/A,115,4
6,N/A,N/A,N/A,591,597,N/A,120,3
7,N/A,N/A,N/A,584,591,N/A,125,2
5,N/A,N/A,N/A,579,584,N/A,130,1
11,N/A,N/A,N/A,568,579,N/A,135,6
7,N/A,N/A,N/A,561,568,N/A,139,4
16,N/A,N/A,N/A,1835,1851,N/A,5,6
6,N/A,N/A,N/A,1829,1835,N/A,8,3
5,N/A,N/A,N/A,1824,1829,N/A,12,1
10,N/A,N/A,N/A,1814,1824,N/A,17,6
6,N/A,N/A,N/A,1808,1814,N/A,20,3
4,N/A,N/A,N/A,1804,1808,N/A,26,3
13,N/A,N/A,N/A,1791,1804,N/A,29,6
5,N/A,N/A,N/A,1786,1791,N/A,32,3
7,N/A,N/A,N/A,1779,1786,N/A,38,3
7,N/A,N/A,N/A,1772,1779,N/A,44,3
4,N/A,N/A,N/A,1768,1772,N/A,49,2
15,N/A,N/A,N/A,1753,1768,N/A,53,6
7,N/A,N/A,N/A,1746,1753,N/A,57,4
4,N/A,N/A,N/A,1742,1746,N/A,61,2
17,N/A,N/A,N/A,1725,1742,N/A,65,6
6,N/A,N/A,N/A,1719,1725,N/A,68,3
5,N/A,N/A,N/A,1714,1719,N/A,73,2
15,N/A,N/A,N/A,1699,1714,N/A,77,6
5,N/A,N/A,N/A,1694,1699,N/A,80,3
5,N/A,N/A,N/A,1689,1694,N/A,85,2
12,N/A,N/A,N/A,1677,1689,N/A,88,5
5,N/A,N/A,N/A,1672,1677,N/A,91,2
4,N/A,N/A,N/A,1668,1672,N/A,97,2
13,N/A,N/A,N/A,1655,1668,N/A,101,6
10,N/A,N/A,N/A,1645,1655,N/A,106,5
6,N/A,N/A,N/A,1639,1645,N/A,110,3
4,N/A,N/A,N/A,1635,1639,N/A,115,2
4,N/A,N/A,N/A,1631,1635,N/A,120,1
13,N/A,N/A,N/A,1618,1631,N/A,125,6
6,N/A,N/A,N/A,1612,1618,N/A,128,3
5,N/A,N/A,N/A,587,592,N/A,3,1
12,N/A,N/A,N/A,575,587,N/A,7,5
12,N/A,N/A,N/A,563,575,N/A,13,5
6,N/A,N/A,N/A,557,563,N/A,18,4
8,N/A,N/A,N/A,549,557,N/A,24,4
7,N/A,N/A,N/A,542,549,N/A,28,2
4,N/A,N/A,N/A,538,542,N/A,33,1
12,N/A,N/A,N/A,526,538,N/A,37,5
4,N/A,N/A,N/A,522,526,N/A,40,2
7,N/A,N/A,N/A,515,522,N/A,46,2
6,N/A,N/A,N/A,509,515,N/A,52,2
10,N/A,N/A,N/A,499,509,N/A,55,5
7,N/A,N/A,N/A,492,499,N/A,58,2
5,N/A,N/A,N/A,487,492,N/A,63,1
9,N/A,N/A,N/A,478,487,N/A,67,5
9,N/A,N/A,N/A,469,478,N/A,73,5
6,N/A,N/A,N/A,463,469,N/A,76,2
4,N/A,N/A,N/A,459,463,N/A,81,1
5,N/A,N/A,N/A,454,459,N/A,87,1
5,N/A,N/A,N/A,449,454,N/A,90,4
5,N/A,N/A,N/A,444,449,N/A,95,3
6,N/A,N/A,N/A,438,444,N/A,101,3
7,N/A,N/A,N/A,431,438,N/A,106,2
18,N/A,N/A,N/A,413,431,N/A,110,6
8,N/A,N/A,N/A,405,413,N/A,114,4
4,N/A,N/A,N/A,401,405,N/A,117,1
11,N/A,N/A,N/A,390,401,N/A,121,5
7,N/A,N/A,N/A,383,390,N/A,124,2
15,N/A,N/A,N/A,368,383,N/A,128,6
7,N/A,N/A,N/A,361,368,N/A,131,3
8,N/A,N/A,N/A,506,514,N/A,4,4
6,N/A,N/A,N/A,500,506,N/A,9,3
6,N/A,N/A,N/A,494,500,N/A,14,2
5,N/A,N/A,N/A,489,494,N/A,20,2
4,N/A,N/A,N/A,485,489,N/A,25,1
5,N/A,N/A,N/A,480,485,N/A,31,1
19,N/A,N/A,N/A,461,480,N/A,36,6
4,N/A,N/A,N/A,457,461,N/A,42,0
4,N/A,N/A,N/A,453,457,N/A,45,3
7,N/A,N/A,N/A,446,453,N/A,50,2
13,N/A,N/A,N/A,433,446,N/A,54,6
5,N/A,N/A,N/A,428,433,N/A,58,4
5,N/A,N/A,N/A,423,428,N/A,61,1
10,N/A,N/A,N/A,413,423,N/A,66,6
12,N/A,N/A,N/A,401,413,N/A,71,5
11,N/A,N/A,N/A,390,401,N/A,77,5
11,N/A,N/A,N/A,379,390,N/A,83,5
9,N/A,N/A,N/A,370,379,N/A,89,5
5,N/A,N/A,N/A,365,370,N/A,93,3
11,N/A,N/A,N/A,354,365,N/A,96,6
6,N/A,N/A,N/A,348,354,N/A,99,3
4,N/A,N/A,N/A,344,348,N/A,103,1
7,N/A,N/A,N/A,337,344,N/A,106,4
6,N/A,N/A,N/A,331,337,N/A,112,4
4,N/A,N/A,N/A,327,331,N/A,116,2
5,N/A,N/A,N/A,322,327,N/A,122,2
13,N/A,N/A,N/A,309,322,N/A,126,6
6,N/A,N/A,N/A,303,309,N/A,129,3
5,N/A,N/A,N/A,298,303,N/A,133,1
5,N/A,N/A,N/A,293,298,N/A,139,1
5,N/A,N/A,N/A,1450,1455,N/A,4,3
4,N/A,N/A,N/A,1446,1450,N/A,9,2
13,N/A,N/A,N/A,1433,1446,N/A,13,6
4,N/A,N/A,N/A,1429,1433,N/A,19,0
11,N/A,N/A,N/A,1418,1429,N/A,24,5
6,N/A,N/A,N/A,1412,1418,N/A,27,2
4,N/A,N/A,N/A,1408,1412,N/A,32,1
4,N/A,N/A,N/A,1404,1408,N/A,38,1
9,N/A,N/A,N/A,1395,1404,N/A,42,5
6,N/A,N/A,N/A,1389,1395,N/A,45,2
4,N/A,N/A,N/A,1385,1389,N/A,50,1
9,N/A,N/A,N/A,1376,1385,N/A,54,5
6,N/A,N/A,N/A,1370,1376,N/A,58,3
5,N/A,N/A,N/A,1365,1370,N/A,64,3
5,N/A,N/A,N/A,1360,1365,N/A,68,1
12,N/A,N/A,N/A,1348,1360,N/A,73,6
4,N/A,N/A,N/A,1344,1348,N/A,79,0
6,N/A,N/A,N/A,1338,1344,N/A,83,4
7,N/A,N/A,N/A,1331,1338,N/A,87,2
17,N/A,N/A,N/A,1314,1331,N/A,91,6
5,N/A,N/A,N/A,1309,1314,N/A,97,0
6,N/A,N/A,N/A,1303,1309,N/A,100,3
4,N/A,N/A,N/A,1299,1303,N/A,105,2
11,N/A,N/A,N/A,1288,1299,N/A,109,6
5,N/A,N/A,N/A,1283,1288,N/A,115,0
7,N/A,N/A,N/A,1276,1283,N/A,118,3
4,N/A,N/A,N/A,1272,1276,N/A,123,2
12,N/A,N/A,N/A,1260,1272,N/A,127,6
4,N/A,N/A,N/A,1256,1260,N/A,130,3
4,N/A,N/A,N/A,1252,1256,N/A,136,3
5,N/A,N/A,N/A,329,334,N/A,6,2
10,N/A,N/A,N/A,319,329,N/A,9,5
5,N/A,N/A,N/A,314,319,N/A,13,3
10,N/A,N/A,N/A,304,314,N/A,16,6
12,N/A,N/A,N/A,292,304,N/A,21,5
6,N/A,N/A,N/A,286,292,N/A,26,4
6,N/A,N/A,N/A,280,286,N/A,30,2
4,N/A,N/A,N/A,276,280,N/A,36,2
6,N/A,N/A,N/A,270,276,N/A,42,2
5,N/A,N/A,N/A,265,270,N/A,47,1
14,N/A,N/A,N/A,251,265,N/A,52,6
8,N/A,N/A,N/A,243,251,N/A,56,4
5,N/A,N/A,N/A,238,243,N/A,61,3
17,N/A,N/A,N/A,221,238,N/A,64,6
5,N/A,N/A,N/A,216,221,N/A,67,3
7,N/A,N/A,N/A,209,216,N/A,73,3
11,N/A,N/A,N/A,198,209,N/A,76,6
8,N/A,N/A,N/A,190,198,N/A,80,4
8,N/A,N/A,N/A,182,190,N/A,86,4
4,N/A,N/A,N/A,178,182,N/A,91,3
18,N/A,N/A,N/A,160,178,N/A,94,6
12,N/A,N/A,N/A,148,160,N/A,99,5
7,N/A,N/A,N/A,141,148,N/A,102,2
10,N/A,N/A,N/A,131,141,N/A,106,6
5,N/A,N/A,N/A,126,131,N/A,110,4
7,N/A,N/A,N/A,119,126,N/A,114,2
9,N/A,N/A,N/A,110,119,N/A,117,5
4,N/A,N/A,N/A,106,110,N/A,120,2
12,N/A,N/A,N/A,94,106,N/A,123,5
10,N/A,N/A,N/A,84,94,N/A,129,5
6,N/A,N/A,N/A,1777,1783,N/A,4,4
4,N/A,N/A,N/A,1773,1777,N/A,7,1
16,N/A,N/A,N/A,1757,1773,N/A,12,6
4,N/A,N/A,N/A,1753,1757,N/A,18,0
5,N/A,N/A,N/A,1748,1753,N/A,22,4
5,N/A,N/A,N/A,1743,1748,N/A,28,4
5,N/A,N/A,N/A,1738,1743,N/A,34,4
4,N/A,N/A,N/A,1734,1738,N/A,39,3
5,N/A,N/A,N/A,1729,1734,N/A,45,3
10,N/A,N/A,N/A,1719,1729,N/A,48,6
5,N/A,N/A,N/A,1714,1719,N/A,51,3
10,N/A,N/A,N/A,1704,1714,N/A,54,6
12,N/A,N/A,N/A,1692,1704,N/A,59,5
7,N/A,N/A,N/A,1685,1692,N/A,64,4
8,N/A,N/A,N/A,1677,1685,N/A,70,4
5,N/A,N/A,N/A,1672,1677,N/A,73,1
10,N/A,N/A,N/A,1662,1672,N/A,77,5
5,N/A,N/A,N/A,1657,1662,N/A,81,3
18,N/A,N/A,N/A,1639,1657,N/A,84,6
7,N/A,N/A,N/A,1632,1639,N/A,88,4
7,N/A,N/A,N/A,1625,1632,N/A,92,2
6,N/A,N/A,N/A,1619,1625,N/A,98,2
10,N/A,N/A,N/A,1609,1619,N/A,102,6
9,N/A,N/A,N/A,1600,1609,N/A,107,5
5,N/A,N/A,N/A,1595,1600,N/A,110,2
5,N/A,N/A,N/A,1590,1595,N/A,115,1
7,N/A,N/A,N/A,1583,1590,N/A,118,4
6,N/A,N/A,N/A,1577,1583,N/A,123,3
12,N/A,N/A,N/A,1565,1577,N/A,126,6
12,N/A,N/A,N/A,1553,1565,N/A,131,5
4,N/A,N/A,N/A,1437,1441,N/A,3,2
12,N/A,N/A,N/A,1425,1437,N/A,7,6
7,N/A,N/A,N/A,1418,1425,N/A,10,3
5,N/A,N/A,N/A,1413,1418,N/A,15,2
6,N/A,N/A,N/A,1407,1413,N/A,21,2
10,N/A,N/A,N/A,1397,1407,N/A,25,6
7,N/A,N/A,N/A,1390,1397,N/A,28,3
4,N/A,N/A,N/A,1386,1390,N/A,32,1
16,N/A,N/A,N/A,1370,1386,N/A,37,6
4,N/A,N/A,N/A,1366,1370,N/A,43,0
6,N/A,N/A,N/A,1360,1366,N/A,47,4
4,N/A,N/A,N/A,1356,1360,N/A,51,2
4,N/A,N/A,N/A,1352,1356,N/A,56,1
4,N/A,N/A,N/A,1348,1352,N/A,62,1
4,N/A,N/A,N/A,1344,1348,N/A,68,1
18,N/A,N/A,N/A,1326,1344,N/A,73,6
4,N/A,N/A,N/A,1322,1326,N/A,79,0
6,N/A,N/A,N/A,1316,1322,N/A,83,4
7,N/A,N/A,N/A,1309,1316,N/A,88,3
14,N/A,N/A,N/A,1295,1309,N/A,91,6
4,N/A,N/A,N/A,1291,1295,N/A,97,0
7,N/A,N/A,N/A,1284,1291,N/A,101,4
6,N/A,N/A,N/A,1278,1284,N/A,107,4
6,N/A,N/A,N/A,1272,1278,N/A,113,4
7,N/A,N/A,N/A,1265,1272,N/A,117,2
9,N/A,N/A,N/A,1256,1265,N/A,120,5
8,N/A,N/A,N/A,1248,1256,N/A,125,4
6,N/A,N/A,N/A,1242,1248,N/A,131,4
5,N/A,N/A,N/A,1237,1242,N/A,134,1
4,N/A,N/A,N/A,1233,1237,N/A,140,1
4,N/A,N/A,N/A,337,341,N/A,6,1
10,N/A,N/A,N/A,327,337,N/A,10,5
6,N/A,N/A,N/A,321,327,N/A,15,4
5,N/A,N/A,N/A,316,321,N/A,20,3
17,N/A,N/A,N/A,299,316,N/A,23,6
7,N/A,N/A,N/A,292,299,N/A,26,3
12,N/A,N/A,N/A,280,292,N/A,29,6
10,N/A,N/A,N/A,270,280,N/A,34,5
6,N/A,N/A,N/A,264,270,N/A,39,4
5,N/A,N/A,N/A,259,264,N/A,45,4
6,N/A,N/A,N/A,253,259,N/A,50,3
5,N/A,N/A,N/A,248,253,N/A,56,3
18,N/A,N/A,N/A,230,248,N/A,59,6
8,N/A,N/A,N/A,222,230,N/A,63,4
8,N/A,N/A,N/A,214,222,N/A,69,4
4,N/A,N/A,N/A,210,214,N/A,72,1
6,N/A,N/A,N/A,204,210,N/A,75,4
7,N/A,N/A,N/A,197,204,N/A,80,3
6,N/A,N/A,N/A,191,197,N/A,86,3
14,N/A,N/A,N/A,177,191,N/A,89,6
4,N/A,N/A,N/A,173,177,N/A,92,3
15,N/A,N/A,N/A,158,173,N/A,95,6
12,N/A,N/A,N/A,146,158,N/A,100,5
7,N/A,N/A,N/A,139,146,N/A,105,4
5,N/A,N/A,N/A,134,139,N/A,110,3
5,N/A,N/A,N/A,129,134,N/A,114,1
12,N/A,N/A,N/A,117,129,N/A,119,6
7,N/A,N/A,N/A,110,117,N/A,122,3
6,N/A,N/A,N/A,104,110,N/A,127,2
10,N/A,N/A,N/A,94,104,N/A,130,5
12,N/A,N/A,N/A,1610,1622,N/A,6,5
6,N/A,N/A,N/A,1604,1610,N/A,10,3
5,N/A,N/A,N/A,1599,1604,N/A,14,1
6,N/A,N/A,N/A,1593,1599,N/A,17,4
4,N/A,N/A,N/A,1589,1593,N/A,20,1
5,N/A,N/A,N/A,1584,1589,N/A,23,4
4,N/A,N/A,N/A,1580,1584,N/A,26,1
6,N/A,N/A,N/A,1574,1580,N/A,29,4
5,N/A,N/A,N/A,1569,1574,N/A,34,3
4,N/A,N/A,N/A,1565,1569,N/A,38,1
5,N/A,N/A,N/A,1560,1565,N/A,41,4
7,N/A,N/A,N/A,1553,1560,N/A,45,2
9,N/A,N/A,N/A,1544,1553,N/A,48,5
4,N/A,N/A,N/A,1540,1544,N/A,51,2
12,N/A,N/A,N/A,1528,1540,N/A,54,5
4,N/A,N/A,N/A,1524,1528,N/A,58,3
12,N/A,N/A,N/A,1512,1524,N/A,61,6
12,N/A,N/A,N/A,1500,1512,N/A,66,5
6,N/A,N/A,N/A,1494,1500,N/A,69,2
16,N/A,N/A,N/A,1478,1494,N/A,73,6
9,N/A,N/A,N/A,1469,1478,N/A,78,5
12,N/A,N/A,N/A,1457,1469,N/A,84,5
12,N/A,N/A,N/A,1445,1457,N/A,90,5
5,N/A,N/A,N/A,1440,1445,N/A,95,4
7,N/A,N/A,N/A,1433,1440,N/A,101,4
5,N/A,N/A,N/A,1428,1433,N/A,107,4
4,N/A,N/A,N/A,1424,1428,N/A,110,1
6,N/A,N/A,N/A,1418,1424,N/A,113,4
6,N/A,N/A,N/A,1412,1418,N/A,117,2
6,N/A,N/A,N/A,1406,1412,N/A,123,2
4,N/A,N/A,N/A,1096,1100,N/A,6,1
11,N/A,N/A,N/A,1085,1096,N/A,10,5
5,N/A,N/A,N/A,1080,1085,N/A,14,3
5,N/A,N/A,N/A,1075,1080,N/A,18,1
8,N/A,N/A,N/A,1067,1075,N/A,21,4
5,N/A,N/A,N/A,1062,1067,N/A,24,1
9,N/A,N/A,N/A,1053,1062,N/A,28,5
6,N/A,N/A,N/A,1047,1053,N/A,33,4
6,N/A,N/A,N/A,1041,1047,N/A,38,3
4,N/A,N/A,N/A,1037,1041,N/A,44,3
4,N/A,N/A,N/A,1033,1037,N/A,48,1
4,N/A,N/A,N/A,1029,1033,N/A,54,1
5,N/A,N/A,N/A,1024,1029,N/A,57,4
5,N/A,N/A,N/A,1019,1024,N/A,60,1
5,N/A,N/A,N/A,1014,1019,N/A,66,1
5,N/A,N/A,N/A,1009,1014,N/A,72,1
5,N/A,N/A,N/A,1004,1009,N/A,78,1
11,N/A,N/A,N/A,993,1004,N/A,83,6
8,N/A,N/A,N/A,985,993,N/A,87,4
5,N/A,N/A,N/A,980,985,N/A,92,3
4,N/A,N/A,N/A,976,980,N/A,96,1
7,N/A,N/A,N/A,969,976,N/A,99,4
6,N/A,N/A,N/A,963,969,N/A,105,4
6,N/A,N/A,N/A,957,963,N/A,110,3
11,N/A,N/A,N/A,946,957,N/A,113,6
7,N/A,N/A,N/A,939,946,N/A,117,4
7,N/A,N/A,N/A,932,939,N/A,121,2
5,N/A,N/A,N/A,927,932,N/A,126,1
9,N/A,N/A,N/A,918,927,N/A,130,5
5,N/A,N/A,N/A,913,918,N/A,133,2
11,N/A,N/A,N/A,1792,1803,N/A,5,5
9,N/A,N/A,N/A,1783,1792,N/A,11,5
5,N/A,N/A,N/A,1778,1783,N/A,15,3
7,N/A,N/A,N/A,1771,1778,N/A,20,2
11,N/A,N/A,N/A,1760,1771,N/A,24,6
10,N/A,N/A,N/A,1750,1760,N/A,29,5
7,N/A,N/A,N/A,1743,1750,N/A,33,3
4,N/A,N/A,N/A,1739,1743,N/A,39,3
7,N/A,N/A,N/A,1732,1739,N/A,44,2
4,N/A,N/A,N/A,1728,1732,N/A,49,1
10,N/A,N/A,N/A,1718,1728,N/A,54,6
12,N/A,N/A,N/A,1706,1718,N/A,59,5
7,N/A,N/A,N/A,1699,1706,N/A,63,3
19,N/A,N/A,N/A,1680,1699,N/A,66,6
4,N/A,N/A,N/A,1676,1680,N/A,72,0
7,N/A,N/A,N/A,1669,1676,N/A,76,4
7,N/A,N/A,N/A,1662,1669,N/A,81,3
5,N/A,N/A,N/A,1657,1662,N/A,85,1
7,N/A,N/A,N/A,1650,1657,N/A,88,4
5,N/A,N/A,N/A,1645,1650,N/A,94,4
6,N/A,N/A,N/A,1639,1645,N/A,99,3
4,N/A,N/A,N/A,1635,1639,N/A,105,3
5,N/A,N/A,N/A,1630,1635,N/A,111,3
6,N/A,N/A,N/A,1624,1630,N/A,116,2
9,N/A,N/A,N/A,1615,1624,N/A,119,5
5,N/A,N/A,N/A,1610,1615,N/A,124,4
6,N/A,N/A,N/A,1604,1610,N/A,129,3
4,N/A,N/A,N/A,1600,1604,N/A,134,2
12,N/A,N/A,N/A,1588,1600,N/A,137,5
7,N/A,N/A,N/A,1581,1588,N/A,142,4
7,N/A,N/A,N/A,1429,1436,N/A,3,4
7,N/A,N/A,N/A,1422,1429,N/A,9,4
6,N/A,N/A,N/A,1416,1422,N/A,14,3
4,N/A,N/A,N/A,1412,1416,N/A,18,1
6,N/A,N/A,N/A,1406,1412,N/A,21,4
7,N/A,N/A,N/A,1399,1406,N/A,25,2
4,N/A,N/A,N/A,1395,1399,N/A,30,1
8,N/A,N/A,N/A,1387,1395,N/A,33,4
6,N/A,N/A,N/A,1381,1387,N/A,39,4
6,N/A,N/A,N/A,1375,1381,N/A,44,3
4,N/A,N/A,N/A,1371,1375,N/A,48,1
9,N/A,N/A,N/A,1362,1371,N/A,52,5
12,N/A,N/A,N/A,1350,1362,N/A,58,5
7,N/A,N/A,N/A,1343,1350,N/A,61,2
5,N/A,N/A,N/A,1338,1343,N/A,67,2
19,N/A,N/A,N/A,1319,1338,N/A,71,6
4,N/A,N/A,N/A,1315,1319,N/A,77,0
5,N/A,N/A,N/A,1310,1315,N/A,80,3
4,N/A,N/A,N/A,1306,1310,N/A,84,1
4,N/A,N/A,N/A,1302,1306,N/A,90,1
10,N/A,N/A,N/A,1292,1302,N/A,94,5
6,N/A,N/A,N/A,1286,1292,N/A,99,4
4,N/A,N/A,N/A,1282,1286,N/A,103,2
4,N/A,N/A,N/A,1278,1282,N/A,108,1
5,N/A,N/A,N/A,1273,1278,N/A,114,1
4,N/A,N/A,N/A,1269,1273,N/A,120,1
4,N/A,N/A,N/A,1265,1269,N/A,126,1
4,N/A,N/A,N/A,1261,1265,N/A,132,1
4,N/A,N/A,N/A,1257,1261,N/A,138,1
4,N/A,N/A,N/A,1253,1257,N/A,144,1
4,N/A,N/A,N/A,484,488,N/A,5,2
10,N/A,N/A,N/A,474,484,N/A,8,5
12,N/A,N/A,N/A,462,474,N/A,14,5
7,N/A,N/A,N/A,455,462,N/A,18,3
5,N/A,N/A,N/A,450,455,N/A,22,1
11,N/A,N/A,N/A,439,450,N/A,26,5
9,N/A,N/A,N/A,430,439,N/A,32,5
10,N/A,N/A,N/A,420,430,N/A,38,5
8,N/A,N/A,N/A,412,420,N/A,43,4
6,N/A,N/A,N/A,406,412,N/A,49,4
4,N/A,N/A,N/A,402,406,N/A,52,1
5,N/A,N/A,N/A,397,402,N/A,58,1
8,N/A,N/A,N/A,389,397,N/A,61,4
5,N/A,N/A,N/A,384,389,N/A,66,3
4,N/A,N/A,N/A,380,384,N/A,70,1
10,N/A,N/A,N/A,370,380,N/A,74,5
10,N/A,N/A,N/A,360,370,N/A,80,5
4,N/A,N/A,N/A,356,360,N/A,83,2
11,N/A,N/A,N/A,345,356,N/A,87,6
5,N/A,N/A,N/A,340,345,N/A,90,3
5,N/A,N/A,N/A,335,340,N/A,94,1
14,N/A,N/A,N/A,321,335,N/A,99,6
10,N/A,N/A,N/A,311,321,N/A,104,5
6,N/A,N/A,N/A,305,311,N/A,107,2
4,N/A,N/A,N/A,301,305,N/A,112,1
13,N/A,N/A,N/A,288,301,N/A,117,6
6,N/A,N/A,N/A,282,288,N/A,121,4
4,N/A,N/A,N/A,278,282,N/A,126,3
4,N/A,N/A,N/A,274,278,N/A,130,1
4,N/A,N/A,N/A,270,274,N/A,136,1
7,N/A,N/A,N/A,563,570,N/A,4,4
6,N/A,N/A,N/A,557,563,N/A,9,3
6,N/A,N/A,N/A,551,557,N/A,15,3
7,N/A,N/A,N/A,544,551,N/A,20,2
5,N/A,N/A,N/A,539,544,N/A,26,2
7,N/A,N/A,N/A,532,539,N/A,32,2
5,N/A,N/A,N/A,527,532,N/A,37,1
11,N/A,N/A,N/A,516,527,N/A,42,6
4,N/A,N/A,N/A,512,516,N/A,45,3
4,N/A,N/A,N/A,508,512,N/A,49,1
5,N/A,N/A,N/A,503,508,N/A,55,1
10,N/A,N/A,N/A,493,503,N/A,60,6
4,N/A,N/A,N/A,489,493,N/A,66,0
9,N/A,N/A,N/A,480,489,N/A,71,5
6,N/A,N/A,N/A,474,480,N/A,75,3
11,N/A,N/A,N/A,463,474,N/A,78,6
11,N/A,N/A,N/A,452,463,N/A,83,5
10,N/A,N/A,N/A,442,452,N/A,89,5
5,N/A,N/A,N/A,437,442,N/A,93,3
7,N/A,N/A,N/A,430,437,N/A,99,3
6,N/A,N/A,N/A,424,430,N/A,105,3
5,N/A,N/A,N/A,419,424,N/A,109,1
7,N/A,N/A,N/A,412,419,N/A,112,4
6,N/A,N/A,N/A,406,412,N/A,116,2
4,N/A,N/A,N/A,402,406,N/A,121,1
5,N/A,N/A,N/A,397,402,N/A,127,1
4,N/A,N/A,N/A,393,397,N/A,133,1
6,N/A,N/A,N/A,387,393,N/A,136,4
5,N/A,N/A,N/A,382,387,N/A,139,1
5,N/A,N/A,N/A,377,382,N/A,145,1
5,N/A,N/A,N/A,1214,1219,N/A,5,1
6,N/A,N/A,N/A,1208,1214,N/A,8,4
5,N/A,N/A,N/A,1203,1208,N/A,11,1
5,N/A,N/A,N/A,1198,1203,N/A,17,1
11,N/A,N/A,N/A,1187,1198,N/A,21,5
5,N/A,N/A,N/A,1182,1187,N/A,25,3
16,N/A,N/A,N/A,1166,1182,N/A,28,6
9,N/A,N/A,N/A,1157,1166,N/A,33,5
7,N/A,N/A,N/A,1150,1157,N/A,38,4
4,N/A,N/A,N/A,1146,1150,N/A,41,1
14,N/A,N/A,N/A,1132,1146,N/A,46,6
4,N/A,N/A,N/A,1128,1132,N/A,49,3
6,N/A,N/A,N/A,1122,1128,N/A,55,3
5,N/A,N/A,N/A,1117,1122,N/A,60,2
5,N/A,N/A,N/A,1112,1117,N/A,65,1
8,N/A,N/A,N/A,1104,1112,N/A,68,4
4,N/A,N/A,N/A,1100,1104,N/A,72,2
4,N/A,N/A,N/A,1096,1100,N/A,78,2
4,N/A,N/A,N/A,1092,1096,N/A,83,1
14,N/A,N/A,N/A,1078,1092,N/A,88,6
4,N/A,N/A,N/A,1074,1078,N/A,94,0
11,N/A,N/A,N/A,1063,1074,N/A,99,5
6,N/A,N/A,N/A,1057,1063,N/A,103,3
4,N/A,N/A,N/A,1053,1057,N/A,107,1
8,N/A,N/A,N/A,1045,1053,N/A,110,4
7,N/A,N/A,N/A,1038,1045,N/A,116,4
4,N/A,N/A,N/A,1034,1038,N/A,119,1
11,N/A,N/A,N/A,1023,1034,N/A,123,5
6,N/A,N/A,N/A,1017,1023,N/A,126,2
19,N/A,N/A,N/A,998,1017,N/A,130,6
4,N/A,N/A,N/A,1445,1449,N/A,5,1
6,N/A,N/A,N/A,1439,1445,N/A,8,4
5,N/A,N/A,N/A,1434,1439,N/A,14,4
6,N/A,N/A,N/A,1428,1434,N/A,20,4
7,N/A,N/A,N/A,1421,1428,N/A,26,4
8,N/A,N/A,N/A,1413,1421,N/A,32,4
5,N/A,N/A,N/A,1408,1413,N/A,35,1
6,N/A,N/A,N/A,1402,1408,N/A,38,4
5,N/A,N/A,N/A,1397,1402,N/A,42,2
4,N/A,N/A,N/A,1393,1397,N/A,47,1
18,N/A,N/A,N/A,1375,1393,N/A,52,6
6,N/A,N/A,N/A,1369,1375,N/A,56,4
5,N/A,N/A,N/A,1364,1369,N/A,62,4
7,N/A,N/A,N/A,1357,1364,N/A,67,3
19,N/A,N/A,N/A,1338,1357,N/A,70,6
7,N/A,N/A,N/A,1331,1338,N/A,74,4
4,N/A,N/A,N/A,1327,1331,N/A,77,1
7,N/A,N/A,N/A,1320,1327,N/A,80,4
5,N/A,N/A,N/A,1315,1320,N/A,84,2
9,N/A,N/A,N/A,1306,1315,N/A,87,5
11,N/A,N/A,N/A,1295,1306,N/A,93,5
9,N/A,N/A,N/A,1286,1295,N/A,99,5
12,N/A,N/A,N/A,1274,1286,N/A,105,5
10,N/A,N/A,N/A,1264,1274,N/A,111,5
4,N/A,N/A,N/A,1260,1264,N/A,114,2
4,N/A,N/A,N/A,1256,1260,N/A,119,1
4,N/A,N/A,N/A,1252,1256,N/A,125,1
7,N/A,N/A,N/A,1245,1252,N/A,128,4
6,N/A,N/A,N/A,1239,1245,N/A,132,2
4,N/A,N/A,N/A,1235,1239,N/A,137,1
6,N/A,N/A,N/A,370,376,N/A,3,4
5,N/A,N/A,N/A,365,370,N/A,6,1
12,N/A,N/A,N/A,353,365,N/A,11,6
6,N/A,N/A,N/A,347,353,N/A,15,4
6,N/A,N/A,N/A,341,347,N/A,19,2
5,N/A,N/A,N/A,336,341,N/A,24,1
8,N/A,N/A,N/A,328,336,N/A,27,4
4,N/A,N/A,N/A,324,328,N/A,30,1
12,N/A,N/A,N/A,312,324,N/A,34,5
6,N/A,N/A,N/A,306,312,N/A,37,2
4,N/A,N/A,N/A,302,306,N/A,42,1
4,N/A,N/A,N/A,298,302,N/A,48,1
17,N/A,N/A,N/A,281,298,N/A,53,6
7,N/A,N/A,N/A,274,281,N/A,57,4
4,N/A,N/A,N/A,270,274,N/A,60,1
8,N/A,N/A,N/A,262,270,N/A,63,4
4,N/A,N/A,N/A,258,262,N/A,66,1
5,N/A,N/A,N/A,253,258,N/A,72,1
12,N/A,N/A,N/A,241,253,N/A,76,5
4,N/A,N/A,N/A,237,241,N/A,80,3
5,N/A,N/A,N/A,232,237,N/A,86,3
5,N/A,N/A,N/A,227,232,N/A,90,1
12,N/A,N/A,N/A,215,227,N/A,95,6
5,N/A,N/A,N/A,210,215,N/A,99,4
4,N/A,N/A,N/A,206,210,N/A,102,1
4,N/A,N/A,N/A,202,206,N/A,108,1
18,N/A,N/A,N/A,184,202,N/A,113,6
7,N/A,N/A,N/A,177,184,N/A,116,3
15,N/A,N/A,N/A,162,177,N/A,119,6
9,N/A,N/A,N/A,153,162,N/A,124,5
5,N/A,N/A,N/A,1312,1317,N/A,3,1
19,N/A,N/A,N/A,1293,1312,N/A,8,6
8,N/A,N/A,N/A,1285,1293,N/A,12,4
5,N/A,N/A,N/A,1280,1285,N/A,18,4
7,N/A,N/A,N/A,1273,1280,N/A,22,2
11,N/A,N/A,N/A,1262,1273,N/A,25,5
5,N/A,N/A,N/A,1257,1262,N/A,29,3
7,N/A,N/A,N/A,1250,1257,N/A,35,3
4,N/A,N/A,N/A,1246,1250,N/A,41,3
11,N/A,N/A,N/A,1235,1246,N/A,44,6
10,N/A,N/A,N/A,1225,1235,N/A,49,5
6,N/A,N/A,N/A,1219,1225,N/A,52,2
4,N/A,N/A,N/A,1215,1219,N/A,57,1
8,N/A,N/A,N/A,1207,1215,N/A,60,4
4,N/A,N/A,N/A,1203,1207,N/A,63,1
11,N/A,N/A,N/A,1192,1203,N/A,67,5
10,N/A,N/A,N/A,1182,1192,N/A,73,5
7,N/A,N/A,N/A,1175,1182,N/A,77,3
4,N/A,N/A,N/A,1171,1175,N/A,81,1
11,N/A,N/A,N/A,1160,1171,N/A,86,6
10,N/A,N/A,N/A,1150,1160,N/A,91,5
7,N/A,N/A,N/A,1143,1150,N/A,96,4
5,N/A,N/A,N/A,1138,1143,N/A,102,4
8,N/A,N/A,N/A,1130,1138,N/A,108,4
4,N/A,N/A,N/A,1126,1130,N/A,113,3
6,N/A,N/A,N/A,1120,1126,N/A,119,3
12,N/A,N/A,N/A,1108,1120,N/A,122,6
7,N/A,N/A,N/A,1101,1108,N/A,125,3
5,N/A,N/A,N/A,1096,1101,N/A,131,3
4,N/A,N/A,N/A,1092,1096,N/A,136,2
5,N/A,N/A,N/A,1807,1812,N/A,4,4
4,N/A,N/A,N/A,1803,1807,N/A,8,2
15,N/A,N/A,N/A,1788,1803,N/A,12,6
4,N/A,N/A,N/A,1784,1788,N/A,18,0
19,N/A,N/A,N/A,1765,1784,N/A,24,6
7,N/A,N/A,N/A,1758,1765,N/A,27,3
6,N/A,N/A,N/A,1752,1758,N/A,32,2
4,N/A,N/A,N/A,1748,1752,N/A,37,1
5,N/A,N/A,N/A,1743,1748,N/A,40,4
4,N/A,N/A,N/A,1739,1743,N/A,43,1
11,N/A,N/A,N/A,1728,1739,N/A,48,6
4,N/A,N/A,N/A,1724,1728,N/A,51,3
7,N/A,N/A,N/A,1717,1724,N/A,57,3
5,N/A,N/A,N/A,1712,1717,N/A,63,3
5,N/A,N/A,N/A,1707,1712,N/A,67,1
7,N/A,N/A,N/A,1700,1707,N/A,70,4
7,N/A,N/A,N/A,1693,1700,N/A,75,3
5,N/A,N/A,N/A,1688,1693,N/A,81,3
11,N/A,N/A,N/A,1677,1688,N/A,84,6
5,N/A,N/A,N/A,1672,1677,N/A,90,0
7,N/A,N/A,N/A,1665,1672,N/A,93,3
12,N/A,N/A,N/A,1653,1665,N/A,96,6
5,N/A,N/A,N/A,1648,1653,N/A,102,0
9,N/A,N/A,N/A,1639,1648,N/A,107,5
5,N/A,N/A,N/A,1634,1639,N/A,111,3
6,N/A,N/A,N/A,1628,1634,N/A,117,3
5,N/A,N/A,N/A,1623,1628,N/A,122,2
14,N/A,N/A,N/A,1609,1623,N/A,126,6
11,N/A,N/A,N/A,1598,1609,N/A,131,5
5,N/A,N/A,N/A,1593,1598,N/A,135,3
5,N/A,N/A,N/A,483,488,N/A,6,1
4,N/A,N/A,N/A,479,483,N/A,12,1
6,N/A,N/A,N/A,473,479,N/A,15,4
7,N/A,N/A,N/A,466,473,N/A,19,2
10,N/A,N/A,N/A,456,466,N/A,22,5
5,N/A,N/A,N/A,451,456,N/A,26,3
5,N/A,N/A,N/A,446,451,N/A,30,1
6,N/A,N/A,N/A,440,446,N/A,33,4
6,N/A,N/A,N/A,434,440,N/A,37,2
6,N/A,N/A,N/A,428,434,N/A,43,2
12,N/A,N/A,N/A,416,428,N/A,47,6
5,N/A,N/A,N/A,411,416,N/A,51,4
8,N/A,N/A,N/A,403,411,N/A,57,4
5,N/A,N/A,N/A,398,403,N/A,60,1
19,N/A,N/A,N/A,379,398,N/A,65,6
5,N/A,N/A,N/A,374,379,N/A,71,0
12,N/A,N/A,N/A,362,374,N/A,76,5
10,N/A,N/A,N/A,352,362,N/A,82,5
4,N/A,N/A,N/A,348,352,N/A,85,2
10,N/A,N/A,N/A,338,348,N/A,89,6
10,N/A,N/A,N/A,328,338,N/A,94,5
5,N/A,N/A,N/A,323,328,N/A,98,3
12,N/A,N/A,N/A,311,323,N/A,101,6
4,N/A,N/A,N/A,307,311,N/A,107,0
9,N/A,N/A,N/A,298,307,N/A,112,5
4,N/A,N/A,N/A,294,298,N/A,115,2
11,N/A,N/A,N/A,283,294,N/A,119,6
12,N/A,N/A,N/A,271,283,N/A,124,5
4,N/A,N/A,N/A,267,271,N/A,127,2
4,N/A,N/A,N/A,263,267,N/A,132,1
18,N/A,N/A,N/A,1688,1706,N/A,6,6
5,N/A,N/A,N/A,1683,1688,N/A,12,0
11,N/A,N/A,N/A,1672,1683,N/A,17,5
6,N/A,N/A,N/A,1666,1672,N/A,20,2
4,N/A,N/A,N/A,1662,1666,N/A,26,2
4,N/A,N/A,N/A,1658,1662,N/A,32,2
7,N/A,N/A,N/A,1651,1658,N/A,38,2
10,N/A,N/A,N/A,1641,1651,N/A,42,6
7,N/A,N/A,N/A,1634,1641,N/A,46,4
7,N/A,N/A,N/A,1627,1634,N/A,50,2
12,N/A,N/A,N/A,1615,1627,N/A,53,5
7,N/A,N/A,N/A,1608,1615,N/A,57,3
4,N/A,N/A,N/A,1604,1608,N/A,61,1
9,N/A,N/A,N/A,1595,1604,N/A,65,5
7,N/A,N/A,N/A,1588,1595,N/A,69,3
5,N/A,N/A,N/A,1583,1588,N/A,74,2
7,N/A,N/A,N/A,1576,1583,N/A,80,2
15,N/A,N/A,N/A,1561,1576,N/A,84,6
6,N/A,N/A,N/A,1555,1561,N/A,87,3
18,N/A,N/A,N/A,1537,1555,N/A,90,6
5,N/A,N/A,N/A,1532,1537,N/A,96,0
6,N/A,N/A,N/A,1526,1532,N/A,100,4
5,N/A,N/A,N/A,1521,1526,N/A,106,4
8,N/A,N/A,N/A,1513,1521,N/A,112,4
4,N/A,N/A,N/A,1509,1513,N/A,117,3
18,N/A,N/A,N/A,1491,1509,N/A,120,6
10,N/A,N/A,N/A,1481,1491,N/A,125,5
9,N/A,N/A,N/A,1472,1481,N/A,131,5
4,N/A,N/A,N/A,1468,1472,N/A,134,2
5,N/A,N/A,N/A,1463,1468,N/A,140,2
4,N/A,N/A,N/A,1904,1908,N/A,6,1
6,N/A,N/A,N/A,1898,1904,N/A,9,4
4,N/A,N/A,N/A,1894,1898,N/A,13,2
4,N/A,N/A,N/A,1890,1894,N/A,19,2
9,N/A,N/A,N/A,1881,1890,N/A,22,5
6,N/A,N/A,N/A,1875,1881,N/A,27,4
5,N/A,N/A,N/A,1870,1875,N/A,30,1
9,N/A,N/A,N/A,1861,1870,N/A,34,5
10,N/A,N/A,N/A,1851,1861,N/A,40,5
6,N/A,N/A,N/A,1845,1851,N/A,44,3
5,N/A,N/A,N/A,1840,1845,N/A,48,1
17,N/A,N/A,N/A,1823,1840,N/A,53,6
4,N/A,N/A,N/A,1819,1823,N/A,56,3
5,N/A,N/A,N/A,1814,1819,N/A,62,3
5,N/A,N/A,N/A,1809,1814,N/A,66,1
10,N/A,N/A,N/A,1799,1809,N/A,70,5
10,N/A,N/A,N/A,1789,1799,N/A,76,5
8,N/A,N/A,N/A,1781,1789,N/A,81,4
4,N/A,N/A,N/A,1777,1781,N/A,85,2
13,N/A,N/A,N/A,1764,1777,N/A,89,6
7,N/A,N/A,N/A,1757,1764,N/A,92,3
4,N/A,N/A,N/A,1753,1757,N/A,97,2
4,N/A,N/A,N/A,1749,1753,N/A,103,2
12,N/A,N/A,N/A,1737,1749,N/A,106,5
6,N/A,N/A,N/A,1731,1737,N/A,111,4
5,N/A,N/A,N/A,1726,1731,N/A,117,4
7,N/A,N/A,N/A,1719,1726,N/A,123,4
6,N/A,N/A,N/A,1713,1719,N/A,129,4
5,N/A,N/A,N/A,1708,1713,N/A,133,2
9,N/A,N/A,N/A,1699,1708,N/A,136,5
7,N/A,N/A,N/A,1186,1193,N/A,3,4
6,N/A,N/A,N/A,1180,1186,N/A,7,2
12,N/A,N/A,N/A,1168,1180,N/A,11,6
10,N/A,N/A,N/A,1158,1168,N/A,16,5
9,N/A,N/A,N/A,1149,1158,N/A,22,5
10,N/A,N/A,N/A,1139,1149,N/A,28,5
6,N/A,N/A,N/A,1133,1139,N/A,31,2
12,N/A,N/A,N/A,1121,1133,N/A,34,5
6,N/A,N/A,N/A,1115,1121,N/A,37,2
10,N/A,N/A,N/A,1105,1115,N/A,40,5
5,N/A,N/A,N/A,1100,1105,N/A,44,3
4,N/A,N/A,N/A,1096,1100,N/A,50,3
4,N/A,N/A,N/A,1092,1096,N/A,54,1
13,N/A,N/A,N/A,1079,1092,N/A,59,6
4,N/A,N/A,N/A,1075,1079,N/A,62,3
4,N/A,N/A,N/A,1071,1075,N/A,66,1
5,N/A,N/A,N/A,1066,1071,N/A,72,1
16,N/A,N/A,N/A,1050,1066,N/A,77,6
5,N/A,N/A,N/A,1045,1050,N/A,80,3
4,N/A,N/A,N/A,1041,1045,N/A,85,2
11,N/A,N/A,N/A,1030,1041,N/A,88,5
5,N/A,N/A,N/A,1025,1030,N/A,92,3
4,N/A,N/A,N/A,1021,1025,N/A,96,1
12,N/A,N/A,N/A,1009,1021,N/A,101,6
12,N/A,N/A,N/A,997,1009,N/A,106,5
11,N/A,N/A,N/A,986,997,N/A,112,5
5,N/A,N/A,N/A,981,986,N/A,117,4
4,N/A,N/A,N/A,977,981,N/A,121,2
11,N/A,N/A,N/A,966,977,N/A,125,6
4,N/A,N/A,N/A,962,966,N/A,131,0
5,N/A,N/A,N/A,1689,1694,N/A,3,1
11,N/A,N/A,N/A,1678,1689,N/A,7,5
6,N/A,N/A,N/A,1672,1678,N/A,11,3
19,N/A,N/A,N/A,1653,1672,N/A,14,6
8,N/A,N/A,N/A,1645,1653,N/A,18,4
7,N/A,N/A,N/A,1638,1645,N/A,23,3
17,N/A,N/A,N/A,1621,1638,N/A,26,6
5,N/A,N/A,N/A,1616,1621,N/A,32,0
6,N/A,N/A,N/A,1610,1616,N/A,35,3
5,N/A,N/A,N/A,1605,1610,N/A,40,2
17,N/A,N/A,N/A,1588,1605,N/A,44,6
6,N/A,N/A,N/A,1582,1588,N/A,47,3
7,N/A,N/A,N/A,1575,1582,N/A,53,3
17,N/A,N/A,N/A,1558,1575,N/A,56,6
6,N/A,N/A,N/A,1552,1558,N/A,60,4
7,N/A,N/A,N/A,1545,1552,N/A,64,2
10,N/A,N/A,N/A,1535,1545,N/A,68,6
5,N/A,N/A,N/A,1530,1535,N/A,72,4
5,N/A,N/A,N/A,1525,1530,N/A,78,4
6,N/A,N/A,N/A,1519,1525,N/A,83,3
4,N/A,N/A,N/A,1515,1519,N/A,87,1
8,N/A,N/A,N/A,1507,1515,N/A,90,4
7,N/A,N/A,N/A,1500,1507,N/A,96,4
7,N/A,N/A,N/A,1493,1500,N/A,101,3
5,N/A,N/A,N/A,1488,1493,N/A,107,3
11,N/A,N/A,N/A,1477,1488,N/A,110,6
9,N/A,N/A,N/A,1468,1477,N/A,115,5
5,N/A,N/A,N/A,1463,1468,N/A,120,4
7,N/A,N/A,N/A,1456,1463,N/A,124,2
7,N/A,N/A,N/A,1449,1456,N/A,130,2
5,N/A,N/A,N/A,1071,1076,N/A,5,3
17,N/A,N/A,N/A,1054,1071,N/A,8,6
5,N/A,N/A,N/A,1049,1054,N/A,14,0
11,N/A,N/A,N/A,1038,1049,N/A,19,5
5,N/A,N/A,N/A,1033,1038,N/A,22,2
14,N/A,N/A,N/A,1019,1033,N/A,26,6
5,N/A,N/A,N/A,1014,1019,N/A,29,3
5,N/A,N/A,N/A,1009,1014,N/A,35,3
6,N/A,N/A,N/A,1003,1009,N/A,41,3
4,N/A,N/A,N/A,999,1003,N/A,45,1
4,N/A,N/A,N/A,995,999,N/A,51,1
11,N/A,N/A,N/A,984,995,N/A,55,5
5,N/A,N/A,N/A,979,984,N/A,58,2
12,N/A,N/A,N/A,967,979,N/A,62,6
4,N/A,N/A,N/A,963,967,N/A,68,0
12,N/A,N/A,N/A,951,963,N/A,74,6
7,N/A,N/A,N/A,944,951,N/A,77,3
4,N/A,N/A,N/A,940,944,N/A,82,2
12,N/A,N/A,N/A,928,940,N/A,85,5
7,N/A,N/A,N/A,921,928,N/A,88,2
11,N/A,N/A,N/A,910,921,N/A,92,6
5,N/A,N/A,N/A,905,910,N/A,96,4
4,N/A,N/A,N/A,901,905,N/A,99,1
13,N/A,N/A,N/A,888,901,N/A,104,6
5,N/A,N/A,N/A,883,888,N/A,108,4
6,N/A,N/A,N/A,877,883,N/A,114,4
4,N/A,N/A,N/A,873,877,N/A,118,2
4,N/A,N/A,N/A,869,873,N/A,123,1
11,N/A,N/A,N/A,858,869,N/A,127,5
10,N/A,N/A,N/A,848,858,N/A,133,5
4,N/A,N/A,N/A,1163,1167,N/A,3,3
6,N/A,N/A,N/A,1157,1163,N/A,9,3
5,N/A,N/A,N/A,1152,1157,N/A,15,3
5,N/A,N/A,N/A,1147,1152,N/A,19,1
5,N/A,N/A,N/A,1142,1147,N/A,25,1
12,N/A,N/A,N/A,1130,1142,N/A,30,6
9,N/A,N/A,N/A,1121,1130,N/A,35,5
6,N/A,N/A,N/A,1115,1121,N/A,39,3
18,N/A,N/A,N/A,1097,1115,N/A,42,6
12,N/A,N/A,N/A,1085,1097,N/A,47,5
11,N/A,N/A,N/A,1074,1085,N/A,53,5
12,N/A,N/A,N/A,1062,1074,N/A,59,5
7,N/A,N/A,N/A,1055,1062,N/A,62,2
4,N/A,N/A,N/A,1051,1055,N/A,67,1
4,N/A,N/A,N/A,1047,1051,N/A,73,1
13,N/A,N/A,N/A,1034,1047,N/A,78,6
7,N/A,N/A,N/A,1027,1034,N/A,82,4
5,N/A,N/A,N/A,1022,1027,N/A,86,2
9,N/A,N/A,N/A,1013,1022,N/A,89,5
6,N/A,N/A,N/A,1007,1013,N/A,92,2
19,N/A,N/A,N/A,988,1007,N/A,96,6
4,N/A,N/A,N/A,984,988,N/A,99,3
7,N/A,N/A,N/A,977,984,N/A,104,2
5,N/A,N/A,N/A,972,977,N/A,109,1
11,N/A,N/A,N/A,961,972,N/A,113,5
6,N/A,N/A,N/A,955,961,N/A,117,3
16,N/A,N/A,N/A,939,955,N/A,120,6
6,N/A,N/A,N/A,933,939,N/A,124,4
7,N/A,N/A,N/A,926,933,N/A,130,4
5,N/A,N/A,N/A,921,926,N/A,136,4
15,N/A,N/A,N/A,1411,1426,N/A,5,6
5,N/A,N/A,N/A,1406,1411,N/A,11,0
5,N/A,N/A,N/A,1401,1406,N/A,15,4
6,N/A,N/A,N/A,1395,1401,N/A,21,4
5,N/A,N/A,N/A,1390,1395,N/A,25,2
5,N/A,N/A,N/A,1385,1390,N/A,30,1
10,N/A,N/A,N/A,1375,1385,N/A,34,5
7,N/A,N/A,N/A,1368,1375,N/A,39,4
7,N/A,N/A,N/A,1361,1368,N/A,43,2
12,N/A,N/A,N/A,1349,1361,N/A,46,5
5,N/A,N/A,N/A,1344,1349,N/A,50,3
5,N/A,N/A,N/A,1339,1344,N/A,56,3
6,N/A,N/A,N/A,1333,1339,N/A,62,3
6,N/A,N/A,N/A,1327,1333,N/A,67,2
4,N/A,N/A,N/A,1323,1327,N/A,72,1
12,N/A,N/A,N/A,1311,1323,N/A,77,6
10,N/A,N/A,N/A,1301,1311,N/A,82,5
8,N/A,N/A,N/A,1293,1301,N/A,87,4
6,N/A,N/A,N/A,1287,1293,N/A,92,3
4,N/A,N/A,N/A,1283,1287,N/A,97,2
4,N/A,N/A,N/A,1279,1283,N/A,102,1
9,N/A,N/A,N/A,1270,1279,N/A,106,5
8,N/A,N/A,N/A,1262,1270,N/A,111,4
6,N/A,N/A,N/A,1256,1262,N/A,116,3
7,N/A,N/A,N/A,1249,1256,N/A,122,3
5,N/A,N/A,N/A,1244,1249,N/A,127,2
18,N/A,N/A,N/A,1226,1244,N/A,131,6
10,N/A,N/A,N/A,1216,1226,N/A,136,5
5,N/A,N/A,N/A,1211,1216,N/A,141,4
4,N/A,N/A,N/A,1207,1211,N/A,145,2
5,N/A,N/A,N/A,1235,1240,N/A,5,1
5,N/A,N/A,N/A,1230,1235,N/A,11,1
12,N/A,N/A,N/A,1218,1230,N/A,15,5
12,N/A,N/A,N/A,1206,1218,N/A,21,5
5,N/A,N/A,N/A,1201,1206,N/A,25,3
5,N/A,N/A,N/A,1196,1201,N/A,31,3
7,N/A,N/A,N/A,1189,1196,N/A,36,2
4,N/A,N/A,N/A,1185,1189,N/A,41,1
7,N/A,N/A,N/A,1178,1185,N/A,44,4
6,N/A,N/A,N/A,1172,1178,N/A,49,3
10,N/A,N/A,N/A,1162,1172,N/A,52,6
6,N/A,N/A,N/A,1156,1162,N/A,56,4
5,N/A,N/A,N/A,1151,1156,N/A,61,3
4,N/A,N/A,N/A,1147,1151,N/A,66,2
10,N/A,N/A,N/A,1137,1147,N/A,69,5
5,N/A,N/A,N/A,1132,1137,N/A,74,4
8,N/A,N/A,N/A,1124,1132,N/A,80,4
5,N/A,N/A,N/A,1119,1124,N/A,84,2
5,N/A,N/A,N/A,1114,1119,N/A,89,1
10,N/A,N/A,N/A,1104,1114,N/A,93,5
8,N/A,N/A,N/A,1096,1104,N/A,98,4
6,N/A,N/A,N/A,1090,1096,N/A,104,4
6,N/A,N/A,N/A,1084,1090,N/A,110,4
6,N/A,N/A,N/A,1078,1084,N/A,116,4
5,N/A,N/A,N/A,1073,1078,N/A,120,2
6,N/A,N/A,N/A,1067,1073,N/A,126,2
7,N/A,N/A,N/A,1060,1067,N/A,132,2
7,N/A,N/A,N/A,1053,1060,N/A,138,2
4,N/A,N/A,N/A,1049,1053,N/A,144,2
11,N/A,N/A,N/A,1038,1049,N/A,147,5
11,N/A,N/A,N/A,842,853,N/A,4,5
11,N/A,N/A,N/A,831,842,N/A,10,5
7,N/A,N/A,N/A,824,831,N/A,14,3
4,N/A,N/A,N/A,820,824,N/A,18,1
6,N/A,N/A,N/A,814,820,N/A,21,4
8,N/A,N/A,N/A,806,814,N/A,27,4
7,N/A,N/A,N/A,799,806,N/A,33,4
4,N/A,N/A,N/A,795,799,N/A,36,1
13,N/A,N/A,N/A,782,795,N/A,41,6
6,N/A,N/A,N/A,776,782,N/A,45,4
7,N/A,N/A,N/A,769,776,N/A,49,2
10,N/A,N/A,N/A,759,769,N/A,52,5
12,N/A,N/A,N/A,747,759,N/A,58,5
5,N/A,N/A,N/A,742,747,N/A,62,3
15,N/A,N/A,N/A,727,742,N/A,65,6
7,N/A,N/A,N/A,720,727,N/A,68,3
15,N/A,N/A,N/A,705,720,N/A,71,6
10,N/A,N/A,N/A,695,705,N/A,76,5
11,N/A,N/A,N/A,684,695,N/A,82,5
7,N/A,N/A,N/A,677,684,N/A,87,4
4,N/A,N/A,N/A,673,677,N/A,92,3
4,N/A,N/A,N/A,669,673,N/A,98,3
13,N/A,N/A,N/A,656,669,N/A,101,6
7,N/A,N/A,N/A,649,656,N/A,105,4
5,N/A,N/A,N/A,644,649,N/A,108,1
8,N/A,N/A,N/A,636,644,N/A,111,4
6,N/A,N/A,N/A,630,636,N/A,115,2
5,N/A,N/A,N/A,625,630,N/A,120,1
15,N/A,N/A,N/A,610,625,N/A,125,6
10,N/A,N/A,N/A,600,610,N/A,130,5
5,N/A,N/A,N/A,562,567,N/A,5,2
6,N/A,N/A,N/A,556,562,N/A,11,2
5,N/A,N/A,N/A,551,556,N/A,17,2
4,N/A,N/A,N/A,547,551,N/A,23,2
12,N/A,N/A,N/A,535,547,N/A,26,5
6,N/A,N/A,N/A,529,535,N/A,30,3
4,N/A,N/A,N/A,525,529,N/A,34,1
4,N/A,N/A,N/A,521,525,N/A,40,1
16,N/A,N/A,N/A,505,521,N/A,45,6
4,N/A,N/A,N/A,501,505,N/A,48,3
6,N/A,N/A,N/A,495,501,N/A,54,3
5,N/A,N/A,N/A,490,495,N/A,60,3
15,N/A,N/A,N/A,475,490,N/A,63,6
12,N/A,N/A,N/A,463,475,N/A,68,5
4,N/A,N/A,N/A,459,463,N/A,72,3
16,N/A,N/A,N/A,443,459,N/A,75,6
8,N/A,N/A,N/A,435,443,N/A,79,4
6,N/A,N/A,N/A,429,435,N/A,85,4
4,N/A,N/A,N/A,425,429,N/A,88,1
9,N/A,N/A,N/A,416,425,N/A,92,5
7,N/A,N/A,N/A,409,416,N/A,97,4
5,N/A,N/A,N/A,404,409,N/A,101,2
11,N/A,N/A,N/A,393,404,N/A,104,5
4,N/A,N/A,N/A,389,393,N/A,107,2
7,N/A,N/A,N/A,382,389,N/A,113,2
6,N/A,N/A,N/A,376,382,N/A,119,2
7,N/A,N/A,N/A,369,376,N/A,125,2
17,N/A,N/A,N/A,352,369,N/A,129,6
7,N/A,N/A,N/A,345,352,N/A,133,4
4,N/A,N/A,N/A,341,345,N/A,136,1
5,N/A,N/A,N/A,1733,1738,N/A,3,4
7,N/A,N/A,N/A,1726,1733,N/A,9,4
6,N/A,N/A,N/A,1720,1726,N/A,14,3
5,N/A,N/A,N/A,1715,1720,N/A,20,3
7,N/A,N/A,N/A,1708,1715,N/A,25,2
4,N/A,N/A,N/A,1704,1708,N/A,30,1
7,N/A,N/A,N/A,1697,1704,N/A,33,4
5,N/A,N/A,N/A,1692,1697,N/A,39,4
5,N/A,N/A,N/A,1687,1692,N/A,45,4
4,N/A,N/A,N/A,1683,1687,N/A,49,2
4,N/A,N/A,N/A,1679,1683,N/A,54,1
19,N/A,N/A,N/A,1660,1679,N/A,59,6
5,N/A,N/A,N/A,1655,1660,N/A,65,0
7,N/A,N/A,N/A,1648,1655,N/A,69,4
7,N/A,N/A,N/A,1641,1648,N/A,74,3
4,N/A,N/A,N/A,1637,1641,N/A,78,1
17,N/A,N/A,N/A,1620,1637,N/A,83,6
7,N/A,N/A,N/A,1613,1620,N/A,87,4
7,N/A,N/A,N/A,1606,1613,N/A,91,2
11,N/A,N/A,N/A,1595,1606,N/A,94,5
4,N/A,N/A,N/A,1591,1595,N/A,98,3
4,N/A,N/A,N/A,1587,1591,N/A,104,3
16,N/A,N/A,N/A,1571,1587,N/A,107,6
12,N/A,N/A,N/A,1559,1571,N/A,112,5
12,N/A,N/A,N/A,1547,1559,N/A,118,5
7,N/A,N/A,N/A,1540,1547,N/A,122,3
4,N/A,N/A,N/A,1536,1540,N/A,128,3
4,N/A,N/A,N/A,1532,1536,N/A,133,2
12,N/A,N/A,N/A,1520,1532,N/A,136,5
6,N/A,N/A,N/A,1514,1520,N/A,139,2
5,N/A,N/A,N/A,1749,1754,N/A,3,1
11,N/A,N/A,N/A,1738,1749,N/A,7,5
5,N/A,N/A,N/A,1733,1738,N/A,11,3
4,N/A,N/A,N/A,1729,1733,N/A,15,1
5,N/A,N/A,N/A,1724,1729,N/A,18,4
4,N/A,N/A,N/A,1720,1724,N/A,21,1
5,N/A,N/A,N/A,1715,1720,N/A,24,4
6,N/A,N/A,N/A,1709,1715,N/A,29,3
6,N/A,N/A,N/A,1703,1709,N/A,34,2
10,N/A,N/A,N/A,1693,1703,N/A,38,6
12,N/A,N/A,N/A,1681,1693,N/A,43,5
7,N/A,N/A,N/A,1674,1681,N/A,48,4
7,N/A,N/A,N/A,1667,1674,N/A,53,3
7,N/A,N/A,N/A,1660,1667,N/A,58,2
4,N/A,N/A,N/A,1656,1660,N/A,64,2
4,N/A,N/A,N/A,1652,1656,N/A,69,1
11,N/A,N/A,N/A,1641,1652,N/A,73,5
7,N/A,N/A,N/A,1634,1641,N/A,78,4
8,N/A,N/A,N/A,1626,1634,N/A,84,4
6,N/A,N/A,N/A,1620,1626,N/A,88,2
4,N/A,N/A,N/A,1616,1620,N/A,93,1
10,N/A,N/A,N/A,1606,1616,N/A,97,5
6,N/A,N/A,N/A,1600,1606,N/A,100,2
12,N/A,N/A,N/A,1588,1600,N/A,103,5
6,N/A,N/A,N/A,1582,1588,N/A,108,4
4,N/A,N/A,N/A,1578,1582,N/A,113,3
4,N/A,N/A,N/A,1574,1578,N/A,118,2
10,N/A,N/A,N/A,1564,1574,N/A,121,5
6,N/A,N/A,N/A,1558,1564,N/A,126,4
5,N/A,N/A,N/A,1553,1558,N/A,130,2
5,N/A,N/A,N/A,805,810,N/A,6,1
6,N/A,N/A,N/A,799,805,N/A,9,4
7,N/A,N/A,N/A,792,799,N/A,15,4
8,N/A,N/A,N/A,784,792,N/A,21,4
4,N/A,N/A,N/A,780,784,N/A,24,1
6,N/A,N/A,N/A,774,780,N/A,27,4
4,N/A,N/A,N/A,770,774,N/A,31,2
5,N/A,N/A,N/A,765,770,N/A,36,1
11,N/A,N/A,N/A,754,765,N/A,40,5
7,N/A,N/A,N/A,747,754,N/A,44,3
4,N/A,N/A,N/A,743,747,N/A,49,2
4,N/A,N/A,N/A,739,743,N/A,54,1
9,N/A,N/A,N/A,730,739,N/A,58,5
7,N/A,N/A,N/A,723,730,N/A,61,2
5,N/A,N/A,N/A,718,723,N/A,67,2
19,N/A,N/A,N/A,699,718,N/A,71,6
5,N/A,N/A,N/A,694,699,N/A,77,0
9,N/A,N/A,N/A,685,694,N/A,82,5
12,N/A,N/A,N/A,673,685,N/A,88,5
4,N/A,N/A,N/A,669,673,N/A,92,3
6,N/A,N/A,N/A,663,669,N/A,98,3
7,N/A,N/A,N/A,656,663,N/A,104,3
14,N/A,N/A,N/A,642,656,N/A,107,6
11,N/A,N/A,N/A,631,642,N/A,112,5
4,N/A,N/A,N/A,627,631,N/A,115,2
10,N/A,N/A,N/A,617,627,N/A,119,6
7,N/A,N/A,N/A,610,617,N/A,122,3
4,N/A,N/A,N/A,606,610,N/A,127,2
10,N/A,N/A,N/A,596,606,N/A,131,6
4,N/A,N/A,N/A,592,596,N/A,137,0
7,N/A,N/A,N/A,1161,1168,N/A,5,2
6,N/A,N/A,N/A,1155,1161,N/A,11,2
7,N/A,N/A,N/A,1148,1155,N/A,17,2
5,N/A,N/A,N/A,1143,1148,N/A,22,1
9,N/A,N/A,N/A,1134,1143,N/A,26,5
4,N/A,N/A,N/A,1130,1134,N/A,29,2
5,N/A,N/A,N/A,1125,1130,N/A,34,1
8,N/A,N/A,N/A,1117,1125,N/A,37,4
4,N/A,N/A,N/A,1113,1117,N/A,40,1
5,N/A,N/A,N/A,1108,1113,N/A,43,4
6,N/A,N/A,N/A,1102,1108,N/A,49,4
5,N/A,N/A,N/A,1097,1102,N/A,52,1
9,N/A,N/A,N/A,1088,1097,N/A,56,5
7,N/A,N/A,N/A,1081,1088,N/A,60,3
7,N/A,N/A,N/A,1074,1081,N/A,65,2
4,N/A,N/A,N/A,1070,1074,N/A,70,1
4,N/A,N/A,N/A,1066,1070,N/A,76,1
9,N/A,N/A,N/A,1057,1066,N/A,80,5
7,N/A,N/A,N/A,1050,1057,N/A,85,4
6,N/A,N/A,N/A,1044,1050,N/A,91,4
6,N/A,N/A,N/A,1038,1044,N/A,95,2
5,N/A,N/A,N/A,1033,1038,N/A,101,2
12,N/A,N/A,N/A,1021,1033,N/A,104,5
8,N/A,N/A,N/A,1013,1021,N/A,109,4
7,N/A,N/A,N/A,1006,1013,N/A,115,4
6,N/A,N/A,N/A,1000,1006,N/A,121,4
7,N/A,N/A,N/A,993,1000,N/A,125,2
7,N/A,N/A,N/A,986,993,N/A,131,2
4,N/A,N/A,N/A,982,986,N/A,136,1
4,N/A,N/A,N/A,978,982,N/A,142,1
4,N/A,N/A,N/A,1972,1976,N/A,3,3
5,N/A,N/A,N/A,1967,1972,N/A,8,2
6,N/A,N/A,N/A,1961,1967,N/A,14,2
12,N/A,N/A,N/A,1949,1961,N/A,17,5
5,N/A,N/A,N/A,1944,1949,N/A,21,3
12,N/A,N/A,N/A,1932,1944,N/A,24,6
6,N/A,N/A,N/A,1926,1932,N/A,28,4
5,N/A,N/A,N/A,1921,1926,N/A,32,2
18,N/A,N/A,N/A,1903,1921,N/A,36,6
6,N/A,N/A,N/A,1897,1903,N/A,39,3
5,N/A,N/A,N/A,1892,1897,N/A,44,2
10,N/A,N/A,N/A,1882,1892,N/A,47,5
4,N/A,N/A,N/A,1878,1882,N/A,51,3
7,N/A,N/A,N/A,1871,1878,N/A,56,2
5,N/A,N/A,N/A,1866,1871,N/A,61,1
16,N/A,N/A,N/A,1850,1866,N/A,66,6
4,N/A,N/A,N/A,1846,1850,N/A,72,0
12,N/A,N/A,N/A,1834,1846,N/A,77,5
7,N/A,N/A,N/A,1827,1834,N/A,81,3
4,N/A,N/A,N/A,1823,1827,N/A,87,3
4,N/A,N/A,N/A,1819,1823,N/A,91,1
16,N/A,N/A,N/A,1803,1819,N/A,96,6
6,N/A,N/A,N/A,1797,1803,N/A,100,4
7,N/A,N/A,N/A,1790,1797,N/A,106,4
4,N/A,N/A,N/A,1786,1790,N/A,110,2
5,N/A,N/A,N/A,1781,1786,N/A,115,1
18,N/A,N/A,N/A,1763,1781,N/A,120,6
4,N/A,N/A,N/A,1759,1763,N/A,123,3
14,N/A,N/A,N/A,1745,1759,N/A,126,6
11,N/A,N/A,N/A,1734,1745,N/A,131,5
6,N/A,N/A,N/A,956,962,N/A,4,4
6,N/A,N/A,N/A,950,956,N/A,10,4
4,N/A,N/A,N/A,946,950,N/A,13,1
7,N/A,N/A,N/A,939,946,N/A,16,4
7,N/A,N/A,N/A,932,939,N/A,21,3
5,N/A,N/A,N/A,927,932,N/A,25,1
4,N/A,N/A,N/A,923,927,N/A,31,1
9,N/A,N/A,N/A,914,923,N/A,35,5
5,N/A,N/A,N/A,909,914,N/A,38,2
9,N/A,N/A,N/A,900,909,N/A,41,5
5,N/A,N/A,N/A,895,900,N/A,46,4
5,N/A,N/A,N/A,890,895,N/A,52,4
5,N/A,N/A,N/A,885,890,N/A,57,3
4,N/A,N/A,N/A,881,885,N/A,61,1
11,N/A,N/A,N/A,870,881,N/A,66,6
7,N/A,N/A,N/A,863,870,N/A,69,3
4,N/A,N/A,N/A,859,863,N/A,73,1
7,N/A,N/A,N/A,852,859,N/A,76,4
4,N/A,N/A,N/A,848,852,N/A,79,1
15,N/A,N/A,N/A,833,848,N/A,84,6
4,N/A,N/A,N/A,829,833,N/A,90,0
11,N/A,N/A,N/A,818,829,N/A,95,5
6,N/A,N/A,N/A,812,818,N/A,100,4
7,N/A,N/A,N/A,805,812,N/A,106,4
4,N/A,N/A,N/A,801,805,N/A,109,1
12,N/A,N/A,N/A,789,801,N/A,113,5
9,N/A,N/A,N/A,780,789,N/A,119,5
12,N/A,N/A,N/A,768,780,N/A,125,5
4,N/A,N/A,N/A,764,768,N/A,129,3
5,N/A,N/A,N/A,759,764,N/A,133,1
6,N/A,N/A,N/A,1269,1275,N/A,5,3
19,N/A,N/A,N/A,1250,1269,N/A,8,6
8,N/A,N/A,N/A,1242,1250,N/A,12,4
4,N/A,N/A,N/A,1238,1242,N/A,15,1
11,N/A,N/A,N/A,1227,1238,N/A,20,6
9,N/A,N/A,N/A,1218,1227,N/A,25,5
7,N/A,N/A,N/A,1211,1218,N/A,30,4
4,N/A,N/A,N/A,1207,1211,N/A,34,2
5,N/A,N/A,N/A,1202,1207,N/A,39,1
13,N/A,N/A,N/A,1189,1202,N/A,44,6
11,N/A,N/A,N/A,1178,1189,N/A,49,5
4,N/A,N/A,N/A,1174,1178,N/A,53,3
4,N/A,N/A,N/A,1170,1174,N/A,57,1
19,N/A,N/A,N/A,1151,1170,N/A,62,6
5,N/A,N/A,N/A,1146,1151,N/A,66,4
8,N/A,N/A,N/A,1138,1146,N/A,72,4
5,N/A,N/A,N/A,1133,1138,N/A,78,4
6,N/A,N/A,N/A,1127,1133,N/A,82,2
9,N/A,N/A,N/A,1118,1127,N/A,85,5
6,N/A,N/A,N/A,1112,1118,N/A,88,2
7,N/A,N/A,N/A,1105,1112,N/A,94,2
17,N/A,N/A,N/A,1088,1105,N/A,98,6
4,N/A,N/A,N/A,1084,1088,N/A,104,0
9,N/A,N/A,N/A,1075,1084,N/A,109,5
11,N/A,N/A,N/A,1064,1075,N/A,115,5
7,N/A,N/A,N/A,1057,1064,N/A,119,3
4,N/A,N/A,N/A,1053,1057,N/A,123,1
10,N/A,N/A,N/A,1043,1053,N/A,127,5
7,N/A,N/A,N/A,1036,1043,N/A,130,2
16,N/A,N/A,N/A,1020,1036,N/A,134,6
12,N/A,N/A,N/A,1722,1734,N/A,5,5
5,N/A,N/A,N/A,1717,1722,N/A,10,4
5,N/A,N/A,N/A,1712,1717,N/A,15,3
11,N/A,N/A,N/A,1701,1712,N/A,18,6
7,N/A,N/A,N/A,1694,1701,N/A,22,4
4,N/A,N/A,N/A,1690,1694,N/A,25,1
11,N/A,N/A,N/A,1679,1690,N/A,29,5
10,N/A,N/A,N/A,1669,1679,N/A,35,5
6,N/A,N/A,N/A,1663,1669,N/A,38,2
6,N/A,N/A,N/A,1657,1663,N/A,44,2
6,N/A,N/A,N/A,1651,1657,N/A,50,2
12,N/A,N/A,N/A,1639,1651,N/A,53,5
11,N/A,N/A,N/A,1628,1639,N/A,59,5
11,N/A,N/A,N/A,1617,1628,N/A,65,5
6,N/A,N/A,N/A,1611,1617,N/A,68,2
5,N/A,N/A,N/A,1606,1611,N/A,73,1
4,N/A,N/A,N/A,1602,1606,N/A,79,1
12,N/A,N/A,N/A,1590,1602,N/A,84,6
11,N/A,N/A,N/A,1579,1590,N/A,89,5
6,N/A,N/A,N/A,1573,1579,N/A,93,3
7,N/A,N/A,N/A,1566,1573,N/A,98,2
14,N/A,N/A,N/A,1552,1566,N/A,102,6
6,N/A,N/A,N/A,1546,1552,N/A,106,4
4,N/A,N/A,N/A,1542,1546,N/A,109,1
4,N/A,N/A,N/A,1538,1542,N/A,115,1
8,N/A,N/A,N/A,1530,1538,N/A,118,4
5,N/A,N/A,N/A,1525,1530,N/A,122,2
5,N/A,N/A,N/A,1520,1525,N/A,128,2
4,N/A,N/A,N/A,1516,1520,N/A,134,2
6,N/A,N/A,N/A,1510,1516,N/A,140,2
11,N/A,N/A,N/A,1109,1120,N/A,6,5
4,N/A,N/A,N/A,1105,1109,N/A,9,2
6,N/A,N/A,N/A,1099,1105,N/A,15,2
5,N/A,N/A,N/A,1094,1099,N/A,20,1
11,N/A,N/A,N/A,1083,1094,N/A,24,5
5,N/A,N/A,N/A,1078,1083,N/A,27,2
10,N/A,N/A,N/A,1068,1078,N/A,30,5
9,N/A,N/A,N/A,1059,1068,N/A,36,5
11,N/A,N/A,N/A,1048,1059,N/A,42,5
9,N/A,N/A,N/A,1039,1048,N/A,48,5
10,N/A,N/A,N/A,1029,1039,N/A,54,5
8,N/A,N/A,N/A,1021,1029,N/A,59,4
6,N/A,N/A,N/A,1015,1021,N/A,63,2
5,N/A,N/A,N/A,1010,1015,N/A,68,1
5,N/A,N/A,N/A,1005,1010,N/A,74,1
4,N/A,N/A,N/A,1001,1005,N/A,80,1
4,N/A,N/A,N/A,997,1001,N/A,86,1
16,N/A,N/A,N/A,981,997,N/A,91,6
4,N/A,N/A,N/A,977,981,N/A,94,3
18,N/A,N/A,N/A,959,977,N/A,97,6
5,N/A,N/A,N/A,954,959,N/A,103,0
11,N/A,N/A,N/A,943,954,N/A,109,6
4,N/A,N/A,N/A,939,943,N/A,115,0
6,N/A,N/A,N/A,933,939,N/A,118,3
6,N/A,N/A,N/A,927,933,N/A,123,2
9,N/A,N/A,N/A,918,927,N/A,126,5
6,N/A,N/A,N/A,912,918,N/A,131,4
5,N/A,N/A,N/A,907,912,N/A,136,3
7,N/A,N/A,N/A,900,907,N/A,141,2
12,N/A,N/A,N/A,888,900,N/A,145,6
12,N/A,N/A,N/A,674,686,N/A,4,5
6,N/A,N/A,N/A,668,674,N/A,8,3
4,N/A,N/A,N/A,664,668,N/A,12,1
5,N/A,N/A,N/A,659,664,N/A,18,1
7,N/A,N/A,N/A,652,659,N/A,21,4
4,N/A,N/A,N/A,648,652,N/A,24,1
6,N/A,N/A,N/A,642,648,N/A,27,4
6,N/A,N/A,N/A,636,642,N/A,32,3
4,N/A,N/A,N/A,632,636,N/A,37,2
5,N/A,N/A,N/A,627,632,N/A,42,1
10,N/A,N/A,N/A,617,627,N/A,46,5
12,N/A,N/A,N/A,605,617,N/A,52,5
7,N/A,N/A,N/A,598,605,N/A,55,2
10,N/A,N/A,N/A,588,598,N/A,59,6
6,N/A,N/A,N/A,582,588,N/A,62,3
19,N/A,N/A,N/A,563,582,N/A,65,6
6,N/A,N/A,N/A,557,563,N/A,69,4
7,N/A,N/A,N/A,550,557,N/A,75,4
5,N/A,N/A,N/A,545,550,N/A,79,2
5,N/A,N/A,N/A,540,545,N/A,84,1
7,N/A,N/A,N/A,533,540,N/A,87,4
5,N/A,N/A,N/A,528,533,N/A,92,3
5,N/A,N/A,N/A,523,528,N/A,96,1
8,N/A,N/A,N/A,515,523,N/A,99,4
7,N/A,N/A,N/A,508,515,N/A,103,2
9,N/A,N/A,N/A,499,508,N/A,106,5
5,N/A,N/A,N/A,494,499,N/A,110,3
6,N/A,N/A,N/A,488,494,N/A,115,2
9,N/A,N/A,N/A,479,488,N/A,118,5
6,N/A,N/A,N/A,473,479,N/A,123,4
11,N/A,N/A,N/A,1960,1971,N/A,5,6
6,N/A,N/A,N/A,1954,1960,N/A,8,3
6,N/A,N/A,N/A,1948,1954,N/A,14,3
13,N/A,N/A,N/A,1935,1948,N/A,17,6
4,N/A,N/A,N/A,1931,1935,N/A,23,0
12,N/A,N/A,N/A,1919,1931,N/A,28,5
5,N/A,N/A,N/A,1914,1919,N/A,32,3
5,N/A,N/A,N/A,1909,1914,N/A,38,3
4,N/A,N/A,N/A,1905,1909,N/A,42,1
5,N/A,N/A,N/A,1900,1905,N/A,45,4
7,N/A,N/A,N/A,1893,1900,N/A,49,2
4,N/A,N/A,N/A,1889,1893,N/A,54,1
12,N/A,N/A,N/A,1877,1889,N/A,58,5
5,N/A,N/A,N/A,1872,1877,N/A,63,4
5,N/A,N/A,N/A,1867,1872,N/A,69,4
5,N/A,N/A,N/A,1862,1867,N/A,72,1
8,N/A,N/A,N/A,1854,1862,N/A,75,4
7,N/A,N/A,N/A,1847,1854,N/A,79,2
11,N/A,N/A,N/A,1836,1847,N/A,82,5
9,N/A,N/A,N/A,1827,1836,N/A,88,5
9,N/A,N/A,N/A,1818,1827,N/A,94,5
11,N/A,N/A,N/A,1807,1818,N/A,100,5
4,N/A,N/A,N/A,1803,1807,N/A,103,2
5,N/A,N/A,N/A,1798,1803,N/A,108,1
12,N/A,N/A,N/A,1786,1798,N/A,112,5
6,N/A,N/A,N/A,1780,1786,N/A,117,4
4,N/A,N/A,N/A,1776,1780,N/A,120,1
17,N/A,N/A,N/A,1759,1776,N/A,125,6
4,N/A,N/A,N/A,1755,1759,N/A,131,0
12,N/A,N/A,N/A,1743,1755,N/A,136,5
16,N/A,N/A,N/A,980,996,N/A,5,6
12,N/A,N/A,N/A,968,980,N/A,10,5
7,N/A,N/A,N/A,961,968,N/A,15,4
5,N/A,N/A,N/A,956,961,N/A,21,4
4,N/A,N/A,N/A,952,956,N/A,26,3
7,N/A,N/A,N/A,945,952,N/A,31,2
4,N/A,N/A,N/A,941,945,N/A,36,1
19,N/A,N/A,N/A,922,941,N/A,41,6
6,N/A,N/A,N/A,916,922,N/A,45,4
7,N/A,N/A,N/A,909,916,N/A,50,3
4,N/A,N/A,N/A,905,909,N/A,55,2
10,N/A,N/A,N/A,895,905,N/A,58,5
7,N/A,N/A,N/A,888,895,N/A,62,3
5,N/A,N/A,N/A,883,888,N/A,66,1
5,N/A,N/A,N/A,878,883,N/A,72,1
5,N/A,N/A,N/A,873,878,N/A,78,1
5,N/A,N/A,N/A,868,873,N/A,84,1
16,N/A,N/A,N/A,852,868,N/A,89,6
5,N/A,N/A,N/A,847,852,N/A,95,0
11,N/A,N/A,N/A,836,847,N/A,100,5
7,N/A,N/A,N/A,829,836,N/A,105,4
8,N/A,N/A,N/A,821,829,N/A,111,4
4,N/A,N/A,N/A,817,821,N/A,115,2
12,N/A,N/A,N/A,805,817,N/A,118,5
6,N/A,N/A,N/A,799,805,N/A,123,4
5,N/A,N/A,N/A,794,799,N/A,127,2
17,N/A,N/A,N/A,777,794,N/A,131,6
5,N/A,N/A,N/A,772,777,N/A,135,4
4,N/A,N/A,N/A,768,772,N/A,140,3
17,N/A,N/A,N/A,751,768,N/A,143,6
4,N/A,N/A,N/A,914,918,N/A,5,1
13,N/A,N/A,N/A,901,914,N/A,10,6
4,N/A,N/A,N/A,897,901,N/A,16,0
4,N/A,N/A,N/A,893,897,N/A,19,3
4,N/A,N/A,N/A,889,893,N/A,24,2
4,N/A,N/A,N/A,885,889,N/A,29,1
5,N/A,N/A,N/A,880,885,N/A,35,1
8,N/A,N/A,N/A,872,880,N/A,38,4
4,N/A,N/A,N/A,868,872,N/A,41,1
5,N/A,N/A,N/A,863,868,N/A,47,1
10,N/A,N/A,N/A,853,863,N/A,51,5
6,N/A,N/A,N/A,847,853,N/A,55,3
4,N/A,N/A,N/A,843,847,N/A,59,1
5,N/A,N/A,N/A,838,843,N/A,65,1
4,N/A,N/A,N/A,834,838,N/A,71,1
12,N/A,N/A,N/A,822,834,N/A,75,5
6,N/A,N/A,N/A,816,822,N/A,79,3
6,N/A,N/A,N/A,810,816,N/A,85,3
18,N/A,N/A,N/A,792,810,N/A,88,6
5,N/A,N/A,N/A,787,792,N/A,94,0
5,N/A,N/A,N/A,782,787,N/A,98,4
4,N/A,N/A,N/A,778,782,N/A,103,3
7,N/A,N/A,N/A,771,778,N/A,109,3
4,N/A,N/A,N/A,767,771,N/A,113,1
10,N/A,N/A,N/A,757,767,N/A,117,5
7,N/A,N/A,N/A,750,757,N/A,120,2
5,N/A,N/A,N/A,745,750,N/A,126,2
11,N/A,N/A,N/A,734,745,N/A,130,6
4,N/A,N/A,N/A,730,734,N/A,136,0
6,N/A,N/A,N/A,724,730,N/A,140,4
11,N/A,N/A,N/A,326,337,N/A,6,5
10,N/A,N/A,N/A,316,326,N/A,12,5
5,N/A,N/A,N/A,311,316,N/A,16,3
16,N/A,N/A,N/A,295,311,N/A,19,6
6,N/A,N/A,N/A,289,295,N/A,22,3
18,N/A,N/A,N/A,271,289,N/A,25,6
6,N/A,N/A,N/A,265,271,N/A,28,3
7,N/A,N/A,N/A,258,265,N/A,33,2
11,N/A,N/A,N/A,247,258,N/A,36,5
4,N/A,N/A,N/A,243,247,N/A,40,3
5,N/A,N/A,N/A,238,243,N/A,46,3
6,N/A,N/A,N/A,232,238,N/A,52,3
6,N/A,N/A,N/A,226,232,N/A,57,2
18,N/A,N/A,N/A,208,226,N/A,61,6
7,N/A,N/A,N/A,201,208,N/A,65,4
6,N/A,N/A,N/A,195,201,N/A,70,3
5,N/A,N/A,N/A,190,195,N/A,74,1
4,N/A,N/A,N/A,186,190,N/A,80,1
10,N/A,N/A,N/A,176,186,N/A,84,5
6,N/A,N/A,N/A,170,176,N/A,89,4
5,N/A,N/A,N/A,165,170,N/A,95,4
7,N/A,N/A,N/A,158,165,N/A,101,4
4,N/A,N/A,N/A,154,158,N/A,104,1
13,N/A,N/A,N/A,141,154,N/A,109,6
5,N/A,N/A,N/A,136,141,N/A,115,0
12,N/A,N/A,N/A,124,136,N/A,120,5
12,N/A,N/A,N/A,112,124,N/A,126,5
5,N/A,N/A,N/A,107,112,N/A,129,2
15,N/A,N/A,N/A,92,107,N/A,133,6
7,N/A,N/A,N/A,85,92,N/A,137,4
4,N/A,N/A,N/A,1805,1809,N/A,5,2
15,N/A,N/A,N/A,1790,1805,N/A,9,6
4,N/A,N/A,N/A,1786,1790,N/A,12,3
18,N/A,N/A,N/A,1768,1786,N/A,15,6
6,N/A,N/A,N/A,1762,1768,N/A,19,4
4,N/A,N/A,N/A,1758,1762,N/A,23,2
17,N/A,N/A,N/A,1741,1758,N/A,27,6
8,N/A,N/A,N/A,1733,1741,N/A,31,4
4,N/A,N/A,N/A,1729,1733,N/A,35,2
5,N/A,N/A,N/A,1724,1729,N/A,40,1
5,N/A,N/A,N/A,1719,1724,N/A,46,1
7,N/A,N/A,N/A,1712,1719,N/A,49,4
5,N/A,N/A,N/A,1707,1712,N/A,55,4
5,N/A,N/A,N/A,1702,1707,N/A,59,2
18,N/A,N/A,N/A,1684,1702,N/A,63,6
7,N/A,N/A,N/A,1677,1684,N/A,67,4
5,N/A,N/A,N/A,1672,1677,N/A,70,1
16,N/A,N/A,N/A,1656,1672,N/A,75,6
5,N/A,N/A,N/A,1651,1656,N/A,78,3
4,N/A,N/A,N/A,1647,1651,N/A,82,1
5,N/A,N/A,N/A,1642,1647,N/A,85,4
5,N/A,N/A,N/A,1637,1642,N/A,88,1
19,N/A,N/A,N/A,1618,1637,N/A,93,6
5,N/A,N/A,N/A,1613,1618,N/A,96,3
17,N/A,N/A,N/A,1596,1613,N/A,99,6
12,N/A,N/A,N/A,1584,1596,N/A,104,5
5,N/A,N/A,N/A,1579,1584,N/A,109,4
5,N/A,N/A,N/A,1574,1579,N/A,114,3
16,N/A,N/A,N/A,1558,1574,N/A,117,6
5,N/A,N/A,N/A,1553,1558,N/A,121,4
5,N/A,N/A,N/A,301,306,N/A,3,1
13,N/A,N/A,N/A,288,301,N/A,8,6
4,N/A,N/A,N/A,284,288,N/A,11,3
14,N/A,N/A,N/A,270,284,N/A,14,6
4,N/A,N/A,N/A,266,270,N/A,20,0
16,N/A,N/A,N/A,250,266,N/A,26,6
5,N/A,N/A,N/A,245,250,N/A,32,0
5,N/A,N/A,N/A,240,245,N/A,36,4
6,N/A,N/A,N/A,234,240,N/A,41,3
19,N/A,N/A,N/A,215,234,N/A,44,6
5,N/A,N/A,N/A,210,215,N/A,50,0
12,N/A,N/A,N/A,198,210,N/A,56,6
5,N/A,N/A,N/A,193,198,N/A,62,0
7,N/A,N/A,N/A,186,193,N/A,65,3
4,N/A,N/A,N/A,182,186,N/A,71,3
4,N/A,N/A,N/A,178,182,N/A,76,2
5,N/A,N/A,N/A,173,178,N/A,81,1
4,N/A,N/A,N/A,169,173,N/A,87,1
4,N/A,N/A,N/A,165,169,N/A,93,1
5,N/A,N/A,N/A,160,165,N/A,96,4
4,N/A,N/A,N/A,156,160,N/A,99,1
5,N/A,N/A,N/A,151,156,N/A,105,1
7,N/A,N/A,N/A,144,151,N/A,108,4
8,N/A,N/A,N/A,136,144,N/A,114,4
6,N/A,N/A,N/A,130,136,N/A,119,3
17,N/A,N/A,N/A,113,130,N/A,122,6
12,N/A,N/A,N/A,101,113,N/A,127,5
6,N/A,N/A,N/A,95,101,N/A,131,3
5,N/A,N/A,N/A,90,95,N/A,137,3
5,N/A,N/A,N/A,85,90,N/A,141,1
10,N/A,N/A,N/A,1498,1508,N/A,4,6
4,N/A,N/A,N/A,1494,1498,N/A,10,0
17,N/A,N/A,N/A,1477,1494,N/A,16,6
6,N/A,N/A,N/A,1471,1477,N/A,19,3
19,N/A,N/A,N/A,1452,1471,N/A,22,6
12,N/A,N/A,N/A,1440,1452,N/A,27,5
5,N/A,N/A,N/A,1435,1440,N/A,32,4
5,N/A,N/A,N/A,1430,1435,N/A,35,1
12,N/A,N/A,N/A,1418,1430,N/A,40,6
12,N/A,N/A,N/A,1406,1418,N/A,45,5
8,N/A,N/A,N/A,1398,1406,N/A,50,4
6,N/A,N/A,N/A,1392,1398,N/A,55,3
4,N/A,N/A,N/A,1388,1392,N/A,61,3
18,N/A,N/A,N/A,1370,1388,N/A,64,6
4,N/A,N/A,N/A,1366,1370,N/A,67,3
5,N/A,N/A,N/A,1361,1366,N/A,71,1
10,N/A,N/A,N/A,1351,1361,N/A,75,5
8,N/A,N/A,N/A,1343,1351,N/A,80,4
5,N/A,N/A,N/A,1338,1343,N/A,83,1
5,N/A,N/A,N/A,1333,1338,N/A,86,4
5,N/A,N/A,N/A,1328,1333,N/A,90,2
12,N/A,N/A,N/A,1316,1328,N/A,93,5
6,N/A,N/A,N/A,1310,1316,N/A,98,4
4,N/A,N/A,N/A,1306,1310,N/A,102,2
10,N/A,N/A,N/A,1296,1306,N/A,105,5
5,N/A,N/A,N/A,1291,1296,N/A,110,4
5,N/A,N/A,N/A,1286,1291,N/A,116,4
4,N/A,N/A,N/A,1282,1286,N/A,119,1
16,N/A,N/A,N/A,1266,1282,N/A,124,6
5,N/A,N/A,N/A,1261,1266,N/A,128,4
5,N/A,N/A,N/A,906,911,N/A,6,3
7,N/A,N/A,N/A,899,906,N/A,12,3
10,N/A,N/A,N/A,889,899,N/A,15,6
7,N/A,N/A,N/A,882,889,N/A,19,4
8,N/A,N/A,N/A,874,882,N/A,25,4
6,N/A,N/A,N/A,868,874,N/A,30,3
5,N/A,N/A,N/A,863,868,N/A,35,2
5,N/A,N/A,N/A,858,863,N/A,41,2
7,N/A,N/A,N/A,851,858,N/A,47,2
6,N/A,N/A,N/A,845,851,N/A,53,2
4,N/A,N/A,N/A,841,845,N/A,59,2
17,N/A,N/A,N/A,824,841,N/A,63,6
7,N/A,N/A,N/A,817,824,N/A,66,3
6,N/A,N/A,N/A,811,817,N/A,72,3
14,N/A,N/A,N/A,797,811,N/A,75,6
7,N/A,N/A,N/A,790,797,N/A,78,3
12,N/A,N/A,N/A,778,790,N/A,81,6
12,N/A,N/A,N/A,766,778,N/A,86,5
4,N/A,N/A,N/A,762,766,N/A,90,3
16,N/A,N/A,N/A,746,762,N/A,93,6
7,N/A,N/A,N/A,739,746,N/A,96,3
6,N/A,N/A,N/A,733,739,N/A,101,2
11,N/A,N/A,N/A,722,733,N/A,104,5
11,N/A,N/A,N/A,711,722,N/A,110,5
5,N/A,N/A,N/A,706,711,N/A,114,3
11,N/A,N/A,N/A,695,706,N/A,117,6
12,N/A,N/A,N/A,683,695,N/A,122,5
6,N/A,N/A,N/A,677,683,N/A,126,3
5,N/A,N/A,N/A,672,677,N/A,130,1
10,N/A,N/A,N/A,662,672,N/A,134,5
7,N/A,N/A,N/A,1763,1770,N/A,4,2
15,N/A,N/A,N/A,1748,1763,N/A,8,6
7,N/A,N/A,N/A,1741,1748,N/A,12,4
4,N/A,N/A,N/A,1737,1741,N/A,17,3
5,N/A,N/A,N/A,1732,1737,N/A,21,1
10,N/A,N/A,N/A,1722,1732,N/A,26,6
4,N/A,N/A,N/A,1718,1722,N/A,32,0
7,N/A,N/A,N/A,1711,1718,N/A,35,3
10,N/A,N/A,N/A,1701,1711,N/A,38,6
4,N/A,N/A,N/A,1697,1701,N/A,44,0
10,N/A,N/A,N/A,1687,1697,N/A,49,5
7,N/A,N/A,N/A,1680,1687,N/A,52,2
12,N/A,N/A,N/A,1668,1680,N/A,55,5
12,N/A,N/A,N/A,1656,1668,N/A,61,5
9,N/A,N/A,N/A,1647,1656,N/A,67,5
12,N/A,N/A,N/A,1635,1647,N/A,73,5
5,N/A,N/A,N/A,1630,1635,N/A,76,2
4,N/A,N/A,N/A,1626,1630,N/A,81,1
7,N/A,N/A,N/A,1619,1626,N/A,84,4
6,N/A,N/A,N/A,1613,1619,N/A,90,4
5,N/A,N/A,N/A,1608,1613,N/A,93,1
4,N/A,N/A,N/A,1604,1608,N/A,99,1
14,N/A,N/A,N/A,1590,1604,N/A,104,6
6,N/A,N/A,N/A,1584,1590,N/A,108,4
5,N/A,N/A,N/A,1579,1584,N/A,111,1
5,N/A,N/A,N/A,1574,1579,N/A,117,1
4,N/A,N/A,N/A,1570,1574,N/A,123,1
4,N/A,N/A,N/A,1566,1570,N/A,129,1
10,N/A,N/A,N/A,1556,1566,N/A,134,6
9,N/A,N/A,N/A,1547,1556,N/A,139,5
9,N/A,N/A,N/A,1212,1221,N/A,5,5
4,N/A,N/A,N/A,1208,1212,N/A,9,3
18,N/A,N/A,N/A,1190,1208,N/A,12,6
10,N/A,N/A,N/A,1180,1190,N/A,17,5
5,N/A,N/A,N/A,1175,1180,N/A,21,3
7,N/A,N/A,N/A,1168,1175,N/A,26,2
11,N/A,N/A,N/A,1157,1168,N/A,30,6
5,N/A,N/A,N/A,1152,1157,N/A,33,3
5,N/A,N/A,N/A,1147,1152,N/A,37,1
4,N/A,N/A,N/A,1143,1147,N/A,43,1
10,N/A,N/A,N/A,1133,1143,N/A,48,6
6,N/A,N/A,N/A,1127,1133,N/A,51,3
18,N/A,N/A,N/A,1109,1127,N/A,54,6
6,N/A,N/A,N/A,1103,1109,N/A,57,3
4,N/A,N/A,N/A,1099,1103,N/A,61,1
12,N/A,N/A,N/A,1087,1099,N/A,65,5
11,N/A,N/A,N/A,1076,1087,N/A,71,5
12,N/A,N/A,N/A,1064,1076,N/A,77,5
5,N/A,N/A,N/A,1059,1064,N/A,81,3
4,N/A,N/A,N/A,1055,1059,N/A,85,1
9,N/A,N/A,N/A,1046,1055,N/A,89,5
4,N/A,N/A,N/A,1042,1046,N/A,92,2
12,N/A,N/A,N/A,1030,1042,N/A,96,6
5,N/A,N/A,N/A,1025,1030,N/A,99,3
4,N/A,N/A,N/A,1021,1025,N/A,104,2
5,N/A,N/A,N/A,1016,1021,N/A,110,2
4,N/A,N/A,N/A,1012,1016,N/A,115,1
14,N/A,N/A,N/A,998,1012,N/A,120,6
11,N/A,N/A,N/A,987,998,N/A,125,5
11,N/A,N/A,N/A,976,987,N/A,131,5
5,N/A,N/A,N/A,797,802,N/A,4,1
13,N/A,N/A,N/A,784,797,N/A,9,6
7,N/A,N/A,N/A,777,784,N/A,12,3
4,N/A,N/A,N/A,773,777,N/A,16,1
9,N/A,N/A,N/A,764,773,N/A,20,5
5,N/A,N/A,N/A,759,764,N/A,25,4
8,N/A,N/A,N/A,751,759,N/A,31,4
7,N/A,N/A,N/A,744,751,N/A,36,3
4,N/A,N/A,N/A,740,744,N/A,41,2
4,N/A,N/A,N/A,736,740,N/A,47,2
5,N/A,N/A,N/A,731,736,N/A,52,1
6,N/A,N/A,N/A,725,731,N/A,55,4
7,N/A,N/A,N/A,718,725,N/A,60,3
6,N/A,N/A,N/A,712,718,N/A,65,2
12,N/A,N/A,N/A,700,712,N/A,68,5
5,N/A,N/A,N/A,695,700,N/A,71,2
7,N/A,N/A,N/A,688,695,N/A,77,2
12,N/A,N/A,N/A,676,688,N/A,80,5
8,N/A,N/A,N/A,668,676,N/A,85,4
7,N/A,N/A,N/A,661,668,N/A,89,2
7,N/A,N/A,N/A,654,661,N/A,95,2
5,N/A,N/A,N/A,649,654,N/A,101,2
10,N/A,N/A,N/A,639,649,N/A,104,5
6,N/A,N/A,N/A,633,639,N/A,109,4
5,N/A,N/A,N/A,628,633,N/A,114,3
14,N/A,N/A,N/A,614,628,N/A,117,6
6,N/A,N/A,N/A,608,614,N/A,121,4
7,N/A,N/A,N/A,601,608,N/A,126,3
4,N/A,N/A,N/A,597,601,N/A,131,2
16,N/A,N/A,N/A,581,597,N/A,135,6
5,N/A,N/A,N/A,1870,1875,N/A,5,1
12,N/A,N/A,N/A,1858,1870,N/A,9,5
7,N/A,N/A,N/A,1851,1858,N/A,13,3
16,N/A,N/A,N/A,1835,1851,N/A,16,6
7,N/A,N/A,N/A,1828,1835,N/A,19,3
19,N/A,N/A,N/A,1809,1828,N/A,22,6
5,N/A,N/A,N/A,1804,1809,N/A,26,4
7,N/A,N/A,N/A,1797,1804,N/A,30,2
5,N/A,N/A,N/A,1792,1797,N/A,36,2
10,N/A,N/A,N/A,1782,1792,N/A,39,5
8,N/A,N/A,N/A,1774,1782,N/A,44,4
5,N/A,N/A,N/A,1769,1774,N/A,47,1
10,N/A,N/A,N/A,1759,1769,N/A,51,5
4,N/A,N/A,N/A,1755,1759,N/A,55,3
10,N/A,N/A,N/A,1745,1755,N/A,58,6
4,N/A,N/A,N/A,1741,1745,N/A,64,0
8,N/A,N/A,N/A,1733,1741,N/A,68,4
4,N/A,N/A,N/A,1729,1733,N/A,71,1
12,N/A,N/A,N/A,1717,1729,N/A,75,5
10,N/A,N/A,N/A,1707,1717,N/A,81,5
5,N/A,N/A,N/A,1702,1707,N/A,86,4
4,N/A,N/A,N/A,1698,1702,N/A,89,1
4,N/A,N/A,N/A,1694,1698,N/A,95,1
8,N/A,N/A,N/A,1686,1694,N/A,98,4
7,N/A,N/A,N/A,1679,1686,N/A,102,2
5,N/A,N/A,N/A,1674,1679,N/A,107,1
5,N/A,N/A,N/A,1669,1674,N/A,113,1
11,N/A,N/A,N/A,1658,1669,N/A,117,5
5,N/A,N/A,N/A,1653,1658,N/A,122,4
5,N/A,N/A,N/A,1648,1653,N/A,125,1
5,N/A,N/A,N/A,425,430,N/A,5,4
5,N/A,N/A,N/A,420,425,N/A,8,1
12,N/A,N/A,N/A,408,420,N/A,12,5
7,N/A,N/A,N/A,401,408,N/A,15,2
17,N/A,N/A,N/A,384,401,N/A,19,6
7,N/A,N/A,N/A,377,384,N/A,22,3
5,N/A,N/A,N/A,372,377,N/A,27,2
10,N/A,N/A,N/A,362,372,N/A,30,5
9,N/A,N/A,N/A,353,362,N/A,36,5
5,N/A,N/A,N/A,348,353,N/A,41,4
5,N/A,N/A,N/A,343,348,N/A,45,2
15,N/A,N/A,N/A,328,343,N/A,49,6
12,N/A,N/A,N/A,316,328,N/A,54,5
5,N/A,N/A,N/A,311,316,N/A,58,3
4,N/A,N/A,N/A,307,311,N/A,64,3
6,N/A,N/A,N/A,301,307,N/A,70,3
16,N/A,N/A,N/A,285,301,N/A,73,6
6,N/A,N/A,N/A,279,285,N/A,76,3
19,N/A,N/A,N/A,260,279,N/A,79,6
4,N/A,N/A,N/A,256,260,N/A,85,0
4,N/A,N/A,N/A,252,256,N/A,88,3
16,N/A,N/A,N/A,236,252,N/A,91,6
8,N/A,N/A,N/A,228,236,N/A,95,4
5,N/A,N/A,N/A,223,228,N/A,101,4
5,N/A,N/A,N/A,218,223,N/A,106,3
16,N/A,N/A,N/A,202,218,N/A,109,6
7,N/A,N/A,N/A,195,202,N/A,113,4
8,N/A,N/A,N/A,187,195,N/A,119,4
8,N/A,N/A,N/A,179,187,N/A,125,4
5,N/A,N/A,N/A,174,179,N/A,128,1
10,N/A,N/A,N/A,1010,1020,N/A,3,5
5,N/A,N/A,N/A,1005,1010,N/A,7,3
11,N/A,N/A,N/A,994,1005,N/A,10,6
4,N/A,N/A,N/A,990,994,N/A,13,3
5,N/A,N/A,N/A,985,990,N/A,19,3
7,N/A,N/A,N/A,978,985,N/A,25,3
5,N/A,N/A,N/A,973,978,N/A,31,3
5,N/A,N/A,N/A,968,973,N/A,35,1
7,N/A,N/A,N/A,961,968,N/A,38,4
5,N/A,N/A,N/A,956,961,N/A,44,4
6,N/A,N/A,N/A,950,956,N/A,48,2
11,N/A,N/A,N/A,939,950,N/A,51,5
7,N/A,N/A,N/A,932,939,N/A,55,3
12,N/A,N/A,N/A,920,932,N/A,58,6
6,N/A,N/A,N/A,914,920,N/A,62,4
7,N/A,N/A,N/A,907,914,N/A,68,4
7,N/A,N/A,N/A,900,907,N/A,74,4
5,N/A,N/A,N/A,895,900,N/A,78,2
6,N/A,N/A,N/A,889,895,N/A,84,2
5,N/A,N/A,N/A,884,889,N/A,90,2
14,N/A,N/A,N/A,870,884,N/A,94,6
7,N/A,N/A,N/A,863,870,N/A,97,3
11,N/A,N/A,N/A,852,863,N/A,100,6
4,N/A,N/A,N/A,848,852,N/A,103,3
6,N/A,N/A,N/A,842,848,N/A,109,3
15,N/A,N/A,N/A,827,842,N/A,112,6
5,N/A,N/A,N/A,822,827,N/A,118,0
7,N/A,N/A,N/A,815,822,N/A,121,3
5,N/A,N/A,N/A,810,815,N/A,125,1
12,N/A,N/A,N/A,798,810,N/A,130,6
4,N/A,N/A,N/A,622,626,N/A,3,2
10,N/A,N/A,N/A,612,622,N/A,7,6
4,N/A,N/A,N/A,608,612,N/A,10,3
14,N/A,N/A,N/A,594,608,N/A,13,6
12,N/A,N/A,N/A,582,594,N/A,18,5
4,N/A,N/A,N/A,578,582,N/A,21,2
4,N/A,N/A,N/A,574,578,N/A,26,1
4,N/A,N/A,N/A,570,574,N/A,32,1
10,N/A,N/A,N/A,560,570,N/A,36,5
6,N/A,N/A,N/A,554,560,N/A,41,4
7,N/A,N/A,N/A,547,554,N/A,46,3
7,N/A,N/A,N/A,540,547,N/A,52,3
18,N/A,N/A,N/A,522,540,N/A,55,6
7,N/A,N/A,N/A,515,522,N/A,58,3
5,N/A,N/A,N/A,510,515,N/A,62,1
5,N/A,N/A,N/A,505,510,N/A,65,4
4,N/A,N/A,N/A,501,505,N/A,70,3
7,N/A,N/A,N/A,494,501,N/A,76,3
6,N/A,N/A,N/A,488,494,N/A,81,2
5,N/A,N/A,N/A,483,488,N/A,86,1
12,N/A,N/A,N/A,471,483,N/A,90,5
7,N/A,N/A,N/A,464,471,N/A,94,3
5,N/A,N/A,N/A,459,464,N/A,100,3
5,N/A,N/A,N/A,454,459,N/A,105,2
7,N/A,N/A,N/A,447,454,N/A,111,2
10,N/A,N/A,N/A,437,447,N/A,114,5
12,N/A,N/A,N/A,425,437,N/A,120,5
6,N/A,N/A,N/A,419,425,N/A,124,3
12,N/A,N/A,N/A,407,419,N/A,127,6
4,N/A,N/A,N/A,403,407,N/A,133,0
5,N/A,N/A,N/A,609,614,N/A,3,2
6,N/A,N/A,N/A,603,609,N/A,9,2
12,N/A,N/A,N/A,591,603,N/A,13,6
5,N/A,N/A,N/A,586,591,N/A,17,4
4,N/A,N/A,N/A,582,586,N/A,20,1
10,N/A,N/A,N/A,572,582,N/A,25,6
4,N/A,N/A,N/A,568,572,N/A,31,0
6,N/A,N/A,N/A,562,568,N/A,34,3
4,N/A,N/A,N/A,558,562,N/A,38,1
4,N/A,N/A,N/A,554,558,N/A,44,1
12,N/A,N/A,N/A,542,554,N/A,49,6
10,N/A,N/A,N/A,532,542,N/A,54,5
10,N/A,N/A,N/A,522,532,N/A,60,5
5,N/A,N/A,N/A,517,522,N/A,63,2
9,N/A,N/A,N/A,508,517,N/A,66,5
11,N/A,N/A,N/A,497,508,N/A,72,5
5,N/A,N/A,N/A,492,497,N/A,76,3
4,N/A,N/A,N/A,488,492,N/A,82,3
4,N/A,N/A,N/A,484,488,N/A,86,1
7,N/A,N/A,N/A,477,484,N/A,89,4
5,N/A,N/A,N/A,472,477,N/A,92,1
6,N/A,N/A,N/A,466,472,N/A,95,4
4,N/A,N/A,N/A,462,466,N/A,100,3
16,N/A,N/A,N/A,446,462,N/A,103,6
8,N/A,N/A,N/A,438,446,N/A,107,4
7,N/A,N/A,N/A,431,438,N/A,112,3
10,N/A,N/A,N/A,421,431,N/A,115,6
5,N/A,N/A,N/A,416,421,N/A,121,0
5,N/A,N/A,N/A,411,416,N/A,125,4
7,N/A,N/A,N/A,404,411,N/A,130,3
5,N/A,N/A,N/A,1365,1370,N/A,3,4
5,N/A,N/A,N/A,1360,1365,N/A,6,1
11,N/A,N/A,N/A,1349,1360,N/A,10,5
11,N/A,N/A,N/A,1338,1349,N/A,16,5
5,N/A,N/A,N/A,1333,1338,N/A,19,2
5,N/A,N/A,N/A,1328,1333,N/A,24,1
6,N/A,N/A,N/A,1322,1328,N/A,27,4
4,N/A,N/A,N/A,1318,1322,N/A,31,2
12,N/A,N/A,N/A,1306,1318,N/A,34,5
6,N/A,N/A,N/A,1300,1306,N/A,38,3
6,N/A,N/A,N/A,1294,1300,N/A,43,2
12,N/A,N/A,N/A,1282,1294,N/A,47,6
4,N/A,N/A,N/A,1278,1282,N/A,53,0
19,N/A,N/A,N/A,1259,1278,N/A,59,6
12,N/A,N/A,N/A,1247,1259,N/A,64,5
11,N/A,N/A,N/A,1236,1247,N/A,70,5
7,N/A,N/A,N/A,1229,1236,N/A,75,4
6,N/A,N/A,N/A,1223,1229,N/A,80,3
4,N/A,N/A,N/A,1219,1223,N/A,85,2
16,N/A,N/A,N/A,1203,1219,N/A,89,6
4,N/A,N/A,N/A,1199,1203,N/A,95,0
7,N/A,N/A,N/A,1192,1199,N/A,98,3
7,N/A,N/A,N/A,1185,1192,N/A,103,2
13,N/A,N/A,N/A,1172,1185,N/A,107,6
4,N/A,N/A,N/A,1168,1172,N/A,113,0
5,N/A,N/A,N/A,1163,1168,N/A,117,4
4,N/A,N/A,N/A,1159,1163,N/A,121,2
7,N/A,N/A,N/A,1152,1159,N/A,127,2
14,N/A,N/A,N/A,1138,1152,N/A,131,6
11,N/A,N/A,N/A,1127,1138,N/A,136,5
4,N/A,N/A,N/A,1445,1449,N/A,5,3
5,N/A,N/A,N/A,1440,1445,N/A,11,3
5,N/A,N/A,N/A,1435,1440,N/A,15,1
12,N/A,N/A,N/A,1423,1435,N/A,20,6
5,N/A,N/A,N/A,1418,1423,N/A,26,0
7,N/A,N/A,N/A,1411,1418,N/A,29,3
7,N/A,N/A,N/A,1404,1411,N/A,34,2
9,N/A,N/A,N/A,1395,1404,N/A,37,5
5,N/A,N/A,N/A,1390,1395,N/A,41,3
5,N/A,N/A,N/A,1385,1390,N/A,46,2
5,N/A,N/A,N/A,1380,1385,N/A,52,2
12,N/A,N/A,N/A,1368,1380,N/A,55,5
5,N/A,N/A,N/A,1363,1368,N/A,59,3
4,N/A,N/A,N/A,1359,1363,N/A,64,2
7,N/A,N/A,N/A,1352,1359,N/A,70,2
17,N/A,N/A,N/A,1335,1352,N/A,74,6
6,N/A,N/A,N/A,1329,1335,N/A,77,3
4,N/A,N/A,N/A,1325,1329,N/A,81,1
14,N/A,N/A,N/A,1311,1325,N/A,86,6
10,N/A,N/A,N/A,1301,1311,N/A,91,5
11,N/A,N/A,N/A,1290,1301,N/A,97,5
5,N/A,N/A,N/A,1285,1290,N/A,100,2
10,N/A,N/A,N/A,1275,1285,N/A,103,5
4,N/A,N/A,N/A,1271,1275,N/A,106,2
5,N/A,N/A,N/A,1266,1271,N/A,111,1
9,N/A,N/A,N/A,1257,1266,N/A,115,5
6,N/A,N/A,N/A,1251,1257,N/A,120,4
4,N/A,N/A,N/A,1247,1251,N/A,125,3
4,N/A,N/A,N/A,1243,1247,N/A,129,1
5,N/A,N/A,N/A,1238,1243,N/A,135,1
7,N/A,N/A,N/A,486,493,N/A,5,2
5,N/A,N/A,N/A,481,486,N/A,10,1
5,N/A,N/A,N/A,476,481,N/A,16,1
12,N/A,N/A,N/A,464,476,N/A,20,5
6,N/A,N/A,N/A,458,464,N/A,23,2
4,N/A,N/A,N/A,454,458,N/A,28,1
10,N/A,N/A,N/A,444,454,N/A,32,5
12,N/A,N/A,N/A,432,444,N/A,38,5
5,N/A,N/A,N/A,427,432,N/A,41,2
14,N/A,N/A,N/A,413,427,N/A,45,6
10,N/A,N/A,N/A,403,413,N/A,50,5
5,N/A,N/A,N/A,398,403,N/A,53,2
5,N/A,N/A,N/A,393,398,N/A,58,1
10,N/A,N/A,N/A,383,393,N/A,62,5
6,N/A,N/A,N/A,377,383,N/A,65,2
4,N/A,N/A,N/A,373,377,N/A,70,1
5,N/A,N/A,N/A,368,373,N/A,76,1
16,N/A,N/A,N/A,352,368,N/A,81,6
7,N/A,N/A,N/A,345,352,N/A,84,3
5,N/A,N/A,N/A,340,345,N/A,88,1
12,N/A,N/A,N/A,328,340,N/A,93,6
11,N/A,N/A,N/A,317,328,N/A,98,5
7,N/A,N/A,N/A,310,317,N/A,101,2
5,N/A,N/A,N/A,305,310,N/A,106,1
4,N/A,N/A,N/A,301,305,N/A,112,1
12,N/A,N/A,N/A,289,301,N/A,116,5
10,N/A,N/A,N/A,279,289,N/A,122,5
5,N/A,N/A,N/A,274,279,N/A,126,3
4,N/A,N/A,N/A,270,274,N/A,132,3
10,N/A,N/A,N/A,260,270,N/A,135,6
13,N/A,N/A,N/A,992,1005,N/A,3,6
9,N/A,N/A,N/A,983,992,N/A,8,5
4,N/A,N/A,N/A,979,983,N/A,11,2
4,N/A,N/A,N/A,975,979,N/A,17,2
4,N/A,N/A,N/A,971,975,N/A,22,1
9,N/A,N/A,N/A,962,971,N/A,26,5
11,N/A,N/A,N/A,951,962,N/A,32,5
11,N/A,N/A,N/A,940,951,N/A,38,5
4,N/A,N/A,N/A,936,940,N/A,42,3
4,N/A,N/A,N/A,932,936,N/A,46,1
5,N/A,N/A,N/A,927,932,N/A,52,1
4,N/A,N/A,N/A,923,927,N/A,58,1
4,N/A,N/A,N/A,919,923,N/A,64,1
6,N/A,N/A,N/A,913,919,N/A,67,4
5,N/A,N/A,N/A,908,913,N/A,70,1
4,N/A,N/A,N/A,904,908,N/A,76,1
7,N/A,N/A,N/A,897,904,N/A,79,4
6,N/A,N/A,N/A,891,897,N/A,84,3
5,N/A,N/A,N/A,886,891,N/A,90,3
6,N/A,N/A,N/A,880,886,N/A,96,3
16,N/A,N/A,N/A,864,880,N/A,99,6
5,N/A,N/A,N/A,859,864,N/A,105,0
6,N/A,N/A,N/A,853,859,N/A,108,3
6,N/A,N/A,N/A,847,853,N/A,113,2
5,N/A,N/A,N/A,842,847,N/A,118,1
10,N/A,N/A,N/A,832,842,N/A,123,6
6,N/A,N/A,N/A,826,832,N/A,127,4
6,N/A,N/A,N/A,820,826,N/A,131,2
5,N/A,N/A,N/A,815,820,N/A,137,2
15,N/A,N/A,N/A,800,815,N/A,141,6
15,N/A,N/A,N/A,457,472,N/A,4,6
5,N/A,N/A,N/A,452,457,N/A,7,3
7,N/A,N/A,N/A,445,452,N/A,12,2
9,N/A,N/A,N/A,436,445,N/A,15,5
10,N/A,N/A,N/A,426,436,N/A,21,5
6,N/A,N/A,N/A,420,426,N/A,24,2
11,N/A,N/A,N/A,409,420,N/A,27,5
12,N/A,N/A,N/A,397,409,N/A,33,5
5,N/A,N/A,N/A,392,397,N/A,37,3
7,N/A,N/A,N/A,385,392,N/A,43,3
17,N/A,N/A,N/A,368,385,N/A,46,6
5,N/A,N/A,N/A,363,368,N/A,49,3
4,N/A,N/A,N/A,359,363,N/A,53,1
10,N/A,N/A,N/A,349,359,N/A,57,5
10,N/A,N/A,N/A,339,349,N/A,63,5
8,N/A,N/A,N/A,331,339,N/A,68,4
4,N/A,N/A,N/A,327,331,N/A,72,2
5,N/A,N/A,N/A,322,327,N/A,78,2
5,N/A,N/A,N/A,317,322,N/A,83,1
18,N/A,N/A,N/A,299,317,N/A,88,6
4,N/A,N/A,N/A,295,299,N/A,91,3
5,N/A,N/A,N/A,290,295,N/A,96,2
9,N/A,N/A,N/A,281,290,N/A,99,5
12,N/A,N/A,N/A,269,281,N/A,105,5
9,N/A,N/A,N/A,260,269,N/A,111,5
7,N/A,N/A,N/A,253,260,N/A,115,3
6,N/A,N/A,N/A,247,253,N/A,120,2
4,N/A,N/A,N/A,243,247,N/A,125,1
4,N/A,N/A,N/A,239,243,N/A,131,1
6,N/A,N/A,N/A,233,239,N/A,134,4
6,N/A,N/A,N/A,1849,1855,N/A,4,4
4,N/A,N/A,N/A,1845,1849,N/A,9,3
7,N/A,N/A,N/A,1838,1845,N/A,15,3
13,N/A,N/A,N/A,1825,1838,N/A,18,6
7,N/A,N/A,N/A,1818,1825,N/A,21,3
4,N/A,N/A,N/A,1814,1818,N/A,25,1
4,N/A,N/A,N/A,1810,1814,N/A,31,1
10,N/A,N/A,N/A,1800,1810,N/A,36,6
5,N/A,N/A,N/A,1795,1800,N/A,42,0
12,N/A,N/A,N/A,1783,1795,N/A,47,5
8,N/A,N/A,N/A,1775,1783,N/A,52,4
4,N/A,N/A,N/A,1771,1775,N/A,55,1
9,N/A,N/A,N/A,1762,1771,N/A,59,5
7,N/A,N/A,N/A,1755,1762,N/A,62,2
18,N/A,N/A,N/A,1737,1755,N/A,66,6
4,N/A,N/A,N/A,1733,1737,N/A,69,3
6,N/A,N/A,N/A,1727,1733,N/A,74,2
11,N/A,N/A,N/A,1716,1727,N/A,77,5
11,N/A,N/A,N/A,1705,1716,N/A,83,5
5,N/A,N/A,N/A,1700,1705,N/A,88,4
4,N/A,N/A,N/A,1696,1700,N/A,91,1
15,N/A,N/A,N/A,1681,1696,N/A,96,6
8,N/A,N/A,N/A,1673,1681,N/A,100,4
5,N/A,N/A,N/A,1668,1673,N/A,105,3
7,N/A,N/A,N/A,1661,1668,N/A,110,2
10,N/A,N/A,N/A,1651,1661,N/A,113,5
9,N/A,N/A,N/A,1642,1651,N/A,119,5
10,N/A,N/A,N/A,1632,1642,N/A,125,5
7,N/A,N/A,N/A,1625,1632,N/A,129,3
11,N/A,N/A,N/A,1614,1625,N/A,132,6
4,N/A,N/A,N/A,770,774,N/A,3,1
15,N/A,N/A,N/A,755,770,N/A,8,6
12,N/A,N/A,N/A,743,755,N/A,13,5
12,N/A,N/A,N/A,731,743,N/A,19,5
7,N/A,N/A,N/A,724,731,N/A,23,3
5,N/A,N/A,N/A,719,724,N/A,27,1
11,N/A,N/A,N/A,708,719,N/A,31,5
5,N/A,N/A,N/A,703,708,N/A,36,4
6,N/A,N/A,N/A,697,703,N/A,42,4
7,N/A,N/A,N/A,690,697,N/A,47,3
19,N/A,N/A,N/A,671,690,N/A,50,6
7,N/A,N/A,N/A,664,671,N/A,53,3
5,N/A,N/A,N/A,659,664,N/A,58,2
5,N/A,N/A,N/A,654,659,N/A,63,1
11,N/A,N/A,N/A,643,654,N/A,67,5
7,N/A,N/A,N/A,636,643,N/A,72,4
5,N/A,N/A,N/A,631,636,N/A,78,4
6,N/A,N/A,N/A,625,631,N/A,82,2
6,N/A,N/A,N/A,619,625,N/A,88,2
11,N/A,N/A,N/A,608,619,N/A,92,6
5,N/A,N/A,N/A,603,608,N/A,95,3
12,N/A,N/A,N/A,591,603,N/A,98,6
5,N/A,N/A,N/A,586,591,N/A,104,0
14,N/A,N/A,N/A,572,586,N/A,110,6
5,N/A,N/A,N/A,567,572,N/A,114,4
8,N/A,N/A,N/A,559,567,N/A,120,4
5,N/A,N/A,N/A,554,559,N/A,126,4
5,N/A,N/A,N/A,549,554,N/A,130,2
11,N/A,N/A,N/A,538,549,N/A,134,6
5,N/A,N/A,N/A,533,538,N/A,140,0
10,N/A,N/A,N/A,1026,1036,N/A,6,5
5,N/A,N/A,N/A,1021,1026,N/A,11,4
6,N/A,N/A,N/A,1015,1021,N/A,16,3
16,N/A,N/A,N/A,999,1015,N/A,19,6
5,N/A,N/A,N/A,994,999,N/A,25,0
5,N/A,N/A,N/A,989,994,N/A,29,4
6,N/A,N/A,N/A,983,989,N/A,35,4
4,N/A,N/A,N/A,979,983,N/A,40,3
5,N/A,N/A,N/A,974,979,N/A,44,1
14,N/A,N/A,N/A,960,974,N/A,49,6
4,N/A,N/A,N/A,956,960,N/A,52,3
4,N/A,N/A,N/A,952,956,N/A,56,1
6,N/A,N/A,N/A,946,952,N/A,59,4
5,N/A,N/A,N/A,941,946,N/A,63,2
11,N/A,N/A,N/A,930,941,N/A,67,6
8,N/A,N/A,N/A,922,930,N/A,71,4
4,N/A,N/A,N/A,918,922,N/A,75,2
4,N/A,N/A,N/A,914,918,N/A,81,2
5,N/A,N/A,N/A,909,914,N/A,86,1
9,N/A,N/A,N/A,900,909,N/A,90,5
10,N/A,N/A,N/A,890,900,N/A,96,5
6,N/A,N/A,N/A,884,890,N/A,101,4
6,N/A,N/A,N/A,878,884,N/A,105,2
11,N/A,N/A,N/A,867,878,N/A,109,6
9,N/A,N/A,N/A,858,867,N/A,114,5
5,N/A,N/A,N/A,853,858,N/A,119,4
5,N/A,N/A,N/A,848,853,N/A,124,3
4,N/A,N/A,N/A,844,848,N/A,128,1
12,N/A,N/A,N/A,832,844,N/A,133,6
11,N/A,N/A,N/A,821,832,N/A,138,5
9,N/A,N/A,N/A,1764,1773,N/A,6,5
7,N/A,N/A,N/A,1757,1764,N/A,10,3
4,N/A,N/A,N/A,1753,1757,N/A,14,1
5,N/A,N/A,N/A,1748,1753,N/A,20,1
5,N/A,N/A,N/A,1743,1748,N/A,26,1
17,N/A,N/A,N/A,1726,1743,N/A,31,6
9,N/A,N/A,N/A,1717,1726,N/A,36,5
6,N/A,N/A,N/A,1711,1717,N/A,41,4
5,N/A,N/A,N/A,1706,1711,N/A,46,3
7,N/A,N/A,N/A,1699,1706,N/A,51,2
4,N/A,N/A,N/A,1695,1699,N/A,56,1
16,N/A,N/A,N/A,1679,1695,N/A,61,6
5,N/A,N/A,N/A,1674,1679,N/A,64,3
4,N/A,N/A,N/A,1670,1674,N/A,68,1
11,N/A,N/A,N/A,1659,1670,N/A,73,6
9,N/A,N/A,N/A,1650,1659,N/A,78,5
9,N/A,N/A,N/A,1641,1650,N/A,84,5
6,N/A,N/A,N/A,1635,1641,N/A,87,2
10,N/A,N/A,N/A,1625,1635,N/A,90,5
9,N/A,N/A,N/A,1616,1625,N/A,96,5
5,N/A,N/A,N/A,1611,1616,N/A,100,3
6,N/A,N/A,N/A,1605,1611,N/A,106,3
12,N/A,N/A,N/A,1593,1605,N/A,109,6
9,N/A,N/A,N/A,1584,1593,N/A,114,5
4,N/A,N/A,N/A,1580,1584,N/A,117,2
11,N/A,N/A,N/A,1569,1580,N/A,120,5
11,N/A,N/A,N/A,1558,1569,N/A,126,5
6,N/A,N/A,N/A,1552,1558,N/A,131,4
7,N/A,N/A,N/A,1545,1552,N/A,136,3
7,N/A,N/A,N/A,1538,1545,N/A,141,2
7,N/A,N/A,N/A,1175,1182,N/A,4,2
17,N/A,N/A,N/A,1158,1175,N/A,8,6
4,N/A,N/A,N/A,1154,1158,N/A,14,0
12,N/A,N/A,N/A,1142,1154,N/A,19,5
5,N/A,N/A,N/A,1137,1142,N/A,22,2
4,N/A,N/A,N/A,1133,1137,N/A,27,1
4,N/A,N/A,N/A,1129,1133,N/A,33,1
12,N/A,N/A,N/A,1117,1129,N/A,37,5
7,N/A,N/A,N/A,1110,1117,N/A,40,2
4,N/A,N/A,N/A,1106,1110,N/A,45,1
12,N/A,N/A,N/A,1094,1106,N/A,49,5
7,N/A,N/A,N/A,1087,1094,N/A,52,2
5,N/A,N/A,N/A,1082,1087,N/A,57,1
5,N/A,N/A,N/A,1077,1082,N/A,63,1
4,N/A,N/A,N/A,1073,1077,N/A,69,1
11,N/A,N/A,N/A,1062,1073,N/A,74,6
5,N/A,N/A,N/A,1057,1062,N/A,80,0
10,N/A,N/A,N/A,1047,1057,N/A,85,5
6,N/A,N/A,N/A,1041,1047,N/A,89,3
5,N/A,N/A,N/A,1036,1041,N/A,93,1
5,N/A,N/A,N/A,1031,1036,N/A,99,1
12,N/A,N/A,N/A,1019,1031,N/A,103,5
5,N/A,N/A,N/A,1014,1019,N/A,108,4
5,N/A,N/A,N/A,1009,1014,N/A,112,2
10,N/A,N/A,N/A,999,1009,N/A,115,5
6,N/A,N/A,N/A,993,999,N/A,120,4
4,N/A,N/A,N/A,989,993,N/A,124,2
12,N/A,N/A,N/A,977,989,N/A,128,6
5,N/A,N/A,N/A,972,977,N/A,134,0
10,N/A,N/A,N/A,962,972,N/A,139,5
5,N/A,N/A,N/A,572,577,N/A,6,1
7,N/A,N/A,N/A,565,572,N/A,9,4
6,N/A,N/A,N/A,559,565,N/A,15,4
5,N/A,N/A,N/A,554,559,N/A,18,1
9,N/A,N/A,N/A,545,554,N/A,22,5
7,N/A,N/A,N/A,538,545,N/A,27,4
7,N/A,N/A,N/A,531,538,N/A,33,4
4,N/A,N/A,N/A,527,531,N/A,37,2
13,N/A,N/A,N/A,514,527,N/A,41,6
11,N/A,N/A,N/A,503,514,N/A,46,5
11,N/A,N/A,N/A,492,503,N/A,52,5
6,N/A,N/A,N/A,486,492,N/A,56,3
5,N/A,N/A,N/A,481,486,N/A,62,3
11,N/A,N/A,N/A,470,481,N/A,65,6
10,N/A,N/A,N/A,460,470,N/A,70,5
7,N/A,N/A,N/A,453,460,N/A,75,4
7,N/A,N/A,N/A,446,453,N/A,80,3
14,N/A,N/A,N/A,432,446,N/A,83,6
5,N/A,N/A,N/A,427,432,N/A,87,4
7,N/A,N/A,N/A,420,427,N/A,92,3
11,N/A,N/A,N/A,409,420,N/A,95,6
9,N/A,N/A,N/A,400,409,N/A,100,5
4,N/A,N/A,N/A,396,400,N/A,104,3
4,N/A,N/A,N/A,392,396,N/A,108,1
4,N/A,N/A,N/A,388,392,N/A,114,1
4,N/A,N/A,N/A,384,388,N/A,120,1
15,N/A,N/A,N/A,369,384,N/A,125,6
4,N/A,N/A,N/A,365,369,N/A,131,0
6,N/A,N/A,N/A,359,365,N/A,135,4
5,N/A,N/A,N/A,354,359,N/A,138,1
14,N/A,N/A,N/A,403,417,N/A,3,6
5,N/A,N/A,N/A,398,403,N/A,9,0
12,N/A,N/A,N/A,386,398,N/A,15,6
4,N/A,N/A,N/A,382,386,N/A,21,0
8,N/A,N/A,N/A,374,382,N/A,25,4
6,N/A,N/A,N/A,368,374,N/A,31,4
6,N/A,N/A,N/A,362,368,N/A,36,3
16,N/A,N/A,N/A,346,362,N/A,39,6
9,N/A,N/A,N/A,337,346,N/A,44,5
7,N/A,N/A,N/A,330,337,N/A,49,4
5,N/A,N/A,N/A,325,330,N/A,52,1
13,N/A,N/A,N/A,312,325,N/A,57,6
5,N/A,N/A,N/A,307,312,N/A,63,0
5,N/A,N/A,N/A,302,307,N/A,66,3
7,N/A,N/A,N/A,295,302,N/A,71,2
11,N/A,N/A,N/A,284,295,N/A,74,5
4,N/A,N/A,N/A,280,284,N/A,77,2
6,N/A,N/A,N/A,274,280,N/A,83,2
5,N/A,N/A,N/A,269,274,N/A,88,1
5,N/A,N/A,N/A,264,269,N/A,91,4
4,N/A,N/A,N/A,260,264,N/A,94,1
10,N/A,N/A,N/A,250,260,N/A,98,5
6,N/A,N/A,N/A,244,250,N/A,103,4
4,N/A,N/A,N/A,240,244,N/A,108,3
4,N/A,N/A,N/A,236,240,N/A,112,1
17,N/A,N/A,N/A,219,236,N/A,117,6
8,N/A,N/A,N/A,211,219,N/A,121,4
6,N/A,N/A,N/A,205,211,N/A,125,2
5,N/A,N/A,N/A,200,205,N/A,130,1
11,N/A,N/A,N/A,189,200,N/A,135,6
5,N/A,N/A,N/A,1438,1443,N/A,3,1
5,N/A,N/A,N/A,1433,1438,N/A,6,4
4,N/A,N/A,N/A,1429,1433,N/A,11,3
6,N/A,N/A,N/A,1423,1429,N/A,17,3
10,N/A,N/A,N/A,1413,1423,N/A,20,6
9,N/A,N/A,N/A,1404,1413,N/A,25,5
6,N/A,N/A,N/A,1398,1404,N/A,29,3
4,N/A,N/A,N/A,1394,1398,N/A,34,2
5,N/A,N/A,N/A,1389,1394,N/A,39,1
17,N/A,N/A,N/A,1372,1389,N/A,44,6
8,N/A,N/A,N/A,1364,1372,N/A,48,4
4,N/A,N/A,N/A,1360,1364,N/A,51,1
11,N/A,N/A,N/A,1349,1360,N/A,55,5
12,N/A,N/A,N/A,1337,1349,N/A,61,5
9,N/A,N/A,N/A,1328,1337,N/A,67,5
10,N/A,N/A,N/A,1318,1328,N/A,73,5
6,N/A,N/A,N/A,1312,1318,N/A,77,3
6,N/A,N/A,N/A,1306,1312,N/A,82,2
15,N/A,N/A,N/A,1291,1306,N/A,86,6
5,N/A,N/A,N/A,1286,1291,N/A,90,4
5,N/A,N/A,N/A,1281,1286,N/A,93,1
14,N/A,N/A,N/A,1267,1281,N/A,98,6
5,N/A,N/A,N/A,1262,1267,N/A,104,0
10,N/A,N/A,N/A,1252,1262,N/A,110,6
12,N/A,N/A,N/A,1240,1252,N/A,115,5
5,N/A,N/A,N/A,1235,1240,N/A,118,2
4,N/A,N/A,N/A,1231,1235,N/A,123,1
13,N/A,N/A,N/A,1218,1231,N/A,128,6
5,N/A,N/A,N/A,1213,1218,N/A,132,4
5,N/A,N/A,N/A,1208,1213,N/A,138,4
6,N/A,N/A,N/A,1648,1654,N/A,4,2
15,N/A,N/A,N/A,1633,1648,N/A,8,6
5,N/A,N/A,N/A,1628,1633,N/A,14,0
6,N/A,N/A,N/A,1622,1628,N/A,17,3
7,N/A,N/A,N/A,1615,1622,N/A,23,3
4,N/A,N/A,N/A,1611,1615,N/A,27,1
16,N/A,N/A,N/A,1595,1611,N/A,32,6
7,N/A,N/A,N/A,1588,1595,N/A,36,4
6,N/A,N/A,N/A,1582,1588,N/A,42,4
4,N/A,N/A,N/A,1578,1582,N/A,47,3
18,N/A,N/A,N/A,1560,1578,N/A,50,6
7,N/A,N/A,N/A,1553,1560,N/A,54,4
7,N/A,N/A,N/A,1546,1553,N/A,59,3
7,N/A,N/A,N/A,1539,1546,N/A,64,2
4,N/A,N/A,N/A,1535,1539,N/A,69,1
8,N/A,N/A,N/A,1527,1535,N/A,72,4
4,N/A,N/A,N/A,1523,1527,N/A,75,1
15,N/A,N/A,N/A,1508,1523,N/A,80,6
6,N/A,N/A,N/A,1502,1508,N/A,84,4
6,N/A,N/A,N/A,1496,1502,N/A,90,4
6,N/A,N/A,N/A,1490,1496,N/A,94,2
11,N/A,N/A,N/A,1479,1490,N/A,97,5
6,N/A,N/A,N/A,1473,1479,N/A,102,4
4,N/A,N/A,N/A,1469,1473,N/A,105,1
5,N/A,N/A,N/A,1464,1469,N/A,111,1
12,N/A,N/A,N/A,1452,1464,N/A,116,6
5,N/A,N/A,N/A,1447,1452,N/A,122,0
10,N/A,N/A,N/A,1437,1447,N/A,127,5
12,N/A,N/A,N/A,1425,1437,N/A,133,5
11,N/A,N/A,N/A,1414,1425,N/A,139,5
8,N/A,N/A,N/A,395,403,N/A,6,4
6,N/A,N/A,N/A,389,395,N/A,12,4
8,N/A,N/A,N/A,381,389,N/A,18,4
5,N/A,N/A,N/A,376,381,N/A,22,2
4,N/A,N/A,N/A,372,376,N/A,27,1
10,N/A,N/A,N/A,362,372,N/A,31,5
8,N/A,N/A,N/A,354,362,N/A,36,4
4,N/A,N/A,N/A,350,354,N/A,39,1
6,N/A,N/A,N/A,344,350,N/A,42,4
4,N/A,N/A,N/A,340,344,N/A,45,1
10,N/A,N/A,N/A,330,340,N/A,49,5
5,N/A,N/A,N/A,325,330,N/A,52,2
18,N/A,N/A,N/A,307,325,N/A,56,6
4,N/A,N/A,N/A,303,307,N/A,62,0
12,N/A,N/A,N/A,291,303,N/A,68,6
11,N/A,N/A,N/A,280,291,N/A,73,5
5,N/A,N/A,N/A,275,280,N/A,76,2
11,N/A,N/A,N/A,264,275,N/A,80,6
8,N/A,N/A,N/A,256,264,N/A,84,4
7,N/A,N/A,N/A,249,256,N/A,88,2
5,N/A,N/A,N/A,244,249,N/A,94,2
4,N/A,N/A,N/A,240,244,N/A,99,1
8,N/A,N/A,N/A,232,240,N/A,102,4
6,N/A,N/A,N/A,226,232,N/A,108,4
8,N/A,N/A,N/A,218,226,N/A,114,4
6,N/A,N/A,N/A,212,218,N/A,118,2
19,N/A,N/A,N/A,193,212,N/A,122,6
8,N/A,N/A,N/A,185,193,N/A,126,4
5,N/A,N/A,N/A,180,185,N/A,131,3
18,N/A,N/A,N/A,162,180,N/A,134,6
7,N/A,N/A,N/A,1203,1210,N/A,4,2
18,N/A,N/A,N/A,1185,1203,N/A,8,6
4,N/A,N/A,N/A,1181,1185,N/A,14,0
19,N/A,N/A,N/A,1162,1181,N/A,20,6
6,N/A,N/A,N/A,1156,1162,N/A,24,4
7,N/A,N/A,N/A,1149,1156,N/A,29,3
4,N/A,N/A,N/A,1145,1149,N/A,35,3
6,N/A,N/A,N/A,1139,1145,N/A,40,2
11,N/A,N/A,N/A,1128,1139,N/A,44,6
10,N/A,N/A,N/A,1118,1128,N/A,49,5
5,N/A,N/A,N/A,1113,1118,N/A,52,2
4,N/A,N/A,N/A,1109,1113,N/A,57,1
4,N/A,N/A,N/A,1105,1109,N/A,63,1
4,N/A,N/A,N/A,1101,1105,N/A,69,1
8,N/A,N/A,N/A,1093,1101,N/A,72,4
6,N/A,N/A,N/A,1087,1093,N/A,78,4
6,N/A,N/A,N/A,1081,1087,N/A,83,3
13,N/A,N/A,N/A,1068,1081,N/A,86,6
8,N/A,N/A,N/A,1060,1068,N/A,90,4
5,N/A,N/A,N/A,1055,1060,N/A,96,4
4,N/A,N/A,N/A,1051,1055,N/A,100,2
5,N/A,N/A,N/A,1046,1051,N/A,105,1
17,N/A,N/A,N/A,1029,1046,N/A,110,6
12,N/A,N/A,N/A,1017,1029,N/A,115,5
4,N/A,N/A,N/A,1013,1017,N/A,118,2
12,N/A,N/A,N/A,1001,1013,N/A,121,5
12,N/A,N/A,N/A,989,1001,N/A,127,5
10,N/A,N/A,N/A,979,989,N/A,133,5
7,N/A,N/A,N/A,972,979,N/A,136,2
14,N/A,N/A,N/A,958,972,N/A,140,6
7,N/A,N/A,N/A,1175,1182,N/A,4,4
6,N/A,N/A,N/A,1169,1175,N/A,8,2
15,N/A,N/A,N/A,1154,1169,N/A,12,6
4,N/A,N/A,N/A,1150,1154,N/A,15,3
7,N/A,N/A,N/A,1143,1150,N/A,20,2
12,N/A,N/A,N/A,1131,1143,N/A,24,6
9,N/A,N/A,N/A,1122,1131,N/A,29,5
5,N/A,N/A,N/A,1117,1122,N/A,32,2
11,N/A,N/A,N/A,1106,1117,N/A,35,5
7,N/A,N/A,N/A,1099,1106,N/A,40,4
5,N/A,N/A,N/A,1094,1099,N/A,46,4
4,N/A,N/A,N/A,1090,1094,N/A,51,3
7,N/A,N/A,N/A,1083,1090,N/A,56,2
5,N/A,N/A,N/A,1078,1083,N/A,61,1
5,N/A,N/A,N/A,1073,1078,N/A,67,1
4,N/A,N/A,N/A,1069,1073,N/A,73,1
4,N/A,N/A,N/A,1065,1069,N/A,79,1
10,N/A,N/A,N/A,1055,1065,N/A,83,5
6,N/A,N/A,N/A,1049,1055,N/A,87,3
10,N/A,N/A,N/A,1039,1049,N/A,90,6
4,N/A,N/A,N/A,1035,1039,N/A,96,0
8,N/A,N/A,N/A,1027,1035,N/A,100,4
5,N/A,N/A,N/A,1022,1027,N/A,103,1
6,N/A,N/A,N/A,1016,1022,N/A,106,4
6,N/A,N/A,N/A,1010,1016,N/A,111,3
5,N/A,N/A,N/A,1005,1010,N/A,117,3
5,N/A,N/A,N/A,1000,1005,N/A,123,3
5,N/A,N/A,N/A,995,1000,N/A,127,1
19,N/A,N/A,N/A,976,995,N/A,132,6
5,N/A,N/A,N/A,971,976,N/A,138,0
5,N/A,N/A,N/A,358,363,N/A,3,1
5,N/A,N/A,N/A,353,358,N/A,6,4
7,N/A,N/A,N/A,346,353,N/A,11,3
5,N/A,N/A,N/A,341,346,N/A,15,1
11,N/A,N/A,N/A,330,341,N/A,20,6
4,N/A,N/A,N/A,326,330,N/A,23,3
10,N/A,N/A,N/A,316,326,N/A,26,6
6,N/A,N/A,N/A,310,316,N/A,29,3
7,N/A,N/A,N/A,303,310,N/A,35,3
11,N/A,N/A,N/A,292,303,N/A,38,6
5,N/A,N/A,N/A,287,292,N/A,42,4
6,N/A,N/A,N/A,281,287,N/A,48,4
5,N/A,N/A,N/A,276,281,N/A,51,1
15,N/A,N/A,N/A,261,276,N/A,56,6
11,N/A,N/A,N/A,250,261,N/A,61,5
5,N/A,N/A,N/A,245,250,N/A,64,2
12,N/A,N/A,N/A,233,245,N/A,67,5
12,N/A,N/A,N/A,221,233,N/A,73,5
7,N/A,N/A,N/A,214,221,N/A,77,3
5,N/A,N/A,N/A,209,214,N/A,81,1
8,N/A,N/A,N/A,201,209,N/A,84,4
4,N/A,N/A,N/A,197,201,N/A,87,1
5,N/A,N/A,N/A,192,197,N/A,90,4
6,N/A,N/A,N/A,186,192,N/A,95,3
13,N/A,N/A,N/A,173,186,N/A,98,6
4,N/A,N/A,N/A,169,173,N/A,104,0
8,N/A,N/A,N/A,161,169,N/A,108,4
4,N/A,N/A,N/A,157,161,N/A,113,3
6,N/A,N/A,N/A,151,157,N/A,118,2
13,N/A,N/A,N/A,138,151,N/A,122,6
6,N/A,N/A,N/A,1040,1046,N/A,4,3
5,N/A,N/A,N/A,1035,1040,N/A,8,1
16,N/A,N/A,N/A,1019,1035,N/A,13,6
4,N/A,N/A,N/A,1015,1019,N/A,19,0
11,N/A,N/A,N/A,1004,1015,N/A,25,6
4,N/A,N/A,N/A,1000,1004,N/A,31,0
18,N/A,N/A,N/A,982,1000,N/A,37,6
11,N/A,N/A,N/A,971,982,N/A,42,5
11,N/A,N/A,N/A,960,971,N/A,48,5
7,N/A,N/A,N/A,953,960,N/A,53,4
7,N/A,N/A,N/A,946,953,N/A,59,4
4,N/A,N/A,N/A,942,946,N/A,64,3
6,N/A,N/A,N/A,936,942,N/A,70,3
7,N/A,N/A,N/A,929,936,N/A,75,2
11,N/A,N/A,N/A,918,929,N/A,78,5
4,N/A,N/A,N/A,914,918,N/A,82,3
6,N/A,N/A,N/A,908,914,N/A,87,2
14,N/A,N/A,N/A,894,908,N/A,91,6
11,N/A,N/A,N/A,883,894,N/A,96,5
7,N/A,N/A,N/A,876,883,N/A,99,2
4,N/A,N/A,N/A,872,876,N/A,104,1
11,N/A,N/A,N/A,861,872,N/A,109,6
7,N/A,N/A,N/A,854,861,N/A,113,4
4,N/A,N/A,N/A,850,854,N/A,117,2
10,N/A,N/A,N/A,840,850,N/A,120,5
5,N/A,N/A,N/A,835,840,N/A,125,4
7,N/A,N/A,N/A,828,835,N/A,131,4
4,N/A,N/A,N/A,824,828,N/A,135,2
10,N/A,N/A,N/A,814,824,N/A,138,5
12,N/A,N/A,N/A,802,814,N/A,144,5
7,N/A,N/A,N/A,865,872,N/A,5,4
5,N/A,N/A,N/A,860,865,N/A,8,1
7,N/A,N/A,N/A,853,860,N/A,11,4
6,N/A,N/A,N/A,847,853,N/A,17,4
4,N/A,N/A,N/A,843,847,N/A,22,3
5,N/A,N/A,N/A,838,843,N/A,27,2
9,N/A,N/A,N/A,829,838,N/A,30,5
6,N/A,N/A,N/A,823,829,N/A,33,2
12,N/A,N/A,N/A,811,823,N/A,36,5
6,N/A,N/A,N/A,805,811,N/A,40,3
4,N/A,N/A,N/A,801,805,N/A,44,1
13,N/A,N/A,N/A,788,801,N/A,49,6
10,N/A,N/A,N/A,778,788,N/A,54,5
5,N/A,N/A,N/A,773,778,N/A,59,4
4,N/A,N/A,N/A,769,773,N/A,64,3
4,N/A,N/A,N/A,765,769,N/A,70,3
4,N/A,N/A,N/A,761,765,N/A,74,1
8,N/A,N/A,N/A,753,761,N/A,77,4
4,N/A,N/A,N/A,749,753,N/A,81,2
18,N/A,N/A,N/A,731,749,N/A,85,6
4,N/A,N/A,N/A,727,731,N/A,88,3
7,N/A,N/A,N/A,720,727,N/A,94,3
6,N/A,N/A,N/A,714,720,N/A,100,3
7,N/A,N/A,N/A,707,714,N/A,106,3
4,N/A,N/A,N/A,703,707,N/A,110,1
9,N/A,N/A,N/A,694,703,N/A,114,5
11,N/A,N/A,N/A,683,694,N/A,120,5
10,N/A,N/A,N/A,673,683,N/A,126,5
12,N/A,N/A,N/A,661,673,N/A,132,5
4,N/A,N/A,N/A,657,661,N/A,135,2
12,N/A,N/A,N/A,1378,1390,N/A,5,5
9,N/A,N/A,N/A,1369,1378,N/A,11,5
7,N/A,N/A,N/A,1362,1369,N/A,15,3
5,N/A,N/A,N/A,1357,1362,N/A,19,1
8,N/A,N/A,N/A,1349,1357,N/A,22,4
6,N/A,N/A,N/A,1343,1349,N/A,28,4
7,N/A,N/A,N/A,1336,1343,N/A,33,3
10,N/A,N/A,N/A,1326,1336,N/A,36,6
7,N/A,N/A,N/A,1319,1326,N/A,39,3
17,N/A,N/A,N/A,1302,1319,N/A,42,6
6,N/A,N/A,N/A,1296,1302,N/A,46,4
4,N/A,N/A,N/A,1292,1296,N/A,49,1
5,N/A,N/A,N/A,1287,1292,N/A,55,1
18,N/A,N/A,N/A,1269,1287,N/A,60,6
9,N/A,N/A,N/A,1260,1269,N/A,65,5
4,N/A,N/A,N/A,1256,1260,N/A,69,3
5,N/A,N/A,N/A,1251,1256,N/A,75,3
13,N/A,N/A,N/A,1238,1251,N/A,78,6
9,N/A,N/A,N/A,1229,1238,N/A,83,5
9,N/A,N/A,N/A,1220,1229,N/A,89,5
5,N/A,N/A,N/A,1215,1220,N/A,93,3
5,N/A,N/A,N/A,1210,1215,N/A,97,1
13,N/A,N/A,N/A,1197,1210,N/A,102,6
4,N/A,N/A,N/A,1193,1197,N/A,108,0
12,N/A,N/A,N/A,1181,1193,N/A,113,5
5,N/A,N/A,N/A,1176,1181,N/A,116,2
9,N/A,N/A,N/A,1167,1176,N/A,119,5
9,N/A,N/A,N/A,1158,1167,N/A,125,5
7,N/A,N/A,N/A,1151,1158,N/A,129,3
4,N/A,N/A,N/A,1147,1151,N/A,133,1
4,N/A,N/A,N/A,1872,1876,N/A,3,2
14,N/A,N/A,N/A,1858,1872,N/A,7,6
4,N/A,N/A,N/A,1854,1858,N/A,10,3
4,N/A,N/A,N/A,1850,1854,N/A,14,1
11,N/A,N/A,N/A,1839,1850,N/A,18,5
7,N/A,N/A,N/A,1832,1839,N/A,22,3
5,N/A,N/A,N/A,1827,1832,N/A,28,3
7,N/A,N/A,N/A,1820,1827,N/A,34,3
11,N/A,N/A,N/A,1809,1820,N/A,37,6
6,N/A,N/A,N/A,1803,1809,N/A,40,3
5,N/A,N/A,N/A,1798,1803,N/A,44,1
10,N/A,N/A,N/A,1788,1798,N/A,48,5
4,N/A,N/A,N/A,1784,1788,N/A,52,3
5,N/A,N/A,N/A,1779,1784,N/A,56,1
4,N/A,N/A,N/A,1775,1779,N/A,62,1
10,N/A,N/A,N/A,1765,1775,N/A,66,5
5,N/A,N/A,N/A,1760,1765,N/A,71,4
5,N/A,N/A,N/A,1755,1760,N/A,75,2
9,N/A,N/A,N/A,1746,1755,N/A,78,5
11,N/A,N/A,N/A,1735,1746,N/A,84,5
5,N/A,N/A,N/A,1730,1735,N/A,88,3
6,N/A,N/A,N/A,1724,1730,N/A,93,2
9,N/A,N/A,N/A,1715,1724,N/A,96,5
10,N/A,N/A,N/A,1705,1715,N/A,102,5
6,N/A,N/A,N/A,1699,1705,N/A,105,2
17,N/A,N/A,N/A,1682,1699,N/A,109,6
4,N/A,N/A,N/A,1678,1682,N/A,115,0
4,N/A,N/A,N/A,1674,1678,N/A,118,3
5,N/A,N/A,N/A,1669,1674,N/A,124,3
6,N/A,N/A,N/A,1663,1669,N/A,129,2
14,N/A,N/A,N/A,1535,1549,N/A,6,6
5,N/A,N/A,N/A,1530,1535,N/A,9,3
6,N/A,N/A,N/A,1524,1530,N/A,15,3
19,N/A,N/A,N/A,1505,1524,N/A,18,6
5,N/A,N/A,N/A,1500,1505,N/A,24,0
12,N/A,N/A,N/A,1488,1500,N/A,29,5
5,N/A,N/A,N/A,1483,1488,N/A,32,2
4,N/A,N/A,N/A,1479,1483,N/A,37,1
6,N/A,N/A,N/A,1473,1479,N/A,40,4
4,N/A,N/A,N/A,1469,1473,N/A,45,3
12,N/A,N/A,N/A,1457,1469,N/A,48,6
4,N/A,N/A,N/A,1453,1457,N/A,51,3
11,N/A,N/A,N/A,1442,1453,N/A,54,6
7,N/A,N/A,N/A,1435,1442,N/A,57,3
5,N/A,N/A,N/A,1430,1435,N/A,62,2
12,N/A,N/A,N/A,1418,1430,N/A,65,5
8,N/A,N/A,N/A,1410,1418,N/A,70,4
7,N/A,N/A,N/A,1403,1410,N/A,76,4
7,N/A,N/A,N/A,1396,1403,N/A,80,2
18,N/A,N/A,N/A,1378,1396,N/A,84,6
5,N/A,N/A,N/A,1373,1378,N/A,88,4
4,N/A,N/A,N/A,1369,1373,N/A,91,1
19,N/A,N/A,N/A,1350,1369,N/A,96,6
5,N/A,N/A,N/A,1345,1350,N/A,102,0
5,N/A,N/A,N/A,1340,1345,N/A,105,3
7,N/A,N/A,N/A,1333,1340,N/A,110,2
12,N/A,N/A,N/A,1321,1333,N/A,113,5
8,N/A,N/A,N/A,1313,1321,N/A,118,4
5,N/A,N/A,N/A,1308,1313,N/A,124,4
4,N/A,N/A,N/A,1304,1308,N/A,129,3
7,N/A,N/A,N/A,1473,1480,N/A,5,4
4,N/A,N/A,N/A,1469,1473,N/A,8,1
11,N/A,N/A,N/A,1458,1469,N/A,12,5
11,N/A,N/A,N/A,1447,1458,N/A,18,5
12,N/A,N/A,N/A,1435,1447,N/A,24,5
9,N/A,N/A,N/A,1426,1435,N/A,30,5
4,N/A,N/A,N/A,1422,1426,N/A,33,2
10,N/A,N/A,N/A,1412,1422,N/A,36,5
9,N/A,N/A,N/A,1403,1412,N/A,42,5
11,N/A,N/A,N/A,1392,1403,N/A,48,5
10,N/A,N/A,N/A,1382,1392,N/A,54,5
5,N/A,N/A,N/A,1377,1382,N/A,59,4
4,N/A,N/A,N/A,1373,1377,N/A,64,3
6,N/A,N/A,N/A,1367,1373,N/A,70,3
4,N/A,N/A,N/A,1363,1367,N/A,74,1
18,N/A,N/A,N/A,1345,1363,N/A,79,6
8,N/A,N/A,N/A,1337,1345,N/A,83,4
4,N/A,N/A,N/A,1333,1337,N/A,86,1
10,N/A,N/A,N/A,1323,1333,N/A,90,5
6,N/A,N/A,N/A,1317,1323,N/A,93,2
5,N/A,N/A,N/A,1312,1317,N/A,98,1
4,N/A,N/A,N/A,1308,1312,N/A,104,1
8,N/A,N/A,N/A,1300,1308,N/A,107,4
8,N/A,N/A,N/A,1292,1300,N/A,113,4
4,N/A,N/A,N/A,1288,1292,N/A,118,3
4,N/A,N/A,N/A,1284,1288,N/A,122,1
5,N/A,N/A,N/A,1279,1284,N/A,128,1
4,N/A,N/A,N/A,1275,1279,N/A,134,1
8,N/A,N/A,N/A,1267,1275,N/A,137,4
4,N/A,N/A,N/A,1263,1267,N/A,142,3
5,N/A,N/A,N/A,1189,1194,N/A,5,1
4,N/A,N/A,N/A,1185,1189,N/A,11,1
4,N/A,N/A,N/A,1181,1185,N/A,17,1
10,N/A,N/A,N/A,1171,1181,N/A,22,6
10,N/A,N/A,N/A,1161,1171,N/A,27,5
11,N/A,N/A,N/A,1150,1161,N/A,33,5
7,N/A,N/A,N/A,1143,1150,N/A,36,2
16,N/A,N/A,N/A,1127,1143,N/A,40,6
5,N/A,N/A,N/A,1122,1127,N/A,44,4
6,N/A,N/A,N/A,1116,1122,N/A,50,4
5,N/A,N/A,N/A,1111,1116,N/A,55,3
7,N/A,N/A,N/A,1104,1111,N/A,60,2
5,N/A,N/A,N/A,1099,1104,N/A,65,1
11,N/A,N/A,N/A,1088,1099,N/A,69,5
11,N/A,N/A,N/A,1077,1088,N/A,75,5
4,N/A,N/A,N/A,1073,1077,N/A,79,3
6,N/A,N/A,N/A,1067,1073,N/A,85,3
7,N/A,N/A,N/A,1060,1067,N/A,91,3
5,N/A,N/A,N/A,1055,1060,N/A,95,1
6,N/A,N/A,N/A,1049,1055,N/A,98,4
4,N/A,N/A,N/A,1045,1049,N/A,103,3
5,N/A,N/A,N/A,1040,1045,N/A,107,1
7,N/A,N/A,N/A,1033,1040,N/A,110,4
6,N/A,N/A,N/A,1027,1033,N/A,115,3
5,N/A,N/A,N/A,1022,1027,N/A,120,2
14,N/A,N/A,N/A,1008,1022,N/A,124,6
5,N/A,N/A,N/A,1003,1008,N/A,130,0
12,N/A,N/A,N/A,991,1003,N/A,136,6
4,N/A,N/A,N/A,987,991,N/A,142,0
6,N/A,N/A,N/A,981,987,N/A,145,3
11,N/A,N/A,N/A,1853,1864,N/A,3,5
7,N/A,N/A,N/A,1846,1853,N/A,6,2
12,N/A,N/A,N/A,1834,1846,N/A,10,6
8,N/A,N/A,N/A,1826,1834,N/A,14,4
6,N/A,N/A,N/A,1820,1826,N/A,19,3
5,N/A,N/A,N/A,1815,1820,N/A,23,1
10,N/A,N/A,N/A,1805,1815,N/A,27,5
5,N/A,N/A,N/A,1800,1805,N/A,31,3
4,N/A,N/A,N/A,1796,1800,N/A,37,3
4,N/A,N/A,N/A,1792,1796,N/A,41,1
9,N/A,N/A,N/A,1783,1792,N/A,45,5
10,N/A,N/A,N/A,1773,1783,N/A,51,5
11,N/A,N/A,N/A,1762,1773,N/A,57,5
10,N/A,N/A,N/A,1752,1762,N/A,63,5
6,N/A,N/A,N/A,1746,1752,N/A,68,4
4,N/A,N/A,N/A,1742,1746,N/A,73,3
4,N/A,N/A,N/A,1738,1742,N/A,77,1
5,N/A,N/A,N/A,1733,1738,N/A,83,1
7,N/A,N/A,N/A,1726,1733,N/A,86,4
4,N/A,N/A,N/A,1722,1726,N/A,89,1
4,N/A,N/A,N/A,1718,1722,N/A,95,1
4,N/A,N/A,N/A,1714,1718,N/A,101,1
5,N/A,N/A,N/A,1709,1714,N/A,104,4
5,N/A,N/A,N/A,1704,1709,N/A,108,2
10,N/A,N/A,N/A,1694,1704,N/A,111,5
7,N/A,N/A,N/A,1687,1694,N/A,116,4
6,N/A,N/A,N/A,1681,1687,N/A,120,2
11,N/A,N/A,N/A,1670,1681,N/A,123,5
7,N/A,N/A,N/A,1663,1670,N/A,126,2
7,N/A,N/A,N/A,1656,1663,N/A,132,2
12,N/A,N/A,N/A,1950,1962,N/A,6,5
6,N/A,N/A,N/A,1944,1950,N/A,10,3
16,N/A,N/A,N/A,1928,1944,N/A,13,6
5,N/A,N/A,N/A,1923,1928,N/A,19,0
6,N/A,N/A,N/A,1917,1923,N/A,22,3
4,N/A,N/A,N/A,1913,1917,N/A,26,1
5,N/A,N/A,N/A,1908,1913,N/A,32,1
11,N/A,N/A,N/A,1897,1908,N/A,37,6
7,N/A,N/A,N/A,1890,1897,N/A,40,3
10,N/A,N/A,N/A,1880,1890,N/A,43,6
11,N/A,N/A,N/A,1869,1880,N/A,48,5
10,N/A,N/A,N/A,1859,1869,N/A,54,5
7,N/A,N/A,N/A,1852,1859,N/A,59,4
5,N/A,N/A,N/A,1847,1852,N/A,64,3
4,N/A,N/A,N/A,1843,1847,N/A,70,3
7,N/A,N/A,N/A,1836,1843,N/A,76,3
13,N/A,N/A,N/A,1823,1836,N/A,79,6
5,N/A,N/A,N/A,1818,1823,N/A,85,0
11,N/A,N/A,N/A,1807,1818,N/A,90,5
8,N/A,N/A,N/A,1799,1807,N/A,95,4
4,N/A,N/A,N/A,1795,1799,N/A,98,1
10,N/A,N/A,N/A,1785,1795,N/A,102,5
4,N/A,N/A,N/A,1781,1785,N/A,106,3
6,N/A,N/A,N/A,1775,1781,N/A,111,2
7,N/A,N/A,N/A,1768,1775,N/A,117,2
6,N/A,N/A,N/A,1762,1768,N/A,123,2
4,N/A,N/A,N/A,1758,1762,N/A,129,2
17,N/A,N/A,N/A,1741,1758,N/A,133,6
12,N/A,N/A,N/A,1729,1741,N/A,138,5
5,N/A,N/A,N/A,1724,1729,N/A,141,2
4,N/A,N/A,N/A,923,927,N/A,5,1
5,N/A,N/A,N/A,918,923,N/A,11,1
5,N/A,N/A,N/A,913,918,N/A,17,1
10,N/A,N/A,N/A,903,913,N/A,22,6
7,N/A,N/A,N/A,896,903,N/A,25,3
5,N/A,N/A,N/A,891,896,N/A,29,1
16,N/A,N/A,N/A,875,891,N/A,34,6
5,N/A,N/A,N/A,870,875,N/A,40,0
13,N/A,N/A,N/A,857,870,N/A,46,6
11,N/A,N/A,N/A,846,857,N/A,51,5
5,N/A,N/A,N/A,841,846,N/A,56,4
5,N/A,N/A,N/A,836,841,N/A,61,3
14,N/A,N/A,N/A,822,836,N/A,64,6
4,N/A,N/A,N/A,818,822,N/A,70,0
15,N/A,N/A,N/A,803,818,N/A,76,6
7,N/A,N/A,N/A,796,803,N/A,80,4
4,N/A,N/A,N/A,792,796,N/A,83,1
4,N/A,N/A,N/A,788,792,N/A,89,1
11,N/A,N/A,N/A,777,788,N/A,93,5
12,N/A,N/A,N/A,765,777,N/A,99,5
7,N/A,N/A,N/A,758,765,N/A,103,3
19,N/A,N/A,N/A,739,758,N/A,106,6
4,N/A,N/A,N/A,735,739,N/A,112,0
6,N/A,N/A,N/A,729,735,N/A,116,4
4,N/A,N/A,N/A,725,729,N/A,120,2
18,N/A,N/A,N/A,707,725,N/A,124,6
7,N/A,N/A,N/A,700,707,N/A,128,4
4,N/A,N/A,N/A,696,700,N/A,131,1
6,N/A,N/A,N/A,690,696,N/A,134,4
6,N/A,N/A,N/A,684,690,N/A,138,2
5,N/A,N/A,N/A,1916,1921,N/A,4,1
5,N/A,N/A,N/A,1911,1916,N/A,10,1
4,N/A,N/A,N/A,1907,1911,N/A,16,1
8,N/A,N/A,N/A,1899,1907,N/A,19,4
5,N/A,N/A,N/A,1894,1899,N/A,22,1
9,N/A,N/A,N/A,1885,1894,N/A,26,5
9,N/A,N/A,N/A,1876,1885,N/A,32,5
5,N/A,N/A,N/A,1871,1876,N/A,37,4
6,N/A,N/A,N/A,1865,1871,N/A,41,2
12,N/A,N/A,N/A,1853,1865,N/A,45,6
11,N/A,N/A,N/A,1842,1853,N/A,50,5
7,N/A,N/A,N/A,1835,1842,N/A,53,2
4,N/A,N/A,N/A,1831,1835,N/A,59,2
11,N/A,N/A,N/A,1820,1831,N/A,62,5
9,N/A,N/A,N/A,1811,1820,N/A,68,5
10,N/A,N/A,N/A,1801,1811,N/A,74,5
11,N/A,N/A,N/A,1790,1801,N/A,80,5
5,N/A,N/A,N/A,1785,1790,N/A,83,2
19,N/A,N/A,N/A,1766,1785,N/A,87,6
12,N/A,N/A,N/A,1754,1766,N/A,92,5
7,N/A,N/A,N/A,1747,1754,N/A,95,2
5,N/A,N/A,N/A,1742,1747,N/A,100,1
7,N/A,N/A,N/A,1735,1742,N/A,103,4
5,N/A,N/A,N/A,1730,1735,N/A,109,4
4,N/A,N/A,N/A,1726,1730,N/A,112,1
12,N/A,N/A,N/A,1714,1726,N/A,116,5
7,N/A,N/A,N/A,1707,1714,N/A,119,2
11,N/A,N/A,N/A,1696,1707,N/A,122,5
7,N/A,N/A,N/A,1689,1696,N/A,127,4
5,N/A,N/A,N/A,1684,1689,N/A,131,2
13,N/A,N/A,N/A,1568,1581,N/A,3,6
5,N/A,N/A,N/A,1563,1568,N/A,9,0
18,N/A,N/A,N/A,1545,1563,N/A,15,6
7,N/A,N/A,N/A,1538,1545,N/A,18,3
4,N/A,N/A,N/A,1534,1538,N/A,22,1
11,N/A,N/A,N/A,1523,1534,N/A,27,6
11,N/A,N/A,N/A,1512,1523,N/A,32,5
4,N/A,N/A,N/A,1508,1512,N/A,35,2
10,N/A,N/A,N/A,1498,1508,N/A,38,5
7,N/A,N/A,N/A,1491,1498,N/A,42,3
7,N/A,N/A,N/A,1484,1491,N/A,48,3
7,N/A,N/A,N/A,1477,1484,N/A,53,2
4,N/A,N/A,N/A,1473,1477,N/A,58,1
10,N/A,N/A,N/A,1463,1473,N/A,63,6
9,N/A,N/A,N/A,1454,1463,N/A,68,5
11,N/A,N/A,N/A,1443,1454,N/A,74,5
6,N/A,N/A,N/A,1437,1443,N/A,77,2
10,N/A,N/A,N/A,1427,1437,N/A,80,5
9,N/A,N/A,N/A,1418,1427,N/A,86,5
7,N/A,N/A,N/A,1411,1418,N/A,91,4
6,N/A,N/A,N/A,1405,1411,N/A,97,4
4,N/A,N/A,N/A,1401,1405,N/A,101,2
5,N/A,N/A,N/A,1396,1401,N/A,106,1
14,N/A,N/A,N/A,1382,1396,N/A,111,6
5,N/A,N/A,N/A,1377,1382,N/A,117,0
11,N/A,N/A,N/A,1366,1377,N/A,122,5
5,N/A,N/A,N/A,1361,1366,N/A,125,2
5,N/A,N/A,N/A,1356,1361,N/A,130,1
5,N/A,N/A,N/A,1351,1356,N/A,136,1
9,N/A,N/A,N/A,1342,1351,N/A,140,5
5,N/A,N/A,N/A,1740,1745,N/A,6,4
4,N/A,N/A,N/A,1736,1740,N/A,9,1
5,N/A,N/A,N/A,1731,1736,N/A,15,1
17,N/A,N/A,N/A,1714,1731,N/A,20,6
7,N/A,N/A,N/A,1707,1714,N/A,24,4
5,N/A,N/A,N/A,1702,1707,N/A,30,4
7,N/A,N/A,N/A,1695,1702,N/A,35,3
10,N/A,N/A,N/A,1685,1695,N/A,38,6
5,N/A,N/A,N/A,1680,1685,N/A,44,0
12,N/A,N/A,N/A,1668,1680,N/A,50,6
11,N/A,N/A,N/A,1657,1668,N/A,55,5
6,N/A,N/A,N/A,1651,1657,N/A,60,4
4,N/A,N/A,N/A,1647,1651,N/A,63,1
12,N/A,N/A,N/A,1635,1647,N/A,67,5
6,N/A,N/A,N/A,1629,1635,N/A,71,3
11,N/A,N/A,N/A,1618,1629,N/A,74,6
6,N/A,N/A,N/A,1612,1618,N/A,77,3
6,N/A,N/A,N/A,1606,1612,N/A,83,3
7,N/A,N/A,N/A,1599,1606,N/A,89,3
7,N/A,N/A,N/A,1592,1599,N/A,95,3
16,N/A,N/A,N/A,1576,1592,N/A,98,6
8,N/A,N/A,N/A,1568,1576,N/A,102,4
4,N/A,N/A,N/A,1564,1568,N/A,105,1
5,N/A,N/A,N/A,1559,1564,N/A,108,4
5,N/A,N/A,N/A,1554,1559,N/A,111,1
10,N/A,N/A,N/A,1544,1554,N/A,116,6
6,N/A,N/A,N/A,1538,1544,N/A,119,3
17,N/A,N/A,N/A,1521,1538,N/A,122,6
7,N/A,N/A,N/A,1514,1521,N/A,125,3
5,N/A,N/A,N/A,1509,1514,N/A,131,3
7,N/A,N/A,N/A,1859,1866,N/A,6,4
4,N/A,N/A,N/A,1855,1859,N/A,11,3
17,N/A,N/A,N/A,1838,1855,N/A,14,6
4,N/A,N/A,N/A,1834,1838,N/A,17,3
14,N/A,N/A,N/A,1820,1834,N/A,20,6
12,N/A,N/A,N/A,1808,1820,N/A,25,5
5,N/A,N/A,N/A,1803,1808,N/A,28,2
4,N/A,N/A,N/A,1799,1803,N/A,33,1
6,N/A,N/A,N/A,1793,1799,N/A,36,4
6,N/A,N/A,N/A,1787,1793,N/A,42,4
5,N/A,N/A,N/A,1782,1787,N/A,45,1
8,N/A,N/A,N/A,1774,1782,N/A,48,4
4,N/A,N/A,N/A,1770,1774,N/A,51,1
10,N/A,N/A,N/A,1760,1770,N/A,56,6
8,N/A,N/A,N/A,1752,1760,N/A,60,4
5,N/A,N/A,N/A,1747,1752,N/A,65,3
5,N/A,N/A,N/A,1742,1747,N/A,69,1
14,N/A,N/A,N/A,1728,1742,N/A,74,6
7,N/A,N/A,N/A,1721,1728,N/A,78,4
5,N/A,N/A,N/A,1716,1721,N/A,84,4
6,N/A,N/A,N/A,1710,1716,N/A,90,4
4,N/A,N/A,N/A,1706,1710,N/A,94,2
9,N/A,N/A,N/A,1697,1706,N/A,97,5
5,N/A,N/A,N/A,1692,1697,N/A,100,2
10,N/A,N/A,N/A,1682,1692,N/A,103,5
7,N/A,N/A,N/A,1675,1682,N/A,107,3
5,N/A,N/A,N/A,1670,1675,N/A,111,1
17,N/A,N/A,N/A,1653,1670,N/A,116,6
5,N/A,N/A,N/A,1648,1653,N/A,122,0
10,N/A,N/A,N/A,1638,1648,N/A,127,5
5,N/A,N/A,N/A,1463,1468,N/A,3,1
4,N/A,N/A,N/A,1459,1463,N/A,9,1
5,N/A,N/A,N/A,1454,1459,N/A,15,1
16,N/A,N/A,N/A,1438,1454,N/A,20,6
6,N/A,N/A,N/A,1432,1438,N/A,23,3
19,N/A,N/A,N/A,1413,1432,N/A,26,6
5,N/A,N/A,N/A,1408,1413,N/A,30,4
7,N/A,N/A,N/A,1401,1408,N/A,34,2
4,N/A,N/A,N/A,1397,1401,N/A,39,1
5,N/A,N/A,N/A,1392,1397,N/A,45,1
7,N/A,N/A,N/A,1385,1392,N/A,48,4
4,N/A,N/A,N/A,1381,1385,N/A,52,2
12,N/A,N/A,N/A,1369,1381,N/A,55,5
12,N/A,N/A,N/A,1357,1369,N/A,61,5
7,N/A,N/A,N/A,1350,1357,N/A,66,4
7,N/A,N/A,N/A,1343,1350,N/A,72,4
7,N/A,N/A,N/A,1336,1343,N/A,78,4
6,N/A,N/A,N/A,1330,1336,N/A,83,3
10,N/A,N/A,N/A,1320,1330,N/A,86,6
10,N/A,N/A,N/A,1310,1320,N/A,91,5
7,N/A,N/A,N/A,1303,1310,N/A,96,4
4,N/A,N/A,N/A,1299,1303,N/A,99,1
12,N/A,N/A,N/A,1287,1299,N/A,103,5
7,N/A,N/A,N/A,1280,1287,N/A,106,2
10,N/A,N/A,N/A,1270,1280,N/A,109,5
11,N/A,N/A,N/A,1259,1270,N/A,115,5
6,N/A,N/A,N/A,1253,1259,N/A,119,3
7,N/A,N/A,N/A,1246,1253,N/A,125,3
7,N/A,N/A,N/A,1239,1246,N/A,131,3
14,N/A,N/A,N/A,1225,1239,N/A,134,6
7,N/A,N/A,N/A,371,378,N/A,4,4
5,N/A,N/A,N/A,366,371,N/A,8,2
14,N/A,N/A,N/A,352,366,N/A,12,6
8,N/A,N/A,N/A,344,352,N/A,16,4
4,N/A,N/A,N/A,340,344,N/A,21,3
6,N/A,N/A,N/A,334,340,N/A,26,2
5,N/A,N/A,N/A,329,334,N/A,31,1
11,N/A,N/A,N/A,318,329,N/A,35,5
8,N/A,N/A,N/A,310,318,N/A,40,4
6,N/A,N/A,N/A,304,310,N/A,45,3
4,N/A,N/A,N/A,300,304,N/A,49,1
8,N/A,N/A,N/A,292,300,N/A,52,4
6,N/A,N/A,N/A,286,292,N/A,56,2
4,N/A,N/A,N/A,282,286,N/A,62,2
9,N/A,N/A,N/A,273,282,N/A,65,5
4,N/A,N/A,N/A,269,273,N/A,69,3
6,N/A,N/A,N/A,263,269,N/A,74,2
18,N/A,N/A,N/A,245,263,N/A,78,6
5,N/A,N/A,N/A,240,245,N/A,84,0
7,N/A,N/A,N/A,233,240,N/A,87,3
4,N/A,N/A,N/A,229,233,N/A,93,3
15,N/A,N/A,N/A,214,229,N/A,96,6
4,N/A,N/A,N/A,210,214,N/A,102,0
7,N/A,N/A,N/A,203,210,N/A,106,4
4,N/A,N/A,N/A,199,203,N/A,109,1
7,N/A,N/A,N/A,192,199,N/A,112,4
4,N/A,N/A,N/A,188,192,N/A,117,3
5,N/A,N/A,N/A,183,188,N/A,121,1
5,N/A,N/A,N/A,178,183,N/A,127,1
8,N/A,N/A,N/A,170,178,N/A,130,4
4,N/A,N/A,N/A,1187,1191,N/A,3,1
17,N/A,N/A,N/A,1170,1187,N/A,8,6
7,N/A,N/A,N/A,1163,1170,N/A,12,4
7,N/A,N/A,N/A,1156,1163,N/A,17,3
7,N/A,N/A,N/A,1149,1156,N/A,23,3
17,N/A,N/A,N/A,1132,1149,N/A,26,6
4,N/A,N/A,N/A,1128,1132,N/A,29,3
15,N/A,N/A,N/A,1113,1128,N/A,32,6
4,N/A,N/A,N/A,1109,1113,N/A,38,0
5,N/A,N/A,N/A,1104,1109,N/A,42,4
5,N/A,N/A,N/A,1099,1104,N/A,45,1
4,N/A,N/A,N/A,1095,1099,N/A,51,1
15,N/A,N/A,N/A,1080,1095,N/A,56,6
5,N/A,N/A,N/A,1075,1080,N/A,60,4
4,N/A,N/A,N/A,1071,1075,N/A,63,1
5,N/A,N/A,N/A,1066,1071,N/A,69,1
6,N/A,N/A,N/A,1060,1066,N/A,72,4
5,N/A,N/A,N/A,1055,1060,N/A,76,2
5,N/A,N/A,N/A,1050,1055,N/A,81,1
15,N/A,N/A,N/A,1035,1050,N/A,86,6
6,N/A,N/A,N/A,1029,1035,N/A,90,4
4,N/A,N/A,N/A,1025,1029,N/A,93,1
5,N/A,N/A,N/A,1020,1025,N/A,99,1
11,N/A,N/A,N/A,1009,1020,N/A,103,5
5,N/A,N/A,N/A,1004,1009,N/A,106,2
5,N/A,N/A,N/A,999,1004,N/A,111,1
13,N/A,N/A,N/A,986,999,N/A,116,6
4,N/A,N/A,N/A,982,986,N/A,122,0
4,N/A,N/A,N/A,978,982,N/A,125,3
4,N/A,N/A,N/A,974,978,N/A,131,3
7,N/A,N/A,N/A,451,458,N/A,5,4
5,N/A,N/A,N/A,446,451,N/A,10,3
5,N/A,N/A,N/A,441,446,N/A,15,2
15,N/A,N/A,N/A,426,441,N/A,19,6
5,N/A,N/A,N/A,421,426,N/A,25,0
6,N/A,N/A,N/A,415,421,N/A,29,4
5,N/A,N/A,N/A,410,415,N/A,33,2
12,N/A,N/A,N/A,398,410,N/A,36,5
5,N/A,N/A,N/A,393,398,N/A,41,4
6,N/A,N/A,N/A,387,393,N/A,47,4
8,N/A,N/A,N/A,379,387,N/A,53,4
5,N/A,N/A,N/A,374,379,N/A,56,1
19,N/A,N/A,N/A,355,374,N/A,61,6
5,N/A,N/A,N/A,350,355,N/A,67,0
9,N/A,N/A,N/A,341,350,N/A,72,5
6,N/A,N/A,N/A,335,341,N/A,76,3
6,N/A,N/A,N/A,329,335,N/A,82,3
16,N/A,N/A,N/A,313,329,N/A,85,6
9,N/A,N/A,N/A,304,313,N/A,90,5
7,N/A,N/A,N/A,297,304,N/A,94,3
7,N/A,N/A,N/A,290,297,N/A,99,2
11,N/A,N/A,N/A,279,290,N/A,102,5
6,N/A,N/A,N/A,273,279,N/A,105,2
4,N/A,N/A,N/A,269,273,N/A,110,1
5,N/A,N/A,N/A,264,269,N/A,113,4
4,N/A,N/A,N/A,260,264,N/A,117,2
6,N/A,N/A,N/A,254,260,N/A,123,2
17,N/A,N/A,N/A,237,254,N/A,127,6
5,N/A,N/A,N/A,232,237,N/A,131,4
4,N/A,N/A,N/A,228,232,N/A,135,2
11,N/A,N/A,N/A,692,703,N/A,4,6
7,N/A,N/A,N/A,685,692,N/A,7,3
4,N/A,N/A,N/A,681,685,N/A,12,2
15,N/A,N/A,N/A,666,681,N/A,16,6
6,N/A,N/A,N/A,660,666,N/A,20,4
4,N/A,N/A,N/A,656,660,N/A,24,2
13,N/A,N/A,N/A,643,656,N/A,28,6
7,N/A,N/A,N/A,636,643,N/A,32,4
7,N/A,N/A,N/A,629,636,N/A,37,3
7,N/A,N/A,N/A,622,629,N/A,42,2
19,N/A,N/A,N/A,603,622,N/A,46,6
10,N/A,N/A,N/A,593,603,N/A,51,5
8,N/A,N/A,N/A,585,593,N/A,56,4
7,N/A,N/A,N/A,578,585,N/A,61,3
4,N/A,N/A,N/A,574,578,N/A,67,3
4,N/A,N/A,N/A,570,574,N/A,71,1
18,N/A,N/A,N/A,552,570,N/A,76,6
4,N/A,N/A,N/A,548,552,N/A,82,0
13,N/A,N/A,N/A,535,548,N/A,88,6
4,N/A,N/A,N/A,531,535,N/A,94,0
7,N/A,N/A,N/A,524,531,N/A,97,3
4,N/A,N/A,N/A,520,524,N/A,102,2
15,N/A,N/A,N/A,505,520,N/A,106,6
5,N/A,N/A,N/A,500,505,N/A,109,3
17,N/A,N/A,N/A,483,500,N/A,112,6
8,N/A,N/A,N/A,475,483,N/A,116,4
6,N/A,N/A,N/A,469,475,N/A,121,3
4,N/A,N/A,N/A,465,469,N/A,127,3
5,N/A,N/A,N/A,460,465,N/A,131,1
19,N/A,N/A,N/A,441,460,N/A,136,6
18,N/A,N/A,N/A,1908,1926,N/A,6,6
8,N/A,N/A,N/A,1900,1908,N/A,10,4
5,N/A,N/A,N/A,1895,1900,N/A,13,1
12,N/A,N/A,N/A,1883,1895,N/A,17,5
7,N/A,N/A,N/A,1876,1883,N/A,22,4
4,N/A,N/A,N/A,1872,1876,N/A,26,2
4,N/A,N/A,N/A,1868,1872,N/A,31,1
5,N/A,N/A,N/A,1863,1868,N/A,34,4
8,N/A,N/A,N/A,1855,1863,N/A,40,4
5,N/A,N/A,N/A,1850,1855,N/A,43,1
4,N/A,N/A,N/A,1846,1850,N/A,49,1
4,N/A,N/A,N/A,1842,1846,N/A,55,1
4,N/A,N/A,N/A,1838,1842,N/A,61,1
11,N/A,N/A,N/A,1827,1838,N/A,65,5
5,N/A,N/A,N/A,1822,1827,N/A,70,4
6,N/A,N/A,N/A,1816,1822,N/A,76,4
7,N/A,N/A,N/A,1809,1816,N/A,82,4
5,N/A,N/A,N/A,1804,1809,N/A,85,1
16,N/A,N/A,N/A,1788,1804,N/A,90,6
5,N/A,N/A,N/A,1783,1788,N/A,93,3
10,N/A,N/A,N/A,1773,1783,N/A,96,6
7,N/A,N/A,N/A,1766,1773,N/A,100,4
7,N/A,N/A,N/A,1759,1766,N/A,105,3
13,N/A,N/A,N/A,1746,1759,N/A,108,6
12,N/A,N/A,N/A,1734,1746,N/A,113,5
10,N/A,N/A,N/A,1724,1734,N/A,119,5
4,N/A,N/A,N/A,1720,1724,N/A,123,3
6,N/A,N/A,N/A,1714,1720,N/A,128,2
12,N/A,N/A,N/A,1702,1714,N/A,131,5
5,N/A,N/A,N/A,1697,1702,N/A,135,3
6,N/A,N/A,N/A,727,733,N/A,6,4
6,N/A,N/A,N/A,721,727,N/A,11,3
4,N/A,N/A,N/A,717,721,N/A,16,2
14,N/A,N/A,N/A,703,717,N/A,20,6
10,N/A,N/A,N/A,693,703,N/A,25,5
12,N/A,N/A,N/A,681,693,N/A,31,5
7,N/A,N/A,N/A,674,681,N/A,34,2
15,N/A,N/A,N/A,659,674,N/A,38,6
7,N/A,N/A,N/A,652,659,N/A,41,3
5,N/A,N/A,N/A,647,652,N/A,47,3
6,N/A,N/A,N/A,641,647,N/A,53,3
5,N/A,N/A,N/A,636,641,N/A,59,3
7,N/A,N/A,N/A,629,636,N/A,64,2
6,N/A,N/A,N/A,623,629,N/A,70,2
9,N/A,N/A,N/A,614,623,N/A,73,5
5,N/A,N/A,N/A,609,614,N/A,78,4
4,N/A,N/A,N/A,605,609,N/A,81,1
4,N/A,N/A,N/A,601,605,N/A,87,1
4,N/A,N/A,N/A,597,601,N/A,93,1
5,N/A,N/A,N/A,592,597,N/A,99,1
17,N/A,N/A,N/A,575,592,N/A,104,6
4,N/A,N/A,N/A,571,575,N/A,107,3
5,N/A,N/A,N/A,566,571,N/A,111,1
16,N/A,N/A,N/A,550,566,N/A,116,6
10,N/A,N/A,N/A,540,550,N/A,121,5
5,N/A,N/A,N/A,535,540,N/A,126,4
5,N/A,N/A,N/A,530,535,N/A,130,2
5,N/A,N/A,N/A,525,530,N/A,136,2
5,N/A,N/A,N/A,520,525,N/A,141,1
5,N/A,N/A,N/A,515,520,N/A,144,4
12,N/A,N/A,N/A,1158,1170,N/A,6,5
6,N/A,N/A,N/A,1152,1158,N/A,11,4
4,N/A,N/A,N/A,1148,1152,N/A,14,1
6,N/A,N/A,N/A,1142,1148,N/A,17,4
4,N/A,N/A,N/A,1138,1142,N/A,22,3
7,N/A,N/A,N/A,1131,1138,N/A,27,2
16,N/A,N/A,N/A,1115,1131,N/A,31,6
5,N/A,N/A,N/A,1110,1115,N/A,34,3
13,N/A,N/A,N/A,1097,1110,N/A,37,6
4,N/A,N/A,N/A,1093,1097,N/A,43,0
14,N/A,N/A,N/A,1079,1093,N/A,49,6
8,N/A,N/A,N/A,1071,1079,N/A,53,4
5,N/A,N/A,N/A,1066,1071,N/A,57,2
16,N/A,N/A,N/A,1050,1066,N/A,61,6
9,N/A,N/A,N/A,1041,1050,N/A,66,5
5,N/A,N/A,N/A,1036,1041,N/A,70,3
4,N/A,N/A,N/A,1032,1036,N/A,74,1
19,N/A,N/A,N/A,1013,1032,N/A,79,6
5,N/A,N/A,N/A,1008,1013,N/A,82,3
4,N/A,N/A,N/A,1004,1008,N/A,86,1
5,N/A,N/A,N/A,999,1004,N/A,92,1
15,N/A,N/A,N/A,984,999,N/A,97,6
7,N/A,N/A,N/A,977,984,N/A,101,4
7,N/A,N/A,N/A,970,977,N/A,105,2
5,N/A,N/A,N/A,965,970,N/A,111,2
11,N/A,N/A,N/A,954,965,N/A,115,6
5,N/A,N/A,N/A,949,954,N/A,118,3
14,N/A,N/A,N/A,935,949,N/A,121,6
11,N/A,N/A,N/A,924,935,N/A,126,5
4,N/A,N/A,N/A,920,924,N/A,129,2
7,N/A,N/A,N/A,1280,1287,N/A,5,4
5,N/A,N/A,N/A,1275,1280,N/A,10,3
4,N/A,N/A,N/A,1271,1275,N/A,15,2
16,N/A,N/A,N/A,1255,1271,N/A,19,6
5,N/A,N/A,N/A,1250,1255,N/A,22,3
7,N/A,N/A,N/A,1243,1250,N/A,28,3
18,N/A,N/A,N/A,1225,1243,N/A,31,6
12,N/A,N/A,N/A,1213,1225,N/A,36,5
12,N/A,N/A,N/A,1201,1213,N/A,42,5
7,N/A,N/A,N/A,1194,1201,N/A,45,2
7,N/A,N/A,N/A,1187,1194,N/A,51,2
4,N/A,N/A,N/A,1183,1187,N/A,56,1
5,N/A,N/A,N/A,1178,1183,N/A,59,4
5,N/A,N/A,N/A,1173,1178,N/A,64,3
7,N/A,N/A,N/A,1166,1173,N/A,70,3
4,N/A,N/A,N/A,1162,1166,N/A,76,3
7,N/A,N/A,N/A,1155,1162,N/A,81,2
4,N/A,N/A,N/A,1151,1155,N/A,86,1
12,N/A,N/A,N/A,1139,1151,N/A,91,6
8,N/A,N/A,N/A,1131,1139,N/A,95,4
5,N/A,N/A,N/A,1126,1131,N/A,101,4
7,N/A,N/A,N/A,1119,1126,N/A,105,2
5,N/A,N/A,N/A,1114,1119,N/A,110,1
12,N/A,N/A,N/A,1102,1114,N/A,115,6
4,N/A,N/A,N/A,1098,1102,N/A,121,0
9,N/A,N/A,N/A,1089,1098,N/A,126,5
12,N/A,N/A,N/A,1077,1089,N/A,132,5
6,N/A,N/A,N/A,1071,1077,N/A,136,3
17,N/A,N/A,N/A,1054,1071,N/A,139,6
5,N/A,N/A,N/A,1049,1054,N/A,143,4
15,N/A,N/A,N/A,600,615,N/A,5,6
7,N/A,N/A,N/A,593,600,N/A,9,4
5,N/A,N/A,N/A,588,593,N/A,15,4
7,N/A,N/A,N/A,581,588,N/A,21,4
4,N/A,N/A,N/A,577,581,N/A,25,2
15,N/A,N/A,N/A,562,577,N/A,29,6
6,N/A,N/A,N/A,556,562,N/A,33,4
7,N/A,N/A,N/A,549,556,N/A,37,2
5,N/A,N/A,N/A,544,549,N/A,42,1
8,N/A,N/A,N/A,536,544,N/A,45,4
7,N/A,N/A,N/A,529,536,N/A,49,2
5,N/A,N/A,N/A,524,529,N/A,54,1
7,N/A,N/A,N/A,517,524,N/A,57,4
7,N/A,N/A,N/A,510,517,N/A,61,2
4,N/A,N/A,N/A,506,510,N/A,66,1
4,N/A,N/A,N/A,502,506,N/A,72,1
8,N/A,N/A,N/A,494,502,N/A,75,4
7,N/A,N/A,N/A,487,494,N/A,81,4
7,N/A,N/A,N/A,480,487,N/A,85,2
5,N/A,N/A,N/A,475,480,N/A,90,1
5,N/A,N/A,N/A,470,475,N/A,93,4
7,N/A,N/A,N/A,463,470,N/A,98,3
5,N/A,N/A,N/A,458,463,N/A,102,1
5,N/A,N/A,N/A,453,458,N/A,108,1
11,N/A,N/A,N/A,442,453,N/A,113,6
7,N/A,N/A,N/A,435,442,N/A,116,3
7,N/A,N/A,N/A,428,435,N/A,121,2
4,N/A,N/A,N/A,424,428,N/A,127,2
4,N/A,N/A,N/A,420,424,N/A,132,1
12,N/A,N/A,N/A,408,420,N/A,136,5
8,N/A,N/A,N/A,1892,1900,N/A,3,4
7,N/A,N/A,N/A,1885,1892,N/A,9,4
5,N/A,N/A,N/A,1880,1885,N/A,12,1
11,N/A,N/A,N/A,1869,1880,N/A,16,5
10,N/A,N/A,N/A,1859,1869,N/A,22,5
5,N/A,N/A,N/A,1854,1859,N/A,26,3
15,N/A,N/A,N/A,1839,1854,N/A,29,6
4,N/A,N/A,N/A,1835,1839,N/A,35,0
18,N/A,N/A,N/A,1817,1835,N/A,41,6
6,N/A,N/A,N/A,1811,1817,N/A,44,3
7,N/A,N/A,N/A,1804,1811,N/A,50,3
13,N/A,N/A,N/A,1791,1804,N/A,53,6
5,N/A,N/A,N/A,1786,1791,N/A,59,0
18,N/A,N/A,N/A,1768,1786,N/A,65,6
7,N/A,N/A,N/A,1761,1768,N/A,68,3
5,N/A,N/A,N/A,1756,1761,N/A,72,1
6,N/A,N/A,N/A,1750,1756,N/A,75,4
8,N/A,N/A,N/A,1742,1750,N/A,81,4
7,N/A,N/A,N/A,1735,1742,N/A,86,3
7,N/A,N/A,N/A,1728,1735,N/A,91,2
14,N/A,N/A,N/A,1714,1728,N/A,95,6
6,N/A,N/A,N/A,1708,1714,N/A,99,4
6,N/A,N/A,N/A,1702,1708,N/A,104,3
5,N/A,N/A,N/A,1697,1702,N/A,108,1
7,N/A,N/A,N/A,1690,1697,N/A,111,4
8,N/A,N/A,N/A,1682,1690,N/A,117,4
5,N/A,N/A,N/A,1677,1682,N/A,123,4
5,N/A,N/A,N/A,1672,1677,N/A,128,3
6,N/A,N/A,N/A,1666,1672,N/A,134,3
5,N/A,N/A,N/A,1661,1666,N/A,138,1
12,N/A,N/A,N/A,634,646,N/A,6,6
4,N/A,N/A,N/A,630,634,N/A,9,3
7,N/A,N/A,N/A,623,630,N/A,15,3
5,N/A,N/A,N/A,618,623,N/A,20,2
5,N/A,N/A,N/A,613,618,N/A,25,1
12,N/A,N/A,N/A,601,613,N/A,29,5
6,N/A,N/A,N/A,595,601,N/A,33,3
5,N/A,N/A,N/A,590,595,N/A,37,1
4,N/A,N/A,N/A,586,590,N/A,43,1
5,N/A,N/A,N/A,581,586,N/A,49,1
11,N/A,N/A,N/A,570,581,N/A,54,6
7,N/A,N/A,N/A,563,570,N/A,57,3
5,N/A,N/A,N/A,558,563,N/A,61,1
5,N/A,N/A,N/A,553,558,N/A,67,1
10,N/A,N/A,N/A,543,553,N/A,72,6
6,N/A,N/A,N/A,537,543,N/A,76,4
4,N/A,N/A,N/A,533,537,N/A,81,3
4,N/A,N/A,N/A,529,533,N/A,87,3
7,N/A,N/A,N/A,522,529,N/A,92,2
12,N/A,N/A,N/A,510,522,N/A,95,5
4,N/A,N/A,N/A,506,510,N/A,98,2
6,N/A,N/A,N/A,500,506,N/A,104,2
6,N/A,N/A,N/A,494,500,N/A,110,2
11,N/A,N/A,N/A,483,494,N/A,113,5
7,N/A,N/A,N/A,476,483,N/A,118,4
7,N/A,N/A,N/A,469,476,N/A,124,4
6,N/A,N/A,N/A,463,469,N/A,128,2
4,N/A,N/A,N/A,459,463,N/A,133,1
18,N/A,N/A,N/A,441,459,N/A,138,6
6,N/A,N/A,N/A,435,441,N/A,142,4
12,N/A,N/A,N/A,1440,1452,N/A,6,6
5,N/A,N/A,N/A,1435,1440,N/A,10,4
5,N/A,N/A,N/A,1430,1435,N/A,13,1
5,N/A,N/A,N/A,1425,1430,N/A,19,1
11,N/A,N/A,N/A,1414,1425,N/A,23,5
8,N/A,N/A,N/A,1406,1414,N/A,28,4
5,N/A,N/A,N/A,1401,1406,N/A,32,2
7,N/A,N/A,N/A,1394,1401,N/A,38,2
5,N/A,N/A,N/A,1389,1394,N/A,43,1
4,N/A,N/A,N/A,1385,1389,N/A,49,1
7,N/A,N/A,N/A,1378,1385,N/A,52,4
4,N/A,N/A,N/A,1374,1378,N/A,57,3
4,N/A,N/A,N/A,1370,1374,N/A,61,1
6,N/A,N/A,N/A,1364,1370,N/A,64,4
6,N/A,N/A,N/A,1358,1364,N/A,68,2
14,N/A,N/A,N/A,1344,1358,N/A,72,6
10,N/A,N/A,N/A,1334,1344,N/A,77,5
8,N/A,N/A,N/A,1326,1334,N/A,82,4
4,N/A,N/A,N/A,1322,1326,N/A,86,2
13,N/A,N/A,N/A,1309,1322,N/A,90,6
5,N/A,N/A,N/A,1304,1309,N/A,96,0
10,N/A,N/A,N/A,1294,1304,N/A,102,6
5,N/A,N/A,N/A,1289,1294,N/A,105,3
6,N/A,N/A,N/A,1283,1289,N/A,110,2
12,N/A,N/A,N/A,1271,1283,N/A,114,6
6,N/A,N/A,N/A,1265,1271,N/A,118,4
8,N/A,N/A,N/A,1257,1265,N/A,124,4
7,N/A,N/A,N/A,1250,1257,N/A,130,4
5,N/A,N/A,N/A,1245,1250,N/A,135,3
7,N/A,N/A,N/A,1238,1245,N/A,140,2
11,N/A,N/A,N/A,1440,1451,N/A,6,5
6,N/A,N/A,N/A,1434,1440,N/A,11,4
7,N/A,N/A,N/A,1427,1434,N/A,15,2
5,N/A,N/A,N/A,1422,1427,N/A,21,2
12,N/A,N/A,N/A,1410,1422,N/A,25,6
6,N/A,N/A,N/A,1404,1410,N/A,28,3
6,N/A,N/A,N/A,1398,1404,N/A,33,2
10,N/A,N/A,N/A,1388,1398,N/A,36,5
5,N/A,N/A,N/A,1383,1388,N/A,41,4
4,N/A,N/A,N/A,1379,1383,N/A,44,1
6,N/A,N/A,N/A,1373,1379,N/A,47,4
4,N/A,N/A,N/A,1369,1373,N/A,52,3
4,N/A,N/A,N/A,1365,1369,N/A,58,3
15,N/A,N/A,N/A,1350,1365,N/A,61,6
4,N/A,N/A,N/A,1346,1350,N/A,64,3
13,N/A,N/A,N/A,1333,1346,N/A,67,6
10,N/A,N/A,N/A,1323,1333,N/A,72,5
6,N/A,N/A,N/A,1317,1323,N/A,77,4
5,N/A,N/A,N/A,1312,1317,N/A,82,3
4,N/A,N/A,N/A,1308,1312,N/A,88,3
4,N/A,N/A,N/A,1304,1308,N/A,93,2
5,N/A,N/A,N/A,1299,1304,N/A,98,1
4,N/A,N/A,N/A,1295,1299,N/A,104,1
4,N/A,N/A,N/A,1291,1295,N/A,110,1
12,N/A,N/A,N/A,1279,1291,N/A,115,6
5,N/A,N/A,N/A,1274,1279,N/A,119,4
5,N/A,N/A,N/A,1269,1274,N/A,122,1
11,N/A,N/A,N/A,1258,1269,N/A,126,5
5,N/A,N/A,N/A,1253,1258,N/A,131,4
4,N/A,N/A,N/A,1249,1253,N/A,134,1
4,N/A,N/A,N/A,1715,1719,N/A,5,3
7,N/A,N/A,N/A,1708,1715,N/A,10,2
16,N/A,N/A,N/A,1692,1708,N/A,14,6
5,N/A,N/A,N/A,1687,1692,N/A,18,4
8,N/A,N/A,N/A,1679,1687,N/A,24,4
7,N/A,N/A,N/A,1672,1679,N/A,30,4
5,N/A,N/A,N/A,1667,1672,N/A,36,4
8,N/A,N/A,N/A,1659,1667,N/A,42,4
5,N/A,N/A,N/A,1654,1659,N/A,47,3
7,N/A,N/A,N/A,1647,1654,N/A,53,3
15,N/A,N/A,N/A,1632,1647,N/A,56,6
4,N/A,N/A,N/A,1628,1632,N/A,59,3
4,N/A,N/A,N/A,1624,1628,N/A,65,3
6,N/A,N/A,N/A,1618,1624,N/A,71,3
5,N/A,N/A,N/A,1613,1618,N/A,75,1
10,N/A,N/A,N/A,1603,1613,N/A,79,5
6,N/A,N/A,N/A,1597,1603,N/A,83,3
10,N/A,N/A,N/A,1587,1597,N/A,86,6
4,N/A,N/A,N/A,1583,1587,N/A,89,3
6,N/A,N/A,N/A,1577,1583,N/A,95,3
4,N/A,N/A,N/A,1573,1577,N/A,100,2
6,N/A,N/A,N/A,1567,1573,N/A,106,2
6,N/A,N/A,N/A,1561,1567,N/A,112,2
5,N/A,N/A,N/A,1556,1561,N/A,117,1
9,N/A,N/A,N/A,1547,1556,N/A,121,5
7,N/A,N/A,N/A,1540,1547,N/A,124,2
9,N/A,N/A,N/A,1531,1540,N/A,127,5
9,N/A,N/A,N/A,1522,1531,N/A,133,5
11,N/A,N/A,N/A,1511,1522,N/A,139,5
5,N/A,N/A,N/A,1506,1511,N/A,144,4
7,N/A,N/A,N/A,478,485,N/A,4,2
5,N/A,N/A,N/A,473,478,N/A,9,1
13,N/A,N/A,N/A,460,473,N/A,14,6
9,N/A,N/A,N/A,451,460,N/A,19,5
5,N/A,N/A,N/A,446,451,N/A,24,4
4,N/A,N/A,N/A,442,446,N/A,27,1
12,N/A,N/A,N/A,430,442,N/A,31,5
9,N/A,N/A,N/A,421,430,N/A,37,5
5,N/A,N/A,N/A,416,421,N/A,42,4
4,N/A,N/A,N/A,412,416,N/A,45,1
5,N/A,N/A,N/A,407,412,N/A,51,1
11,N/A,N/A,N/A,396,407,N/A,56,6
4,N/A,N/A,N/A,392,396,N/A,62,0
10,N/A,N/A,N/A,382,392,N/A,67,5
9,N/A,N/A,N/A,373,382,N/A,73,5
12,N/A,N/A,N/A,361,373,N/A,79,5
4,N/A,N/A,N/A,357,361,N/A,82,2
14,N/A,N/A,N/A,343,357,N/A,86,6
8,N/A,N/A,N/A,335,343,N/A,90,4
4,N/A,N/A,N/A,331,335,N/A,93,1
15,N/A,N/A,N/A,316,331,N/A,98,6
5,N/A,N/A,N/A,311,316,N/A,104,0
18,N/A,N/A,N/A,293,311,N/A,110,6
5,N/A,N/A,N/A,288,293,N/A,116,0
12,N/A,N/A,N/A,276,288,N/A,121,5
8,N/A,N/A,N/A,268,276,N/A,126,4
4,N/A,N/A,N/A,264,268,N/A,130,2
15,N/A,N/A,N/A,249,264,N/A,134,6
4,N/A,N/A,N/A,245,249,N/A,140,0
4,N/A,N/A,N/A,241,245,N/A,143,3
5,N/A,N/A,N/A,1229,1234,N/A,5,1
12,N/A,N/A,N/A,1217,1229,N/A,9,5
5,N/A,N/A,N/A,1212,1217,N/A,14,4
7,N/A,N/A,N/A,1205,1212,N/A,19,3
17,N/A,N/A,N/A,1188,1205,N/A,22,6
8,N/A,N/A,N/A,1180,1188,N/A,26,4
5,N/A,N/A,N/A,1175,1180,N/A,32,4
5,N/A,N/A,N/A,1170,1175,N/A,35,1
15,N/A,N/A,N/A,1155,1170,N/A,40,6
6,N/A,N/A,N/A,1149,1155,N/A,44,4
6,N/A,N/A,N/A,1143,1149,N/A,48,2
4,N/A,N/A,N/A,1139,1143,N/A,53,1
13,N/A,N/A,N/A,1126,1139,N/A,58,6
5,N/A,N/A,N/A,1121,1126,N/A,61,3
5,N/A,N/A,N/A,1116,1121,N/A,66,2
11,N/A,N/A,N/A,1105,1116,N/A,70,6
10,N/A,N/A,N/A,1095,1105,N/A,75,5
6,N/A,N/A,N/A,1089,1095,N/A,79,3
11,N/A,N/A,N/A,1078,1089,N/A,82,6
10,N/A,N/A,N/A,1068,1078,N/A,87,5
12,N/A,N/A,N/A,1056,1068,N/A,93,5
11,N/A,N/A,N/A,1045,1056,N/A,99,5
5,N/A,N/A,N/A,1040,1045,N/A,103,3
13,N/A,N/A,N/A,1027,1040,N/A,106,6
8,N/A,N/A,N/A,1019,1027,N/A,110,4
6,N/A,N/A,N/A,1013,1019,N/A,116,4
6,N/A,N/A,N/A,1007,1013,N/A,120,2
5,N/A,N/A,N/A,1002,1007,N/A,125,1
4,N/A,N/A,N/A,998,1002,N/A,131,1
10,N/A,N/A,N/A,988,998,N/A,135,5
5,N/A,N/A,N/A,1969,1974,N/A,3,1
10,N/A,N/A,N/A,1959,1969,N/A,7,5
9,N/A,N/A,N/A,1950,1959,N/A,13,5
5,N/A,N/A,N/A,1945,1950,N/A,16,2
17,N/A,N/A,N/A,1928,1945,N/A,20,6
5,N/A,N/A,N/A,1923,1928,N/A,23,3
4,N/A,N/A,N/A,1919,1923,N/A,27,1
9,N/A,N/A,N/A,1910,1919,N/A,31,5
8,N/A,N/A,N/A,1902,1910,N/A,36,4
4,N/A,N/A,N/A,1898,1902,N/A,39,1
10,N/A,N/A,N/A,1888,1898,N/A,44,6
8,N/A,N/A,N/A,1880,1888,N/A,48,4
5,N/A,N/A,N/A,1875,1880,N/A,51,1
14,N/A,N/A,N/A,1861,1875,N/A,56,6
7,N/A,N/A,N/A,1854,1861,N/A,60,4
6,N/A,N/A,N/A,1848,1854,N/A,64,2
10,N/A,N/A,N/A,1838,1848,N/A,67,5
9,N/A,N/A,N/A,1829,1838,N/A,73,5
6,N/A,N/A,N/A,1823,1829,N/A,77,3
6,N/A,N/A,N/A,1817,1823,N/A,83,3
4,N/A,N/A,N/A,1813,1817,N/A,89,3
6,N/A,N/A,N/A,1807,1813,N/A,94,2
12,N/A,N/A,N/A,1795,1807,N/A,97,5
6,N/A,N/A,N/A,1789,1795,N/A,101,3
6,N/A,N/A,N/A,1783,1789,N/A,106,2
5,N/A,N/A,N/A,1778,1783,N/A,111,1
4,N/A,N/A,N/A,1774,1778,N/A,117,1
11,N/A,N/A,N/A,1763,1774,N/A,121,5
5,N/A,N/A,N/A,1758,1763,N/A,124,2
4,N/A,N/A,N/A,1754,1758,N/A,129,1
6,N/A,N/A,N/A,742,748,N/A,5,2
14,N/A,N/A,N/A,728,742,N/A,9,6
7,N/A,N/A,N/A,721,728,N/A,13,4
6,N/A,N/A,N/A,715,721,N/A,17,2
4,N/A,N/A,N/A,711,715,N/A,22,1
6,N/A,N/A,N/A,705,711,N/A,25,4
5,N/A,N/A,N/A,700,705,N/A,29,2
4,N/A,N/A,N/A,696,700,N/A,34,1
12,N/A,N/A,N/A,684,696,N/A,39,6
6,N/A,N/A,N/A,678,684,N/A,42,3
12,N/A,N/A,N/A,666,678,N/A,45,6
4,N/A,N/A,N/A,662,666,N/A,51,0
12,N/A,N/A,N/A,650,662,N/A,56,5
11,N/A,N/A,N/A,639,650,N/A,62,5
6,N/A,N/A,N/A,633,639,N/A,66,3
10,N/A,N/A,N/A,623,633,N/A,69,6
4,N/A,N/A,N/A,619,623,N/A,72,3
4,N/A,N/A,N/A,615,619,N/A,76,1
17,N/A,N/A,N/A,598,615,N/A,81,6
12,N/A,N/A,N/A,586,598,N/A,86,5
11,N/A,N/A,N/A,575,586,N/A,92,5
7,N/A,N/A,N/A,568,575,N/A,96,3
10,N/A,N/A,N/A,558,568,N/A,99,6
10,N/A,N/A,N/A,548,558,N/A,104,5
7,N/A,N/A,N/A,541,548,N/A,107,2
7,N/A,N/A,N/A,534,541,N/A,113,2
17,N/A,N/A,N/A,517,534,N/A,117,6
11,N/A,N/A,N/A,506,517,N/A,122,5
8,N/A,N/A,N/A,498,506,N/A,127,4
4,N/A,N/A,N/A,494,498,N/A,132,3
7,N/A,N/A,N/A,1069,1076,N/A,4,4
7,N/A,N/A,N/A,1062,1069,N/A,9,3
4,N/A,N/A,N/A,1058,1062,N/A,14,2
4,N/A,N/A,N/A,1054,1058,N/A,19,1
6,N/A,N/A,N/A,1048,1054,N/A,22,4
7,N/A,N/A,N/A,1041,1048,N/A,26,2
5,N/A,N/A,N/A,1036,1041,N/A,31,1
10,N/A,N/A,N/A,1026,1036,N/A,36,6
4,N/A,N/A,N/A,1022,1026,N/A,39,3
7,N/A,N/A,N/A,1015,1022,N/A,45,3
4,N/A,N/A,N/A,1011,1015,N/A,49,1
6,N/A,N/A,N/A,1005,1011,N/A,52,4
7,N/A,N/A,N/A,998,1005,N/A,57,3
5,N/A,N/A,N/A,993,998,N/A,61,1
4,N/A,N/A,N/A,989,993,N/A,67,1
4,N/A,N/A,N/A,985,989,N/A,73,1
11,N/A,N/A,N/A,974,985,N/A,78,6
5,N/A,N/A,N/A,969,974,N/A,82,4
5,N/A,N/A,N/A,964,969,N/A,88,4
6,N/A,N/A,N/A,958,964,N/A,94,4
5,N/A,N/A,N/A,953,958,N/A,100,4
8,N/A,N/A,N/A,945,953,N/A,106,4
8,N/A,N/A,N/A,937,945,N/A,112,4
8,N/A,N/A,N/A,929,937,N/A,118,4
5,N/A,N/A,N/A,924,929,N/A,121,1
5,N/A,N/A,N/A,919,924,N/A,127,1
11,N/A,N/A,N/A,908,919,N/A,132,6
11,N/A,N/A,N/A,897,908,N/A,137,5
6,N/A,N/A,N/A,891,897,N/A,142,4
5,N/A,N/A,N/A,886,891,N/A,147,3
6,N/A,N/A,N/A,382,388,N/A,5,2
9,N/A,N/A,N/A,373,382,N/A,8,5
7,N/A,N/A,N/A,366,373,N/A,11,2
17,N/A,N/A,N/A,349,366,N/A,15,6
5,N/A,N/A,N/A,344,349,N/A,18,3
4,N/A,N/A,N/A,340,344,N/A,22,1
14,N/A,N/A,N/A,326,340,N/A,27,6
10,N/A,N/A,N/A,316,326,N/A,32,5
4,N/A,N/A,N/A,312,316,N/A,36,3
14,N/A,N/A,N/A,298,312,N/A,39,6
5,N/A,N/A,N/A,293,298,N/A,45,0
7,N/A,N/A,N/A,286,293,N/A,49,4
4,N/A,N/A,N/A,282,286,N/A,52,1
14,N/A,N/A,N/A,268,282,N/A,57,6
11,N/A,N/A,N/A,257,268,N/A,62,5
12,N/A,N/A,N/A,245,257,N/A,68,5
4,N/A,N/A,N/A,241,245,N/A,71,2
4,N/A,N/A,N/A,237,241,N/A,77,2
11,N/A,N/A,N/A,226,237,N/A,80,5
5,N/A,N/A,N/A,221,226,N/A,85,4
7,N/A,N/A,N/A,214,221,N/A,90,3
17,N/A,N/A,N/A,197,214,N/A,93,6
7,N/A,N/A,N/A,190,197,N/A,97,4
5,N/A,N/A,N/A,185,190,N/A,100,1
4,N/A,N/A,N/A,181,185,N/A,106,1
5,N/A,N/A,N/A,176,181,N/A,109,4
7,N/A,N/A,N/A,169,176,N/A,115,4
5,N/A,N/A,N/A,164,169,N/A,118,1
16,N/A,N/A,N/A,148,164,N/A,123,6
5,N/A,N/A,N/A,143,148,N/A,126,3
7,N/A,N/A,N/A,1706,1713,N/A,4,3
6,N/A,N/A,N/A,1700,1706,N/A,9,2
5,N/A,N/A,N/A,1695,1700,N/A,14,1
9,N/A,N/A,N/A,1686,1695,N/A,18,5
11,N/A,N/A,N/A,1675,1686,N/A,24,5
12,N/A,N/A,N/A,1663,1675,N/A,30,5
4,N/A,N/A,N/A,1659,1663,N/A,34,3
7,N/A,N/A,N/A,1652,1659,N/A,39,2
4,N/A,N/A,N/A,1648,1652,N/A,45,2
17,N/A,N/A,N/A,1631,1648,N/A,49,6
12,N/A,N/A,N/A,1619,1631,N/A,54,5
5,N/A,N/A,N/A,1614,1619,N/A,57,2
6,N/A,N/A,N/A,1608,1614,N/A,63,2
6,N/A,N/A,N/A,1602,1608,N/A,69,2
5,N/A,N/A,N/A,1597,1602,N/A,74,1
12,N/A,N/A,N/A,1585,1597,N/A,79,6
5,N/A,N/A,N/A,1580,1585,N/A,85,0
16,N/A,N/A,N/A,1564,1580,N/A,91,6
4,N/A,N/A,N/A,1560,1564,N/A,97,0
8,N/A,N/A,N/A,1552,1560,N/A,101,4
5,N/A,N/A,N/A,1547,1552,N/A,104,1
5,N/A,N/A,N/A,1542,1547,N/A,107,4
5,N/A,N/A,N/A,1537,1542,N/A,110,1
4,N/A,N/A,N/A,1533,1537,N/A,116,1
11,N/A,N/A,N/A,1522,1533,N/A,121,6
6,N/A,N/A,N/A,1516,1522,N/A,125,4
5,N/A,N/A,N/A,1511,1516,N/A,128,1
5,N/A,N/A,N/A,1506,1511,N/A,131,4
5,N/A,N/A,N/A,1501,1506,N/A,137,4
4,N/A,N/A,N/A,1497,1501,N/A,142,3
6,N/A,N/A,N/A,491,497,N/A,4,2
5,N/A,N/A,N/A,486,491,N/A,9,1
7,N/A,N/A,N/A,479,486,N/A,12,4
5,N/A,N/A,N/A,474,479,N/A,16,2
4,N/A,N/A,N/A,470,474,N/A,21,1
8,N/A,N/A,N/A,462,470,N/A,24,4
7,N/A,N/A,N/A,455,462,N/A,28,2
5,N/A,N/A,N/A,450,455,N/A,33,1
4,N/A,N/A,N/A,446,450,N/A,39,1
10,N/A,N/A,N/A,436,446,N/A,43,5
10,N/A,N/A,N/A,426,436,N/A,49,5
7,N/A,N/A,N/A,419,426,N/A,53,3
4,N/A,N/A,N/A,415,419,N/A,57,1
19,N/A,N/A,N/A,396,415,N/A,62,6
10,N/A,N/A,N/A,386,396,N/A,67,5
8,N/A,N/A,N/A,378,386,N/A,72,4
4,N/A,N/A,N/A,374,378,N/A,75,1
8,N/A,N/A,N/A,366,374,N/A,78,4
5,N/A,N/A,N/A,361,366,N/A,81,1
16,N/A,N/A,N/A,345,361,N/A,86,6
8,N/A,N/A,N/A,337,345,N/A,90,4
4,N/A,N/A,N/A,333,337,N/A,94,2
10,N/A,N/A,N/A,323,333,N/A,98,6
5,N/A,N/A,N/A,318,323,N/A,104,0
16,N/A,N/A,N/A,302,318,N/A,110,6
6,N/A,N/A,N/A,296,302,N/A,113,3
6,N/A,N/A,N/A,290,296,N/A,119,3
5,N/A,N/A,N/A,285,290,N/A,123,1
10,N/A,N/A,N/A,275,285,N/A,127,5
7,N/A,N/A,N/A,268,275,N/A,130,2
12,N/A,N/A,N/A,1458,1470,N/A,3,5
10,N/A,N/A,N/A,1448,1458,N/A,9,5
10,N/A,N/A,N/A,1438,1448,N/A,15,5
9,N/A,N/A,N/A,1429,1438,N/A,21,5
9,N/A,N/A,N/A,1420,1429,N/A,27,5
7,N/A,N/A,N/A,1413,1420,N/A,31,3
6,N/A,N/A,N/A,1407,1413,N/A,36,2
12,N/A,N/A,N/A,1395,1407,N/A,40,6
11,N/A,N/A,N/A,1384,1395,N/A,45,5
6,N/A,N/A,N/A,1378,1384,N/A,48,2
5,N/A,N/A,N/A,1373,1378,N/A,54,2
12,N/A,N/A,N/A,1361,1373,N/A,57,5
6,N/A,N/A,N/A,1355,1361,N/A,60,2
10,N/A,N/A,N/A,1345,1355,N/A,64,6
6,N/A,N/A,N/A,1339,1345,N/A,68,4
7,N/A,N/A,N/A,1332,1339,N/A,72,2
10,N/A,N/A,N/A,1322,1332,N/A,75,5
9,N/A,N/A,N/A,1313,1322,N/A,81,5
5,N/A,N/A,N/A,1308,1313,N/A,86,4
4,N/A,N/A,N/A,1304,1308,N/A,89,1
5,N/A,N/A,N/A,1299,1304,N/A,95,1
4,N/A,N/A,N/A,1295,1299,N/A,101,1
19,N/A,N/A,N/A,1276,1295,N/A,106,6
12,N/A,N/A,N/A,1264,1276,N/A,111,5
4,N/A,N/A,N/A,1260,1264,N/A,115,3
6,N/A,N/A,N/A,1254,1260,N/A,120,2
7,N/A,N/A,N/A,1247,1254,N/A,126,2
5,N/A,N/A,N/A,1242,1247,N/A,131,1
6,N/A,N/A,N/A,1236,1242,N/A,134,4
6,N/A,N/A,N/A,1230,1236,N/A,138,2
4,N/A,N/A,N/A,609,613,N/A,5,1
5,N/A,N/A,N/A,604,609,N/A,8,4
4,N/A,N/A,N/A,600,604,N/A,11,1
9,N/A,N/A,N/A,591,600,N/A,15,5
10,N/A,N/A,N/A,581,591,N/A,21,5
9,N/A,N/A,N/A,572,581,N/A,27,5
5,N/A,N/A,N/A,567,572,N/A,31,3
6,N/A,N/A,N/A,561,567,N/A,37,3
5,N/A,N/A,N/A,556,561,N/A,42,2
9,N/A,N/A,N/A,547,556,N/A,45,5
8,N/A,N/A,N/A,539,547,N/A,50,4
7,N/A,N/A,N/A,532,539,N/A,54,2
7,N/A,N/A,N/A,525,532,N/A,60,2
7,N/A,N/A,N/A,518,525,N/A,66,2
12,N/A,N/A,N/A,506,518,N/A,69,5
7,N/A,N/A,N/A,499,506,N/A,74,4
5,N/A,N/A,N/A,494,499,N/A,79,3
6,N/A,N/A,N/A,488,494,N/A,84,2
4,N/A,N/A,N/A,484,488,N/A,89,1
14,N/A,N/A,N/A,470,484,N/A,94,6
6,N/A,N/A,N/A,464,470,N/A,98,4
7,N/A,N/A,N/A,457,464,N/A,104,4
5,N/A,N/A,N/A,452,457,N/A,107,1
5,N/A,N/A,N/A,447,452,N/A,110,4
4,N/A,N/A,N/A,443,447,N/A,114,2
16,N/A,N/A,N/A,427,443,N/A,118,6
11,N/A,N/A,N/A,416,427,N/A,123,5
4,N/A,N/A,N/A,412,416,N/A,126,2
4,N/A,N/A,N/A,408,412,N/A,131,1
5,N/A,N/A,N/A,403,408,N/A,137,1
12,N/A,N/A,N/A,1502,1514,N/A,3,5
7,N/A,N/A,N/A,1495,1502,N/A,8,4
4,N/A,N/A,N/A,1491,1495,N/A,12,2
4,N/A,N/A,N/A,1487,1491,N/A,18,2
4,N/A,N/A,N/A,1483,1487,N/A,24,2
5,N/A,N/A,N/A,1478,1483,N/A,29,1
5,N/A,N/A,N/A,1473,1478,N/A,35,1
10,N/A,N/A,N/A,1463,1473,N/A,40,6
4,N/A,N/A,N/A,1459,1463,N/A,43,3
7,N/A,N/A,N/A,1452,1459,N/A,49,3
6,N/A,N/A,N/A,1446,1452,N/A,55,3
4,N/A,N/A,N/A,1442,1446,N/A,61,3
6,N/A,N/A,N/A,1436,1442,N/A,67,3
7,N/A,N/A,N/A,1429,1436,N/A,73,3
5,N/A,N/A,N/A,1424,1429,N/A,78,2
10,N/A,N/A,N/A,1414,1424,N/A,82,6
5,N/A,N/A,N/A,1409,1414,N/A,88,0
9,N/A,N/A,N/A,1400,1409,N/A,93,5
7,N/A,N/A,N/A,1393,1400,N/A,98,4
4,N/A,N/A,N/A,1389,1393,N/A,101,1
11,N/A,N/A,N/A,1378,1389,N/A,106,6
8,N/A,N/A,N/A,1370,1378,N/A,110,4
4,N/A,N/A,N/A,1366,1370,N/A,115,3
16,N/A,N/A,N/A,1350,1366,N/A,118,6
5,N/A,N/A,N/A,1345,1350,N/A,124,0
16,N/A,N/A,N/A,1329,1345,N/A,130,6
7,N/A,N/A,N/A,1322,1329,N/A,134,4
6,N/A,N/A,N/A,1316,1322,N/A,139,3
6,N/A,N/A,N/A,1310,1316,N/A,145,3
5,N/A,N/A,N/A,1305,1310,N/A,149,1
6,N/A,N/A,N/A,930,936,N/A,3,3
11,N/A,N/A,N/A,919,930,N/A,6,6
4,N/A,N/A,N/A,915,919,N/A,12,0
12,N/A,N/A,N/A,903,915,N/A,17,5
11,N/A,N/A,N/A,892,903,N/A,23,5
7,N/A,N/A,N/A,885,892,N/A,26,2
9,N/A,N/A,N/A,876,885,N/A,29,5
4,N/A,N/A,N/A,872,876,N/A,32,2
4,N/A,N/A,N/A,868,872,N/A,37,1
6,N/A,N/A,N/A,862,868,N/A,40,4
5,N/A,N/A,N/A,857,862,N/A,45,3
5,N/A,N/A,N/A,852,857,N/A,51,3
5,N/A,N/A,N/A,847,852,N/A,56,2
4,N/A,N/A,N/A,843,847,N/A,61,1
5,N/A,N/A,N/A,838,843,N/A,67,1
5,N/A,N/A,N/A,833,838,N/A,73,1
6,N/A,N/A,N/A,827,833,N/A,76,4
5,N/A,N/A,N/A,822,827,N/A,79,1
9,N/A,N/A,N/A,813,822,N/A,83,5
8,N/A,N/A,N/A,805,813,N/A,88,4
7,N/A,N/A,N/A,798,805,N/A,94,4
8,N/A,N/A,N/A,790,798,N/A,100,4
6,N/A,N/A,N/A,784,790,N/A,105,3
7,N/A,N/A,N/A,777,784,N/A,111,3
4,N/A,N/A,N/A,773,777,N/A,115,1
9,N/A,N/A,N/A,764,773,N/A,119,5
6,N/A,N/A,N/A,758,764,N/A,122,2
13,N/A,N/A,N/A,745,758,N/A,126,6
5,N/A,N/A,N/A,740,745,N/A,129,3
5,N/A,N/A,N/A,735,740,N/A,135,3
6,N/A,N/A,N/A,1103,1109,N/A,4,4
7,N/A,N/A,N/A,1096,1103,N/A,8,2
14,N/A,N/A,N/A,1082,1096,N/A,12,6
5,N/A,N/A,N/A,1077,1082,N/A,18,0
19,N/A,N/A,N/A,1058,1077,N/A,24,6
5,N/A,N/A,N/A,1053,1058,N/A,27,3
11,N/A,N/A,N/A,1042,1053,N/A,30,6
8,N/A,N/A,N/A,1034,1042,N/A,34,4
5,N/A,N/A,N/A,1029,1034,N/A,40,4
5,N/A,N/A,N/A,1024,1029,N/A,46,4
5,N/A,N/A,N/A,1019,1024,N/A,50,2
5,N/A,N/A,N/A,1014,1019,N/A,55,1
4,N/A,N/A,N/A,1010,1014,N/A,61,1
16,N/A,N/A,N/A,994,1010,N/A,66,6
6,N/A,N/A,N/A,988,994,N/A,69,3
5,N/A,N/A,N/A,983,988,N/A,75,3
7,N/A,N/A,N/A,976,983,N/A,81,3
14,N/A,N/A,N/A,962,976,N/A,84,6
12,N/A,N/A,N/A,950,962,N/A,89,5
7,N/A,N/A,N/A,943,950,N/A,93,3
7,N/A,N/A,N/A,936,943,N/A,99,3
4,N/A,N/A,N/A,932,936,N/A,103,1
10,N/A,N/A,N/A,922,932,N/A,107,5
12,N/A,N/A,N/A,910,922,N/A,113,5
6,N/A,N/A,N/A,904,910,N/A,117,3
6,N/A,N/A,N/A,898,904,N/A,122,2
6,N/A,N/A,N/A,892,898,N/A,128,2
11,N/A,N/A,N/A,881,892,N/A,131,5
5,N/A,N/A,N/A,876,881,N/A,135,3
18,N/A,N/A,N/A,858,876,N/A,138,6
5,N/A,N/A,N/A,1763,1768,N/A,3,3
5,N/A,N/A,N/A,1758,1763,N/A,7,1
10,N/A,N/A,N/A,1748,1758,N/A,11,5
6,N/A,N/A,N/A,1742,1748,N/A,15,3
4,N/A,N/A,N/A,1738,1742,N/A,19,1
8,N/A,N/A,N/A,1730,1738,N/A,22,4
6,N/A,N/A,N/A,1724,1730,N/A,26,2
4,N/A,N/A,N/A,1720,1724,N/A,31,1
15,N/A,N/A,N/A,1705,1720,N/A,36,6
4,N/A,N/A,N/A,1701,1705,N/A,39,3
7,N/A,N/A,N/A,1694,1701,N/A,44,2
7,N/A,N/A,N/A,1687,1694,N/A,50,2
17,N/A,N/A,N/A,1670,1687,N/A,54,6
4,N/A,N/A,N/A,1666,1670,N/A,57,3
19,N/A,N/A,N/A,1647,1666,N/A,60,6
11,N/A,N/A,N/A,1636,1647,N/A,65,5
8,N/A,N/A,N/A,1628,1636,N/A,70,4
5,N/A,N/A,N/A,1623,1628,N/A,73,1
13,N/A,N/A,N/A,1610,1623,N/A,78,6
10,N/A,N/A,N/A,1600,1610,N/A,83,5
4,N/A,N/A,N/A,1596,1600,N/A,87,3
7,N/A,N/A,N/A,1589,1596,N/A,92,2
18,N/A,N/A,N/A,1571,1589,N/A,96,6
11,N/A,N/A,N/A,1560,1571,N/A,101,5
4,N/A,N/A,N/A,1556,1560,N/A,104,2
4,N/A,N/A,N/A,1552,1556,N/A,109,1
5,N/A,N/A,N/A,1547,1552,N/A,115,1
4,N/A,N/A,N/A,1543,1547,N/A,121,1
8,N/A,N/A,N/A,1535,1543,N/A,124,4
7,N/A,N/A,N/A,1528,1535,N/A,129,3
15,N/A,N/A,N/A,1474,1489,N/A,6,6
4,N/A,N/A,N/A,1470,1474,N/A,9,3
6,N/A,N/A,N/A,1464,1470,N/A,14,2
5,N/A,N/A,N/A,1459,1464,N/A,20,2
5,N/A,N/A,N/A,1454,1459,N/A,25,1
10,N/A,N/A,N/A,1444,1454,N/A,30,6
9,N/A,N/A,N/A,1435,1444,N/A,35,5
7,N/A,N/A,N/A,1428,1435,N/A,38,2
6,N/A,N/A,N/A,1422,1428,N/A,44,2
11,N/A,N/A,N/A,1411,1422,N/A,48,6
5,N/A,N/A,N/A,1406,1411,N/A,54,0
7,N/A,N/A,N/A,1399,1406,N/A,58,4
4,N/A,N/A,N/A,1395,1399,N/A,61,1
8,N/A,N/A,N/A,1387,1395,N/A,64,4
5,N/A,N/A,N/A,1382,1387,N/A,68,2
5,N/A,N/A,N/A,1377,1382,N/A,73,1
4,N/A,N/A,N/A,1373,1377,N/A,79,1
5,N/A,N/A,N/A,1368,1373,N/A,82,4
6,N/A,N/A,N/A,1362,1368,N/A,86,2
4,N/A,N/A,N/A,1358,1362,N/A,92,2
5,N/A,N/A,N/A,1353,1358,N/A,97,1
4,N/A,N/A,N/A,1349,1353,N/A,103,1
10,N/A,N/A,N/A,1339,1349,N/A,107,5
7,N/A,N/A,N/A,1332,1339,N/A,110,2
5,N/A,N/A,N/A,1327,1332,N/A,116,2
7,N/A,N/A,N/A,1320,1327,N/A,122,2
5,N/A,N/A,N/A,1315,1320,N/A,128,2
14,N/A,N/A,N/A,1301,1315,N/A,132,6
4,N/A,N/A,N/A,1297,1301,N/A,138,0
7,N/A,N/A,N/A,1290,1297,N/A,142,4
7,N/A,N/A,N/A,1353,1360,N/A,5,3
5,N/A,N/A,N/A,1348,1353,N/A,11,3
4,N/A,N/A,N/A,1344,1348,N/A,15,1
9,N/A,N/A,N/A,1335,1344,N/A,19,5
6,N/A,N/A,N/A,1329,1335,N/A,24,4
5,N/A,N/A,N/A,1324,1329,N/A,27,1
4,N/A,N/A,N/A,1320,1324,N/A,33,1
15,N/A,N/A,N/A,1305,1320,N/A,38,6
9,N/A,N/A,N/A,1296,1305,N/A,43,5
6,N/A,N/A,N/A,1290,1296,N/A,47,3
4,N/A,N/A,N/A,1286,1290,N/A,52,2
12,N/A,N/A,N/A,1274,1286,N/A,55,5
8,N/A,N/A,N/A,1266,1274,N/A,60,4
4,N/A,N/A,N/A,1262,1266,N/A,63,1
4,N/A,N/A,N/A,1258,1262,N/A,69,1
8,N/A,N/A,N/A,1250,1258,N/A,72,4
4,N/A,N/A,N/A,1246,1250,N/A,77,3
6,N/A,N/A,N/A,1240,1246,N/A,82,2
10,N/A,N/A,N/A,1230,1240,N/A,86,6
6,N/A,N/A,N/A,1224,1230,N/A,90,4
6,N/A,N/A,N/A,1218,1224,N/A,96,4
5,N/A,N/A,N/A,1213,1218,N/A,99,1
9,N/A,N/A,N/A,1204,1213,N/A,103,5
4,N/A,N/A,N/A,1200,1204,N/A,107,3
5,N/A,N/A,N/A,1195,1200,N/A,112,2
4,N/A,N/A,N/A,1191,1195,N/A,118,2
9,N/A,N/A,N/A,1182,1191,N/A,121,5
12,N/A,N/A,N/A,1170,1182,N/A,127,5
6,N/A,N/A,N/A,1164,1170,N/A,132,4
4,N/A,N/A,N/A,1160,1164,N/A,135,1
17,N/A,N/A,N/A,1016,1033,N/A,3,6
9,N/A,N/A,N/A,1007,1016,N/A,8,5
12,N/A,N/A,N/A,995,1007,N/A,14,5
7,N/A,N/A,N/A,988,995,N/A,19,4
7,N/A,N/A,N/A,981,988,N/A,23,2
4,N/A,N/A,N/A,977,981,N/A,28,1
9,N/A,N/A,N/A,968,977,N/A,32,5
7,N/A,N/A,N/A,961,968,N/A,35,2
6,N/A,N/A,N/A,955,961,N/A,41,2
4,N/A,N/A,N/A,951,955,N/A,47,2
5,N/A,N/A,N/A,946,951,N/A,52,1
4,N/A,N/A,N/A,942,946,N/A,58,1
7,N/A,N/A,N/A,935,942,N/A,61,4
4,N/A,N/A,N/A,931,935,N/A,65,2
16,N/A,N/A,N/A,915,931,N/A,69,6
5,N/A,N/A,N/A,910,915,N/A,72,3
5,N/A,N/A,N/A,905,910,N/A,76,1
18,N/A,N/A,N/A,887,905,N/A,81,6
4,N/A,N/A,N/A,883,887,N/A,87,0
9,N/A,N/A,N/A,874,883,N/A,92,5
6,N/A,N/A,N/A,868,874,N/A,95,2
9,N/A,N/A,N/A,859,868,N/A,98,5
4,N/A,N/A,N/A,855,859,N/A,101,2
4,N/A,N/A,N/A,851,855,N/A,106,1
11,N/A,N/A,N/A,840,851,N/A,110,5
7,N/A,N/A,N/A,833,840,N/A,115,4
7,N/A,N/A,N/A,826,833,N/A,121,4
5,N/A,N/A,N/A,821,826,N/A,124,1
16,N/A,N/A,N/A,805,821,N/A,129,6
6,N/A,N/A,N/A,799,805,N/A,132,3
4,N/A,N/A,N/A,405,409,N/A,4,2
10,N/A,N/A,N/A,395,405,N/A,7,5
6,N/A,N/A,N/A,389,395,N/A,11,3
17,N/A,N/A,N/A,372,389,N/A,14,6
10,N/A,N/A,N/A,362,372,N/A,19,5
4,N/A,N/A,N/A,358,362,N/A,22,2
12,N/A,N/A,N/A,346,358,N/A,25,5
7,N/A,N/A,N/A,339,346,N/A,29,3
6,N/A,N/A,N/A,333,339,N/A,34,2
10,N/A,N/A,N/A,323,333,N/A,38,6
8,N/A,N/A,N/A,315,323,N/A,42,4
7,N/A,N/A,N/A,308,315,N/A,46,2
17,N/A,N/A,N/A,291,308,N/A,50,6
6,N/A,N/A,N/A,285,291,N/A,53,3
17,N/A,N/A,N/A,268,285,N/A,56,6
11,N/A,N/A,N/A,257,268,N/A,61,5
4,N/A,N/A,N/A,253,257,N/A,65,3
19,N/A,N/A,N/A,234,253,N/A,68,6
9,N/A,N/A,N/A,225,234,N/A,73,5
5,N/A,N/A,N/A,220,225,N/A,78,4
7,N/A,N/A,N/A,213,220,N/A,83,3
14,N/A,N/A,N/A,199,213,N/A,86,6
12,N/A,N/A,N/A,187,199,N/A,91,5
12,N/A,N/A,N/A,175,187,N/A,97,5
5,N/A,N/A,N/A,170,175,N/A,102,4
6,N/A,N/A,N/A,164,170,N/A,107,3
5,N/A,N/A,N/A,159,164,N/A,112,2
12,N/A,N/A,N/A,147,159,N/A,116,6
7,N/A,N/A,N/A,140,147,N/A,120,4
4,N/A,N/A,N/A,136,140,N/A,123,1
5,N/A,N/A,N/A,1015,1020,N/A,4,3
7,N/A,N/A,N/A,1008,1015,N/A,10,3
4,N/A,N/A,N/A,1004,1008,N/A,14,1
11,N/A,N/A,N/A,993,1004,N/A,19,6
4,N/A,N/A,N/A,989,993,N/A,25,0
7,N/A,N/A,N/A,982,989,N/A,29,4
4,N/A,N/A,N/A,978,982,N/A,32,1
4,N/A,N/A,N/A,974,978,N/A,38,1
10,N/A,N/A,N/A,964,974,N/A,43,6
4,N/A,N/A,N/A,960,964,N/A,49,0
9,N/A,N/A,N/A,951,960,N/A,54,5
4,N/A,N/A,N/A,947,951,N/A,57,2
5,N/A,N/A,N/A,942,947,N/A,63,2
6,N/A,N/A,N/A,936,942,N/A,69,2
19,N/A,N/A,N/A,917,936,N/A,73,6
11,N/A,N/A,N/A,906,917,N/A,78,5
11,N/A,N/A,N/A,895,906,N/A,84,5
4,N/A,N/A,N/A,891,895,N/A,88,3
7,N/A,N/A,N/A,884,891,N/A,93,2
9,N/A,N/A,N/A,875,884,N/A,96,5
6,N/A,N/A,N/A,869,875,N/A,100,3
7,N/A,N/A,N/A,862,869,N/A,106,3
19,N/A,N/A,N/A,843,862,N/A,109,6
11,N/A,N/A,N/A,832,843,N/A,114,5
7,N/A,N/A,N/A,825,832,N/A,119,4
7,N/A,N/A,N/A,818,825,N/A,125,4
5,N/A,N/A,N/A,813,818,N/A,129,2
7,N/A,N/A,N/A,806,813,N/A,135,2
4,N/A,N/A,N/A,802,806,N/A,140,1
9,N/A,N/A,N/A,793,802,N/A,144,5
17,N/A,N/A,N/A,1254,1271,N/A,5,6
10,N/A,N/A,N/A,1244,1254,N/A,10,5
6,N/A,N/A,N/A,1238,1244,N/A,13,2
15,N/A,N/A,N/A,1223,1238,N/A,17,6
6,N/A,N/A,N/A,1217,1223,N/A,20,3
10,N/A,N/A,N/A,1207,1217,N/A,23,6
5,N/A,N/A,N/A,1202,1207,N/A,26,3
4,N/A,N/A,N/A,1198,1202,N/A,30,1
4,N/A,N/A,N/A,1194,1198,N/A,36,1
10,N/A,N/A,N/A,1184,1194,N/A,40,5
4,N/A,N/A,N/A,1180,1184,N/A,43,2
10,N/A,N/A,N/A,1170,1180,N/A,46,5
12,N/A,N/A,N/A,1158,1170,N/A,52,5
9,N/A,N/A,N/A,1149,1158,N/A,58,5
8,N/A,N/A,N/A,1141,1149,N/A,63,4
4,N/A,N/A,N/A,1137,1141,N/A,66,1
6,N/A,N/A,N/A,1131,1137,N/A,69,4
5,N/A,N/A,N/A,1126,1131,N/A,73,2
7,N/A,N/A,N/A,1119,1126,N/A,79,2
5,N/A,N/A,N/A,1114,1119,N/A,84,1
9,N/A,N/A,N/A,1105,1114,N/A,88,5
7,N/A,N/A,N/A,1098,1105,N/A,92,3
6,N/A,N/A,N/A,1092,1098,N/A,98,3
10,N/A,N/A,N/A,1082,1092,N/A,101,6
12,N/A,N/A,N/A,1070,1082,N/A,106,5
11,N/A,N/A,N/A,1059,1070,N/A,112,5
4,N/A,N/A,N/A,1055,1059,N/A,115,2
6,N/A,N/A,N/A,1049,1055,N/A,121,2
4,N/A,N/A,N/A,1045,1049,N/A,126,1
6,N/A,N/A,N/A,1039,1045,N/A,129,4
12,N/A,N/A,N/A,1444,1456,N/A,5,5
4,N/A,N/A,N/A,1440,1444,N/A,9,3
13,N/A,N/A,N/A,1427,1440,N/A,12,6
7,N/A,N/A,N/A,1420,1427,N/A,15,3
6,N/A,N/A,N/A,1414,1420,N/A,21,3
13,N/A,N/A,N/A,1401,1414,N/A,24,6
4,N/A,N/A,N/A,1397,1401,N/A,27,3
5,N/A,N/A,N/A,1392,1397,N/A,31,1
8,N/A,N/A,N/A,1384,1392,N/A,34,4
5,N/A,N/A,N/A,1379,1384,N/A,37,1
5,N/A,N/A,N/A,1374,1379,N/A,43,1
14,N/A,N/A,N/A,1360,1374,N/A,48,6
8,N/A,N/A,N/A,1352,1360,N/A,52,4
4,N/A,N/A,N/A,1348,1352,N/A,55,1
8,N/A,N/A,N/A,1340,1348,N/A,58,4
5,N/A,N/A,N/A,1335,1340,N/A,64,4
4,N/A,N/A,N/A,1331,1335,N/A,69,3
4,N/A,N/A,N/A,1327,1331,N/A,73,1
5,N/A,N/A,N/A,1322,1327,N/A,79,1
8,N/A,N/A,N/A,1314,1322,N/A,82,4
5,N/A,N/A,N/A,1309,1314,N/A,85,1
8,N/A,N/A,N/A,1301,1309,N/A,88,4
5,N/A,N/A,N/A,1296,1301,N/A,93,3
11,N/A,N/A,N/A,1285,1296,N/A,96,6
11,N/A,N/A,N/A,1274,1285,N/A,101,5
5,N/A,N/A,N/A,1269,1274,N/A,105,3
10,N/A,N/A,N/A,1259,1269,N/A,108,6
7,N/A,N/A,N/A,1252,1259,N/A,112,4
6,N/A,N/A,N/A,1246,1252,N/A,117,3
6,N/A,N/A,N/A,1240,1246,N/A,123,3
6,N/A,N/A,N/A,1049,1055,N/A,5,4
6,N/A,N/A,N/A,1043,1049,N/A,10,3
19,N/A,N/A,N/A,1024,1043,N/A,13,6
9,N/A,N/A,N/A,1015,1024,N/A,18,5
5,N/A,N/A,N/A,1010,1015,N/A,23,4
7,N/A,N/A,N/A,1003,1010,N/A,27,2
5,N/A,N/A,N/A,998,1003,N/A,32,1
18,N/A,N/A,N/A,980,998,N/A,37,6
8,N/A,N/A,N/A,972,980,N/A,41,4
7,N/A,N/A,N/A,965,972,N/A,47,4
4,N/A,N/A,N/A,961,965,N/A,52,3
6,N/A,N/A,N/A,955,961,N/A,57,2
11,N/A,N/A,N/A,944,955,N/A,60,5
6,N/A,N/A,N/A,938,944,N/A,63,2
6,N/A,N/A,N/A,932,938,N/A,69,2
4,N/A,N/A,N/A,928,932,N/A,74,1
6,N/A,N/A,N/A,922,928,N/A,77,4
4,N/A,N/A,N/A,918,922,N/A,81,2
5,N/A,N/A,N/A,913,918,N/A,87,2
19,N/A,N/A,N/A,894,913,N/A,91,6
4,N/A,N/A,N/A,890,894,N/A,97,0
14,N/A,N/A,N/A,876,890,N/A,103,6
6,N/A,N/A,N/A,870,876,N/A,106,3
7,N/A,N/A,N/A,863,870,N/A,112,3
19,N/A,N/A,N/A,844,863,N/A,115,6
6,N/A,N/A,N/A,838,844,N/A,118,3
5,N/A,N/A,N/A,833,838,N/A,124,3
16,N/A,N/A,N/A,817,833,N/A,127,6
5,N/A,N/A,N/A,812,817,N/A,133,0
6,N/A,N/A,N/A,806,812,N/A,136,3
4,N/A,N/A,N/A,835,839,N/A,3,2
7,N/A,N/A,N/A,828,835,N/A,9,2
6,N/A,N/A,N/A,822,828,N/A,15,2
5,N/A,N/A,N/A,817,822,N/A,21,2
4,N/A,N/A,N/A,813,817,N/A,26,1
12,N/A,N/A,N/A,801,813,N/A,30,5
7,N/A,N/A,N/A,794,801,N/A,35,4
6,N/A,N/A,N/A,788,794,N/A,41,4
6,N/A,N/A,N/A,782,788,N/A,45,2
12,N/A,N/A,N/A,770,782,N/A,49,6
4,N/A,N/A,N/A,766,770,N/A,55,0
4,N/A,N/A,N/A,762,766,N/A,58,3
4,N/A,N/A,N/A,758,762,N/A,64,3
10,N/A,N/A,N/A,748,758,N/A,67,6
12,N/A,N/A,N/A,736,748,N/A,72,5
10,N/A,N/A,N/A,726,736,N/A,78,5
5,N/A,N/A,N/A,721,726,N/A,81,2
7,N/A,N/A,N/A,714,721,N/A,87,2
12,N/A,N/A,N/A,702,714,N/A,90,5
6,N/A,N/A,N/A,696,702,N/A,93,2
11,N/A,N/A,N/A,685,696,N/A,96,5
5,N/A,N/A,N/A,680,685,N/A,100,3
4,N/A,N/A,N/A,676,680,N/A,104,1
8,N/A,N/A,N/A,668,676,N/A,107,4
4,N/A,N/A,N/A,664,668,N/A,110,1
17,N/A,N/A,N/A,647,664,N/A,115,6
11,N/A,N/A,N/A,636,647,N/A,120,5
11,N/A,N/A,N/A,625,636,N/A,126,5
5,N/A,N/A,N/A,620,625,N/A,131,4
7,N/A,N/A,N/A,613,620,N/A,136,3
7,N/A,N/A,N/A,525,532,N/A,3,3
4,N/A,N/A,N/A,521,525,N/A,9,3
15,N/A,N/A,N/A,506,521,N/A,12,6
5,N/A,N/A,N/A,501,506,N/A,16,4
5,N/A,N/A,N/A,496,501,N/A,21,3
19,N/A,N/A,N/A,477,496,N/A,24,6
11,N/A,N/A,N/A,466,477,N/A,29,5
9,N/A,N/A,N/A,457,466,N/A,35,5
4,N/A,N/A,N/A,453,457,N/A,38,2
4,N/A,N/A,N/A,449,453,N/A,44,2
9,N/A,N/A,N/A,440,449,N/A,47,5
5,N/A,N/A,N/A,435,440,N/A,51,3
19,N/A,N/A,N/A,416,435,N/A,54,6
8,N/A,N/A,N/A,408,416,N/A,58,4
6,N/A,N/A,N/A,402,408,N/A,63,3
4,N/A,N/A,N/A,398,402,N/A,69,3
6,N/A,N/A,N/A,392,398,N/A,74,2
16,N/A,N/A,N/A,376,392,N/A,78,6
5,N/A,N/A,N/A,371,376,N/A,84,0
5,N/A,N/A,N/A,366,371,N/A,88,4
5,N/A,N/A,N/A,361,366,N/A,93,3
4,N/A,N/A,N/A,357,361,N/A,98,2
19,N/A,N/A,N/A,338,357,N/A,102,6
10,N/A,N/A,N/A,328,338,N/A,107,5
4,N/A,N/A,N/A,324,328,N/A,110,2
12,N/A,N/A,N/A,312,324,N/A,113,5
8,N/A,N/A,N/A,304,312,N/A,118,4
5,N/A,N/A,N/A,299,304,N/A,121,1
9,N/A,N/A,N/A,290,299,N/A,125,5
6,N/A,N/A,N/A,284,290,N/A,130,4
15,N/A,N/A,N/A,839,854,N/A,6,6
7,N/A,N/A,N/A,832,839,N/A,10,4
6,N/A,N/A,N/A,826,832,N/A,14,2
10,N/A,N/A,N/A,816,826,N/A,17,5
7,N/A,N/A,N/A,809,816,N/A,22,4
5,N/A,N/A,N/A,804,809,N/A,25,1
4,N/A,N/A,N/A,800,804,N/A,31,1
19,N/A,N/A,N/A,781,800,N/A,36,6
11,N/A,N/A,N/A,770,781,N/A,41,5
9,N/A,N/A,N/A,761,770,N/A,47,5
5,N/A,N/A,N/A,756,761,N/A,51,3
4,N/A,N/A,N/A,752,756,N/A,56,2
5,N/A,N/A,N/A,747,752,N/A,61,1
10,N/A,N/A,N/A,737,747,N/A,65,5
7,N/A,N/A,N/A,730,737,N/A,69,3
6,N/A,N/A,N/A,724,730,N/A,75,3
4,N/A,N/A,N/A,720,724,N/A,79,1
12,N/A,N/A,N/A,708,720,N/A,84,6
7,N/A,N/A,N/A,701,708,N/A,88,4
7,N/A,N/A,N/A,694,701,N/A,93,3
5,N/A,N/A,N/A,689,694,N/A,99,3
7,N/A,N/A,N/A,682,689,N/A,104,2
12,N/A,N/A,N/A,670,682,N/A,107,5
5,N/A,N/A,N/A,665,670,N/A,111,3
5,N/A,N/A,N/A,660,665,N/A,115,1
12,N/A,N/A,N/A,648,660,N/A,119,5
10,N/A,N/A,N/A,638,648,N/A,125,5
12,N/A,N/A,N/A,626,638,N/A,131,5
6,N/A,N/A,N/A,620,626,N/A,134,2
5,N/A,N/A,N/A,615,620,N/A,139,1
5,N/A,N/A,N/A,641,646,N/A,3,3
7,N/A,N/A,N/A,634,641,N/A,8,2
16,N/A,N/A,N/A,618,634,N/A,12,6
6,N/A,N/A,N/A,612,618,N/A,15,3
4,N/A,N/A,N/A,608,612,N/A,19,1
5,N/A,N/A,N/A,603,608,N/A,25,1
11,N/A,N/A,N/A,592,603,N/A,29,5
11,N/A,N/A,N/A,581,592,N/A,35,5
9,N/A,N/A,N/A,572,581,N/A,41,5
8,N/A,N/A,N/A,564,572,N/A,46,4
5,N/A,N/A,N/A,559,564,N/A,49,1
10,N/A,N/A,N/A,549,559,N/A,53,5
5,N/A,N/A,N/A,544,549,N/A,56,2
10,N/A,N/A,N/A,534,544,N/A,59,5
4,N/A,N/A,N/A,530,534,N/A,62,2
12,N/A,N/A,N/A,518,530,N/A,65,5
11,N/A,N/A,N/A,507,518,N/A,71,5
4,N/A,N/A,N/A,503,507,N/A,74,2
5,N/A,N/A,N/A,498,503,N/A,79,1
10,N/A,N/A,N/A,488,498,N/A,84,6
11,N/A,N/A,N/A,477,488,N/A,89,5
4,N/A,N/A,N/A,473,477,N/A,92,2
7,N/A,N/A,N/A,466,473,N/A,98,2
14,N/A,N/A,N/A,452,466,N/A,102,6
6,N/A,N/A,N/A,446,452,N/A,105,3
5,N/A,N/A,N/A,441,446,N/A,110,2
10,N/A,N/A,N/A,431,441,N/A,114,6
5,N/A,N/A,N/A,426,431,N/A,120,0
7,N/A,N/A,N/A,419,426,N/A,123,3
4,N/A,N/A,N/A,415,419,N/A,129,3
4,N/A,N/A,N/A,1645,1649,N/A,6,1
7,N/A,N/A,N/A,1638,1645,N/A,9,4
7,N/A,N/A,N/A,1631,1638,N/A,13,2
13,N/A,N/A,N/A,1618,1631,N/A,17,6
7,N/A,N/A,N/A,1611,1618,N/A,20,3
10,N/A,N/A,N/A,1601,1611,N/A,23,6
7,N/A,N/A,N/A,1594,1601,N/A,26,3
14,N/A,N/A,N/A,1580,1594,N/A,29,6
7,N/A,N/A,N/A,1573,1580,N/A,32,3
7,N/A,N/A,N/A,1566,1573,N/A,38,3
7,N/A,N/A,N/A,1559,1566,N/A,43,2
7,N/A,N/A,N/A,1552,1559,N/A,49,2
16,N/A,N/A,N/A,1536,1552,N/A,53,6
5,N/A,N/A,N/A,1531,1536,N/A,57,4
7,N/A,N/A,N/A,1524,1531,N/A,62,3
7,N/A,N/A,N/A,1517,1524,N/A,68,3
10,N/A,N/A,N/A,1507,1517,N/A,71,6
4,N/A,N/A,N/A,1503,1507,N/A,77,0
13,N/A,N/A,N/A,1490,1503,N/A,83,6
4,N/A,N/A,N/A,1486,1490,N/A,86,3
4,N/A,N/A,N/A,1482,1486,N/A,90,1
12,N/A,N/A,N/A,1470,1482,N/A,94,5
7,N/A,N/A,N/A,1463,1470,N/A,99,4
5,N/A,N/A,N/A,1458,1463,N/A,102,1
12,N/A,N/A,N/A,1446,1458,N/A,107,6
5,N/A,N/A,N/A,1441,1446,N/A,113,0
5,N/A,N/A,N/A,1436,1441,N/A,117,4
4,N/A,N/A,N/A,1432,1436,N/A,122,3
13,N/A,N/A,N/A,1419,1432,N/A,125,6
5,N/A,N/A,N/A,1414,1419,N/A,129,4
5,N/A,N/A,N/A,1714,1719,N/A,3,1
5,N/A,N/A,N/A,1709,1714,N/A,9,1
12,N/A,N/A,N/A,1697,1709,N/A,13,5
11,N/A,N/A,N/A,1686,1697,N/A,19,5
6,N/A,N/A,N/A,1680,1686,N/A,24,4
5,N/A,N/A,N/A,1675,1680,N/A,27,1
4,N/A,N/A,N/A,1671,1675,N/A,33,1
11,N/A,N/A,N/A,1660,1671,N/A,38,6
7,N/A,N/A,N/A,1653,1660,N/A,42,4
4,N/A,N/A,N/A,1649,1653,N/A,45,1
5,N/A,N/A,N/A,1644,1649,N/A,48,4
7,N/A,N/A,N/A,1637,1644,N/A,53,3
5,N/A,N/A,N/A,1632,1637,N/A,57,1
7,N/A,N/A,N/A,1625,1632,N/A,60,4
6,N/A,N/A,N/A,1619,1625,N/A,65,3
16,N/A,N/A,N/A,1603,1619,N/A,68,6
10,N/A,N/A,N/A,1593,1603,N/A,73,5
8,N/A,N/A,N/A,1585,1593,N/A,78,4
6,N/A,N/A,N/A,1579,1585,N/A,84,4
5,N/A,N/A,N/A,1574,1579,N/A,87,1
12,N/A,N/A,N/A,1562,1574,N/A,92,6
5,N/A,N/A,N/A,1557,1562,N/A,96,4
6,N/A,N/A,N/A,1551,1557,N/A,100,2
15,N/A,N/A,N/A,1536,1551,N/A,104,6
9,N/A,N/A,N/A,1527,1536,N/A,109,5
7,N/A,N/A,N/A,1520,1527,N/A,113,3
17,N/A,N/A,N/A,1503,1520,N/A,116,6
5,N/A,N/A,N/A,1498,1503,N/A,122,0
10,N/A,N/A,N/A,1488,1498,N/A,128,6
5,N/A,N/A,N/A,1483,1488,N/A,131,3
9,N/A,N/A,N/A,719,728,N/A,4,5
5,N/A,N/A,N/A,714,719,N/A,8,3
6,N/A,N/A,N/A,708,714,N/A,14,3
5,N/A,N/A,N/A,703,708,N/A,20,3
10,N/A,N/A,N/A,693,703,N/A,23,6
8,N/A,N/A,N/A,685,693,N/A,27,4
7,N/A,N/A,N/A,678,685,N/A,31,2
10,N/A,N/A,N/A,668,678,N/A,35,6
4,N/A,N/A,N/A,664,668,N/A,41,0
5,N/A,N/A,N/A,659,664,N/A,45,4
5,N/A,N/A,N/A,654,659,N/A,50,3
7,N/A,N/A,N/A,647,654,N/A,56,3
13,N/A,N/A,N/A,634,647,N/A,59,6
9,N/A,N/A,N/A,625,634,N/A,64,5
6,N/A,N/A,N/A,619,625,N/A,69,4
5,N/A,N/A,N/A,614,619,N/A,75,4
5,N/A,N/A,N/A,609,614,N/A,78,1
6,N/A,N/A,N/A,603,609,N/A,81,4
4,N/A,N/A,N/A,599,603,N/A,84,1
12,N/A,N/A,N/A,587,599,N/A,89,6
7,N/A,N/A,N/A,580,587,N/A,92,3
5,N/A,N/A,N/A,575,580,N/A,96,1
11,N/A,N/A,N/A,564,575,N/A,100,5
7,N/A,N/A,N/A,557,564,N/A,103,2
10,N/A,N/A,N/A,547,557,N/A,106,5
6,N/A,N/A,N/A,541,547,N/A,110,3
7,N/A,N/A,N/A,534,541,N/A,116,3
15,N/A,N/A,N/A,519,534,N/A,119,6
10,N/A,N/A,N/A,509,519,N/A,124,5
4,N/A,N/A,N/A,505,509,N/A,128,3
4,N/A,N/A,N/A,1867,1871,N/A,3,3
13,N/A,N/A,N/A,1854,1867,N/A,6,6
5,N/A,N/A,N/A,1849,1854,N/A,9,3
4,N/A,N/A,N/A,1845,1849,N/A,13,1
7,N/A,N/A,N/A,1838,1845,N/A,16,4
4,N/A,N/A,N/A,1834,1838,N/A,19,1
7,N/A,N/A,N/A,1827,1834,N/A,22,4
5,N/A,N/A,N/A,1822,1827,N/A,26,2
4,N/A,N/A,N/A,1818,1822,N/A,31,1
10,N/A,N/A,N/A,1808,1818,N/A,35,5
4,N/A,N/A,N/A,1804,1808,N/A,39,3
6,N/A,N/A,N/A,1798,1804,N/A,44,2
11,N/A,N/A,N/A,1787,1798,N/A,47,5
7,N/A,N/A,N/A,1780,1787,N/A,51,3
7,N/A,N/A,N/A,1773,1780,N/A,57,3
7,N/A,N/A,N/A,1766,1773,N/A,63,3
6,N/A,N/A,N/A,1760,1766,N/A,69,3
5,N/A,N/A,N/A,1755,1760,N/A,75,3
7,N/A,N/A,N/A,1748,1755,N/A,80,2
14,N/A,N/A,N/A,1734,1748,N/A,84,6
6,N/A,N/A,N/A,1728,1734,N/A,88,4
5,N/A,N/A,N/A,1723,1728,N/A,93,3
5,N/A,N/A,N/A,1718,1723,N/A,98,2
6,N/A,N/A,N/A,1712,1718,N/A,104,2
5,N/A,N/A,N/A,1707,1712,N/A,110,2
5,N/A,N/A,N/A,1702,1707,N/A,115,1
10,N/A,N/A,N/A,1692,1702,N/A,119,5
10,N/A,N/A,N/A,1682,1692,N/A,125,5
5,N/A,N/A,N/A,1677,1682,N/A,130,4
4,N/A,N/A,N/A,1673,1677,N/A,135,3
10,N/A,N/A,N/A,1988,1998,N/A,5,5
8,N/A,N/A,N/A,1980,1988,N/A,10,4
7,N/A,N/A,N/A,1973,1980,N/A,14,2
9,N/A,N/A,N/A,1964,1973,N/A,17,5
8,N/A,N/A,N/A,1956,1964,N/A,22,4
5,N/A,N/A,N/A,1951,1956,N/A,25,1
14,N/A,N/A,N/A,1937,1951,N/A,30,6
4,N/A,N/A,N/A,1933,1937,N/A,33,3
7,N/A,N/A,N/A,1926,1933,N/A,39,3
17,N/A,N/A,N/A,1909,1926,N/A,42,6
7,N/A,N/A,N/A,1902,1909,N/A,46,4
6,N/A,N/A,N/A,1896,1902,N/A,50,2
19,N/A,N/A,N/A,1877,1896,N/A,54,6
5,N/A,N/A,N/A,1872,1877,N/A,57,3
6,N/A,N/A,N/A,1866,1872,N/A,62,2
5,N/A,N/A,N/A,1861,1866,N/A,67,1
11,N/A,N/A,N/A,1850,1861,N/A,72,6
4,N/A,N/A,N/A,1846,1850,N/A,78,0
14,N/A,N/A,N/A,1832,1846,N/A,84,6
5,N/A,N/A,N/A,1827,1832,N/A,87,3
5,N/A,N/A,N/A,1822,1827,N/A,91,1
5,N/A,N/A,N/A,1817,1822,N/A,97,1
7,N/A,N/A,N/A,1810,1817,N/A,100,4
5,N/A,N/A,N/A,1805,1810,N/A,105,3
14,N/A,N/A,N/A,1791,1805,N/A,108,6
6,N/A,N/A,N/A,1785,1791,N/A,112,4
4,N/A,N/A,N/A,1781,1785,N/A,116,2
10,N/A,N/A,N/A,1771,1781,N/A,119,5
8,N/A,N/A,N/A,1763,1771,N/A,124,4
5,N/A,N/A,N/A,1758,1763,N/A,127,1
5,N/A,N/A,N/A,1165,1170,N/A,5,4
5,N/A,N/A,N/A,1160,1165,N/A,8,1
4,N/A,N/A,N/A,1156,1160,N/A,14,1
11,N/A,N/A,N/A,1145,1156,N/A,18,5
4,N/A,N/A,N/A,1141,1145,N/A,21,2
5,N/A,N/A,N/A,1136,1141,N/A,26,1
5,N/A,N/A,N/A,1131,1136,N/A,32,1
9,N/A,N/A,N/A,1122,1131,N/A,36,5
9,N/A,N/A,N/A,1113,1122,N/A,42,5
7,N/A,N/A,N/A,1106,1113,N/A,45,2
5,N/A,N/A,N/A,1101,1106,N/A,51,2
19,N/A,N/A,N/A,1082,1101,N/A,55,6
5,N/A,N/A,N/A,1077,1082,N/A,61,0
7,N/A,N/A,N/A,1070,1077,N/A,65,4
4,N/A,N/A,N/A,1066,1070,N/A,68,1
8,N/A,N/A,N/A,1058,1066,N/A,71,4
6,N/A,N/A,N/A,1052,1058,N/A,77,4
7,N/A,N/A,N/A,1045,1052,N/A,82,3
4,N/A,N/A,N/A,1041,1045,N/A,86,1
8,N/A,N/A,N/A,1033,1041,N/A,89,4
5,N/A,N/A,N/A,1028,1033,N/A,95,4
4,N/A,N/A,N/A,1024,1028,N/A,99,2
6,N/A,N/A,N/A,1018,1024,N/A,105,2
5,N/A,N/A,N/A,1013,1018,N/A,111,2
10,N/A,N/A,N/A,1003,1013,N/A,114,5
12,N/A,N/A,N/A,991,1003,N/A,120,5
9,N/A,N/A,N/A,982,991,N/A,126,5
7,N/A,N/A,N/A,975,982,N/A,129,2
10,N/A,N/A,N/A,965,975,N/A,132,5
6,N/A,N/A,N/A,959,965,N/A,137,4
4,N/A,N/A,N/A,358,362,N/A,3,3
4,N/A,N/A,N/A,354,358,N/A,7,1
9,N/A,N/A,N/A,345,354,N/A,11,5
8,N/A,N/A,N/A,337,345,N/A,16,4
8,N/A,N/A,N/A,329,337,N/A,22,4
4,N/A,N/A,N/A,325,329,N/A,26,2
5,N/A,N/A,N/A,320,325,N/A,32,2
5,N/A,N/A,N/A,315,320,N/A,38,2
4,N/A,N/A,N/A,311,315,N/A,44,2
4,N/A,N/A,N/A,307,311,N/A,49,1
12,N/A,N/A,N/A,295,307,N/A,53,5
12,N/A,N/A,N/A,283,295,N/A,59,5
5,N/A,N/A,N/A,278,283,N/A,62,2
7,N/A,N/A,N/A,271,278,N/A,68,2
12,N/A,N/A,N/A,259,271,N/A,71,5
11,N/A,N/A,N/A,248,259,N/A,77,5
5,N/A,N/A,N/A,243,248,N/A,81,3
15,N/A,N/A,N/A,228,243,N/A,84,6
4,N/A,N/A,N/A,224,228,N/A,87,3
6,N/A,N/A,N/A,218,224,N/A,93,3
4,N/A,N/A,N/A,214,218,N/A,97,1
5,N/A,N/A,N/A,209,214,N/A,103,1
5,N/A,N/A,N/A,204,209,N/A,106,4
6,N/A,N/A,N/A,198,204,N/A,111,3
7,N/A,N/A,N/A,191,198,N/A,117,3
4,N/A,N/A,N/A,187,191,N/A,121,1
12,N/A,N/A,N/A,175,187,N/A,126,6
5,N/A,N/A,N/A,170,175,N/A,132,0
6,N/A,N/A,N/A,164,170,N/A,135,3
5,N/A,N/A,N/A,159,164,N/A,140,2
4,N/A,N/A,N/A,481,485,N/A,5,2
12,N/A,N/A,N/A,469,481,N/A,8,5
9,N/A,N/A,N/A,460,469,N/A,14,5
7,N/A,N/A,N/A,453,460,N/A,19,4
4,N/A,N/A,N/A,449,453,N/A,23,2
10,N/A,N/A,N/A,439,449,N/A,26,5
7,N/A,N/A,N/A,432,439,N/A,29,2
7,N/A,N/A,N/A,425,432,N/A,35,2
4,N/A,N/A,N/A,421,425,N/A,40,1
5,N/A,N/A,N/A,416,421,N/A,46,1
5,N/A,N/A,N/A,411,416,N/A,49,4
4,N/A,N/A,N/A,407,411,N/A,52,1
7,N/A,N/A,N/A,400,407,N/A,55,4
4,N/A,N/A,N/A,396,400,N/A,58,1
4,N/A,N/A,N/A,392,396,N/A,64,1
16,N/A,N/A,N/A,376,392,N/A,69,6
6,N/A,N/A,N/A,370,376,N/A,73,4
5,N/A,N/A,N/A,365,370,N/A,76,1
11,N/A,N/A,N/A,354,365,N/A,80,5
7,N/A,N/A,N/A,347,354,N/A,83,2
17,N/A,N/A,N/A,330,347,N/A,87,6
10,N/A,N/A,N/A,320,330,N/A,92,5
5,N/A,N/A,N/A,315,320,N/A,97,4
4,N/A,N/A,N/A,311,315,N/A,100,1
4,N/A,N/A,N/A,307,311,N/A,106,1
12,N/A,N/A,N/A,295,307,N/A,110,5
8,N/A,N/A,N/A,287,295,N/A,115,4
5,N/A,N/A,N/A,282,287,N/A,118,1
13,N/A,N/A,N/A,269,282,N/A,123,6
8,N/A,N/A,N/A,261,269,N/A,127,4
10,N/A,N/A,N/A,1239,1249,N/A,5,5
6,N/A,N/A,N/A,1233,1239,N/A,10,4
4,N/A,N/A,N/A,1229,1233,N/A,14,2
15,N/A,N/A,N/A,1214,1229,N/A,18,6
4,N/A,N/A,N/A,1210,1214,N/A,24,0
11,N/A,N/A,N/A,1199,1210,N/A,30,6
6,N/A,N/A,N/A,1193,1199,N/A,33,3
15,N/A,N/A,N/A,1178,1193,N/A,36,6
5,N/A,N/A,N/A,1173,1178,N/A,42,0
9,N/A,N/A,N/A,1164,1173,N/A,47,5
4,N/A,N/A,N/A,1160,1164,N/A,50,2
12,N/A,N/A,N/A,1148,1160,N/A,53,5
4,N/A,N/A,N/A,1144,1148,N/A,56,2
12,N/A,N/A,N/A,1132,1144,N/A,60,6
6,N/A,N/A,N/A,1126,1132,N/A,64,4
5,N/A,N/A,N/A,1121,1126,N/A,67,1
10,N/A,N/A,N/A,1111,1121,N/A,71,5
6,N/A,N/A,N/A,1105,1111,N/A,76,4
6,N/A,N/A,N/A,1099,1105,N/A,82,4
7,N/A,N/A,N/A,1092,1099,N/A,88,4
5,N/A,N/A,N/A,1087,1092,N/A,91,1
12,N/A,N/A,N/A,1075,1087,N/A,95,5
4,N/A,N/A,N/A,1071,1075,N/A,99,3
5,N/A,N/A,N/A,1066,1071,N/A,104,2
6,N/A,N/A,N/A,1060,1066,N/A,110,2
11,N/A,N/A,N/A,1049,1060,N/A,114,6
5,N/A,N/A,N/A,1044,1049,N/A,117,3
6,N/A,N/A,N/A,1038,1044,N/A,123,3
6,N/A,N/A,N/A,1032,1038,N/A,128,2
6,N/A,N/A,N/A,1026,1032,N/A,134,2
16,N/A,N/A,N/A,734,750,N/A,6,6
8,N/A,N/A,N/A,726,734,N/A,10,4
4,N/A,N/A,N/A,722,726,N/A,13,1
5,N/A,N/A,N/A,717,722,N/A,19,1
5,N/A,N/A,N/A,712,717,N/A,22,4
4,N/A,N/A,N/A,708,712,N/A,26,2
7,N/A,N/A,N/A,701,708,N/A,32,2
16,N/A,N/A,N/A,685,701,N/A,36,6
4,N/A,N/A,N/A,681,685,N/A,42,0
6,N/A,N/A,N/A,675,681,N/A,45,3
7,N/A,N/A,N/A,668,675,N/A,50,2
12,N/A,N/A,N/A,656,668,N/A,54,6
12,N/A,N/A,N/A,644,656,N/A,59,5
4,N/A,N/A,N/A,640,644,N/A,62,2
14,N/A,N/A,N/A,626,640,N/A,66,6
7,N/A,N/A,N/A,619,626,N/A,70,4
8,N/A,N/A,N/A,611,619,N/A,76,4
5,N/A,N/A,N/A,606,611,N/A,82,4
4,N/A,N/A,N/A,602,606,N/A,85,1
11,N/A,N/A,N/A,591,602,N/A,89,5
7,N/A,N/A,N/A,584,591,N/A,93,3
4,N/A,N/A,N/A,580,584,N/A,98,2
16,N/A,N/A,N/A,564,580,N/A,102,6
5,N/A,N/A,N/A,559,564,N/A,105,3
5,N/A,N/A,N/A,554,559,N/A,110,2
12,N/A,N/A,N/A,542,554,N/A,113,5
5,N/A,N/A,N/A,537,542,N/A,116,2
7,N/A,N/A,N/A,530,537,N/A,122,2
12,N/A,N/A,N/A,518,530,N/A,125,5
4,N/A,N/A,N/A,514,518,N/A,129,3
11,N/A,N/A,N/A,1174,1185,N/A,5,5
4,N/A,N/A,N/A,1170,1174,N/A,8,2
15,N/A,N/A,N/A,1155,1170,N/A,12,6
10,N/A,N/A,N/A,1145,1155,N/A,17,5
7,N/A,N/A,N/A,1138,1145,N/A,20,2
11,N/A,N/A,N/A,1127,1138,N/A,23,5
5,N/A,N/A,N/A,1122,1127,N/A,26,2
7,N/A,N/A,N/A,1115,1122,N/A,32,2
5,N/A,N/A,N/A,1110,1115,N/A,37,1
6,N/A,N/A,N/A,1104,1110,N/A,40,4
5,N/A,N/A,N/A,1099,1104,N/A,43,1
8,N/A,N/A,N/A,1091,1099,N/A,46,4
4,N/A,N/A,N/A,1087,1091,N/A,49,1
5,N/A,N/A,N/A,1082,1087,N/A,55,1
4,N/A,N/A,N/A,1078,1082,N/A,61,1
4,N/A,N/A,N/A,1074,1078,N/A,67,1
5,N/A,N/A,N/A,1069,1074,N/A,73,1
10,N/A,N/A,N/A,1059,1069,N/A,77,5
12,N/A,N/A,N/A,1047,1059,N/A,83,5
4,N/A,N/A,N/A,1043,1047,N/A,86,2
5,N/A,N/A,N/A,1038,1043,N/A,91,1
5,N/A,N/A,N/A,1033,1038,N/A,97,1
10,N/A,N/A,N/A,1023,1033,N/A,101,5
11,N/A,N/A,N/A,1012,1023,N/A,107,5
5,N/A,N/A,N/A,1007,1012,N/A,112,4
6,N/A,N/A,N/A,1001,1007,N/A,116,2
4,N/A,N/A,N/A,997,1001,N/A,121,1
6,N/A,N/A,N/A,991,997,N/A,124,4
5,N/A,N/A,N/A,986,991,N/A,127,1
4,N/A,N/A,N/A,982,986,N/A,133,1
5,N/A,N/A,N/A,406,411,N/A,4,2
4,N/A,N/A,N/A,402,406,N/A,9,1
11,N/A,N/A,N/A,391,402,N/A,13,5
6,N/A,N/A,N/A,385,391,N/A,18,4
5,N/A,N/A,N/A,380,385,N/A,24,4
4,N/A,N/A,N/A,376,380,N/A,29,3
4,N/A,N/A,N/A,372,376,N/A,33,1
8,N/A,N/A,N/A,364,372,N/A,36,4
4,N/A,N/A,N/A,360,364,N/A,40,2
9,N/A,N/A,N/A,351,360,N/A,43,5
6,N/A,N/A,N/A,345,351,N/A,47,3
5,N/A,N/A,N/A,340,345,N/A,53,3
5,N/A,N/A,N/A,335,340,N/A,57,1
18,N/A,N/A,N/A,317,335,N/A,62,6
4,N/A,N/A,N/A,313,317,N/A,68,0
5,N/A,N/A,N/A,308,313,N/A,71,3
5,N/A,N/A,N/A,303,308,N/A,75,1
11,N/A,N/A,N/A,292,303,N/A,79,5
6,N/A,N/A,N/A,286,292,N/A,83,3
6,N/A,N/A,N/A,280,286,N/A,89,3
5,N/A,N/A,N/A,275,280,N/A,95,3
5,N/A,N/A,N/A,270,275,N/A,100,2
10,N/A,N/A,N/A,260,270,N/A,103,5
5,N/A,N/A,N/A,255,260,N/A,108,4
5,N/A,N/A,N/A,250,255,N/A,111,1
17,N/A,N/A,N/A,233,250,N/A,116,6
8,N/A,N/A,N/A,225,233,N/A,120,4
4,N/A,N/A,N/A,221,225,N/A,123,1
9,N/A,N/A,N/A,212,221,N/A,127,5
7,N/A,N/A,N/A,205,212,N/A,132,4
6,N/A,N/A,N/A,1351,1357,N/A,5,3
14,N/A,N/A,N/A,1337,1351,N/A,8,6
10,N/A,N/A,N/A,1327,1337,N/A,13,5
11,N/A,N/A,N/A,1316,1327,N/A,19,5
7,N/A,N/A,N/A,1309,1316,N/A,24,4
5,N/A,N/A,N/A,1304,1309,N/A,29,3
7,N/A,N/A,N/A,1297,1304,N/A,35,3
5,N/A,N/A,N/A,1292,1297,N/A,41,3
4,N/A,N/A,N/A,1288,1292,N/A,46,2
15,N/A,N/A,N/A,1273,1288,N/A,50,6
7,N/A,N/A,N/A,1266,1273,N/A,53,3
6,N/A,N/A,N/A,1260,1266,N/A,58,2
4,N/A,N/A,N/A,1256,1260,N/A,63,1
4,N/A,N/A,N/A,1252,1256,N/A,69,1
9,N/A,N/A,N/A,1243,1252,N/A,73,5
6,N/A,N/A,N/A,1237,1243,N/A,76,2
9,N/A,N/A,N/A,1228,1237,N/A,79,5
4,N/A,N/A,N/A,1224,1228,N/A,82,2
11,N/A,N/A,N/A,1213,1224,N/A,85,5
5,N/A,N/A,N/A,1208,1213,N/A,88,2
7,N/A,N/A,N/A,1201,1208,N/A,94,2
4,N/A,N/A,N/A,1197,1201,N/A,99,1
4,N/A,N/A,N/A,1193,1197,N/A,105,1
12,N/A,N/A,N/A,1181,1193,N/A,110,6
10,N/A,N/A,N/A,1171,1181,N/A,115,5
12,N/A,N/A,N/A,1159,1171,N/A,121,5
5,N/A,N/A,N/A,1154,1159,N/A,126,4
7,N/A,N/A,N/A,1147,1154,N/A,130,2
12,N/A,N/A,N/A,1135,1147,N/A,134,6
4,N/A,N/A,N/A,1131,1135,N/A,140,0
16,N/A,N/A,N/A,874,890,N/A,6,6
8,N/A,N/A,N/A,866,874,N/A,10,4
6,N/A,N/A,N/A,860,866,N/A,15,3
17,N/A,N/A,N/A,843,860,N/A,18,6
11,N/A,N/A,N/A,832,843,N/A,23,5
6,N/A,N/A,N/A,826,832,N/A,27,3
6,N/A,N/A,N/A,820,826,N/A,32,2
9,N/A,N/A,N/A,811,820,N/A,35,5
5,N/A,N/A,N/A,806,811,N/A,38,2
4,N/A,N/A,N/A,802,806,N/A,44,2
5,N/A,N/A,N/A,797,802,N/A,50,2
12,N/A,N/A,N/A,785,797,N/A,54,6
9,N/A,N/A,N/A,776,785,N/A,59,5
7,N/A,N/A,N/A,769,776,N/A,64,4
8,N/A,N/A,N/A,761,769,N/A,70,4
6,N/A,N/A,N/A,755,761,N/A,74,2
5,N/A,N/A,N/A,750,755,N/A,80,2
10,N/A,N/A,N/A,740,750,N/A,83,5
7,N/A,N/A,N/A,733,740,N/A,86,2
17,N/A,N/A,N/A,716,733,N/A,90,6
7,N/A,N/A,N/A,709,716,N/A,93,3
4,N/A,N/A,N/A,705,709,N/A,99,3
7,N/A,N/A,N/A,698,705,N/A,105,3
4,N/A,N/A,N/A,694,698,N/A,110,2
17,N/A,N/A,N/A,677,694,N/A,114,6
5,N/A,N/A,N/A,672,677,N/A,120,0
4,N/A,N/A,N/A,668,672,N/A,123,3
19,N/A,N/A,N/A,649,668,N/A,126,6
5,N/A,N/A,N/A,644,649,N/A,132,0
12,N/A,N/A,N/A,632,644,N/A,137,5
4,N/A,N/A,N/A,847,851,N/A,5,3
4,N/A,N/A,N/A,843,847,N/A,9,1
8,N/A,N/A,N/A,835,843,N/A,12,4
4,N/A,N/A,N/A,831,835,N/A,15,1
6,N/A,N/A,N/A,825,831,N/A,18,4
7,N/A,N/A,N/A,818,825,N/A,24,4
4,N/A,N/A,N/A,814,818,N/A,27,1
12,N/A,N/A,N/A,802,814,N/A,31,5
8,N/A,N/A,N/A,794,802,N/A,36,4
7,N/A,N/A,N/A,787,794,N/A,42,4
5,N/A,N/A,N/A,782,787,N/A,47,3
14,N/A,N/A,N/A,768,782,N/A,50,6
10,N/A,N/A,N/A,758,768,N/A,55,5
8,N/A,N/A,N/A,750,758,N/A,60,4
4,N/A,N/A,N/A,746,750,N/A,64,2
9,N/A,N/A,N/A,737,746,N/A,67,5
5,N/A,N/A,N/A,732,737,N/A,70,2
5,N/A,N/A,N/A,727,732,N/A,75,1
4,N/A,N/A,N/A,723,727,N/A,81,1
19,N/A,N/A,N/A,704,723,N/A,86,6
10,N/A,N/A,N/A,694,704,N/A,91,5
10,N/A,N/A,N/A,684,694,N/A,97,5
8,N/A,N/A,N/A,676,684,N/A,102,4
4,N/A,N/A,N/A,672,676,N/A,105,1
12,N/A,N/A,N/A,660,672,N/A,110,6
5,N/A,N/A,N/A,655,660,N/A,114,4
4,N/A,N/A,N/A,651,655,N/A,119,3
7,N/A,N/A,N/A,644,651,N/A,124,2
12,N/A,N/A,N/A,632,644,N/A,127,5
6,N/A,N/A,N/A,626,632,N/A,131,3
15,N/A,N/A,N/A,648,663,N/A,6,6
5,N/A,N/A,N/A,643,648,N/A,10,4
4,N/A,N/A,N/A,639,643,N/A,13,1
10,N/A,N/A,N/A,629,639,N/A,18,6
11,N/A,N/A,N/A,618,629,N/A,23,5
4,N/A,N/A,N/A,614,618,N/A,27,3
18,N/A,N/A,N/A,596,614,N/A,30,6
11,N/A,N/A,N/A,585,596,N/A,35,5
5,N/A,N/A,N/A,580,585,N/A,40,4
4,N/A,N/A,N/A,576,580,N/A,45,3
4,N/A,N/A,N/A,572,576,N/A,49,1
14,N/A,N/A,N/A,558,572,N/A,54,6
6,N/A,N/A,N/A,552,558,N/A,58,4
7,N/A,N/A,N/A,545,552,N/A,63,3
5,N/A,N/A,N/A,540,545,N/A,67,1
4,N/A,N/A,N/A,536,540,N/A,73,1
4,N/A,N/A,N/A,532,536,N/A,79,1
5,N/A,N/A,N/A,527,532,N/A,85,1
4,N/A,N/A,N/A,523,527,N/A,91,1
9,N/A,N/A,N/A,514,523,N/A,95,5
6,N/A,N/A,N/A,508,514,N/A,100,4
7,N/A,N/A,N/A,501,508,N/A,105,3
6,N/A,N/A,N/A,495,501,N/A,110,2
15,N/A,N/A,N/A,480,495,N/A,114,6
12,N/A,N/A,N/A,468,480,N/A,119,5
12,N/A,N/A,N/A,456,468,N/A,125,5
4,N/A,N/A,N/A,452,456,N/A,128,2
11,N/A,N/A,N/A,441,452,N/A,132,6
5,N/A,N/A,N/A,436,441,N/A,136,4
7,N/A,N/A,N/A,429,436,N/A,140,2
4,N/A,N/A,N/A,685,689,N/A,3,3
15,N/A,N/A,N/A,670,685,N/A,6,6
4,N/A,N/A,N/A,666,670,N/A,9,3
6,N/A,N/A,N/A,660,666,N/A,14,2
4,N/A,N/A,N/A,656,660,N/A,19,1
5,N/A,N/A,N/A,651,656,N/A,25,1
6,N/A,N/A,N/A,645,651,N/A,28,4
4,N/A,N/A,N/A,641,645,N/A,33,3
5,N/A,N/A,N/A,636,641,N/A,37,1
9,N/A,N/A,N/A,627,636,N/A,41,5
6,N/A,N/A,N/A,621,627,N/A,44,2
9,N/A,N/A,N/A,612,621,N/A,47,5
9,N/A,N/A,N/A,603,612,N/A,53,5
6,N/A,N/A,N/A,597,603,N/A,56,2
14,N/A,N/A,N/A,583,597,N/A,60,6
7,N/A,N/A,N/A,576,583,N/A,64,4
5,N/A,N/A,N/A,571,576,N/A,69,3
6,N/A,N/A,N/A,565,571,N/A,75,3
6,N/A,N/A,N/A,559,565,N/A,81,3
10,N/A,N/A,N/A,549,559,N/A,84,6
8,N/A,N/A,N/A,541,549,N/A,88,4
5,N/A,N/A,N/A,536,541,N/A,91,1
18,N/A,N/A,N/A,518,536,N/A,96,6
12,N/A,N/A,N/A,506,518,N/A,101,5
7,N/A,N/A,N/A,499,506,N/A,106,4
5,N/A,N/A,N/A,494,499,N/A,109,1
18,N/A,N/A,N/A,476,494,N/A,114,6
6,N/A,N/A,N/A,470,476,N/A,118,4
4,N/A,N/A,N/A,466,470,N/A,123,3
7,N/A,N/A,N/A,459,466,N/A,128,2
5,N/A,N/A,N/A,375,380,N/A,3,4
4,N/A,N/A,N/A,371,375,N/A,8,3
5,N/A,N/A,N/A,366,371,N/A,13,2
4,N/A,N/A,N/A,362,366,N/A,19,2
4,N/A,N/A,N/A,358,362,N/A,24,1
4,N/A,N/A,N/A,354,358,N/A,30,1
6,N/A,N/A,N/A,348,354,N/A,33,4
5,N/A,N/A,N/A,343,348,N/A,37,2
18,N/A,N/A,N/A,325,343,N/A,41,6
9,N/A,N/A,N/A,316,325,N/A,46,5
4,N/A,N/A,N/A,312,316,N/A,49,2
4,N/A,N/A,N/A,308,312,N/A,55,2
12,N/A,N/A,N/A,296,308,N/A,58,5
7,N/A,N/A,N/A,289,296,N/A,62,3
13,N/A,N/A,N/A,276,289,N/A,65,6
4,N/A,N/A,N/A,272,276,N/A,68,3
6,N/A,N/A,N/A,266,272,N/A,74,3
11,N/A,N/A,N/A,255,266,N/A,77,6
6,N/A,N/A,N/A,249,255,N/A,81,4
6,N/A,N/A,N/A,243,249,N/A,87,4
4,N/A,N/A,N/A,239,243,N/A,92,3
5,N/A,N/A,N/A,234,239,N/A,96,1
10,N/A,N/A,N/A,224,234,N/A,100,5
10,N/A,N/A,N/A,214,224,N/A,106,5
7,N/A,N/A,N/A,207,214,N/A,111,4
5,N/A,N/A,N/A,202,207,N/A,116,3
14,N/A,N/A,N/A,188,202,N/A,119,6
5,N/A,N/A,N/A,183,188,N/A,123,4
7,N/A,N/A,N/A,176,183,N/A,128,3
4,N/A,N/A,N/A,172,176,N/A,134,3
13,N/A,N/A,N/A,1523,1536,N/A,4,6
5,N/A,N/A,N/A,1518,1523,N/A,7,3
6,N/A,N/A,N/A,1512,1518,N/A,12,2
5,N/A,N/A,N/A,1507,1512,N/A,18,2
7,N/A,N/A,N/A,1500,1507,N/A,24,2
4,N/A,N/A,N/A,1496,1500,N/A,29,1
4,N/A,N/A,N/A,1492,1496,N/A,35,1
8,N/A,N/A,N/A,1484,1492,N/A,38,4
5,N/A,N/A,N/A,1479,1484,N/A,42,2
10,N/A,N/A,N/A,1469,1479,N/A,45,5
7,N/A,N/A,N/A,1462,1469,N/A,48,2
9,N/A,N/A,N/A,1453,1462,N/A,51,5
7,N/A,N/A,N/A,1446,1453,N/A,54,2
6,N/A,N/A,N/A,1440,1446,N/A,60,2
7,N/A,N/A,N/A,1433,1440,N/A,66,2
10,N/A,N/A,N/A,1423,1433,N/A,70,6
7,N/A,N/A,N/A,1416,1423,N/A,73,3
5,N/A,N/A,N/A,1411,1416,N/A,77,1
10,N/A,N/A,N/A,1401,1411,N/A,81,5
7,N/A,N/A,N/A,1394,1401,N/A,85,3
16,N/A,N/A,N/A,1378,1394,N/A,88,6
6,N/A,N/A,N/A,1372,1378,N/A,91,3
4,N/A,N/A,N/A,1368,1372,N/A,97,3
4,N/A,N/A,N/A,1364,1368,N/A,103,3
17,N/A,N/A,N/A,1347,1364,N/A,106,6
9,N/A,N/A,N/A,1338,1347,N/A,111,5
7,N/A,N/A,N/A,1331,1338,N/A,116,4
6,N/A,N/A,N/A,1325,1331,N/A,122,4
5,N/A,N/A,N/A,1320,1325,N/A,127,3
6,N/A,N/A,N/A,1314,1320,N/A,133,3
4,N/A,N/A,N/A,1486,1490,N/A,3,2
5,N/A,N/A,N/A,1481,1486,N/A,9,2
12,N/A,N/A,N/A,1469,1481,N/A,12,5
4,N/A,N/A,N/A,1465,1469,N/A,15,2
15,N/A,N/A,N/A,1450,1465,N/A,19,6
5,N/A,N/A,N/A,1445,1450,N/A,23,4
6,N/A,N/A,N/A,1439,1445,N/A,28,3
7,N/A,N/A,N/A,1432,1439,N/A,33,2
12,N/A,N/A,N/A,1420,1432,N/A,36,5
5,N/A,N/A,N/A,1415,1420,N/A,40,3
17,N/A,N/A,N/A,1398,1415,N/A,43,6
7,N/A,N/A,N/A,1391,1398,N/A,47,4
8,N/A,N/A,N/A,1383,1391,N/A,53,4
7,N/A,N/A,N/A,1376,1383,N/A,58,3
4,N/A,N/A,N/A,1372,1376,N/A,63,2
5,N/A,N/A,N/A,1367,1372,N/A,69,2
4,N/A,N/A,N/A,1363,1367,N/A,74,1
13,N/A,N/A,N/A,1350,1363,N/A,79,6
8,N/A,N/A,N/A,1342,1350,N/A,83,4
4,N/A,N/A,N/A,1338,1342,N/A,87,2
4,N/A,N/A,N/A,1334,1338,N/A,92,1
9,N/A,N/A,N/A,1325,1334,N/A,96,5
5,N/A,N/A,N/A,1320,1325,N/A,101,4
8,N/A,N/A,N/A,1312,1320,N/A,107,4
5,N/A,N/A,N/A,1307,1312,N/A,112,3
4,N/A,N/A,N/A,1303,1307,N/A,116,1
7,N/A,N/A,N/A,1296,1303,N/A,119,4
5,N/A,N/A,N/A,1291,1296,N/A,124,3
4,N/A,N/A,N/A,1287,1291,N/A,128,1
6,N/A,N/A,N/A,1281,1287,N/A,131,4
8,N/A,N/A,N/A,1858,1866,N/A,4,4
6,N/A,N/A,N/A,1852,1858,N/A,8,2
12,N/A,N/A,N/A,1840,1852,N/A,12,6
11,N/A,N/A,N/A,1829,1840,N/A,17,5
12,N/A,N/A,N/A,1817,1829,N/A,23,5
12,N/A,N/A,N/A,1805,1817,N/A,29,5
8,N/A,N/A,N/A,1797,1805,N/A,34,4
6,N/A,N/A,N/A,1791,1797,N/A,38,2
17,N/A,N/A,N/A,1774,1791,N/A,42,6
7,N/A,N/A,N/A,1767,1774,N/A,46,4
6,N/A,N/A,N/A,1761,1767,N/A,52,4
7,N/A,N/A,N/A,1754,1761,N/A,58,4
6,N/A,N/A,N/A,1748,1754,N/A,63,3
4,N/A,N/A,N/A,1744,1748,N/A,67,1
6,N/A,N/A,N/A,1738,1744,N/A,70,4
7,N/A,N/A,N/A,1731,1738,N/A,75,3
4,N/A,N/A,N/A,1727,1731,N/A,79,1
16,N/A,N/A,N/A,1711,1727,N/A,84,6
9,N/A,N/A,N/A,1702,1711,N/A,89,5
11,N/A,N/A,N/A,1691,1702,N/A,95,5
5,N/A,N/A,N/A,1686,1691,N/A,98,2
4,N/A,N/A,N/A,1682,1686,N/A,103,1
11,N/A,N/A,N/A,1671,1682,N/A,107,5
5,N/A,N/A,N/A,1666,1671,N/A,110,2
9,N/A,N/A,N/A,1657,1666,N/A,113,5
7,N/A,N/A,N/A,1650,1657,N/A,118,4
7,N/A,N/A,N/A,1643,1650,N/A,122,2
5,N/A,N/A,N/A,1638,1643,N/A,128,2
5,N/A,N/A,N/A,1633,1638,N/A,133,1
5,N/A,N/A,N/A,1628,1633,N/A,139,1
5,N/A,N/A,N/A,1422,1427,N/A,5,2
6,N/A,N/A,N/A,1416,1422,N/A,11,2
4,N/A,N/A,N/A,1412,1416,N/A,16,1
10,N/A,N/A,N/A,1402,1412,N/A,20,5
4,N/A,N/A,N/A,1398,1402,N/A,23,2
5,N/A,N/A,N/A,1393,1398,N/A,29,2
6,N/A,N/A,N/A,1387,1393,N/A,35,2
6,N/A,N/A,N/A,1381,1387,N/A,41,2
7,N/A,N/A,N/A,1374,1381,N/A,47,2
5,N/A,N/A,N/A,1369,1374,N/A,53,2
12,N/A,N/A,N/A,1357,1369,N/A,57,6
5,N/A,N/A,N/A,1352,1357,N/A,63,0
5,N/A,N/A,N/A,1347,1352,N/A,67,4
4,N/A,N/A,N/A,1343,1347,N/A,72,3
7,N/A,N/A,N/A,1336,1343,N/A,78,3
7,N/A,N/A,N/A,1329,1336,N/A,83,2
5,N/A,N/A,N/A,1324,1329,N/A,88,1
8,N/A,N/A,N/A,1316,1324,N/A,91,4
5,N/A,N/A,N/A,1311,1316,N/A,96,3
5,N/A,N/A,N/A,1306,1311,N/A,100,1
4,N/A,N/A,N/A,1302,1306,N/A,106,1
11,N/A,N/A,N/A,1291,1302,N/A,110,5
7,N/A,N/A,N/A,1284,1291,N/A,114,3
12,N/A,N/A,N/A,1272,1284,N/A,117,6
5,N/A,N/A,N/A,1267,1272,N/A,123,0
5,N/A,N/A,N/A,1262,1267,N/A,127,4
5,N/A,N/A,N/A,1257,1262,N/A,130,1
5,N/A,N/A,N/A,1252,1257,N/A,136,1
12,N/A,N/A,N/A,1240,1252,N/A,141,6
7,N/A,N/A,N/A,1233,1240,N/A,145,4
5,N/A,N/A,N/A,1544,1549,N/A,4,1
19,N/A,N/A,N/A,1525,1544,N/A,9,6
6,N/A,N/A,N/A,1519,1525,N/A,13,4
6,N/A,N/A,N/A,1513,1519,N/A,17,2
4,N/A,N/A,N/A,1509,1513,N/A,22,1
5,N/A,N/A,N/A,1504,1509,N/A,28,1
12,N/A,N/A,N/A,1492,1504,N/A,32,5
5,N/A,N/A,N/A,1487,1492,N/A,37,4
7,N/A,N/A,N/A,1480,1487,N/A,43,4
7,N/A,N/A,N/A,1473,1480,N/A,48,3
7,N/A,N/A,N/A,1466,1473,N/A,53,2
10,N/A,N/A,N/A,1456,1466,N/A,57,6
8,N/A,N/A,N/A,1448,1456,N/A,61,4
5,N/A,N/A,N/A,1443,1448,N/A,65,2
11,N/A,N/A,N/A,1432,1443,N/A,68,5
10,N/A,N/A,N/A,1422,1432,N/A,74,5
7,N/A,N/A,N/A,1415,1422,N/A,79,4
7,N/A,N/A,N/A,1408,1415,N/A,83,2
4,N/A,N/A,N/A,1404,1408,N/A,88,1
6,N/A,N/A,N/A,1398,1404,N/A,91,4
6,N/A,N/A,N/A,1392,1398,N/A,97,4
6,N/A,N/A,N/A,1386,1392,N/A,102,3
19,N/A,N/A,N/A,1367,1386,N/A,105,6
5,N/A,N/A,N/A,1362,1367,N/A,109,4
4,N/A,N/A,N/A,1358,1362,N/A,113,2
9,N/A,N/A,N/A,1349,1358,N/A,116,5
10,N/A,N/A,N/A,1339,1349,N/A,122,5
5,N/A,N/A,N/A,1334,1339,N/A,125,2
19,N/A,N/A,N/A,1315,1334,N/A,129,6
5,N/A,N/A,N/A,1310,1315,N/A,135,0
5,N/A,N/A,N/A,722,727,N/A,5,2
18,N/A,N/A,N/A,704,722,N/A,9,6
10,N/A,N/A,N/A,694,704,N/A,14,5
5,N/A,N/A,N/A,689,694,N/A,18,3
7,N/A,N/A,N/A,682,689,N/A,24,3
17,N/A,N/A,N/A,665,682,N/A,27,6
6,N/A,N/A,N/A,659,665,N/A,30,3
19,N/A,N/A,N/A,640,659,N/A,33,6
10,N/A,N/A,N/A,630,640,N/A,38,5
8,N/A,N/A,N/A,622,630,N/A,43,4
4,N/A,N/A,N/A,618,622,N/A,46,1
5,N/A,N/A,N/A,613,618,N/A,52,1
7,N/A,N/A,N/A,606,613,N/A,55,4
5,N/A,N/A,N/A,601,606,N/A,58,1
7,N/A,N/A,N/A,594,601,N/A,61,4
4,N/A,N/A,N/A,590,594,N/A,64,1
11,N/A,N/A,N/A,579,590,N/A,68,5
5,N/A,N/A,N/A,574,579,N/A,72,3
4,N/A,N/A,N/A,570,574,N/A,77,2
5,N/A,N/A,N/A,565,570,N/A,82,1
5,N/A,N/A,N/A,560,565,N/A,88,1
12,N/A,N/A,N/A,548,560,N/A,92,5
6,N/A,N/A,N/A,542,548,N/A,95,2
14,N/A,N/A,N/A,528,542,N/A,99,6
6,N/A,N/A,N/A,522,528,N/A,103,4
7,N/A,N/A,N/A,515,522,N/A,107,2
5,N/A,N/A,N/A,510,515,N/A,112,1
13,N/A,N/A,N/A,497,510,N/A,117,6
6,N/A,N/A,N/A,491,497,N/A,120,3
6,N/A,N/A,N/A,485,491,N/A,126,3
7,N/A,N/A,N/A,1331,1338,N/A,3,4
4,N/A,N/A,N/A,1327,1331,N/A,6,1
11,N/A,N/A,N/A,1316,1327,N/A,10,5
10,N/A,N/A,N/A,1306,1316,N/A,16,5
4,N/A,N/A,N/A,1302,1306,N/A,19,2
5,N/A,N/A,N/A,1297,1302,N/A,25,2
16,N/A,N/A,N/A,1281,1297,N/A,29,6
6,N/A,N/A,N/A,1275,1281,N/A,32,3
5,N/A,N/A,N/A,1270,1275,N/A,36,1
6,N/A,N/A,N/A,1264,1270,N/A,39,4
5,N/A,N/A,N/A,1259,1264,N/A,42,1
6,N/A,N/A,N/A,1253,1259,N/A,45,4
5,N/A,N/A,N/A,1248,1253,N/A,50,3
4,N/A,N/A,N/A,1244,1248,N/A,54,1
10,N/A,N/A,N/A,1234,1244,N/A,58,5
4,N/A,N/A,N/A,1230,1234,N/A,61,2
16,N/A,N/A,N/A,1214,1230,N/A,65,6
11,N/A,N/A,N/A,1203,1214,N/A,70,5
5,N/A,N/A,N/A,1198,1203,N/A,73,2
6,N/A,N/A,N/A,1192,1198,N/A,79,2
4,N/A,N/A,N/A,1188,1192,N/A,85,2
5,N/A,N/A,N/A,1183,1188,N/A,90,1
12,N/A,N/A,N/A,1171,1183,N/A,94,5
6,N/A,N/A,N/A,1165,1171,N/A,97,2
4,N/A,N/A,N/A,1161,1165,N/A,102,1
16,N/A,N/A,N/A,1145,1161,N/A,107,6
8,N/A,N/A,N/A,1137,1145,N/A,111,4
4,N/A,N/A,N/A,1133,1137,N/A,115,2
5,N/A,N/A,N/A,1128,1133,N/A,120,1
18,N/A,N/A,N/A,1110,1128,N/A,125,6
12,N/A,N/A,N/A,1123,1135,N/A,5,5
7,N/A,N/A,N/A,1116,1123,N/A,9,3
6,N/A,N/A,N/A,1110,1116,N/A,15,3
5,N/A,N/A,N/A,1105,1110,N/A,19,1
17,N/A,N/A,N/A,1088,1105,N/A,24,6
5,N/A,N/A,N/A,1083,1088,N/A,30,0
4,N/A,N/A,N/A,1079,1083,N/A,33,3
6,N/A,N/A,N/A,1073,1079,N/A,39,3
4,N/A,N/A,N/A,1069,1073,N/A,44,2
17,N/A,N/A,N/A,1052,1069,N/A,48,6
7,N/A,N/A,N/A,1045,1052,N/A,51,3
5,N/A,N/A,N/A,1040,1045,N/A,56,2
14,N/A,N/A,N/A,1026,1040,N/A,60,6
6,N/A,N/A,N/A,1020,1026,N/A,63,3
6,N/A,N/A,N/A,1014,1020,N/A,68,2
5,N/A,N/A,N/A,1009,1014,N/A,73,1
12,N/A,N/A,N/A,997,1009,N/A,78,6
5,N/A,N/A,N/A,992,997,N/A,84,0
5,N/A,N/A,N/A,987,992,N/A,88,4
6,N/A,N/A,N/A,981,987,N/A,94,4
6,N/A,N/A,N/A,975,981,N/A,100,4
7,N/A,N/A,N/A,968,975,N/A,106,4
4,N/A,N/A,N/A,964,968,N/A,110,2
13,N/A,N/A,N/A,951,964,N/A,114,6
5,N/A,N/A,N/A,946,951,N/A,120,0
15,N/A,N/A,N/A,931,946,N/A,126,6
9,N/A,N/A,N/A,922,931,N/A,131,5
7,N/A,N/A,N/A,915,922,N/A,134,2
10,N/A,N/A,N/A,905,915,N/A,138,6
6,N/A,N/A,N/A,899,905,N/A,141,3
5,N/A,N/A,N/A,1077,1082,N/A,6,2
9,N/A,N/A,N/A,1068,1077,N/A,9,5
12,N/A,N/A,N/A,1056,1068,N/A,15,5
7,N/A,N/A,N/A,1049,1056,N/A,19,3
6,N/A,N/A,N/A,1043,1049,N/A,25,3
7,N/A,N/A,N/A,1036,1043,N/A,30,2
7,N/A,N/A,N/A,1029,1036,N/A,36,2
4,N/A,N/A,N/A,1025,1029,N/A,41,1
10,N/A,N/A,N/A,1015,1025,N/A,46,6
5,N/A,N/A,N/A,1010,1015,N/A,50,4
7,N/A,N/A,N/A,1003,1010,N/A,56,4
7,N/A,N/A,N/A,996,1003,N/A,61,3
5,N/A,N/A,N/A,991,996,N/A,65,1
4,N/A,N/A,N/A,987,991,N/A,71,1
18,N/A,N/A,N/A,969,987,N/A,76,6
6,N/A,N/A,N/A,963,969,N/A,79,3
16,N/A,N/A,N/A,947,963,N/A,82,6
5,N/A,N/A,N/A,942,947,N/A,86,4
5,N/A,N/A,N/A,937,942,N/A,92,4
5,N/A,N/A,N/A,932,937,N/A,98,4
6,N/A,N/A,N/A,926,932,N/A,103,3
4,N/A,N/A,N/A,922,926,N/A,107,1
9,N/A,N/A,N/A,913,922,N/A,111,5
12,N/A,N/A,N/A,901,913,N/A,117,5
5,N/A,N/A,N/A,896,901,N/A,120,2
4,N/A,N/A,N/A,892,896,N/A,126,2
11,N/A,N/A,N/A,881,892,N/A,129,5
5,N/A,N/A,N/A,876,881,N/A,134,4
5,N/A,N/A,N/A,871,876,N/A,138,2
10,N/A,N/A,N/A,861,871,N/A,141,5
5,N/A,N/A,N/A,1405,1410,N/A,4,4
7,N/A,N/A,N/A,1398,1405,N/A,10,4
7,N/A,N/A,N/A,1391,1398,N/A,15,3
4,N/A,N/A,N/A,1387,1391,N/A,19,1
12,N/A,N/A,N/A,1375,1387,N/A,24,6
12,N/A,N/A,N/A,1363,1375,N/A,29,5
4,N/A,N/A,N/A,1359,1363,N/A,33,3
7,N/A,N/A,N/A,1352,1359,N/A,38,2
5,N/A,N/A,N/A,1347,1352,N/A,43,1
4,N/A,N/A,N/A,1343,1347,N/A,49,1
11,N/A,N/A,N/A,1332,1343,N/A,54,6
12,N/A,N/A,N/A,1320,1332,N/A,59,5
4,N/A,N/A,N/A,1316,1320,N/A,62,2
12,N/A,N/A,N/A,1304,1316,N/A,65,5
7,N/A,N/A,N/A,1297,1304,N/A,69,3
5,N/A,N/A,N/A,1292,1297,N/A,73,1
4,N/A,N/A,N/A,1288,1292,N/A,79,1
11,N/A,N/A,N/A,1277,1288,N/A,83,5
7,N/A,N/A,N/A,1270,1277,N/A,87,3
6,N/A,N/A,N/A,1264,1270,N/A,93,3
12,N/A,N/A,N/A,1252,1264,N/A,96,6
9,N/A,N/A,N/A,1243,1252,N/A,101,5
11,N/A,N/A,N/A,1232,1243,N/A,107,5
5,N/A,N/A,N/A,1227,1232,N/A,112,4
4,N/A,N/A,N/A,1223,1227,N/A,116,2
6,N/A,N/A,N/A,1217,1223,N/A,122,2
4,N/A,N/A,N/A,1213,1217,N/A,128,2
9,N/A,N/A,N/A,1204,1213,N/A,131,5
6,N/A,N/A,N/A,1198,1204,N/A,135,3
7,N/A,N/A,N/A,1191,1198,N/A,141,3
6,N/A,N/A,N/A,1403,1409,N/A,4,3
16,N/A,N/A,N/A,1387,1403,N/A,7,6
6,N/A,N/A,N/A,1381,1387,N/A,11,4
5,N/A,N/A,N/A,1376,1381,N/A,17,4
5,N/A,N/A,N/A,1371,1376,N/A,23,4
5,N/A,N/A,N/A,1366,1371,N/A,28,3
4,N/A,N/A,N/A,1362,1366,N/A,32,1
8,N/A,N/A,N/A,1354,1362,N/A,35,4
4,N/A,N/A,N/A,1350,1354,N/A,38,1
16,N/A,N/A,N/A,1334,1350,N/A,43,6
4,N/A,N/A,N/A,1330,1334,N/A,46,3
4,N/A,N/A,N/A,1326,1330,N/A,50,1
8,N/A,N/A,N/A,1318,1326,N/A,53,4
7,N/A,N/A,N/A,1311,1318,N/A,57,2
4,N/A,N/A,N/A,1307,1311,N/A,62,1
11,N/A,N/A,N/A,1296,1307,N/A,67,6
7,N/A,N/A,N/A,1289,1296,N/A,70,3
5,N/A,N/A,N/A,1284,1289,N/A,76,3
6,N/A,N/A,N/A,1278,1284,N/A,82,3
12,N/A,N/A,N/A,1266,1278,N/A,85,6
8,N/A,N/A,N/A,1258,1266,N/A,89,4
6,N/A,N/A,N/A,1252,1258,N/A,93,2
11,N/A,N/A,N/A,1241,1252,N/A,96,5
12,N/A,N/A,N/A,1229,1241,N/A,102,5
5,N/A,N/A,N/A,1224,1229,N/A,105,2
11,N/A,N/A,N/A,1213,1224,N/A,109,6
6,N/A,N/A,N/A,1207,1213,N/A,112,3
12,N/A,N/A,N/A,1195,1207,N/A,115,6
5,N/A,N/A,N/A,1190,1195,N/A,121,0
7,N/A,N/A,N/A,1183,1190,N/A,124,3
19,N/A,N/A,N/A,512,531,N/A,4,6
5,N/A,N/A,N/A,507,512,N/A,10,0
15,N/A,N/A,N/A,492,507,N/A,16,6
4,N/A,N/A,N/A,488,492,N/A,19,3
16,N/A,N/A,N/A,472,488,N/A,22,6
8,N/A,N/A,N/A,464,472,N/A,26,4
7,N/A,N/A,N/A,457,464,N/A,30,2
5,N/A,N/A,N/A,452,457,N/A,35,1
8,N/A,N/A,N/A,444,452,N/A,38,4
7,N/A,N/A,N/A,437,444,N/A,43,3
7,N/A,N/A,N/A,430,437,N/A,49,3
5,N/A,N/A,N/A,425,430,N/A,55,3
4,N/A,N/A,N/A,421,425,N/A,60,2
11,N/A,N/A,N/A,410,421,N/A,63,5
4,N/A,N/A,N/A,406,410,N/A,66,2
7,N/A,N/A,N/A,399,406,N/A,72,2
6,N/A,N/A,N/A,393,399,N/A,78,2
12,N/A,N/A,N/A,381,393,N/A,81,5
11,N/A,N/A,N/A,370,381,N/A,87,5
5,N/A,N/A,N/A,365,370,N/A,91,3
7,N/A,N/A,N/A,358,365,N/A,97,3
7,N/A,N/A,N/A,351,358,N/A,103,3
15,N/A,N/A,N/A,336,351,N/A,106,6
7,N/A,N/A,N/A,329,336,N/A,110,4
4,N/A,N/A,N/A,325,329,N/A,113,1
5,N/A,N/A,N/A,320,325,N/A,119,1
4,N/A,N/A,N/A,316,320,N/A,125,1
11,N/A,N/A,N/A,305,316,N/A,130,6
5,N/A,N/A,N/A,300,305,N/A,133,3
4,N/A,N/A,N/A,296,300,N/A,139,3
5,N/A,N/A,N/A,349,354,N/A,6,3
5,N/A,N/A,N/A,344,349,N/A,10,1
11,N/A,N/A,N/A,333,344,N/A,15,6
11,N/A,N/A,N/A,322,333,N/A,20,5
10,N/A,N/A,N/A,312,322,N/A,26,5
6,N/A,N/A,N/A,306,312,N/A,29,2
4,N/A,N/A,N/A,302,306,N/A,35,2
5,N/A,N/A,N/A,297,302,N/A,41,2
4,N/A,N/A,N/A,293,297,N/A,47,2
5,N/A,N/A,N/A,288,293,N/A,52,1
10,N/A,N/A,N/A,278,288,N/A,56,5
10,N/A,N/A,N/A,268,278,N/A,62,5
7,N/A,N/A,N/A,261,268,N/A,66,3
4,N/A,N/A,N/A,257,261,N/A,70,1
4,N/A,N/A,N/A,253,257,N/A,76,1
16,N/A,N/A,N/A,237,253,N/A,81,6
12,N/A,N/A,N/A,225,237,N/A,86,5
5,N/A,N/A,N/A,220,225,N/A,91,4
5,N/A,N/A,N/A,215,220,N/A,94,1
13,N/A,N/A,N/A,202,215,N/A,99,6
5,N/A,N/A,N/A,197,202,N/A,105,0
9,N/A,N/A,N/A,188,197,N/A,110,5
8,N/A,N/A,N/A,180,188,N/A,115,4
7,N/A,N/A,N/A,173,180,N/A,119,2
12,N/A,N/A,N/A,161,173,N/A,122,5
4,N/A,N/A,N/A,157,161,N/A,126,3
4,N/A,N/A,N/A,153,157,N/A,130,1
4,N/A,N/A,N/A,149,153,N/A,136,1
4,N/A,N/A,N/A,145,149,N/A,142,1
5,N/A,N/A,N/A,140,145,N/A,148,1
4,N/A,N/A,N/A,1487,1491,N/A,5,1
13,N/A,N/A,N/A,1474,1487,N/A,10,6
12,N/A,N/A,N/A,1462,1474,N/A,15,5
6,N/A,N/A,N/A,1456,1462,N/A,19,3
4,N/A,N/A,N/A,1452,1456,N/A,23,1
11,N/A,N/A,N/A,1441,1452,N/A,27,5
7,N/A,N/A,N/A,1434,1441,N/A,30,2
14,N/A,N/A,N/A,1420,1434,N/A,34,6
4,N/A,N/A,N/A,1416,1420,N/A,40,0
6,N/A,N/A,N/A,1410,1416,N/A,44,4
6,N/A,N/A,N/A,1404,1410,N/A,49,3
18,N/A,N/A,N/A,1386,1404,N/A,52,6
5,N/A,N/A,N/A,1381,1386,N/A,55,3
4,N/A,N/A,N/A,1377,1381,N/A,61,3
4,N/A,N/A,N/A,1373,1377,N/A,65,1
13,N/A,N/A,N/A,1360,1373,N/A,70,6
5,N/A,N/A,N/A,1355,1360,N/A,74,4
5,N/A,N/A,N/A,1350,1355,N/A,78,2
10,N/A,N/A,N/A,1340,1350,N/A,81,5
8,N/A,N/A,N/A,1332,1340,N/A,86,4
7,N/A,N/A,N/A,1325,1332,N/A,90,2
4,N/A,N/A,N/A,1321,1325,N/A,95,1
4,N/A,N/A,N/A,1317,1321,N/A,101,1
9,N/A,N/A,N/A,1308,1317,N/A,105,5
5,N/A,N/A,N/A,1303,1308,N/A,110,4
4,N/A,N/A,N/A,1299,1303,N/A,113,1
4,N/A,N/A,N/A,1295,1299,N/A,119,1
6,N/A,N/A,N/A,1289,1295,N/A,122,4
7,N/A,N/A,N/A,1282,1289,N/A,126,2
5,N/A,N/A,N/A,1277,1282,N/A,131,1
4,N/A,N/A,N/A,1426,1430,N/A,5,2
10,N/A,N/A,N/A,1416,1426,N/A,8,5
4,N/A,N/A,N/A,1412,1416,N/A,12,3
14,N/A,N/A,N/A,1398,1412,N/A,15,6
5,N/A,N/A,N/A,1393,1398,N/A,19,4
7,N/A,N/A,N/A,1386,1393,N/A,24,3
10,N/A,N/A,N/A,1376,1386,N/A,27,6
12,N/A,N/A,N/A,1364,1376,N/A,32,5
12,N/A,N/A,N/A,1352,1364,N/A,38,5
8,N/A,N/A,N/A,1344,1352,N/A,43,4
5,N/A,N/A,N/A,1339,1344,N/A,46,1
5,N/A,N/A,N/A,1334,1339,N/A,52,1
10,N/A,N/A,N/A,1324,1334,N/A,56,5
7,N/A,N/A,N/A,1317,1324,N/A,61,4
6,N/A,N/A,N/A,1311,1317,N/A,65,2
9,N/A,N/A,N/A,1302,1311,N/A,68,5
11,N/A,N/A,N/A,1291,1302,N/A,74,5
6,N/A,N/A,N/A,1285,1291,N/A,79,4
6,N/A,N/A,N/A,1279,1285,N/A,83,2
12,N/A,N/A,N/A,1267,1279,N/A,86,5
8,N/A,N/A,N/A,1259,1267,N/A,91,4
5,N/A,N/A,N/A,1254,1259,N/A,96,3
4,N/A,N/A,N/A,1250,1254,N/A,101,2
10,N/A,N/A,N/A,1240,1250,N/A,104,5
6,N/A,N/A,N/A,1234,1240,N/A,108,3
19,N/A,N/A,N/A,1215,1234,N/A,111,6
12,N/A,N/A,N/A,1203,1215,N/A,116,5
5,N/A,N/A,N/A,1198,1203,N/A,120,3
7,N/A,N/A,N/A,1191,1198,N/A,126,3
7,N/A,N/A,N/A,1184,1191,N/A,131,2
16,N/A,N/A,N/A,363,379,N/A,6,6
7,N/A,N/A,N/A,356,363,N/A,9,3
4,N/A,N/A,N/A,352,356,N/A,13,1
5,N/A,N/A,N/A,347,352,N/A,19,1
5,N/A,N/A,N/A,342,347,N/A,22,4
5,N/A,N/A,N/A,337,342,N/A,27,3
6,N/A,N/A,N/A,331,337,N/A,33,3
5,N/A,N/A,N/A,326,331,N/A,37,1
11,N/A,N/A,N/A,315,326,N/A,41,5
12,N/A,N/A,N/A,303,315,N/A,47,5
4,N/A,N/A,N/A,299,303,N/A,51,3
5,N/A,N/A,N/A,294,299,N/A,55,1
4,N/A,N/A,N/A,290,294,N/A,61,1
7,N/A,N/A,N/A,283,290,N/A,64,4
4,N/A,N/A,N/A,279,283,N/A,67,1
12,N/A,N/A,N/A,267,279,N/A,72,6
5,N/A,N/A,N/A,262,267,N/A,78,0
7,N/A,N/A,N/A,255,262,N/A,81,3
4,N/A,N/A,N/A,251,255,N/A,86,2
5,N/A,N/A,N/A,246,251,N/A,92,2
6,N/A,N/A,N/A,240,246,N/A,98,2
6,N/A,N/A,N/A,234,240,N/A,104,2
4,N/A,N/A,N/A,230,234,N/A,109,1
7,N/A,N/A,N/A,223,230,N/A,112,4
7,N/A,N/A,N/A,216,223,N/A,117,3
5,N/A,N/A,N/A,211,216,N/A,123,3
4,N/A,N/A,N/A,207,211,N/A,129,3
4,N/A,N/A,N/A,203,207,N/A,135,3
6,N/A,N/A,N/A,197,203,N/A,141,3
16,N/A,N/A,N/A,181,197,N/A,144,6
5,N/A,N/A,N/A,767,772,N/A,6,1
11,N/A,N/A,N/A,756,767,N/A,10,5
6,N/A,N/A,N/A,750,756,N/A,13,2
12,N/A,N/A,N/A,738,750,N/A,16,5
4,N/A,N/A,N/A,734,738,N/A,19,2
10,N/A,N/A,N/A,724,734,N/A,23,6
10,N/A,N/A,N/A,714,724,N/A,28,5
11,N/A,N/A,N/A,703,714,N/A,34,5
7,N/A,N/A,N/A,696,703,N/A,37,2
4,N/A,N/A,N/A,692,696,N/A,42,1
5,N/A,N/A,N/A,687,692,N/A,45,4
5,N/A,N/A,N/A,682,687,N/A,48,1
11,N/A,N/A,N/A,671,682,N/A,52,5
4,N/A,N/A,N/A,667,671,N/A,56,3
5,N/A,N/A,N/A,662,667,N/A,62,3
5,N/A,N/A,N/A,657,662,N/A,66,1
11,N/A,N/A,N/A,646,657,N/A,70,5
4,N/A,N/A,N/A,642,646,N/A,74,3
6,N/A,N/A,N/A,636,642,N/A,79,2
5,N/A,N/A,N/A,631,636,N/A,85,2
4,N/A,N/A,N/A,627,631,N/A,90,1
18,N/A,N/A,N/A,609,627,N/A,95,6
4,N/A,N/A,N/A,605,609,N/A,101,0
8,N/A,N/A,N/A,597,605,N/A,105,4
5,N/A,N/A,N/A,592,597,N/A,108,1
12,N/A,N/A,N/A,580,592,N/A,113,6
4,N/A,N/A,N/A,576,580,N/A,119,0
7,N/A,N/A,N/A,569,576,N/A,123,4
4,N/A,N/A,N/A,565,569,N/A,128,3
5,N/A,N/A,N/A,560,565,N/A,132,1
12,N/A,N/A,N/A,733,745,N/A,3,6
4,N/A,N/A,N/A,729,733,N/A,9,0
5,N/A,N/A,N/A,724,729,N/A,12,3
5,N/A,N/A,N/A,719,724,N/A,17,2
5,N/A,N/A,N/A,714,719,N/A,22,1
14,N/A,N/A,N/A,700,714,N/A,27,6
6,N/A,N/A,N/A,694,700,N/A,31,4
6,N/A,N/A,N/A,688,694,N/A,37,4
7,N/A,N/A,N/A,681,688,N/A,41,2
14,N/A,N/A,N/A,667,681,N/A,45,6
10,N/A,N/A,N/A,657,667,N/A,50,5
7,N/A,N/A,N/A,650,657,N/A,53,2
19,N/A,N/A,N/A,631,650,N/A,57,6
10,N/A,N/A,N/A,621,631,N/A,62,5
9,N/A,N/A,N/A,612,621,N/A,68,5
11,N/A,N/A,N/A,601,612,N/A,74,5
5,N/A,N/A,N/A,596,601,N/A,77,2
7,N/A,N/A,N/A,589,596,N/A,83,2
17,N/A,N/A,N/A,572,589,N/A,87,6
8,N/A,N/A,N/A,564,572,N/A,91,4
7,N/A,N/A,N/A,557,564,N/A,95,2
6,N/A,N/A,N/A,551,557,N/A,101,2
11,N/A,N/A,N/A,540,551,N/A,104,5
6,N/A,N/A,N/A,534,540,N/A,109,4
6,N/A,N/A,N/A,528,534,N/A,115,4
4,N/A,N/A,N/A,524,528,N/A,118,1
5,N/A,N/A,N/A,519,524,N/A,124,1
12,N/A,N/A,N/A,507,519,N/A,128,5
10,N/A,N/A,N/A,497,507,N/A,134,5
5,N/A,N/A,N/A,492,497,N/A,139,4
11,N/A,N/A,N/A,1352,1363,N/A,3,5
9,N/A,N/A,N/A,1343,1352,N/A,9,5
4,N/A,N/A,N/A,1339,1343,N/A,12,2
4,N/A,N/A,N/A,1335,1339,N/A,17,1
7,N/A,N/A,N/A,1328,1335,N/A,20,4
7,N/A,N/A,N/A,1321,1328,N/A,25,3
4,N/A,N/A,N/A,1317,1321,N/A,29,1
8,N/A,N/A,N/A,1309,1317,N/A,32,4
6,N/A,N/A,N/A,1303,1309,N/A,37,3
5,N/A,N/A,N/A,1298,1303,N/A,41,1
17,N/A,N/A,N/A,1281,1298,N/A,46,6
7,N/A,N/A,N/A,1274,1281,N/A,49,3
5,N/A,N/A,N/A,1269,1274,N/A,54,2
14,N/A,N/A,N/A,1255,1269,N/A,58,6
4,N/A,N/A,N/A,1251,1255,N/A,61,3
4,N/A,N/A,N/A,1247,1251,N/A,67,3
4,N/A,N/A,N/A,1243,1247,N/A,73,3
16,N/A,N/A,N/A,1227,1243,N/A,76,6
10,N/A,N/A,N/A,1217,1227,N/A,81,5
6,N/A,N/A,N/A,1211,1217,N/A,86,4
6,N/A,N/A,N/A,1205,1211,N/A,91,3
6,N/A,N/A,N/A,1199,1205,N/A,96,2
12,N/A,N/A,N/A,1187,1199,N/A,100,6
6,N/A,N/A,N/A,1181,1187,N/A,104,4
5,N/A,N/A,N/A,1176,1181,N/A,110,4
8,N/A,N/A,N/A,1168,1176,N/A,116,4
5,N/A,N/A,N/A,1163,1168,N/A,119,1
7,N/A,N/A,N/A,1156,1163,N/A,122,4
7,N/A,N/A,N/A,1149,1156,N/A,128,4
7,N/A,N/A,N/A,1142,1149,N/A,132,2
4,N/A,N/A,N/A,1719,1723,N/A,6,1
7,N/A,N/A,N/A,1712,1719,N/A,9,4
7,N/A,N/A,N/A,1705,1712,N/A,13,2
11,N/A,N/A,N/A,1694,1705,N/A,16,5
5,N/A,N/A,N/A,1689,1694,N/A,19,2
12,N/A,N/A,N/A,1677,1689,N/A,22,5
5,N/A,N/A,N/A,1672,1677,N/A,25,2
11,N/A,N/A,N/A,1661,1672,N/A,28,5
6,N/A,N/A,N/A,1655,1661,N/A,32,3
5,N/A,N/A,N/A,1650,1655,N/A,36,1
10,N/A,N/A,N/A,1640,1650,N/A,40,5
4,N/A,N/A,N/A,1636,1640,N/A,44,3
14,N/A,N/A,N/A,1622,1636,N/A,47,6
8,N/A,N/A,N/A,1614,1622,N/A,51,4
4,N/A,N/A,N/A,1610,1614,N/A,55,2
11,N/A,N/A,N/A,1599,1610,N/A,59,6
8,N/A,N/A,N/A,1591,1599,N/A,63,4
5,N/A,N/A,N/A,1586,1591,N/A,69,4
7,N/A,N/A,N/A,1579,1586,N/A,74,3
4,N/A,N/A,N/A,1575,1579,N/A,78,1
5,N/A,N/A,N/A,1570,1575,N/A,84,1
9,N/A,N/A,N/A,1561,1570,N/A,88,5
12,N/A,N/A,N/A,1549,1561,N/A,94,5
5,N/A,N/A,N/A,1544,1549,N/A,97,2
5,N/A,N/A,N/A,1539,1544,N/A,102,1
11,N/A,N/A,N/A,1528,1539,N/A,107,6
7,N/A,N/A,N/A,1521,1528,N/A,111,4
7,N/A,N/A,N/A,1514,1521,N/A,115,2
12,N/A,N/A,N/A,1502,1514,N/A,118,5
6,N/A,N/A,N/A,1496,1502,N/A,122,3
6,N/A,N/A,N/A,1131,1137,N/A,5,2
4,N/A,N/A,N/A,1127,1131,N/A,10,1
8,N/A,N/A,N/A,1119,1127,N/A,13,4
4,N/A,N/A,N/A,1115,1119,N/A,17,2
12,N/A,N/A,N/A,1103,1115,N/A,20,5
6,N/A,N/A,N/A,1097,1103,N/A,25,4
7,N/A,N/A,N/A,1090,1097,N/A,29,2
4,N/A,N/A,N/A,1086,1090,N/A,34,1
7,N/A,N/A,N/A,1079,1086,N/A,37,4
4,N/A,N/A,N/A,1075,1079,N/A,40,1
6,N/A,N/A,N/A,1069,1075,N/A,43,4
5,N/A,N/A,N/A,1064,1069,N/A,49,4
7,N/A,N/A,N/A,1057,1064,N/A,53,2
12,N/A,N/A,N/A,1045,1057,N/A,57,6
4,N/A,N/A,N/A,1041,1045,N/A,60,3
4,N/A,N/A,N/A,1037,1041,N/A,64,1
12,N/A,N/A,N/A,1025,1037,N/A,68,5
6,N/A,N/A,N/A,1019,1025,N/A,73,4
5,N/A,N/A,N/A,1014,1019,N/A,76,1
7,N/A,N/A,N/A,1007,1014,N/A,79,4
8,N/A,N/A,N/A,999,1007,N/A,85,4
5,N/A,N/A,N/A,994,999,N/A,90,3
6,N/A,N/A,N/A,988,994,N/A,96,3
5,N/A,N/A,N/A,983,988,N/A,101,2
12,N/A,N/A,N/A,971,983,N/A,104,5
7,N/A,N/A,N/A,964,971,N/A,108,3
4,N/A,N/A,N/A,960,964,N/A,112,1
5,N/A,N/A,N/A,955,960,N/A,118,1
4,N/A,N/A,N/A,951,955,N/A,124,1
12,N/A,N/A,N/A,939,951,N/A,128,5
12,N/A,N/A,N/A,1197,1209,N/A,3,5
5,N/A,N/A,N/A,1192,1197,N/A,8,4
5,N/A,N/A,N/A,1187,1192,N/A,14,4
5,N/A,N/A,N/A,1182,1187,N/A,17,1
4,N/A,N/A,N/A,1178,1182,N/A,23,1
19,N/A,N/A,N/A,1159,1178,N/A,28,6
4,N/A,N/A,N/A,1155,1159,N/A,34,0
18,N/A,N/A,N/A,1137,1155,N/A,40,6
7,N/A,N/A,N/A,1130,1137,N/A,43,3
6,N/A,N/A,N/A,1124,1130,N/A,49,3
5,N/A,N/A,N/A,1119,1124,N/A,53,1
5,N/A,N/A,N/A,1114,1119,N/A,59,1
6,N/A,N/A,N/A,1108,1114,N/A,62,4
4,N/A,N/A,N/A,1104,1108,N/A,66,2
11,N/A,N/A,N/A,1093,1104,N/A,69,5
5,N/A,N/A,N/A,1088,1093,N/A,74,4
5,N/A,N/A,N/A,1083,1088,N/A,77,1
7,N/A,N/A,N/A,1076,1083,N/A,80,4
6,N/A,N/A,N/A,1070,1076,N/A,84,2
5,N/A,N/A,N/A,1065,1070,N/A,89,1
8,N/A,N/A,N/A,1057,1065,N/A,92,4
5,N/A,N/A,N/A,1052,1057,N/A,98,4
7,N/A,N/A,N/A,1045,1052,N/A,104,4
4,N/A,N/A,N/A,1041,1045,N/A,107,1
5,N/A,N/A,N/A,1036,1041,N/A,113,1
11,N/A,N/A,N/A,1025,1036,N/A,118,6
7,N/A,N/A,N/A,1018,1025,N/A,122,4
7,N/A,N/A,N/A,1011,1018,N/A,127,3
4,N/A,N/A,N/A,1007,1011,N/A,132,2
4,N/A,N/A,N/A,1003,1007,N/A,137,1
7,N/A,N/A,N/A,1853,1860,N/A,3,4
4,N/A,N/A,N/A,1849,1853,N/A,7,2
15,N/A,N/A,N/A,1834,1849,N/A,11,6
9,N/A,N/A,N/A,1825,1834,N/A,16,5
11,N/A,N/A,N/A,1814,1825,N/A,22,5
7,N/A,N/A,N/A,1807,1814,N/A,25,2
10,N/A,N/A,N/A,1797,1807,N/A,29,6
6,N/A,N/A,N/A,1791,1797,N/A,33,4
5,N/A,N/A,N/A,1786,1791,N/A,38,3
7,N/A,N/A,N/A,1779,1786,N/A,43,2
4,N/A,N/A,N/A,1775,1779,N/A,48,1
13,N/A,N/A,N/A,1762,1775,N/A,53,6
12,N/A,N/A,N/A,1750,1762,N/A,58,5
6,N/A,N/A,N/A,1744,1750,N/A,61,2
4,N/A,N/A,N/A,1740,1744,N/A,66,1
4,N/A,N/A,N/A,1736,1740,N/A,72,1
5,N/A,N/A,N/A,1731,1736,N/A,78,1
12,N/A,N/A,N/A,1719,1731,N/A,83,6
11,N/A,N/A,N/A,1708,1719,N/A,88,5
11,N/A,N/A,N/A,1697,1708,N/A,94,5
4,N/A,N/A,N/A,1693,1697,N/A,98,3
13,N/A,N/A,N/A,1680,1693,N/A,101,6
11,N/A,N/A,N/A,1669,1680,N/A,106,5
9,N/A,N/A,N/A,1660,1669,N/A,112,5
7,N/A,N/A,N/A,1653,1660,N/A,116,3
5,N/A,N/A,N/A,1648,1653,N/A,121,2
7,N/A,N/A,N/A,1641,1648,N/A,127,2
4,N/A,N/A,N/A,1637,1641,N/A,132,1
5,N/A,N/A,N/A,1632,1637,N/A,138,1
18,N/A,N/A,N/A,1614,1632,N/A,143,6
10,N/A,N/A,N/A,1427,1437,N/A,4,6
6,N/A,N/A,N/A,1421,1427,N/A,7,3
7,N/A,N/A,N/A,1414,1421,N/A,13,3
4,N/A,N/A,N/A,1410,1414,N/A,17,1
4,N/A,N/A,N/A,1406,1410,N/A,23,1
4,N/A,N/A,N/A,1402,1406,N/A,29,1
19,N/A,N/A,N/A,1383,1402,N/A,34,6
12,N/A,N/A,N/A,1371,1383,N/A,39,5
6,N/A,N/A,N/A,1365,1371,N/A,44,4
7,N/A,N/A,N/A,1358,1365,N/A,50,4
6,N/A,N/A,N/A,1352,1358,N/A,56,4
4,N/A,N/A,N/A,1348,1352,N/A,60,2
5,N/A,N/A,N/A,1343,1348,N/A,65,1
4,N/A,N/A,N/A,1339,1343,N/A,71,1
11,N/A,N/A,N/A,1328,1339,N/A,75,5
12,N/A,N/A,N/A,1316,1328,N/A,81,5
6,N/A,N/A,N/A,1310,1316,N/A,84,2
7,N/A,N/A,N/A,1303,1310,N/A,90,2
4,N/A,N/A,N/A,1299,1303,N/A,96,2
4,N/A,N/A,N/A,1295,1299,N/A,101,1
11,N/A,N/A,N/A,1284,1295,N/A,106,6
11,N/A,N/A,N/A,1273,1284,N/A,111,5
11,N/A,N/A,N/A,1262,1273,N/A,117,5
7,N/A,N/A,N/A,1255,1262,N/A,121,3
5,N/A,N/A,N/A,1250,1255,N/A,125,1
4,N/A,N/A,N/A,1246,1250,N/A,131,1
12,N/A,N/A,N/A,1234,1246,N/A,136,6
11,N/A,N/A,N/A,1223,1234,N/A,141,5
5,N/A,N/A,N/A,1218,1223,N/A,146,4
8,N/A,N/A,N/A,1210,1218,N/A,152,4
5,N/A,N/A,N/A,1263,1268,N/A,6,3
5,N/A,N/A,N/A,1258,1263,N/A,12,3
4,N/A,N/A,N/A,1254,1258,N/A,16,1
12,N/A,N/A,N/A,1242,1254,N/A,21,6
5,N/A,N/A,N/A,1237,1242,N/A,27,0
11,N/A,N/A,N/A,1226,1237,N/A,32,5
11,N/A,N/A,N/A,1215,1226,N/A,38,5
6,N/A,N/A,N/A,1209,1215,N/A,41,2
19,N/A,N/A,N/A,1190,1209,N/A,45,6
12,N/A,N/A,N/A,1178,1190,N/A,50,5
10,N/A,N/A,N/A,1168,1178,N/A,56,5
12,N/A,N/A,N/A,1156,1168,N/A,62,5
4,N/A,N/A,N/A,1152,1156,N/A,65,2
12,N/A,N/A,N/A,1140,1152,N/A,68,5
7,N/A,N/A,N/A,1133,1140,N/A,73,4
4,N/A,N/A,N/A,1129,1133,N/A,78,3
6,N/A,N/A,N/A,1123,1129,N/A,84,3
4,N/A,N/A,N/A,1119,1123,N/A,88,1
7,N/A,N/A,N/A,1112,1119,N/A,91,4
5,N/A,N/A,N/A,1107,1112,N/A,94,1
4,N/A,N/A,N/A,1103,1107,N/A,100,1
4,N/A,N/A,N/A,1099,1103,N/A,106,1
4,N/A,N/A,N/A,1095,1099,N/A,112,1
4,N/A,N/A,N/A,1091,1095,N/A,118,1
12,N/A,N/A,N/A,1079,1091,N/A,122,5
4,N/A,N/A,N/A,1075,1079,N/A,125,2
11,N/A,N/A,N/A,1064,1075,N/A,128,5
12,N/A,N/A,N/A,1052,1064,N/A,134,5
11,N/A,N/A,N/A,1041,1052,N/A,140,5
7,N/A,N/A,N/A,1034,1041,N/A,143,2
4,N/A,N/A,N/A,326,330,N/A,5,3
5,N/A,N/A,N/A,321,326,N/A,9,1
4,N/A,N/A,N/A,317,321,N/A,15,1
19,N/A,N/A,N/A,298,317,N/A,20,6
4,N/A,N/A,N/A,294,298,N/A,26,0
5,N/A,N/A,N/A,289,294,N/A,29,3
5,N/A,N/A,N/A,284,289,N/A,33,1
9,N/A,N/A,N/A,275,284,N/A,37,5
5,N/A,N/A,N/A,270,275,N/A,40,2
9,N/A,N/A,N/A,261,270,N/A,43,5
9,N/A,N/A,N/A,252,261,N/A,49,5
9,N/A,N/A,N/A,243,252,N/A,55,5
5,N/A,N/A,N/A,238,243,N/A,58,2
9,N/A,N/A,N/A,229,238,N/A,61,5
7,N/A,N/A,N/A,222,229,N/A,64,2
19,N/A,N/A,N/A,203,222,N/A,68,6
11,N/A,N/A,N/A,192,203,N/A,73,5
7,N/A,N/A,N/A,185,192,N/A,76,2
10,N/A,N/A,N/A,175,185,N/A,80,6
6,N/A,N/A,N/A,169,175,N/A,84,4
8,N/A,N/A,N/A,161,169,N/A,90,4
4,N/A,N/A,N/A,157,161,N/A,93,1
5,N/A,N/A,N/A,152,157,N/A,96,4
4,N/A,N/A,N/A,148,152,N/A,101,3
4,N/A,N/A,N/A,144,148,N/A,105,1
8,N/A,N/A,N/A,136,144,N/A,108,4
5,N/A,N/A,N/A,131,136,N/A,111,1
4,N/A,N/A,N/A,127,131,N/A,117,1
6,N/A,N/A,N/A,121,127,N/A,120,4
6,N/A,N/A,N/A,115,121,N/A,125,3
7,N/A,N/A,N/A,1274,1281,N/A,6,4
5,N/A,N/A,N/A,1269,1274,N/A,12,4
7,N/A,N/A,N/A,1262,1269,N/A,17,3
4,N/A,N/A,N/A,1258,1262,N/A,22,2
12,N/A,N/A,N/A,1246,1258,N/A,26,6
5,N/A,N/A,N/A,1241,1246,N/A,30,4
5,N/A,N/A,N/A,1236,1241,N/A,33,1
6,N/A,N/A,N/A,1230,1236,N/A,36,4
5,N/A,N/A,N/A,1225,1230,N/A,39,1
5,N/A,N/A,N/A,1220,1225,N/A,42,4
6,N/A,N/A,N/A,1214,1220,N/A,46,2
12,N/A,N/A,N/A,1202,1214,N/A,50,6
4,N/A,N/A,N/A,1198,1202,N/A,56,0
5,N/A,N/A,N/A,1193,1198,N/A,60,4
4,N/A,N/A,N/A,1189,1193,N/A,65,3
4,N/A,N/A,N/A,1185,1189,N/A,69,1
7,N/A,N/A,N/A,1178,1185,N/A,72,4
6,N/A,N/A,N/A,1172,1178,N/A,77,3
13,N/A,N/A,N/A,1159,1172,N/A,80,6
11,N/A,N/A,N/A,1148,1159,N/A,85,5
4,N/A,N/A,N/A,1144,1148,N/A,89,3
4,N/A,N/A,N/A,1140,1144,N/A,94,2
5,N/A,N/A,N/A,1135,1140,N/A,99,1
5,N/A,N/A,N/A,1130,1135,N/A,105,1
13,N/A,N/A,N/A,1117,1130,N/A,110,6
7,N/A,N/A,N/A,1110,1117,N/A,114,4
4,N/A,N/A,N/A,1106,1110,N/A,118,2
4,N/A,N/A,N/A,1102,1106,N/A,123,1
5,N/A,N/A,N/A,1097,1102,N/A,129,1
7,N/A,N/A,N/A,1090,1097,N/A,132,4
7,N/A,N/A,N/A,1095,1102,N/A,4,3
6,N/A,N/A,N/A,1089,1095,N/A,9,2
4,N/A,N/A,N/A,1085,1089,N/A,15,2
5,N/A,N/A,N/A,1080,1085,N/A,21,2
11,N/A,N/A,N/A,1069,1080,N/A,24,5
7,N/A,N/A,N/A,1062,1069,N/A,28,3
14,N/A,N/A,N/A,1048,1062,N/A,31,6
10,N/A,N/A,N/A,1038,1048,N/A,36,5
6,N/A,N/A,N/A,1032,1038,N/A,40,3
5,N/A,N/A,N/A,1027,1032,N/A,44,1
19,N/A,N/A,N/A,1008,1027,N/A,49,6
12,N/A,N/A,N/A,996,1008,N/A,54,5
10,N/A,N/A,N/A,986,996,N/A,60,5
9,N/A,N/A,N/A,977,986,N/A,66,5
4,N/A,N/A,N/A,973,977,N/A,69,2
4,N/A,N/A,N/A,969,973,N/A,74,1
5,N/A,N/A,N/A,964,969,N/A,77,4
6,N/A,N/A,N/A,958,964,N/A,83,4
8,N/A,N/A,N/A,950,958,N/A,89,4
7,N/A,N/A,N/A,943,950,N/A,94,3
6,N/A,N/A,N/A,937,943,N/A,99,2
12,N/A,N/A,N/A,925,937,N/A,102,5
11,N/A,N/A,N/A,914,925,N/A,108,5
6,N/A,N/A,N/A,908,914,N/A,112,3
5,N/A,N/A,N/A,903,908,N/A,116,1
5,N/A,N/A,N/A,898,903,N/A,119,4
5,N/A,N/A,N/A,893,898,N/A,125,4
7,N/A,N/A,N/A,886,893,N/A,129,2
11,N/A,N/A,N/A,875,886,N/A,132,5
6,N/A,N/A,N/A,869,875,N/A,136,3
5,N/A,N/A,N/A,1269,1274,N/A,5,2
4,N/A,N/A,N/A,1265,1269,N/A,11,2
9,N/A,N/A,N/A,1256,1265,N/A,14,5
6,N/A,N/A,N/A,1250,1256,N/A,17,2
11,N/A,N/A,N/A,1239,1250,N/A,20,5
7,N/A,N/A,N/A,1232,1239,N/A,24,3
19,N/A,N/A,N/A,1213,1232,N/A,27,6
7,N/A,N/A,N/A,1206,1213,N/A,31,4
6,N/A,N/A,N/A,1200,1206,N/A,35,2
19,N/A,N/A,N/A,1181,1200,N/A,39,6
12,N/A,N/A,N/A,1169,1181,N/A,44,5
8,N/A,N/A,N/A,1161,1169,N/A,49,4
8,N/A,N/A,N/A,1153,1161,N/A,55,4
8,N/A,N/A,N/A,1145,1153,N/A,61,4
5,N/A,N/A,N/A,1140,1145,N/A,64,1
8,N/A,N/A,N/A,1132,1140,N/A,67,4
7,N/A,N/A,N/A,1125,1132,N/A,71,2
10,N/A,N/A,N/A,1115,1125,N/A,74,5
9,N/A,N/A,N/A,1106,1115,N/A,80,5
9,N/A,N/A,N/A,1097,1106,N/A,86,5
7,N/A,N/A,N/A,1090,1097,N/A,90,3
16,N/A,N/A,N/A,1074,1090,N/A,93,6
4,N/A,N/A,N/A,1070,1074,N/A,96,3
6,N/A,N/A,N/A,1064,1070,N/A,102,3
13,N/A,N/A,N/A,1051,1064,N/A,105,6
5,N/A,N/A,N/A,1046,1051,N/A,109,4
5,N/A,N/A,N/A,1041,1046,N/A,113,2
17,N/A,N/A,N/A,1024,1041,N/A,117,6
7,N/A,N/A,N/A,1017,1024,N/A,120,3
4,N/A,N/A,N/A,1013,1017,N/A,125,2
6,N/A,N/A,N/A,798,804,N/A,3,4
4,N/A,N/A,N/A,794,798,N/A,8,3
15,N/A,N/A,N/A,779,794,N/A,11,6
10,N/A,N/A,N/A,769,779,N/A,16,5
8,N/A,N/A,N/A,761,769,N/A,21,4
6,N/A,N/A,N/A,755,761,N/A,26,3
5,N/A,N/A,N/A,750,755,N/A,31,2
7,N/A,N/A,N/A,743,750,N/A,37,2
4,N/A,N/A,N/A,739,743,N/A,43,2
10,N/A,N/A,N/A,729,739,N/A,46,5
12,N/A,N/A,N/A,717,729,N/A,52,5
5,N/A,N/A,N/A,712,717,N/A,57,4
5,N/A,N/A,N/A,707,712,N/A,60,1
5,N/A,N/A,N/A,702,707,N/A,66,1
12,N/A,N/A,N/A,690,702,N/A,70,5
9,N/A,N/A,N/A,681,690,N/A,76,5
6,N/A,N/A,N/A,675,681,N/A,80,3
4,N/A,N/A,N/A,671,675,N/A,86,3
7,N/A,N/A,N/A,664,671,N/A,92,3
14,N/A,N/A,N/A,650,664,N/A,95,6
4,N/A,N/A,N/A,646,650,N/A,98,3
7,N/A,N/A,N/A,639,646,N/A,104,3
5,N/A,N/A,N/A,634,639,N/A,108,1
10,N/A,N/A,N/A,624,634,N/A,113,6
7,N/A,N/A,N/A,617,624,N/A,117,4
4,N/A,N/A,N/A,613,617,N/A,122,3
5,N/A,N/A,N/A,608,613,N/A,128,3
5,N/A,N/A,N/A,603,608,N/A,132,1
11,N/A,N/A,N/A,592,603,N/A,137,6
4,N/A,N/A,N/A,588,592,N/A,143,0
6,N/A,N/A,N/A,1376,1382,N/A,5,4
4,N/A,N/A,N/A,1372,1376,N/A,10,3
16,N/A,N/A,N/A,1356,1372,N/A,13,6
6,N/A,N/A,N/A,1350,1356,N/A,16,3
4,N/A,N/A,N/A,1346,1350,N/A,22,3
6,N/A,N/A,N/A,1340,1346,N/A,27,2
6,N/A,N/A,N/A,1334,1340,N/A,33,2
5,N/A,N/A,N/A,1329,1334,N/A,38,1
8,N/A,N/A,N/A,1321,1329,N/A,41,4
5,N/A,N/A,N/A,1316,1321,N/A,44,1
9,N/A,N/A,N/A,1307,1316,N/A,48,5
8,N/A,N/A,N/A,1299,1307,N/A,53,4
7,N/A,N/A,N/A,1292,1299,N/A,59,4
5,N/A,N/A,N/A,1287,1292,N/A,62,1
11,N/A,N/A,N/A,1276,1287,N/A,66,5
4,N/A,N/A,N/A,1272,1276,N/A,69,2
4,N/A,N/A,N/A,1268,1272,N/A,74,1
12,N/A,N/A,N/A,1256,1268,N/A,78,5
5,N/A,N/A,N/A,1251,1256,N/A,83,4
8,N/A,N/A,N/A,1243,1251,N/A,89,4
6,N/A,N/A,N/A,1237,1243,N/A,93,2
18,N/A,N/A,N/A,1219,1237,N/A,97,6
4,N/A,N/A,N/A,1215,1219,N/A,103,0
19,N/A,N/A,N/A,1196,1215,N/A,109,6
8,N/A,N/A,N/A,1188,1196,N/A,113,4
5,N/A,N/A,N/A,1183,1188,N/A,116,1
5,N/A,N/A,N/A,1178,1183,N/A,122,1
5,N/A,N/A,N/A,1173,1178,N/A,128,1
11,N/A,N/A,N/A,1162,1173,N/A,132,5
4,N/A,N/A,N/A,1158,1162,N/A,135,2
5,N/A,N/A,N/A,1209,1214,N/A,3,4
4,N/A,N/A,N/A,1205,1209,N/A,6,1
7,N/A,N/A,N/A,1198,1205,N/A,9,4
8,N/A,N/A,N/A,1190,1198,N/A,15,4
5,N/A,N/A,N/A,1185,1190,N/A,18,1
5,N/A,N/A,N/A,1180,1185,N/A,24,1
11,N/A,N/A,N/A,1169,1180,N/A,28,5
6,N/A,N/A,N/A,1163,1169,N/A,33,4
5,N/A,N/A,N/A,1158,1163,N/A,36,1
12,N/A,N/A,N/A,1146,1158,N/A,40,5
7,N/A,N/A,N/A,1139,1146,N/A,45,4
4,N/A,N/A,N/A,1135,1139,N/A,48,1
5,N/A,N/A,N/A,1130,1135,N/A,54,1
5,N/A,N/A,N/A,1125,1130,N/A,60,1
11,N/A,N/A,N/A,1114,1125,N/A,64,5
5,N/A,N/A,N/A,1109,1114,N/A,67,2
19,N/A,N/A,N/A,1090,1109,N/A,71,6
9,N/A,N/A,N/A,1081,1090,N/A,76,5
8,N/A,N/A,N/A,1073,1081,N/A,81,4
4,N/A,N/A,N/A,1069,1073,N/A,86,3
12,N/A,N/A,N/A,1057,1069,N/A,89,6
4,N/A,N/A,N/A,1053,1057,N/A,92,3
5,N/A,N/A,N/A,1048,1053,N/A,96,1
10,N/A,N/A,N/A,1038,1048,N/A,100,5
12,N/A,N/A,N/A,1026,1038,N/A,106,5
4,N/A,N/A,N/A,1022,1026,N/A,110,3
15,N/A,N/A,N/A,1007,1022,N/A,113,6
5,N/A,N/A,N/A,1002,1007,N/A,117,4
4,N/A,N/A,N/A,998,1002,N/A,121,2
5,N/A,N/A,N/A,993,998,N/A,126,1
4,N/A,N/A,N/A,1892,1896,N/A,5,3
5,N/A,N/A,N/A,1887,1892,N/A,11,3
4,N/A,N/A,N/A,1883,1887,N/A,15,1
9,N/A,N/A,N/A,1874,1883,N/A,19,5
5,N/A,N/A,N/A,1869,1874,N/A,23,3
12,N/A,N/A,N/A,1857,1869,N/A,26,6
4,N/A,N/A,N/A,1853,1857,N/A,32,0
6,N/A,N/A,N/A,1847,1853,N/A,35,3
7,N/A,N/A,N/A,1840,1847,N/A,40,2
15,N/A,N/A,N/A,1825,1840,N/A,44,6
4,N/A,N/A,N/A,1821,1825,N/A,50,0
7,N/A,N/A,N/A,1814,1821,N/A,53,3
4,N/A,N/A,N/A,1810,1814,N/A,57,1
6,N/A,N/A,N/A,1804,1810,N/A,60,4
4,N/A,N/A,N/A,1800,1804,N/A,63,1
5,N/A,N/A,N/A,1795,1800,N/A,69,1
15,N/A,N/A,N/A,1780,1795,N/A,74,6
8,N/A,N/A,N/A,1772,1780,N/A,78,4
5,N/A,N/A,N/A,1767,1772,N/A,83,3
5,N/A,N/A,N/A,1762,1767,N/A,89,3
6,N/A,N/A,N/A,1756,1762,N/A,94,2
6,N/A,N/A,N/A,1750,1756,N/A,100,2
6,N/A,N/A,N/A,1744,1750,N/A,106,2
5,N/A,N/A,N/A,1739,1744,N/A,111,1
12,N/A,N/A,N/A,1727,1739,N/A,115,5
6,N/A,N/A,N/A,1721,1727,N/A,118,2
16,N/A,N/A,N/A,1705,1721,N/A,122,6
6,N/A,N/A,N/A,1699,1705,N/A,126,4
8,N/A,N/A,N/A,1691,1699,N/A,132,4
5,N/A,N/A,N/A,1686,1691,N/A,135,1
7,N/A,N/A,N/A,457,464,N/A,6,4
7,N/A,N/A,N/A,450,457,N/A,11,3
16,N/A,N/A,N/A,434,450,N/A,14,6
4,N/A,N/A,N/A,430,434,N/A,20,0
9,N/A,N/A,N/A,421,430,N/A,25,5
6,N/A,N/A,N/A,415,421,N/A,28,2
6,N/A,N/A,N/A,409,415,N/A,34,2
9,N/A,N/A,N/A,400,409,N/A,37,5
7,N/A,N/A,N/A,393,400,N/A,41,3
4,N/A,N/A,N/A,389,393,N/A,45,1
7,N/A,N/A,N/A,382,389,N/A,48,4
7,N/A,N/A,N/A,375,382,N/A,53,3
18,N/A,N/A,N/A,357,375,N/A,56,6
9,N/A,N/A,N/A,348,357,N/A,61,5
8,N/A,N/A,N/A,340,348,N/A,66,4
7,N/A,N/A,N/A,333,340,N/A,71,3
4,N/A,N/A,N/A,329,333,N/A,75,1
11,N/A,N/A,N/A,318,329,N/A,79,5
7,N/A,N/A,N/A,311,318,N/A,82,2
15,N/A,N/A,N/A,296,311,N/A,86,6
7,N/A,N/A,N/A,289,296,N/A,89,3
19,N/A,N/A,N/A,270,289,N/A,92,6
10,N/A,N/A,N/A,260,270,N/A,97,5
10,N/A,N/A,N/A,250,260,N/A,103,5
7,N/A,N/A,N/A,243,250,N/A,106,2
10,N/A,N/A,N/A,233,243,N/A,109,5
7,N/A,N/A,N/A,226,233,N/A,114,4
5,N/A,N/A,N/A,221,226,N/A,117,1
4,N/A,N/A,N/A,217,221,N/A,123,1
13,N/A,N/A,N/A,204,217,N/A,128,6
12,N/A,N/A,N/A,651,663,N/A,3,6
4,N/A,N/A,N/A,647,651,N/A,9,0
5,N/A,N/A,N/A,642,647,N/A,13,4
5,N/A,N/A,N/A,637,642,N/A,18,3
4,N/A,N/A,N/A,633,637,N/A,24,3
5,N/A,N/A,N/A,628,633,N/A,30,3
6,N/A,N/A,N/A,622,628,N/A,36,3
7,N/A,N/A,N/A,615,622,N/A,41,2
7,N/A,N/A,N/A,608,615,N/A,47,2
16,N/A,N/A,N/A,592,608,N/A,51,6
5,N/A,N/A,N/A,587,592,N/A,57,0
7,N/A,N/A,N/A,580,587,N/A,61,4
6,N/A,N/A,N/A,574,580,N/A,67,4
5,N/A,N/A,N/A,569,574,N/A,71,2
6,N/A,N/A,N/A,563,569,N/A,77,2
7,N/A,N/A,N/A,556,563,N/A,83,2
16,N/A,N/A,N/A,540,556,N/A,87,6
5,N/A,N/A,N/A,535,540,N/A,91,4
5,N/A,N/A,N/A,530,535,N/A,97,4
6,N/A,N/A,N/A,524,530,N/A,103,4
6,N/A,N/A,N/A,518,524,N/A,107,2
4,N/A,N/A,N/A,514,518,N/A,112,1
17,N/A,N/A,N/A,497,514,N/A,117,6
7,N/A,N/A,N/A,490,497,N/A,121,4
4,N/A,N/A,N/A,486,490,N/A,124,1
12,N/A,N/A,N/A,474,486,N/A,128,5
12,N/A,N/A,N/A,462,474,N/A,134,5
6,N/A,N/A,N/A,456,462,N/A,137,2
4,N/A,N/A,N/A,452,456,N/A,142,1
5,N/A,N/A,N/A,447,452,N/A,148,1
5,N/A,N/A,N/A,412,417,N/A,5,2
12,N/A,N/A,N/A,400,412,N/A,8,5
5,N/A,N/A,N/A,395,400,N/A,13,4
4,N/A,N/A,N/A,391,395,N/A,16,1
9,N/A,N/A,N/A,382,391,N/A,20,5
10,N/A,N/A,N/A,372,382,N/A,26,5
4,N/A,N/A,N/A,368,372,N/A,30,3
6,N/A,N/A,N/A,362,368,N/A,35,2
4,N/A,N/A,N/A,358,362,N/A,41,2
12,N/A,N/A,N/A,346,358,N/A,44,5
7,N/A,N/A,N/A,339,346,N/A,48,3
14,N/A,N/A,N/A,325,339,N/A,51,6
12,N/A,N/A,N/A,313,325,N/A,56,5
4,N/A,N/A,N/A,309,313,N/A,60,3
16,N/A,N/A,N/A,293,309,N/A,63,6
12,N/A,N/A,N/A,281,293,N/A,68,5
5,N/A,N/A,N/A,276,281,N/A,71,2
5,N/A,N/A,N/A,271,276,N/A,76,1
19,N/A,N/A,N/A,252,271,N/A,81,6
6,N/A,N/A,N/A,246,252,N/A,85,4
4,N/A,N/A,N/A,242,246,N/A,89,2
16,N/A,N/A,N/A,226,242,N/A,93,6
5,N/A,N/A,N/A,221,226,N/A,99,0
5,N/A,N/A,N/A,216,221,N/A,102,3
6,N/A,N/A,N/A,210,216,N/A,107,2
9,N/A,N/A,N/A,201,210,N/A,110,5
11,N/A,N/A,N/A,190,201,N/A,116,5
10,N/A,N/A,N/A,180,190,N/A,122,5
7,N/A,N/A,N/A,173,180,N/A,126,3
6,N/A,N/A,N/A,167,173,N/A,132,3
5,N/A,N/A,N/A,1376,1381,N/A,3,4
5,N/A,N/A,N/A,1371,1376,N/A,9,4
4,N/A,N/A,N/A,1367,1371,N/A,13,2
5,N/A,N/A,N/A,1362,1367,N/A,19,2
4,N/A,N/A,N/A,1358,1362,N/A,25,2
4,N/A,N/A,N/A,1354,1358,N/A,31,2
5,N/A,N/A,N/A,1349,1354,N/A,36,1
9,N/A,N/A,N/A,1340,1349,N/A,40,5
5,N/A,N/A,N/A,1335,1340,N/A,44,3
7,N/A,N/A,N/A,1328,1335,N/A,50,3
5,N/A,N/A,N/A,1323,1328,N/A,54,1
12,N/A,N/A,N/A,1311,1323,N/A,58,5
5,N/A,N/A,N/A,1306,1311,N/A,62,3
17,N/A,N/A,N/A,1289,1306,N/A,65,6
11,N/A,N/A,N/A,1278,1289,N/A,70,5
6,N/A,N/A,N/A,1272,1278,N/A,74,3
6,N/A,N/A,N/A,1266,1272,N/A,80,3
17,N/A,N/A,N/A,1249,1266,N/A,83,6
5,N/A,N/A,N/A,1244,1249,N/A,89,0
10,N/A,N/A,N/A,1234,1244,N/A,94,5
11,N/A,N/A,N/A,1223,1234,N/A,100,5
5,N/A,N/A,N/A,1218,1223,N/A,105,4
7,N/A,N/A,N/A,1211,1218,N/A,111,4
8,N/A,N/A,N/A,1203,1211,N/A,117,4
5,N/A,N/A,N/A,1198,1203,N/A,120,1
14,N/A,N/A,N/A,1184,1198,N/A,125,6
4,N/A,N/A,N/A,1180,1184,N/A,128,3
13,N/A,N/A,N/A,1167,1180,N/A,131,6
6,N/A,N/A,N/A,1161,1167,N/A,135,4
5,N/A,N/A,N/A,1156,1161,N/A,141,4
8,N/A,N/A,N/A,1434,1442,N/A,5,4
5,N/A,N/A,N/A,1429,1434,N/A,9,2
10,N/A,N/A,N/A,1419,1429,N/A,13,6
6,N/A,N/A,N/A,1413,1419,N/A,16,3
6,N/A,N/A,N/A,1407,1413,N/A,22,3
5,N/A,N/A,N/A,1402,1407,N/A,27,2
5,N/A,N/A,N/A,1397,1402,N/A,32,1
5,N/A,N/A,N/A,1392,1397,N/A,38,1
10,N/A,N/A,N/A,1382,1392,N/A,43,6
5,N/A,N/A,N/A,1377,1382,N/A,46,3
15,N/A,N/A,N/A,1362,1377,N/A,49,6
5,N/A,N/A,N/A,1357,1362,N/A,53,4
5,N/A,N/A,N/A,1352,1357,N/A,56,1
6,N/A,N/A,N/A,1346,1352,N/A,59,4
6,N/A,N/A,N/A,1340,1346,N/A,65,4
7,N/A,N/A,N/A,1333,1340,N/A,69,2
17,N/A,N/A,N/A,1316,1333,N/A,73,6
11,N/A,N/A,N/A,1305,1316,N/A,78,5
10,N/A,N/A,N/A,1295,1305,N/A,84,5
7,N/A,N/A,N/A,1288,1295,N/A,88,3
15,N/A,N/A,N/A,1273,1288,N/A,91,6
4,N/A,N/A,N/A,1269,1273,N/A,97,0
6,N/A,N/A,N/A,1263,1269,N/A,101,4
8,N/A,N/A,N/A,1255,1263,N/A,107,4
5,N/A,N/A,N/A,1250,1255,N/A,113,4
5,N/A,N/A,N/A,1245,1250,N/A,119,4
5,N/A,N/A,N/A,1240,1245,N/A,123,2
19,N/A,N/A,N/A,1221,1240,N/A,127,6
10,N/A,N/A,N/A,1211,1221,N/A,132,5
6,N/A,N/A,N/A,1205,1211,N/A,137,4
6,N/A,N/A,N/A,735,741,N/A,6,2
5,N/A,N/A,N/A,730,735,N/A,12,2
5,N/A,N/A,N/A,725,730,N/A,18,2
4,N/A,N/A,N/A,721,725,N/A,24,2
19,N/A,N/A,N/A,702,721,N/A,28,6
5,N/A,N/A,N/A,697,702,N/A,34,0
12,N/A,N/A,N/A,685,697,N/A,40,6
5,N/A,N/A,N/A,680,685,N/A,44,4
8,N/A,N/A,N/A,672,680,N/A,50,4
5,N/A,N/A,N/A,667,672,N/A,53,1
9,N/A,N/A,N/A,658,667,N/A,57,5
10,N/A,N/A,N/A,648,658,N/A,63,5
12,N/A,N/A,N/A,636,648,N/A,69,5
5,N/A,N/A,N/A,631,636,N/A,73,3
16,N/A,N/A,N/A,615,631,N/A,76,6
9,N/A,N/A,N/A,606,615,N/A,81,5
11,N/A,N/A,N/A,595,606,N/A,87,5
5,N/A,N/A,N/A,590,595,N/A,90,2
15,N/A,N/A,N/A,575,590,N/A,94,6
7,N/A,N/A,N/A,568,575,N/A,98,4
6,N/A,N/A,N/A,562,568,N/A,102,2
6,N/A,N/A,N/A,556,562,N/A,108,2
6,N/A,N/A,N/A,550,556,N/A,114,2
4,N/A,N/A,N/A,546,550,N/A,119,1
7,N/A,N/A,N/A,539,546,N/A,122,4
5,N/A,N/A,N/A,534,539,N/A,125,1
12,N/A,N/A,N/A,522,534,N/A,129,5
6,N/A,N/A,N/A,516,522,N/A,134,4
5,N/A,N/A,N/A,511,516,N/A,137,1
6,N/A,N/A,N/A,505,511,N/A,140,4
7,N/A,N/A,N/A,1506,1513,N/A,5,3
15,N/A,N/A,N/A,1491,1506,N/A,8,6
4,N/A,N/A,N/A,1487,1491,N/A,14,0
6,N/A,N/A,N/A,1481,1487,N/A,18,4
6,N/A,N/A,N/A,1475,1481,N/A,23,3
6,N/A,N/A,N/A,1469,1475,N/A,29,3
4,N/A,N/A,N/A,1465,1469,N/A,34,2
9,N/A,N/A,N/A,1456,1465,N/A,37,5
8,N/A,N/A,N/A,1448,1456,N/A,42,4
5,N/A,N/A,N/A,1443,1448,N/A,46,2
4,N/A,N/A,N/A,1439,1443,N/A,52,2
5,N/A,N/A,N/A,1434,1439,N/A,58,2
5,N/A,N/A,N/A,1429,1434,N/A,63,1
12,N/A,N/A,N/A,1417,1429,N/A,67,5
6,N/A,N/A,N/A,1411,1417,N/A,72,4
5,N/A,N/A,N/A,1406,1411,N/A,75,1
19,N/A,N/A,N/A,1387,1406,N/A,80,6
5,N/A,N/A,N/A,1382,1387,N/A,86,0
5,N/A,N/A,N/A,1377,1382,N/A,90,4
4,N/A,N/A,N/A,1373,1377,N/A,95,3
4,N/A,N/A,N/A,1369,1373,N/A,100,2
15,N/A,N/A,N/A,1354,1369,N/A,104,6
11,N/A,N/A,N/A,1343,1354,N/A,109,5
6,N/A,N/A,N/A,1337,1343,N/A,114,4
6,N/A,N/A,N/A,1331,1337,N/A,118,2
4,N/A,N/A,N/A,1327,1331,N/A,124,2
9,N/A,N/A,N/A,1318,1327,N/A,127,5
6,N/A,N/A,N/A,1312,1318,N/A,132,4
5,N/A,N/A,N/A,1307,1312,N/A,136,2
6,N/A,N/A,N/A,1301,1307,N/A,142,2
15,N/A,N/A,N/A,322,337,N/A,4,6
7,N/A,N/A,N/A,315,322,N/A,8,4
5,N/A,N/A,N/A,310,315,N/A,11,1
13,N/A,N/A,N/A,297,310,N/A,16,6
6,N/A,N/A,N/A,291,297,N/A,20,4
4,N/A,N/A,N/A,287,291,N/A,23,1
11,N/A,N/A,N/A,276,287,N/A,28,6
7,N/A,N/A,N/A,269,276,N/A,31,3
12,N/A,N/A,N/A,257,269,N/A,34,6
12,N/A,N/A,N/A,245,257,N/A,39,5
12,N/A,N/A,N/A,233,245,N/A,45,5
7,N/A,N/A,N/A,226,233,N/A,48,2
11,N/A,N/A,N/A,215,226,N/A,51,5
5,N/A,N/A,N/A,210,215,N/A,56,4
8,N/A,N/A,N/A,202,210,N/A,62,4
7,N/A,N/A,N/A,195,202,N/A,68,4
5,N/A,N/A,N/A,190,195,N/A,74,4
6,N/A,N/A,N/A,184,190,N/A,78,2
4,N/A,N/A,N/A,180,184,N/A,84,2
5,N/A,N/A,N/A,175,180,N/A,89,1
6,N/A,N/A,N/A,169,175,N/A,92,4
7,N/A,N/A,N/A,162,169,N/A,98,4
6,N/A,N/A,N/A,156,162,N/A,103,3
5,N/A,N/A,N/A,151,156,N/A,107,1
7,N/A,N/A,N/A,144,151,N/A,110,4
6,N/A,N/A,N/A,138,144,N/A,114,2
4,N/A,N/A,N/A,134,138,N/A,119,1
4,N/A,N/A,N/A,130,134,N/A,125,1
5,N/A,N/A,N/A,125,130,N/A,128,4
4,N/A,N/A,N/A,121,125,N/A,131,1
7,N/A,N/A,N/A,1339,1346,N/A,6,4
5,N/A,N/A,N/A,1334,1339,N/A,9,1
7,N/A,N/A,N/A,1327,1334,N/A,12,4
5,N/A,N/A,N/A,1322,1327,N/A,17,3
5,N/A,N/A,N/A,1317,1322,N/A,22,2
6,N/A,N/A,N/A,1311,1317,N/A,28,2
17,N/A,N/A,N/A,1294,1311,N/A,32,6
7,N/A,N/A,N/A,1287,1294,N/A,36,4
4,N/A,N/A,N/A,1283,1287,N/A,41,3
6,N/A,N/A,N/A,1277,1283,N/A,46,2
4,N/A,N/A,N/A,1273,1277,N/A,52,2
18,N/A,N/A,N/A,1255,1273,N/A,56,6
7,N/A,N/A,N/A,1248,1255,N/A,60,4
4,N/A,N/A,N/A,1244,1248,N/A,63,1
4,N/A,N/A,N/A,1240,1244,N/A,69,1
10,N/A,N/A,N/A,1230,1240,N/A,73,5
7,N/A,N/A,N/A,1223,1230,N/A,77,3
6,N/A,N/A,N/A,1217,1223,N/A,82,2
9,N/A,N/A,N/A,1208,1217,N/A,85,5
6,N/A,N/A,N/A,1202,1208,N/A,89,3
14,N/A,N/A,N/A,1188,1202,N/A,92,6
7,N/A,N/A,N/A,1181,1188,N/A,96,4
5,N/A,N/A,N/A,1176,1181,N/A,102,4
7,N/A,N/A,N/A,1169,1176,N/A,108,4
6,N/A,N/A,N/A,1163,1169,N/A,112,2
10,N/A,N/A,N/A,1153,1163,N/A,115,5
9,N/A,N/A,N/A,1144,1153,N/A,121,5
8,N/A,N/A,N/A,1136,1144,N/A,126,4
4,N/A,N/A,N/A,1132,1136,N/A,129,1
9,N/A,N/A,N/A,1123,1132,N/A,133,5
5,N/A,N/A,N/A,1576,1581,N/A,5,1
12,N/A,N/A,N/A,1564,1576,N/A,10,6
7,N/A,N/A,N/A,1557,1564,N/A,14,4
6,N/A,N/A,N/A,1551,1557,N/A,18,2
7,N/A,N/A,N/A,1544,1551,N/A,24,2
7,N/A,N/A,N/A,1537,1544,N/A,30,2
5,N/A,N/A,N/A,1532,1537,N/A,36,2
6,N/A,N/A,N/A,1526,1532,N/A,42,2
4,N/A,N/A,N/A,1522,1526,N/A,48,2
4,N/A,N/A,N/A,1518,1522,N/A,53,1
16,N/A,N/A,N/A,1502,1518,N/A,58,6
7,N/A,N/A,N/A,1495,1502,N/A,61,3
15,N/A,N/A,N/A,1480,1495,N/A,64,6
7,N/A,N/A,N/A,1473,1480,N/A,67,3
15,N/A,N/A,N/A,1458,1473,N/A,70,6
8,N/A,N/A,N/A,1450,1458,N/A,74,4
8,N/A,N/A,N/A,1442,1450,N/A,80,4
5,N/A,N/A,N/A,1437,1442,N/A,83,1
8,N/A,N/A,N/A,1429,1437,N/A,86,4
7,N/A,N/A,N/A,1422,1429,N/A,91,3
11,N/A,N/A,N/A,1411,1422,N/A,94,6
6,N/A,N/A,N/A,1405,1411,N/A,97,3
6,N/A,N/A,N/A,1399,1405,N/A,102,2
4,N/A,N/A,N/A,1395,1399,N/A,108,2
7,N/A,N/A,N/A,1388,1395,N/A,114,2
5,N/A,N/A,N/A,1383,1388,N/A,119,1
5,N/A,N/A,N/A,1378,1383,N/A,122,4
5,N/A,N/A,N/A,1373,1378,N/A,128,4
5,N/A,N/A,N/A,1368,1373,N/A,133,3
14,N/A,N/A,N/A,1354,1368,N/A,136,6
6,N/A,N/A,N/A,513,519,N/A,4,3
6,N/A,N/A,N/A,507,513,N/A,9,2
4,N/A,N/A,N/A,503,507,N/A,14,1
4,N/A,N/A,N/A,499,503,N/A,20,1
18,N/A,N/A,N/A,481,499,N/A,25,6
4,N/A,N/A,N/A,477,481,N/A,31,0
17,N/A,N/A,N/A,460,477,N/A,37,6
9,N/A,N/A,N/A,451,460,N/A,42,5
10,N/A,N/A,N/A,441,451,N/A,48,5
4,N/A,N/A,N/A,437,441,N/A,51,2
6,N/A,N/A,N/A,431,437,N/A,57,2
5,N/A,N/A,N/A,426,431,N/A,62,1
18,N/A,N/A,N/A,408,426,N/A,67,6
5,N/A,N/A,N/A,403,408,N/A,70,3
7,N/A,N/A,N/A,396,403,N/A,75,2
13,N/A,N/A,N/A,383,396,N/A,79,6
4,N/A,N/A,N/A,379,383,N/A,85,0
9,N/A,N/A,N/A,370,379,N/A,90,5
7,N/A,N/A,N/A,363,370,N/A,93,2
4,N/A,N/A,N/A,359,363,N/A,99,2
12,N/A,N/A,N/A,347,359,N/A,102,5
12,N/A,N/A,N/A,335,347,N/A,108,5
7,N/A,N/A,N/A,328,335,N/A,112,3
13,N/A,N/A,N/A,315,328,N/A,115,6
5,N/A,N/A,N/A,310,315,N/A,118,3
5,N/A,N/A,N/A,305,310,N/A,123,2
4,N/A,N/A,N/A,301,305,N/A,128,1
14,N/A,N/A,N/A,287,301,N/A,133,6
5,N/A,N/A,N/A,282,287,N/A,136,3
5,N/A,N/A,N/A,277,282,N/A,141,2
9,N/A,N/A,N/A,1619,1628,N/A,6,5
4,N/A,N/A,N/A,1615,1619,N/A,10,3
5,N/A,N/A,N/A,1610,1615,N/A,16,3
5,N/A,N/A,N/A,1605,1610,N/A,20,1
7,N/A,N/A,N/A,1598,1605,N/A,23,4
6,N/A,N/A,N/A,1592,1598,N/A,28,3
4,N/A,N/A,N/A,1588,1592,N/A,33,2
4,N/A,N/A,N/A,1584,1588,N/A,38,1
10,N/A,N/A,N/A,1574,1584,N/A,43,6
5,N/A,N/A,N/A,1569,1574,N/A,49,0
19,N/A,N/A,N/A,1550,1569,N/A,55,6
12,N/A,N/A,N/A,1538,1550,N/A,60,5
4,N/A,N/A,N/A,1534,1538,N/A,63,2
5,N/A,N/A,N/A,1529,1534,N/A,69,2
5,N/A,N/A,N/A,1524,1529,N/A,75,2
4,N/A,N/A,N/A,1520,1524,N/A,80,1
5,N/A,N/A,N/A,1515,1520,N/A,86,1
4,N/A,N/A,N/A,1511,1515,N/A,92,1
6,N/A,N/A,N/A,1505,1511,N/A,95,4
5,N/A,N/A,N/A,1500,1505,N/A,99,2
5,N/A,N/A,N/A,1495,1500,N/A,104,1
17,N/A,N/A,N/A,1478,1495,N/A,109,6
8,N/A,N/A,N/A,1470,1478,N/A,113,4
5,N/A,N/A,N/A,1465,1470,N/A,116,1
12,N/A,N/A,N/A,1453,1465,N/A,120,5
5,N/A,N/A,N/A,1448,1453,N/A,123,2
4,N/A,N/A,N/A,1444,1448,N/A,129,2
5,N/A,N/A,N/A,1439,1444,N/A,134,1
11,N/A,N/A,N/A,1428,1439,N/A,139,6
5,N/A,N/A,N/A,1423,1428,N/A,143,4
6,N/A,N/A,N/A,1838,1844,N/A,3,4
7,N/A,N/A,N/A,1831,1838,N/A,9,4
7,N/A,N/A,N/A,1824,1831,N/A,15,4
4,N/A,N/A,N/A,1820,1824,N/A,19,2
5,N/A,N/A,N/A,1815,1820,N/A,24,1
9,N/A,N/A,N/A,1806,1815,N/A,28,5
6,N/A,N/A,N/A,1800,1806,N/A,32,3
6,N/A,N/A,N/A,1794,1800,N/A,37,2
14,N/A,N/A,N/A,1780,1794,N/A,41,6
7,N/A,N/A,N/A,1773,1780,N/A,45,4
7,N/A,N/A,N/A,1766,1773,N/A,51,4
4,N/A,N/A,N/A,1762,1766,N/A,54,1
10,N/A,N/A,N/A,1752,1762,N/A,58,5
6,N/A,N/A,N/A,1746,1752,N/A,62,3
5,N/A,N/A,N/A,1741,1746,N/A,67,2
5,N/A,N/A,N/A,1736,1741,N/A,72,1
5,N/A,N/A,N/A,1731,1736,N/A,78,1
4,N/A,N/A,N/A,1727,1731,N/A,84,1
12,N/A,N/A,N/A,1715,1727,N/A,89,6
8,N/A,N/A,N/A,1707,1715,N/A,93,4
6,N/A,N/A,N/A,1701,1707,N/A,97,2
10,N/A,N/A,N/A,1691,1701,N/A,100,5
10,N/A,N/A,N/A,1681,1691,N/A,106,5
5,N/A,N/A,N/A,1676,1681,N/A,110,3
4,N/A,N/A,N/A,1672,1676,N/A,116,3
10,N/A,N/A,N/A,1662,1672,N/A,119,6
6,N/A,N/A,N/A,1656,1662,N/A,122,3
4,N/A,N/A,N/A,1652,1656,N/A,126,1
5,N/A,N/A,N/A,1647,1652,N/A,132,1
10,N/A,N/A,N/A,1637,1647,N/A,136,5
6,N/A,N/A,N/A,1464,1470,N/A,6,2
10,N/A,N/A,N/A,1454,1464,N/A,9,5
11,N/A,N/A,N/A,1443,1454,N/A,15,5
4,N/A,N/A,N/A,1439,1443,N/A,18,2
11,N/A,N/A,N/A,1428,1439,N/A,21,5
5,N/A,N/A,N/A,1423,1428,N/A,26,4
4,N/A,N/A,N/A,1419,1423,N/A,29,1
7,N/A,N/A,N/A,1412,1419,N/A,32,4
8,N/A,N/A,N/A,1404,1412,N/A,38,4
5,N/A,N/A,N/A,1399,1404,N/A,41,1
5,N/A,N/A,N/A,1394,1399,N/A,44,4
6,N/A,N/A,N/A,1388,1394,N/A,48,2
18,N/A,N/A,N/A,1370,1388,N/A,52,6
4,N/A,N/A,N/A,1366,1370,N/A,58,0
8,N/A,N/A,N/A,1358,1366,N/A,62,4
5,N/A,N/A,N/A,1353,1358,N/A,67,3
4,N/A,N/A,N/A,1349,1353,N/A,71,1
6,N/A,N/A,N/A,1343,1349,N/A,74,4
4,N/A,N/A,N/A,1339,1343,N/A,79,3
5,N/A,N/A,N/A,1334,1339,N/A,84,2
12,N/A,N/A,N/A,1322,1334,N/A,88,6
6,N/A,N/A,N/A,1316,1322,N/A,91,3
15,N/A,N/A,N/A,1301,1316,N/A,94,6
4,N/A,N/A,N/A,1297,1301,N/A,100,0
5,N/A,N/A,N/A,1292,1297,N/A,104,4
8,N/A,N/A,N/A,1284,1292,N/A,110,4
5,N/A,N/A,N/A,1279,1284,N/A,113,1
14,N/A,N/A,N/A,1265,1279,N/A,118,6
4,N/A,N/A,N/A,1261,1265,N/A,124,0
11,N/A,N/A,N/A,1250,1261,N/A,129,5
12,N/A,N/A,N/A,1895,1907,N/A,3,5
6,N/A,N/A,N/A,1889,1895,N/A,6,2
5,N/A,N/A,N/A,1884,1889,N/A,12,2
13,N/A,N/A,N/A,1871,1884,N/A,16,6
5,N/A,N/A,N/A,1866,1871,N/A,22,0
7,N/A,N/A,N/A,1859,1866,N/A,25,3
5,N/A,N/A,N/A,1854,1859,N/A,31,3
15,N/A,N/A,N/A,1839,1854,N/A,34,6
5,N/A,N/A,N/A,1834,1839,N/A,40,0
5,N/A,N/A,N/A,1829,1834,N/A,44,4
4,N/A,N/A,N/A,1825,1829,N/A,49,3
14,N/A,N/A,N/A,1811,1825,N/A,52,6
8,N/A,N/A,N/A,1803,1811,N/A,56,4
4,N/A,N/A,N/A,1799,1803,N/A,60,2
7,N/A,N/A,N/A,1792,1799,N/A,66,2
5,N/A,N/A,N/A,1787,1792,N/A,71,1
10,N/A,N/A,N/A,1777,1787,N/A,75,5
10,N/A,N/A,N/A,1767,1777,N/A,81,5
7,N/A,N/A,N/A,1760,1767,N/A,84,2
15,N/A,N/A,N/A,1745,1760,N/A,88,6
12,N/A,N/A,N/A,1733,1745,N/A,93,5
4,N/A,N/A,N/A,1729,1733,N/A,97,3
16,N/A,N/A,N/A,1713,1729,N/A,100,6
5,N/A,N/A,N/A,1708,1713,N/A,106,0
5,N/A,N/A,N/A,1703,1708,N/A,109,3
7,N/A,N/A,N/A,1696,1703,N/A,114,2
19,N/A,N/A,N/A,1677,1696,N/A,118,6
7,N/A,N/A,N/A,1670,1677,N/A,122,4
4,N/A,N/A,N/A,1666,1670,N/A,126,2
10,N/A,N/A,N/A,1656,1666,N/A,130,6
6,N/A,N/A,N/A,1381,1387,N/A,5,4
5,N/A,N/A,N/A,1376,1381,N/A,11,4
4,N/A,N/A,N/A,1372,1376,N/A,14,1
4,N/A,N/A,N/A,1368,1372,N/A,20,1
4,N/A,N/A,N/A,1364,1368,N/A,26,1
15,N/A,N/A,N/A,1349,1364,N/A,31,6
7,N/A,N/A,N/A,1342,1349,N/A,35,4
4,N/A,N/A,N/A,1338,1342,N/A,38,1
16,N/A,N/A,N/A,1322,1338,N/A,43,6
7,N/A,N/A,N/A,1315,1322,N/A,47,4
5,N/A,N/A,N/A,1310,1315,N/A,53,4
4,N/A,N/A,N/A,1306,1310,N/A,56,1
5,N/A,N/A,N/A,1301,1306,N/A,62,1
6,N/A,N/A,N/A,1295,1301,N/A,65,4
7,N/A,N/A,N/A,1288,1295,N/A,69,2
10,N/A,N/A,N/A,1278,1288,N/A,72,5
8,N/A,N/A,N/A,1270,1278,N/A,77,4
5,N/A,N/A,N/A,1265,1270,N/A,80,1
10,N/A,N/A,N/A,1255,1265,N/A,84,5
5,N/A,N/A,N/A,1250,1255,N/A,87,2
7,N/A,N/A,N/A,1243,1250,N/A,93,2
5,N/A,N/A,N/A,1238,1243,N/A,99,2
12,N/A,N/A,N/A,1226,1238,N/A,103,6
7,N/A,N/A,N/A,1219,1226,N/A,107,4
7,N/A,N/A,N/A,1212,1219,N/A,112,3
5,N/A,N/A,N/A,1207,1212,N/A,118,3
15,N/A,N/A,N/A,1192,1207,N/A,121,6
5,N/A,N/A,N/A,1187,1192,N/A,124,3
11,N/A,N/A,N/A,1176,1187,N/A,127,6
12,N/A,N/A,N/A,1164,1176,N/A,132,5
4,N/A,N/A,N/A,1742,1746,N/A,6,1
8,N/A,N/A,N/A,1734,1742,N/A,9,4
5,N/A,N/A,N/A,1729,1734,N/A,14,3
4,N/A,N/A,N/A,1725,1729,N/A,18,1
4,N/A,N/A,N/A,1721,1725,N/A,24,1
4,N/A,N/A,N/A,1717,1721,N/A,30,1
9,N/A,N/A,N/A,1708,1717,N/A,34,5
12,N/A,N/A,N/A,1696,1708,N/A,40,5
6,N/A,N/A,N/A,1690,1696,N/A,43,2
9,N/A,N/A,N/A,1681,1690,N/A,46,5
6,N/A,N/A,N/A,1675,1681,N/A,49,2
7,N/A,N/A,N/A,1668,1675,N/A,55,2
4,N/A,N/A,N/A,1664,1668,N/A,60,1
9,N/A,N/A,N/A,1655,1664,N/A,64,5
5,N/A,N/A,N/A,1650,1655,N/A,69,4
8,N/A,N/A,N/A,1642,1650,N/A,75,4
6,N/A,N/A,N/A,1636,1642,N/A,80,3
5,N/A,N/A,N/A,1631,1636,N/A,84,1
8,N/A,N/A,N/A,1623,1631,N/A,87,4
5,N/A,N/A,N/A,1618,1623,N/A,93,4
6,N/A,N/A,N/A,1612,1618,N/A,97,2
7,N/A,N/A,N/A,1605,1612,N/A,103,2
19,N/A,N/A,N/A,1586,1605,N/A,107,6
12,N/A,N/A,N/A,1574,1586,N/A,112,5
6,N/A,N/A,N/A,1568,1574,N/A,115,2
12,N/A,N/A,N/A,1556,1568,N/A,118,5
10,N/A,N/A,N/A,1546,1556,N/A,124,5
4,N/A,N/A,N/A,1542,1546,N/A,128,3
5,N/A,N/A,N/A,1537,1542,N/A,132,1
11,N/A,N/A,N/A,1526,1537,N/A,137,6
5,N/A,N/A,N/A,921,926,N/A,4,1
14,N/A,N/A,N/A,907,921,N/A,9,6
4,N/A,N/A,N/A,903,907,N/A,15,0
15,N/A,N/A,N/A,888,903,N/A,21,6
7,N/A,N/A,N/A,881,888,N/A,25,4
4,N/A,N/A,N/A,877,881,N/A,28,1
6,N/A,N/A,N/A,871,877,N/A,31,4
5,N/A,N/A,N/A,866,871,N/A,34,1
12,N/A,N/A,N/A,854,866,N/A,38,5
5,N/A,N/A,N/A,849,854,N/A,42,3
13,N/A,N/A,N/A,836,849,N/A,45,6
11,N/A,N/A,N/A,825,836,N/A,50,5
4,N/A,N/A,N/A,821,825,N/A,53,2
4,N/A,N/A,N/A,817,821,N/A,58,1
10,N/A,N/A,N/A,807,817,N/A,62,5
5,N/A,N/A,N/A,802,807,N/A,65,2
6,N/A,N/A,N/A,796,802,N/A,71,2
9,N/A,N/A,N/A,787,796,N/A,74,5
5,N/A,N/A,N/A,782,787,N/A,78,3
6,N/A,N/A,N/A,776,782,N/A,83,2
4,N/A,N/A,N/A,772,776,N/A,88,1
4,N/A,N/A,N/A,768,772,N/A,94,1
10,N/A,N/A,N/A,758,768,N/A,98,5
6,N/A,N/A,N/A,752,758,N/A,101,2
5,N/A,N/A,N/A,747,752,N/A,106,1
8,N/A,N/A,N/A,739,747,N/A,109,4
5,N/A,N/A,N/A,734,739,N/A,115,4
5,N/A,N/A,N/A,729,734,N/A,118,1
16,N/A,N/A,N/A,713,729,N/A,123,6
10,N/A,N/A,N/A,703,713,N/A,128,5
5,N/A,N/A,N/A,1355,1360,N/A,5,3
5,N/A,N/A,N/A,1350,1355,N/A,9,1
6,N/A,N/A,N/A,1344,1350,N/A,12,4
5,N/A,N/A,N/A,1339,1344,N/A,17,3
17,N/A,N/A,N/A,1322,1339,N/A,20,6
4,N/A,N/A,N/A,1318,1322,N/A,26,0
7,N/A,N/A,N/A,1311,1318,N/A,30,4
6,N/A,N/A,N/A,1305,1311,N/A,36,4
4,N/A,N/A,N/A,1301,1305,N/A,40,2
14,N/A,N/A,N/A,1287,1301,N/A,44,6
10,N/A,N/A,N/A,1277,1287,N/A,49,5
4,N/A,N/A,N/A,1273,1277,N/A,53,3
5,N/A,N/A,N/A,1268,1273,N/A,58,2
7,N/A,N/A,N/A,1261,1268,N/A,64,2
16,N/A,N/A,N/A,1245,1261,N/A,68,6
5,N/A,N/A,N/A,1240,1245,N/A,72,4
8,N/A,N/A,N/A,1232,1240,N/A,78,4
4,N/A,N/A,N/A,1228,1232,N/A,82,2
7,N/A,N/A,N/A,1221,1228,N/A,88,2
4,N/A,N/A,N/A,1217,1221,N/A,93,1
5,N/A,N/A,N/A,1212,1217,N/A,99,1
7,N/A,N/A,N/A,1205,1212,N/A,102,4
5,N/A,N/A,N/A,1200,1205,N/A,105,1
7,N/A,N/A,N/A,1193,1200,N/A,108,4
5,N/A,N/A,N/A,1188,1193,N/A,114,4
7,N/A,N/A,N/A,1181,1188,N/A,118,2
12,N/A,N/A,N/A,1169,1181,N/A,122,6
5,N/A,N/A,N/A,1164,1169,N/A,125,3
7,N/A,N/A,N/A,1157,1164,N/A,131,3
5,N/A,N/A,N/A,1152,1157,N/A,136,2
9,N/A,N/A,N/A,1097,1106,N/A,4,5
11,N/A,N/A,N/A,1086,1097,N/A,10,5
9,N/A,N/A,N/A,1077,1086,N/A,16,5
8,N/A,N/A,N/A,1069,1077,N/A,21,4
4,N/A,N/A,N/A,1065,1069,N/A,24,1
6,N/A,N/A,N/A,1059,1065,N/A,27,4
5,N/A,N/A,N/A,1054,1059,N/A,32,3
13,N/A,N/A,N/A,1041,1054,N/A,35,6
5,N/A,N/A,N/A,1036,1041,N/A,39,4
4,N/A,N/A,N/A,1032,1036,N/A,44,3
4,N/A,N/A,N/A,1028,1032,N/A,48,1
5,N/A,N/A,N/A,1023,1028,N/A,51,4
7,N/A,N/A,N/A,1016,1023,N/A,56,3
4,N/A,N/A,N/A,1012,1016,N/A,60,1
11,N/A,N/A,N/A,1001,1012,N/A,64,5
5,N/A,N/A,N/A,996,1001,N/A,69,4
5,N/A,N/A,N/A,991,996,N/A,72,1
10,N/A,N/A,N/A,981,991,N/A,77,6
10,N/A,N/A,N/A,971,981,N/A,82,5
4,N/A,N/A,N/A,967,971,N/A,86,3
7,N/A,N/A,N/A,960,967,N/A,92,3
4,N/A,N/A,N/A,956,960,N/A,96,1
10,N/A,N/A,N/A,946,956,N/A,100,5
6,N/A,N/A,N/A,940,946,N/A,105,4
6,N/A,N/A,N/A,934,940,N/A,111,4
5,N/A,N/A,N/A,929,934,N/A,116,3
4,N/A,N/A,N/A,925,929,N/A,121,2
5,N/A,N/A,N/A,920,925,N/A,126,1
14,N/A,N/A,N/A,906,920,N/A,131,6
5,N/A,N/A,N/A,901,906,N/A,137,0
8,N/A,N/A,N/A,1005,1013,N/A,3,4
5,N/A,N/A,N/A,1000,1005,N/A,6,1
17,N/A,N/A,N/A,983,1000,N/A,11,6
11,N/A,N/A,N/A,972,983,N/A,16,5
7,N/A,N/A,N/A,965,972,N/A,21,4
6,N/A,N/A,N/A,959,965,N/A,26,3
4,N/A,N/A,N/A,955,959,N/A,32,3
15,N/A,N/A,N/A,940,955,N/A,35,6
4,N/A,N/A,N/A,936,940,N/A,38,3
12,N/A,N/A,N/A,924,936,N/A,41,6
11,N/A,N/A,N/A,913,924,N/A,46,5
9,N/A,N/A,N/A,904,913,N/A,52,5
12,N/A,N/A,N/A,892,904,N/A,58,5
6,N/A,N/A,N/A,886,892,N/A,61,2
11,N/A,N/A,N/A,875,886,N/A,65,6
5,N/A,N/A,N/A,870,875,N/A,68,3
5,N/A,N/A,N/A,865,870,N/A,73,2
5,N/A,N/A,N/A,860,865,N/A,78,1
11,N/A,N/A,N/A,849,860,N/A,82,5
6,N/A,N/A,N/A,843,849,N/A,86,3
5,N/A,N/A,N/A,838,843,N/A,90,1
5,N/A,N/A,N/A,833,838,N/A,96,1
7,N/A,N/A,N/A,826,833,N/A,99,4
7,N/A,N/A,N/A,819,826,N/A,104,3
6,N/A,N/A,N/A,813,819,N/A,109,2
18,N/A,N/A,N/A,795,813,N/A,113,6
4,N/A,N/A,N/A,791,795,N/A,116,3
5,N/A,N/A,N/A,786,791,N/A,122,3
13,N/A,N/A,N/A,773,786,N/A,125,6
5,N/A,N/A,N/A,768,773,N/A,129,4
5,N/A,N/A,N/A,1956,1961,N/A,6,1
4,N/A,N/A,N/A,1952,1956,N/A,12,1
10,N/A,N/A,N/A,1942,1952,N/A,16,5
5,N/A,N/A,N/A,1937,1942,N/A,21,4
6,N/A,N/A,N/A,1931,1937,N/A,26,3
4,N/A,N/A,N/A,1927,1931,N/A,30,1
18,N/A,N/A,N/A,1909,1927,N/A,35,6
7,N/A,N/A,N/A,1902,1909,N/A,38,3
4,N/A,N/A,N/A,1898,1902,N/A,43,2
11,N/A,N/A,N/A,1887,1898,N/A,47,6
7,N/A,N/A,N/A,1880,1887,N/A,50,3
10,N/A,N/A,N/A,1870,1880,N/A,53,6
5,N/A,N/A,N/A,1865,1870,N/A,56,3
5,N/A,N/A,N/A,1860,1865,N/A,61,2
4,N/A,N/A,N/A,1856,1860,N/A,67,2
5,N/A,N/A,N/A,1851,1856,N/A,72,1
6,N/A,N/A,N/A,1845,1851,N/A,75,4
4,N/A,N/A,N/A,1841,1845,N/A,78,1
4,N/A,N/A,N/A,1837,1841,N/A,84,1
10,N/A,N/A,N/A,1827,1837,N/A,88,5
5,N/A,N/A,N/A,1822,1827,N/A,91,2
12,N/A,N/A,N/A,1810,1822,N/A,94,5
7,N/A,N/A,N/A,1803,1810,N/A,97,2
4,N/A,N/A,N/A,1799,1803,N/A,102,1
5,N/A,N/A,N/A,1794,1799,N/A,108,1
10,N/A,N/A,N/A,1784,1794,N/A,112,5
6,N/A,N/A,N/A,1778,1784,N/A,115,2
12,N/A,N/A,N/A,1766,1778,N/A,118,5
6,N/A,N/A,N/A,1760,1766,N/A,121,2
4,N/A,N/A,N/A,1756,1760,N/A,127,2
7,N/A,N/A,N/A,1242,1249,N/A,4,4
5,N/A,N/A,N/A,1237,1242,N/A,9,3
4,N/A,N/A,N/A,1233,1237,N/A,15,3
17,N/A,N/A,N/A,1216,1233,N/A,18,6
4,N/A,N/A,N/A,1212,1216,N/A,24,0
12,N/A,N/A,N/A,1200,1212,N/A,30,6
6,N/A,N/A,N/A,1194,1200,N/A,33,3
14,N/A,N/A,N/A,1180,1194,N/A,36,6
7,N/A,N/A,N/A,1173,1180,N/A,40,4
6,N/A,N/A,N/A,1167,1173,N/A,46,4
6,N/A,N/A,N/A,1161,1167,N/A,52,4
4,N/A,N/A,N/A,1157,1161,N/A,55,1
4,N/A,N/A,N/A,1153,1157,N/A,61,1
7,N/A,N/A,N/A,1146,1153,N/A,64,4
7,N/A,N/A,N/A,1139,1146,N/A,70,4
7,N/A,N/A,N/A,1132,1139,N/A,76,4
6,N/A,N/A,N/A,1126,1132,N/A,80,2
6,N/A,N/A,N/A,1120,1126,N/A,86,2
9,N/A,N/A,N/A,1111,1120,N/A,89,5
12,N/A,N/A,N/A,1099,1111,N/A,95,5
8,N/A,N/A,N/A,1091,1099,N/A,100,4
7,N/A,N/A,N/A,1084,1091,N/A,104,2
9,N/A,N/A,N/A,1075,1084,N/A,107,5
8,N/A,N/A,N/A,1067,1075,N/A,112,4
5,N/A,N/A,N/A,1062,1067,N/A,115,1
10,N/A,N/A,N/A,1052,1062,N/A,120,6
11,N/A,N/A,N/A,1041,1052,N/A,125,5
7,N/A,N/A,N/A,1034,1041,N/A,130,4
5,N/A,N/A,N/A,1029,1034,N/A,133,1
5,N/A,N/A,N/A,1024,1029,N/A,136,4
6,N/A,N/A,N/A,785,791,N/A,5,2
17,N/A,N/A,N/A,768,785,N/A,9,6
6,N/A,N/A,N/A,762,768,N/A,12,3
11,N/A,N/A,N/A,751,762,N/A,15,6
5,N/A,N/A,N/A,746,751,N/A,19,4
4,N/A,N/A,N/A,742,746,N/A,24,3
4,N/A,N/A,N/A,738,742,N/A,28,1
5,N/A,N/A,N/A,733,738,N/A,34,1
8,N/A,N/A,N/A,725,733,N/A,37,4
4,N/A,N/A,N/A,721,725,N/A,41,2
18,N/A,N/A,N/A,703,721,N/A,45,6
6,N/A,N/A,N/A,697,703,N/A,49,4
5,N/A,N/A,N/A,692,697,N/A,53,2
18,N/A,N/A,N/A,674,692,N/A,57,6
7,N/A,N/A,N/A,667,674,N/A,60,3
5,N/A,N/A,N/A,662,667,N/A,65,2
15,N/A,N/A,N/A,647,662,N/A,69,6
4,N/A,N/A,N/A,643,647,N/A,72,3
4,N/A,N/A,N/A,639,643,N/A,76,1
13,N/A,N/A,N/A,626,639,N/A,81,6
4,N/A,N/A,N/A,622,626,N/A,84,3
4,N/A,N/A,N/A,618,622,N/A,90,3
6,N/A,N/A,N/A,612,618,N/A,96,3
6,N/A,N/A,N/A,606,612,N/A,102,3
10,N/A,N/A,N/A,596,606,N/A,105,6
6,N/A,N/A,N/A,590,596,N/A,108,3
5,N/A,N/A,N/A,585,590,N/A,112,1
5,N/A,N/A,N/A,580,585,N/A,118,1
15,N/A,N/A,N/A,565,580,N/A,123,6
6,N/A,N/A,N/A,559,565,N/A,127,4
7,N/A,N/A,N/A,1388,1395,N/A,3,3
6,N/A,N/A,N/A,1382,1388,N/A,9,3
11,N/A,N/A,N/A,1371,1382,N/A,12,6
6,N/A,N/A,N/A,1365,1371,N/A,15,3
5,N/A,N/A,N/A,1360,1365,N/A,21,3
6,N/A,N/A,N/A,1354,1360,N/A,26,2
10,N/A,N/A,N/A,1344,1354,N/A,29,5
4,N/A,N/A,N/A,1340,1344,N/A,32,2
17,N/A,N/A,N/A,1323,1340,N/A,36,6
7,N/A,N/A,N/A,1316,1323,N/A,39,3
16,N/A,N/A,N/A,1300,1316,N/A,42,6
9,N/A,N/A,N/A,1291,1300,N/A,47,5
5,N/A,N/A,N/A,1286,1291,N/A,52,4
7,N/A,N/A,N/A,1279,1286,N/A,57,3
4,N/A,N/A,N/A,1275,1279,N/A,63,3
18,N/A,N/A,N/A,1257,1275,N/A,66,6
7,N/A,N/A,N/A,1250,1257,N/A,69,3
6,N/A,N/A,N/A,1244,1250,N/A,74,2
13,N/A,N/A,N/A,1231,1244,N/A,78,6
11,N/A,N/A,N/A,1220,1231,N/A,83,5
6,N/A,N/A,N/A,1214,1220,N/A,88,4
5,N/A,N/A,N/A,1209,1214,N/A,92,2
11,N/A,N/A,N/A,1198,1209,N/A,95,5
6,N/A,N/A,N/A,1192,1198,N/A,100,4
5,N/A,N/A,N/A,1187,1192,N/A,106,4
4,N/A,N/A,N/A,1183,1187,N/A,109,1
12,N/A,N/A,N/A,1171,1183,N/A,113,5
4,N/A,N/A,N/A,1167,1171,N/A,116,2
16,N/A,N/A,N/A,1151,1167,N/A,120,6
5,N/A,N/A,N/A,1146,1151,N/A,123,3
10,N/A,N/A,N/A,1807,1817,N/A,5,5
12,N/A,N/A,N/A,1795,1807,N/A,11,5
10,N/A,N/A,N/A,1785,1795,N/A,17,5
7,N/A,N/A,N/A,1778,1785,N/A,21,3
10,N/A,N/A,N/A,1768,1778,N/A,24,6
12,N/A,N/A,N/A,1756,1768,N/A,29,5
5,N/A,N/A,N/A,1751,1756,N/A,32,2
4,N/A,N/A,N/A,1747,1751,N/A,37,1
5,N/A,N/A,N/A,1742,1747,N/A,43,1
11,N/A,N/A,N/A,1731,1742,N/A,47,5
4,N/A,N/A,N/A,1727,1731,N/A,50,2
15,N/A,N/A,N/A,1712,1727,N/A,54,6
8,N/A,N/A,N/A,1704,1712,N/A,58,4
7,N/A,N/A,N/A,1697,1704,N/A,62,2
4,N/A,N/A,N/A,1693,1697,N/A,67,1
5,N/A,N/A,N/A,1688,1693,N/A,70,4
5,N/A,N/A,N/A,1683,1688,N/A,75,3
5,N/A,N/A,N/A,1678,1683,N/A,80,2
6,N/A,N/A,N/A,1672,1678,N/A,86,2
7,N/A,N/A,N/A,1665,1672,N/A,92,2
12,N/A,N/A,N/A,1653,1665,N/A,95,5
8,N/A,N/A,N/A,1645,1653,N/A,100,4
5,N/A,N/A,N/A,1640,1645,N/A,105,3
14,N/A,N/A,N/A,1626,1640,N/A,108,6
4,N/A,N/A,N/A,1622,1626,N/A,114,0
4,N/A,N/A,N/A,1618,1622,N/A,117,3
4,N/A,N/A,N/A,1614,1618,N/A,122,2
12,N/A,N/A,N/A,1602,1614,N/A,125,5
4,N/A,N/A,N/A,1598,1602,N/A,128,2
7,N/A,N/A,N/A,1591,1598,N/A,134,2
6,N/A,N/A,N/A,951,957,N/A,3,2
6,N/A,N/A,N/A,945,951,N/A,9,2
4,N/A,N/A,N/A,941,945,N/A,14,1
14,N/A,N/A,N/A,927,941,N/A,19,6
8,N/A,N/A,N/A,919,927,N/A,23,4
5,N/A,N/A,N/A,914,919,N/A,28,3
7,N/A,N/A,N/A,907,914,N/A,33,2
10,N/A,N/A,N/A,897,907,N/A,36,5
10,N/A,N/A,N/A,887,897,N/A,42,5
6,N/A,N/A,N/A,881,887,N/A,46,3
4,N/A,N/A,N/A,877,881,N/A,52,3
5,N/A,N/A,N/A,872,877,N/A,57,2
4,N/A,N/A,N/A,868,872,N/A,62,1
4,N/A,N/A,N/A,864,868,N/A,68,1
10,N/A,N/A,N/A,854,864,N/A,72,5
11,N/A,N/A,N/A,843,854,N/A,78,5
7,N/A,N/A,N/A,836,843,N/A,83,4
4,N/A,N/A,N/A,832,836,N/A,86,1
14,N/A,N/A,N/A,818,832,N/A,91,6
11,N/A,N/A,N/A,807,818,N/A,96,5
5,N/A,N/A,N/A,802,807,N/A,101,4
7,N/A,N/A,N/A,795,802,N/A,105,2
12,N/A,N/A,N/A,783,795,N/A,108,5
7,N/A,N/A,N/A,776,783,N/A,111,2
16,N/A,N/A,N/A,760,776,N/A,115,6
10,N/A,N/A,N/A,750,760,N/A,120,5
7,N/A,N/A,N/A,743,750,N/A,125,4
7,N/A,N/A,N/A,736,743,N/A,130,3
6,N/A,N/A,N/A,730,736,N/A,135,2
12,N/A,N/A,N/A,718,730,N/A,138,5
4,N/A,N/A,N/A,473,477,N/A,5,1
15,N/A,N/A,N/A,458,473,N/A,10,6
12,N/A,N/A,N/A,446,458,N/A,15,5
8,N/A,N/A,N/A,438,446,N/A,20,4
4,N/A,N/A,N/A,434,438,N/A,24,2
4,N/A,N/A,N/A,430,434,N/A,30,2
11,N/A,N/A,N/A,419,430,N/A,33,5
9,N/A,N/A,N/A,410,419,N/A,39,5
10,N/A,N/A,N/A,400,410,N/A,45,5
5,N/A,N/A,N/A,395,400,N/A,48,2
5,N/A,N/A,N/A,390,395,N/A,53,1
19,N/A,N/A,N/A,371,390,N/A,58,6
7,N/A,N/A,N/A,364,371,N/A,62,4
5,N/A,N/A,N/A,359,364,N/A,65,1
14,N/A,N/A,N/A,345,359,N/A,70,6
8,N/A,N/A,N/A,337,345,N/A,74,4
5,N/A,N/A,N/A,332,337,N/A,80,4
6,N/A,N/A,N/A,326,332,N/A,86,4
4,N/A,N/A,N/A,322,326,N/A,89,1
4,N/A,N/A,N/A,318,322,N/A,95,1
18,N/A,N/A,N/A,300,318,N/A,100,6
9,N/A,N/A,N/A,291,300,N/A,105,5
12,N/A,N/A,N/A,279,291,N/A,111,5
6,N/A,N/A,N/A,273,279,N/A,116,4
4,N/A,N/A,N/A,269,273,N/A,120,2
10,N/A,N/A,N/A,259,269,N/A,123,5
6,N/A,N/A,N/A,253,259,N/A,126,2
7,N/A,N/A,N/A,246,253,N/A,132,2
11,N/A,N/A,N/A,235,246,N/A,135,5
5,N/A,N/A,N/A,230,235,N/A,139,3
5,N/A,N/A,N/A,1893,1898,N/A,5,2
16,N/A,N/A,N/A,1877,1893,N/A,9,6
9,N/A,N/A,N/A,1868,1877,N/A,14,5
5,N/A,N/A,N/A,1863,1868,N/A,19,4
5,N/A,N/A,N/A,1858,1863,N/A,25,4
6,N/A,N/A,N/A,1852,1858,N/A,30,3
4,N/A,N/A,N/A,1848,1852,N/A,34,1
11,N/A,N/A,N/A,1837,1848,N/A,38,5
7,N/A,N/A,N/A,1830,1837,N/A,41,2
5,N/A,N/A,N/A,1825,1830,N/A,47,2
5,N/A,N/A,N/A,1820,1825,N/A,52,1
4,N/A,N/A,N/A,1816,1820,N/A,58,1
14,N/A,N/A,N/A,1802,1816,N/A,63,6
10,N/A,N/A,N/A,1792,1802,N/A,68,5
6,N/A,N/A,N/A,1786,1792,N/A,72,3
13,N/A,N/A,N/A,1773,1786,N/A,75,6
11,N/A,N/A,N/A,1762,1773,N/A,80,5
4,N/A,N/A,N/A,1758,1762,N/A,83,2
11,N/A,N/A,N/A,1747,1758,N/A,87,6
5,N/A,N/A,N/A,1742,1747,N/A,93,0
11,N/A,N/A,N/A,1731,1742,N/A,99,6
5,N/A,N/A,N/A,1726,1731,N/A,102,3
5,N/A,N/A,N/A,1721,1726,N/A,108,3
5,N/A,N/A,N/A,1716,1721,N/A,114,3
6,N/A,N/A,N/A,1710,1716,N/A,119,2
12,N/A,N/A,N/A,1698,1710,N/A,122,5
9,N/A,N/A,N/A,1689,1698,N/A,128,5
4,N/A,N/A,N/A,1685,1689,N/A,132,3
10,N/A,N/A,N/A,1675,1685,N/A,135,6
5,N/A,N/A,N/A,1670,1675,N/A,141,0
4,N/A,N/A,N/A,1094,1098,N/A,4,1
6,N/A,N/A,N/A,1088,1094,N/A,7,4
4,N/A,N/A,N/A,1084,1088,N/A,11,2
12,N/A,N/A,N/A,1072,1084,N/A,14,5
6,N/A,N/A,N/A,1066,1072,N/A,19,4
5,N/A,N/A,N/A,1061,1066,N/A,24,3
5,N/A,N/A,N/A,1056,1061,N/A,28,1
5,N/A,N/A,N/A,1051,1056,N/A,31,4
6,N/A,N/A,N/A,1045,1051,N/A,35,2
7,N/A,N/A,N/A,1038,1045,N/A,41,2
13,N/A,N/A,N/A,1025,1038,N/A,45,6
7,N/A,N/A,N/A,1018,1025,N/A,48,3
7,N/A,N/A,N/A,1011,1018,N/A,54,3
7,N/A,N/A,N/A,1004,1011,N/A,59,2
10,N/A,N/A,N/A,994,1004,N/A,62,5
11,N/A,N/A,N/A,983,994,N/A,68,5
5,N/A,N/A,N/A,978,983,N/A,71,2
5,N/A,N/A,N/A,973,978,N/A,76,1
18,N/A,N/A,N/A,955,973,N/A,81,6
5,N/A,N/A,N/A,950,955,N/A,87,0
7,N/A,N/A,N/A,943,950,N/A,90,3
6,N/A,N/A,N/A,937,943,N/A,95,2
6,N/A,N/A,N/A,931,937,N/A,101,2
4,N/A,N/A,N/A,927,931,N/A,106,1
12,N/A,N/A,N/A,915,927,N/A,110,5
12,N/A,N/A,N/A,903,915,N/A,116,5
7,N/A,N/A,N/A,896,903,N/A,119,2
17,N/A,N/A,N/A,879,896,N/A,123,6
7,N/A,N/A,N/A,872,879,N/A,126,3
13,N/A,N/A,N/A,859,872,N/A,129,6
5,N/A,N/A,N/A,1833,1838,N/A,3,1
7,N/A,N/A,N/A,1826,1833,N/A,6,4
5,N/A,N/A,N/A,1821,1826,N/A,11,3
6,N/A,N/A,N/A,1815,1821,N/A,16,2
5,N/A,N/A,N/A,1810,1815,N/A,21,1
9,N/A,N/A,N/A,1801,1810,N/A,25,5
6,N/A,N/A,N/A,1795,1801,N/A,29,3
5,N/A,N/A,N/A,1790,1795,N/A,35,3
7,N/A,N/A,N/A,1783,1790,N/A,41,3
4,N/A,N/A,N/A,1779,1783,N/A,45,1
9,N/A,N/A,N/A,1770,1779,N/A,49,5
5,N/A,N/A,N/A,1765,1770,N/A,52,2
4,N/A,N/A,N/A,1761,1765,N/A,58,2
4,N/A,N/A,N/A,1757,1761,N/A,64,2
5,N/A,N/A,N/A,1752,1757,N/A,69,1
6,N/A,N/A,N/A,1746,1752,N/A,72,4
4,N/A,N/A,N/A,1742,1746,N/A,75,1
14,N/A,N/A,N/A,1728,1742,N/A,80,6
5,N/A,N/A,N/A,1723,1728,N/A,86,0
12,N/A,N/A,N/A,1711,1723,N/A,91,5
5,N/A,N/A,N/A,1706,1711,N/A,94,2
7,N/A,N/A,N/A,1699,1706,N/A,100,2
5,N/A,N/A,N/A,1694,1699,N/A,106,2
11,N/A,N/A,N/A,1683,1694,N/A,109,5
5,N/A,N/A,N/A,1678,1683,N/A,112,2
6,N/A,N/A,N/A,1672,1678,N/A,118,2
12,N/A,N/A,N/A,1660,1672,N/A,121,5
6,N/A,N/A,N/A,1654,1660,N/A,125,3
6,N/A,N/A,N/A,1648,1654,N/A,130,2
7,N/A,N/A,N/A,1641,1648,N/A,136,2
12,N/A,N/A,N/A,1118,1130,N/A,3,5
6,N/A,N/A,N/A,1112,1118,N/A,8,4
5,N/A,N/A,N/A,1107,1112,N/A,11,1
9,N/A,N/A,N/A,1098,1107,N/A,15,5
9,N/A,N/A,N/A,1089,1098,N/A,21,5
5,N/A,N/A,N/A,1084,1089,N/A,26,4
6,N/A,N/A,N/A,1078,1084,N/A,32,4
5,N/A,N/A,N/A,1073,1078,N/A,36,2
12,N/A,N/A,N/A,1061,1073,N/A,39,5
7,N/A,N/A,N/A,1054,1061,N/A,42,2
18,N/A,N/A,N/A,1036,1054,N/A,46,6
7,N/A,N/A,N/A,1029,1036,N/A,50,4
4,N/A,N/A,N/A,1025,1029,N/A,53,1
5,N/A,N/A,N/A,1020,1025,N/A,59,1
5,N/A,N/A,N/A,1015,1020,N/A,65,1
9,N/A,N/A,N/A,1006,1015,N/A,69,5
7,N/A,N/A,N/A,999,1006,N/A,74,4
5,N/A,N/A,N/A,994,999,N/A,80,4
5,N/A,N/A,N/A,989,994,N/A,84,2
5,N/A,N/A,N/A,984,989,N/A,89,1
17,N/A,N/A,N/A,967,984,N/A,94,6
4,N/A,N/A,N/A,963,967,N/A,97,3
19,N/A,N/A,N/A,944,963,N/A,100,6
7,N/A,N/A,N/A,937,944,N/A,103,3
6,N/A,N/A,N/A,931,937,N/A,108,2
4,N/A,N/A,N/A,927,931,N/A,113,1
5,N/A,N/A,N/A,922,927,N/A,119,1
8,N/A,N/A,N/A,914,922,N/A,122,4
5,N/A,N/A,N/A,909,914,N/A,127,3
4,N/A,N/A,N/A,905,909,N/A,131,1
4,N/A,N/A,N/A,484,488,N/A,4,3
4,N/A,N/A,N/A,480,484,N/A,8,1
8,N/A,N/A,N/A,472,480,N/A,11,4
8,N/A,N/A,N/A,464,472,N/A,17,4
4,N/A,N/A,N/A,460,464,N/A,21,2
9,N/A,N/A,N/A,451,460,N/A,24,5
11,N/A,N/A,N/A,440,451,N/A,30,5
7,N/A,N/A,N/A,433,440,N/A,33,2
4,N/A,N/A,N/A,429,433,N/A,38,1
8,N/A,N/A,N/A,421,429,N/A,41,4
5,N/A,N/A,N/A,416,421,N/A,46,3
4,N/A,N/A,N/A,412,416,N/A,50,1
11,N/A,N/A,N/A,401,412,N/A,54,5
11,N/A,N/A,N/A,390,401,N/A,60,5
6,N/A,N/A,N/A,384,390,N/A,63,2
14,N/A,N/A,N/A,370,384,N/A,67,6
11,N/A,N/A,N/A,359,370,N/A,72,5
5,N/A,N/A,N/A,354,359,N/A,76,3
4,N/A,N/A,N/A,350,354,N/A,80,1
5,N/A,N/A,N/A,345,350,N/A,83,4
4,N/A,N/A,N/A,341,345,N/A,87,2
4,N/A,N/A,N/A,337,341,N/A,92,1
7,N/A,N/A,N/A,330,337,N/A,95,4
6,N/A,N/A,N/A,324,330,N/A,101,4
5,N/A,N/A,N/A,319,324,N/A,104,1
5,N/A,N/A,N/A,314,319,N/A,110,1
11,N/A,N/A,N/A,303,314,N/A,114,5
6,N/A,N/A,N/A,297,303,N/A,117,2
7,N/A,N/A,N/A,290,297,N/A,123,2
4,N/A,N/A,N/A,286,290,N/A,128,1
11,N/A,N/A,N/A,637,648,N/A,4,5
5,N/A,N/A,N/A,632,637,N/A,8,3
4,N/A,N/A,N/A,628,632,N/A,14,3
4,N/A,N/A,N/A,624,628,N/A,20,3
4,N/A,N/A,N/A,620,624,N/A,24,1
5,N/A,N/A,N/A,615,620,N/A,27,4
4,N/A,N/A,N/A,611,615,N/A,30,1
12,N/A,N/A,N/A,599,611,N/A,34,5
11,N/A,N/A,N/A,588,599,N/A,40,5
7,N/A,N/A,N/A,581,588,N/A,45,4
6,N/A,N/A,N/A,575,581,N/A,49,2
19,N/A,N/A,N/A,556,575,N/A,53,6
8,N/A,N/A,N/A,548,556,N/A,57,4
5,N/A,N/A,N/A,543,548,N/A,62,3
6,N/A,N/A,N/A,537,543,N/A,68,3
4,N/A,N/A,N/A,533,537,N/A,73,2
5,N/A,N/A,N/A,528,533,N/A,78,1
14,N/A,N/A,N/A,514,528,N/A,83,6
4,N/A,N/A,N/A,510,514,N/A,89,0
19,N/A,N/A,N/A,491,510,N/A,95,6
5,N/A,N/A,N/A,486,491,N/A,101,0
5,N/A,N/A,N/A,481,486,N/A,104,3
7,N/A,N/A,N/A,474,481,N/A,109,2
4,N/A,N/A,N/A,470,474,N/A,114,1
12,N/A,N/A,N/A,458,470,N/A,119,6
5,N/A,N/A,N/A,453,458,N/A,122,3
4,N/A,N/A,N/A,449,453,N/A,128,3
15,N/A,N/A,N/A,434,449,N/A,131,6
4,N/A,N/A,N/A,430,434,N/A,137,0
11,N/A,N/A,N/A,419,430,N/A,142,5
17,N/A,N/A,N/A,990,1007,N/A,3,6
8,N/A,N/A,N/A,982,990,N/A,7,4
4,N/A,N/A,N/A,978,982,N/A,11,2
10,N/A,N/A,N/A,968,978,N/A,14,5
5,N/A,N/A,N/A,963,968,N/A,18,3
7,N/A,N/A,N/A,956,963,N/A,23,2
17,N/A,N/A,N/A,939,956,N/A,27,6
5,N/A,N/A,N/A,934,939,N/A,33,0
5,N/A,N/A,N/A,929,934,N/A,37,4
4,N/A,N/A,N/A,925,929,N/A,40,1
7,N/A,N/A,N/A,918,925,N/A,43,4
6,N/A,N/A,N/A,912,918,N/A,49,4
4,N/A,N/A,N/A,908,912,N/A,52,1
11,N/A,N/A,N/A,897,908,N/A,57,6
12,N/A,N/A,N/A,885,897,N/A,62,5
5,N/A,N/A,N/A,880,885,N/A,66,3
4,N/A,N/A,N/A,876,880,N/A,70,1
13,N/A,N/A,N/A,863,876,N/A,75,6
10,N/A,N/A,N/A,853,863,N/A,80,5
11,N/A,N/A,N/A,842,853,N/A,86,5
4,N/A,N/A,N/A,838,842,N/A,89,2
9,N/A,N/A,N/A,829,838,N/A,92,5
6,N/A,N/A,N/A,823,829,N/A,96,3
11,N/A,N/A,N/A,812,823,N/A,99,6
5,N/A,N/A,N/A,807,812,N/A,102,3
4,N/A,N/A,N/A,803,807,N/A,106,1
5,N/A,N/A,N/A,798,803,N/A,112,1
19,N/A,N/A,N/A,779,798,N/A,117,6
4,N/A,N/A,N/A,775,779,N/A,120,3
5,N/A,N/A,N/A,770,775,N/A,124,1
7,N/A,N/A,N/A,1700,1707,N/A,6,3
4,N/A,N/A,N/A,1696,1700,N/A,11,2
12,N/A,N/A,N/A,1684,1696,N/A,15,6
10,N/A,N/A,N/A,1674,1684,N/A,20,5
5,N/A,N/A,N/A,1669,1674,N/A,23,2
4,N/A,N/A,N/A,1665,1669,N/A,28,1
5,N/A,N/A,N/A,1660,1665,N/A,31,4
6,N/A,N/A,N/A,1654,1660,N/A,35,2
4,N/A,N/A,N/A,1650,1654,N/A,40,1
6,N/A,N/A,N/A,1644,1650,N/A,43,4
5,N/A,N/A,N/A,1639,1644,N/A,47,2
5,N/A,N/A,N/A,1634,1639,N/A,52,1
4,N/A,N/A,N/A,1630,1634,N/A,58,1
11,N/A,N/A,N/A,1619,1630,N/A,62,5
12,N/A,N/A,N/A,1607,1619,N/A,68,5
5,N/A,N/A,N/A,1602,1607,N/A,71,2
4,N/A,N/A,N/A,1598,1602,N/A,76,1
4,N/A,N/A,N/A,1594,1598,N/A,82,1
11,N/A,N/A,N/A,1583,1594,N/A,86,5
10,N/A,N/A,N/A,1573,1583,N/A,92,5
6,N/A,N/A,N/A,1567,1573,N/A,95,2
11,N/A,N/A,N/A,1556,1567,N/A,99,6
5,N/A,N/A,N/A,1551,1556,N/A,105,0
7,N/A,N/A,N/A,1544,1551,N/A,109,4
5,N/A,N/A,N/A,1539,1544,N/A,112,1
17,N/A,N/A,N/A,1522,1539,N/A,117,6
12,N/A,N/A,N/A,1510,1522,N/A,122,5
4,N/A,N/A,N/A,1506,1510,N/A,125,2
5,N/A,N/A,N/A,1501,1506,N/A,130,1
12,N/A,N/A,N/A,1489,1501,N/A,134,5
5,N/A,N/A,N/A,1342,1347,N/A,4,1
19,N/A,N/A,N/A,1323,1342,N/A,9,6
5,N/A,N/A,N/A,1318,1323,N/A,15,0
7,N/A,N/A,N/A,1311,1318,N/A,18,3
4,N/A,N/A,N/A,1307,1311,N/A,23,2
12,N/A,N/A,N/A,1295,1307,N/A,26,5
11,N/A,N/A,N/A,1284,1295,N/A,32,5
8,N/A,N/A,N/A,1276,1284,N/A,37,4
5,N/A,N/A,N/A,1271,1276,N/A,40,1
10,N/A,N/A,N/A,1261,1271,N/A,45,6
8,N/A,N/A,N/A,1253,1261,N/A,49,4
5,N/A,N/A,N/A,1248,1253,N/A,55,4
8,N/A,N/A,N/A,1240,1248,N/A,61,4
4,N/A,N/A,N/A,1236,1240,N/A,66,3
7,N/A,N/A,N/A,1229,1236,N/A,71,2
7,N/A,N/A,N/A,1222,1229,N/A,77,2
13,N/A,N/A,N/A,1209,1222,N/A,81,6
12,N/A,N/A,N/A,1197,1209,N/A,86,5
7,N/A,N/A,N/A,1190,1197,N/A,90,3
6,N/A,N/A,N/A,1184,1190,N/A,95,2
5,N/A,N/A,N/A,1179,1184,N/A,101,2
9,N/A,N/A,N/A,1170,1179,N/A,104,5
6,N/A,N/A,N/A,1164,1170,N/A,107,2
16,N/A,N/A,N/A,1148,1164,N/A,111,6
12,N/A,N/A,N/A,1136,1148,N/A,116,5
8,N/A,N/A,N/A,1128,1136,N/A,121,4
4,N/A,N/A,N/A,1124,1128,N/A,126,3
5,N/A,N/A,N/A,1119,1124,N/A,130,1
5,N/A,N/A,N/A,1114,1119,N/A,136,1
6,N/A,N/A,N/A,1108,1114,N/A,139,4
10,N/A,N/A,N/A,367,377,N/A,5,6
9,N/A,N/A,N/A,358,367,N/A,10,5
4,N/A,N/A,N/A,354,358,N/A,13,2
10,N/A,N/A,N/A,344,354,N/A,16,5
11,N/A,N/A,N/A,333,344,N/A,22,5
8,N/A,N/A,N/A,325,333,N/A,27,4
4,N/A,N/A,N/A,321,325,N/A,31,2
9,N/A,N/A,N/A,312,321,N/A,34,5
7,N/A,N/A,N/A,305,312,N/A,37,2
7,N/A,N/A,N/A,298,305,N/A,43,2
4,N/A,N/A,N/A,294,298,N/A,48,1
5,N/A,N/A,N/A,289,294,N/A,51,4
4,N/A,N/A,N/A,285,289,N/A,55,2
5,N/A,N/A,N/A,280,285,N/A,60,1
7,N/A,N/A,N/A,273,280,N/A,63,4
7,N/A,N/A,N/A,266,273,N/A,69,4
5,N/A,N/A,N/A,261,266,N/A,74,3
12,N/A,N/A,N/A,249,261,N/A,77,6
7,N/A,N/A,N/A,242,249,N/A,80,3
16,N/A,N/A,N/A,226,242,N/A,83,6
7,N/A,N/A,N/A,219,226,N/A,86,3
7,N/A,N/A,N/A,212,219,N/A,91,2
10,N/A,N/A,N/A,202,212,N/A,94,5
4,N/A,N/A,N/A,198,202,N/A,97,2
10,N/A,N/A,N/A,188,198,N/A,101,6
11,N/A,N/A,N/A,177,188,N/A,106,5
12,N/A,N/A,N/A,165,177,N/A,112,5
6,N/A,N/A,N/A,159,165,N/A,115,2
19,N/A,N/A,N/A,140,159,N/A,119,6
4,N/A,N/A,N/A,136,140,N/A,122,3
7,N/A,N/A,N/A,862,869,N/A,6,3
6,N/A,N/A,N/A,856,862,N/A,12,3
5,N/A,N/A,N/A,851,856,N/A,16,1
10,N/A,N/A,N/A,841,851,N/A,20,5
6,N/A,N/A,N/A,835,841,N/A,24,3
5,N/A,N/A,N/A,830,835,N/A,30,3
6,N/A,N/A,N/A,824,830,N/A,36,3
6,N/A,N/A,N/A,818,824,N/A,42,3
7,N/A,N/A,N/A,811,818,N/A,47,2
10,N/A,N/A,N/A,801,811,N/A,51,6
7,N/A,N/A,N/A,794,801,N/A,55,4
5,N/A,N/A,N/A,789,794,N/A,58,1
13,N/A,N/A,N/A,776,789,N/A,63,6
7,N/A,N/A,N/A,769,776,N/A,67,4
6,N/A,N/A,N/A,763,769,N/A,73,4
7,N/A,N/A,N/A,756,763,N/A,79,4
6,N/A,N/A,N/A,750,756,N/A,83,2
5,N/A,N/A,N/A,745,750,N/A,88,1
11,N/A,N/A,N/A,734,745,N/A,93,6
5,N/A,N/A,N/A,729,734,N/A,99,0
14,N/A,N/A,N/A,715,729,N/A,105,6
5,N/A,N/A,N/A,710,715,N/A,108,3
15,N/A,N/A,N/A,695,710,N/A,111,6
5,N/A,N/A,N/A,690,695,N/A,117,0
12,N/A,N/A,N/A,678,690,N/A,122,5
12,N/A,N/A,N/A,666,678,N/A,128,5
7,N/A,N/A,N/A,659,666,N/A,131,2
4,N/A,N/A,N/A,655,659,N/A,137,2
6,N/A,N/A,N/A,649,655,N/A,143,2
5,N/A,N/A,N/A,644,649,N/A,149,2
15,N/A,N/A,N/A,1105,1120,N/A,3,6
9,N/A,N/A,N/A,1096,1105,N/A,8,5
7,N/A,N/A,N/A,1089,1096,N/A,12,3
7,N/A,N/A,N/A,1082,1089,N/A,18,3
5,N/A,N/A,N/A,1077,1082,N/A,23,2
4,N/A,N/A,N/A,1073,1077,N/A,29,2
11,N/A,N/A,N/A,1062,1073,N/A,32,5
8,N/A,N/A,N/A,1054,1062,N/A,37,4
5,N/A,N/A,N/A,1049,1054,N/A,43,4
7,N/A,N/A,N/A,1042,1049,N/A,47,2
4,N/A,N/A,N/A,1038,1042,N/A,52,1
12,N/A,N/A,N/A,1026,1038,N/A,56,5
11,N/A,N/A,N/A,1015,1026,N/A,62,5
6,N/A,N/A,N/A,1009,1015,N/A,66,3
5,N/A,N/A,N/A,1004,1009,N/A,72,3
4,N/A,N/A,N/A,1000,1004,N/A,76,1
15,N/A,N/A,N/A,985,1000,N/A,81,6
4,N/A,N/A,N/A,981,985,N/A,87,0
8,N/A,N/A,N/A,973,981,N/A,91,4
5,N/A,N/A,N/A,968,973,N/A,95,2
9,N/A,N/A,N/A,959,968,N/A,98,5
6,N/A,N/A,N/A,953,959,N/A,101,2
11,N/A,N/A,N/A,942,953,N/A,104,5
5,N/A,N/A,N/A,937,942,N/A,108,3
7,N/A,N/A,N/A,930,937,N/A,113,2
4,N/A,N/A,N/A,926,930,N/A,119,2
10,N/A,N/A,N/A,916,926,N/A,123,6
6,N/A,N/A,N/A,910,916,N/A,126,3
4,N/A,N/A,N/A,906,910,N/A,132,3
18,N/A,N/A,N/A,888,906,N/A,135,6
4,N/A,N/A,N/A,899,903,N/A,6,1
5,N/A,N/A,N/A,894,899,N/A,9,4
5,N/A,N/A,N/A,889,894,N/A,12,1
13,N/A,N/A,N/A,876,889,N/A,17,6
6,N/A,N/A,N/A,870,876,N/A,21,4
7,N/A,N/A,N/A,863,870,N/A,27,4
7,N/A,N/A,N/A,856,863,N/A,33,4
5,N/A,N/A,N/A,851,856,N/A,36,1
4,N/A,N/A,N/A,847,851,N/A,42,1
8,N/A,N/A,N/A,839,847,N/A,45,4
5,N/A,N/A,N/A,834,839,N/A,48,1
5,N/A,N/A,N/A,829,834,N/A,54,1
10,N/A,N/A,N/A,819,829,N/A,59,6
9,N/A,N/A,N/A,810,819,N/A,64,5
6,N/A,N/A,N/A,804,810,N/A,68,3
7,N/A,N/A,N/A,797,804,N/A,73,2
10,N/A,N/A,N/A,787,797,N/A,76,5
5,N/A,N/A,N/A,782,787,N/A,79,2
18,N/A,N/A,N/A,764,782,N/A,83,6
11,N/A,N/A,N/A,753,764,N/A,88,5
4,N/A,N/A,N/A,749,753,N/A,92,3
5,N/A,N/A,N/A,744,749,N/A,96,1
13,N/A,N/A,N/A,731,744,N/A,101,6
7,N/A,N/A,N/A,724,731,N/A,104,3
16,N/A,N/A,N/A,708,724,N/A,107,6
4,N/A,N/A,N/A,704,708,N/A,110,3
10,N/A,N/A,N/A,694,704,N/A,113,6
12,N/A,N/A,N/A,682,694,N/A,118,5
7,N/A,N/A,N/A,675,682,N/A,121,2
6,N/A,N/A,N/A,669,675,N/A,127,2
8,N/A,N/A,N/A,1454,1462,N/A,5,4
7,N/A,N/A,N/A,1447,1454,N/A,10,3
4,N/A,N/A,N/A,1443,1447,N/A,15,2
5,N/A,N/A,N/A,1438,1443,N/A,20,1
11,N/A,N/A,N/A,1427,1438,N/A,24,5
6,N/A,N/A,N/A,1421,1427,N/A,28,3
4,N/A,N/A,N/A,1417,1421,N/A,32,1
10,N/A,N/A,N/A,1407,1417,N/A,36,5
8,N/A,N/A,N/A,1399,1407,N/A,41,4
6,N/A,N/A,N/A,1393,1399,N/A,47,4
7,N/A,N/A,N/A,1386,1393,N/A,53,4
7,N/A,N/A,N/A,1379,1386,N/A,57,2
6,N/A,N/A,N/A,1373,1379,N/A,63,2
4,N/A,N/A,N/A,1369,1373,N/A,68,1
10,N/A,N/A,N/A,1359,1369,N/A,72,5
9,N/A,N/A,N/A,1350,1359,N/A,78,5
9,N/A,N/A,N/A,1341,1350,N/A,84,5
7,N/A,N/A,N/A,1334,1341,N/A,88,3
11,N/A,N/A,N/A,1323,1334,N/A,91,6
7,N/A,N/A,N/A,1316,1323,N/A,94,3
14,N/A,N/A,N/A,1302,1316,N/A,97,6
4,N/A,N/A,N/A,1298,1302,N/A,103,0
5,N/A,N/A,N/A,1293,1298,N/A,106,3
7,N/A,N/A,N/A,1286,1293,N/A,112,3
5,N/A,N/A,N/A,1281,1286,N/A,117,2
5,N/A,N/A,N/A,1276,1281,N/A,122,1
5,N/A,N/A,N/A,1271,1276,N/A,128,1
15,N/A,N/A,N/A,1256,1271,N/A,133,6
7,N/A,N/A,N/A,1249,1256,N/A,137,4
4,N/A,N/A,N/A,1245,1249,N/A,140,1
7,N/A,N/A,N/A,1200,1207,N/A,5,4
4,N/A,N/A,N/A,1196,1200,N/A,8,1
12,N/A,N/A,N/A,1184,1196,N/A,12,5
6,N/A,N/A,N/A,1178,1184,N/A,15,2
16,N/A,N/A,N/A,1162,1178,N/A,19,6
12,N/A,N/A,N/A,1150,1162,N/A,24,5
10,N/A,N/A,N/A,1140,1150,N/A,30,5
12,N/A,N/A,N/A,1128,1140,N/A,36,5
7,N/A,N/A,N/A,1121,1128,N/A,39,2
10,N/A,N/A,N/A,1111,1121,N/A,43,6
5,N/A,N/A,N/A,1106,1111,N/A,46,3
12,N/A,N/A,N/A,1094,1106,N/A,49,6
5,N/A,N/A,N/A,1089,1094,N/A,55,0
9,N/A,N/A,N/A,1080,1089,N/A,60,5
12,N/A,N/A,N/A,1068,1080,N/A,66,5
6,N/A,N/A,N/A,1062,1068,N/A,71,4
4,N/A,N/A,N/A,1058,1062,N/A,74,1
5,N/A,N/A,N/A,1053,1058,N/A,80,1
11,N/A,N/A,N/A,1042,1053,N/A,84,5
5,N/A,N/A,N/A,1037,1042,N/A,88,3
7,N/A,N/A,N/A,1030,1037,N/A,93,2
7,N/A,N/A,N/A,1023,1030,N/A,99,2
10,N/A,N/A,N/A,1013,1023,N/A,102,5
7,N/A,N/A,N/A,1006,1013,N/A,106,3
4,N/A,N/A,N/A,1002,1006,N/A,110,1
5,N/A,N/A,N/A,997,1002,N/A,113,4
5,N/A,N/A,N/A,992,997,N/A,118,3
6,N/A,N/A,N/A,986,992,N/A,124,3
6,N/A,N/A,N/A,980,986,N/A,130,3
19,N/A,N/A,N/A,961,980,N/A,133,6
5,N/A,N/A,N/A,1540,1545,N/A,3,2
16,N/A,N/A,N/A,1524,1540,N/A,7,6
6,N/A,N/A,N/A,1518,1524,N/A,11,4
5,N/A,N/A,N/A,1513,1518,N/A,17,4
7,N/A,N/A,N/A,1506,1513,N/A,23,4
6,N/A,N/A,N/A,1500,1506,N/A,29,4
7,N/A,N/A,N/A,1493,1500,N/A,34,3
5,N/A,N/A,N/A,1488,1493,N/A,38,1
4,N/A,N/A,N/A,1484,1488,N/A,44,1
7,N/A,N/A,N/A,1477,1484,N/A,47,4
4,N/A,N/A,N/A,1473,1477,N/A,50,1
9,N/A,N/A,N/A,1464,1473,N/A,54,5
5,N/A,N/A,N/A,1459,1464,N/A,57,2
13,N/A,N/A,N/A,1446,1459,N/A,61,6
8,N/A,N/A,N/A,1438,1446,N/A,65,4
7,N/A,N/A,N/A,1431,1438,N/A,70,3
5,N/A,N/A,N/A,1426,1431,N/A,74,1
5,N/A,N/A,N/A,1421,1426,N/A,77,4
6,N/A,N/A,N/A,1415,1421,N/A,81,2
4,N/A,N/A,N/A,1411,1415,N/A,87,2
17,N/A,N/A,N/A,1394,1411,N/A,91,6
8,N/A,N/A,N/A,1386,1394,N/A,95,4
8,N/A,N/A,N/A,1378,1386,N/A,101,4
7,N/A,N/A,N/A,1371,1378,N/A,106,3
7,N/A,N/A,N/A,1364,1371,N/A,111,2
19,N/A,N/A,N/A,1345,1364,N/A,115,6
7,N/A,N/A,N/A,1338,1345,N/A,119,4
5,N/A,N/A,N/A,1333,1338,N/A,123,2
7,N/A,N/A,N/A,1326,1333,N/A,129,2
11,N/A,N/A,N/A,1315,1326,N/A,132,5
5,N/A,N/A,N/A,1199,1204,N/A,3,1
4,N/A,N/A,N/A,1195,1199,N/A,9,1
5,N/A,N/A,N/A,1190,1195,N/A,15,1
11,N/A,N/A,N/A,1179,1190,N/A,19,5
6,N/A,N/A,N/A,1173,1179,N/A,24,4
4,N/A,N/A,N/A,1169,1173,N/A,29,3
5,N/A,N/A,N/A,1164,1169,N/A,33,1
4,N/A,N/A,N/A,1160,1164,N/A,39,1
16,N/A,N/A,N/A,1144,1160,N/A,44,6
5,N/A,N/A,N/A,1139,1144,N/A,48,4
5,N/A,N/A,N/A,1134,1139,N/A,51,1
16,N/A,N/A,N/A,1118,1134,N/A,56,6
7,N/A,N/A,N/A,1111,1118,N/A,59,3
5,N/A,N/A,N/A,1106,1111,N/A,64,2
11,N/A,N/A,N/A,1095,1106,N/A,67,5
11,N/A,N/A,N/A,1084,1095,N/A,73,5
5,N/A,N/A,N/A,1079,1084,N/A,76,2
4,N/A,N/A,N/A,1075,1079,N/A,81,1
19,N/A,N/A,N/A,1056,1075,N/A,86,6
9,N/A,N/A,N/A,1047,1056,N/A,91,5
9,N/A,N/A,N/A,1038,1047,N/A,97,5
10,N/A,N/A,N/A,1028,1038,N/A,103,5
7,N/A,N/A,N/A,1021,1028,N/A,108,4
5,N/A,N/A,N/A,1016,1021,N/A,111,1
5,N/A,N/A,N/A,1011,1016,N/A,117,1
4,N/A,N/A,N/A,1007,1011,N/A,123,1
9,N/A,N/A,N/A,998,1007,N/A,127,5
7,N/A,N/A,N/A,991,998,N/A,130,2
5,N/A,N/A,N/A,986,991,N/A,135,1
5,N/A,N/A,N/A,981,986,N/A,141,1
15,N/A,N/A,N/A,1610,1625,N/A,5,6
4,N/A,N/A,N/A,1606,1610,N/A,8,3
6,N/A,N/A,N/A,1600,1606,N/A,13,2
4,N/A,N/A,N/A,1596,1600,N/A,19,2
4,N/A,N/A,N/A,1592,1596,N/A,24,1
11,N/A,N/A,N/A,1581,1592,N/A,29,6
4,N/A,N/A,N/A,1577,1581,N/A,35,0
5,N/A,N/A,N/A,1572,1577,N/A,39,4
4,N/A,N/A,N/A,1568,1572,N/A,43,2
10,N/A,N/A,N/A,1558,1568,N/A,46,5
7,N/A,N/A,N/A,1551,1558,N/A,51,4
5,N/A,N/A,N/A,1546,1551,N/A,55,2
14,N/A,N/A,N/A,1532,1546,N/A,59,6
6,N/A,N/A,N/A,1526,1532,N/A,62,3
7,N/A,N/A,N/A,1519,1526,N/A,68,3
11,N/A,N/A,N/A,1508,1519,N/A,71,6
7,N/A,N/A,N/A,1501,1508,N/A,75,4
4,N/A,N/A,N/A,1497,1501,N/A,78,1
16,N/A,N/A,N/A,1481,1497,N/A,83,6
8,N/A,N/A,N/A,1473,1481,N/A,87,4
6,N/A,N/A,N/A,1467,1473,N/A,92,3
15,N/A,N/A,N/A,1452,1467,N/A,95,6
6,N/A,N/A,N/A,1446,1452,N/A,99,4
4,N/A,N/A,N/A,1442,1446,N/A,102,1
8,N/A,N/A,N/A,1434,1442,N/A,105,4
5,N/A,N/A,N/A,1429,1434,N/A,108,1
10,N/A,N/A,N/A,1419,1429,N/A,112,5
7,N/A,N/A,N/A,1412,1419,N/A,116,3
6,N/A,N/A,N/A,1406,1412,N/A,122,3
5,N/A,N/A,N/A,1401,1406,N/A,127,2
6,N/A,N/A,N/A,606,612,N/A,3,4
7,N/A,N/A,N/A,599,606,N/A,7,2
5,N/A,N/A,N/A,594,599,N/A,12,1
5,N/A,N/A,N/A,589,594,N/A,15,4
5,N/A,N/A,N/A,584,589,N/A,20,3
4,N/A,N/A,N/A,580,584,N/A,24,1
18,N/A,N/A,N/A,562,580,N/A,29,6
5,N/A,N/A,N/A,557,562,N/A,32,3
4,N/A,N/A,N/A,553,557,N/A,38,3
6,N/A,N/A,N/A,547,553,N/A,43,2
5,N/A,N/A,N/A,542,547,N/A,48,1
5,N/A,N/A,N/A,537,542,N/A,51,4
5,N/A,N/A,N/A,532,537,N/A,57,4
7,N/A,N/A,N/A,525,532,N/A,61,2
11,N/A,N/A,N/A,514,525,N/A,64,5
5,N/A,N/A,N/A,509,514,N/A,68,3
6,N/A,N/A,N/A,503,509,N/A,73,2
7,N/A,N/A,N/A,496,503,N/A,79,2
4,N/A,N/A,N/A,492,496,N/A,84,1
4,N/A,N/A,N/A,488,492,N/A,90,1
11,N/A,N/A,N/A,477,488,N/A,94,5
7,N/A,N/A,N/A,470,477,N/A,99,4
5,N/A,N/A,N/A,465,470,N/A,103,2
7,N/A,N/A,N/A,458,465,N/A,109,2
10,N/A,N/A,N/A,448,458,N/A,112,5
11,N/A,N/A,N/A,437,448,N/A,118,5
5,N/A,N/A,N/A,432,437,N/A,122,3
6,N/A,N/A,N/A,426,432,N/A,127,2
5,N/A,N/A,N/A,421,426,N/A,132,1
16,N/A,N/A,N/A,405,421,N/A,137,6
10,N/A,N/A,N/A,1889,1899,N/A,4,6
5,N/A,N/A,N/A,1884,1889,N/A,7,3
6,N/A,N/A,N/A,1878,1884,N/A,12,2
4,N/A,N/A,N/A,1874,1878,N/A,17,1
11,N/A,N/A,N/A,1863,1874,N/A,21,5
12,N/A,N/A,N/A,1851,1863,N/A,27,5
6,N/A,N/A,N/A,1845,1851,N/A,31,3
4,N/A,N/A,N/A,1841,1845,N/A,35,1
10,N/A,N/A,N/A,1831,1841,N/A,39,5
7,N/A,N/A,N/A,1824,1831,N/A,44,4
7,N/A,N/A,N/A,1817,1824,N/A,50,4
4,N/A,N/A,N/A,1813,1817,N/A,54,2
4,N/A,N/A,N/A,1809,1813,N/A,59,1
8,N/A,N/A,N/A,1801,1809,N/A,62,4
6,N/A,N/A,N/A,1795,1801,N/A,68,4
4,N/A,N/A,N/A,1791,1795,N/A,71,1
5,N/A,N/A,N/A,1786,1791,N/A,77,1
12,N/A,N/A,N/A,1774,1786,N/A,81,5
5,N/A,N/A,N/A,1769,1774,N/A,86,4
4,N/A,N/A,N/A,1765,1769,N/A,90,2
12,N/A,N/A,N/A,1753,1765,N/A,93,5
4,N/A,N/A,N/A,1749,1753,N/A,96,2
13,N/A,N/A,N/A,1736,1749,N/A,100,6
8,N/A,N/A,N/A,1728,1736,N/A,104,4
7,N/A,N/A,N/A,1721,1728,N/A,109,3
7,N/A,N/A,N/A,1714,1721,N/A,114,2
18,N/A,N/A,N/A,1696,1714,N/A,118,6
10,N/A,N/A,N/A,1686,1696,N/A,123,5
5,N/A,N/A,N/A,1681,1686,N/A,128,4
8,N/A,N/A,N/A,1673,1681,N/A,134,4
10,N/A,N/A,N/A,1818,1828,N/A,4,5
9,N/A,N/A,N/A,1809,1818,N/A,10,5
9,N/A,N/A,N/A,1800,1809,N/A,16,5
5,N/A,N/A,N/A,1795,1800,N/A,20,3
5,N/A,N/A,N/A,1790,1795,N/A,26,3
12,N/A,N/A,N/A,1778,1790,N/A,29,6
6,N/A,N/A,N/A,1772,1778,N/A,32,3
12,N/A,N/A,N/A,1760,1772,N/A,35,6
11,N/A,N/A,N/A,1749,1760,N/A,40,5
5,N/A,N/A,N/A,1744,1749,N/A,43,2
10,N/A,N/A,N/A,1734,1744,N/A,47,6
12,N/A,N/A,N/A,1722,1734,N/A,52,5
7,N/A,N/A,N/A,1715,1722,N/A,57,4
4,N/A,N/A,N/A,1711,1715,N/A,60,1
11,N/A,N/A,N/A,1700,1711,N/A,64,5
6,N/A,N/A,N/A,1694,1700,N/A,67,2
5,N/A,N/A,N/A,1689,1694,N/A,73,2
4,N/A,N/A,N/A,1685,1689,N/A,78,1
12,N/A,N/A,N/A,1673,1685,N/A,82,5
7,N/A,N/A,N/A,1666,1673,N/A,87,4
4,N/A,N/A,N/A,1662,1666,N/A,92,3
7,N/A,N/A,N/A,1655,1662,N/A,98,3
6,N/A,N/A,N/A,1649,1655,N/A,103,2
9,N/A,N/A,N/A,1640,1649,N/A,106,5
6,N/A,N/A,N/A,1634,1640,N/A,109,2
7,N/A,N/A,N/A,1627,1634,N/A,115,2
19,N/A,N/A,N/A,1608,1627,N/A,119,6
5,N/A,N/A,N/A,1603,1608,N/A,122,3
6,N/A,N/A,N/A,1597,1603,N/A,128,3
12,N/A,N/A,N/A,1585,1597,N/A,131,6
4,N/A,N/A,N/A,589,593,N/A,4,3
5,N/A,N/A,N/A,584,589,N/A,8,1
13,N/A,N/A,N/A,571,584,N/A,13,6
6,N/A,N/A,N/A,565,571,N/A,17,4
5,N/A,N/A,N/A,560,565,N/A,23,4
5,N/A,N/A,N/A,555,560,N/A,28,3
4,N/A,N/A,N/A,551,555,N/A,32,1
4,N/A,N/A,N/A,547,551,N/A,38,1
4,N/A,N/A,N/A,543,547,N/A,44,1
19,N/A,N/A,N/A,524,543,N/A,49,6
11,N/A,N/A,N/A,513,524,N/A,54,5
6,N/A,N/A,N/A,507,513,N/A,59,4
6,N/A,N/A,N/A,501,507,N/A,63,2
13,N/A,N/A,N/A,488,501,N/A,67,6
5,N/A,N/A,N/A,483,488,N/A,70,3
12,N/A,N/A,N/A,471,483,N/A,73,6
6,N/A,N/A,N/A,465,471,N/A,76,3
6,N/A,N/A,N/A,459,465,N/A,81,2
11,N/A,N/A,N/A,448,459,N/A,84,5
6,N/A,N/A,N/A,442,448,N/A,89,4
4,N/A,N/A,N/A,438,442,N/A,92,1
11,N/A,N/A,N/A,427,438,N/A,96,5
6,N/A,N/A,N/A,421,427,N/A,100,3
7,N/A,N/A,N/A,414,421,N/A,106,3
5,N/A,N/A,N/A,409,414,N/A,110,1
4,N/A,N/A,N/A,405,409,N/A,116,1
12,N/A,N/A,N/A,393,405,N/A,120,5
5,N/A,N/A,N/A,388,393,N/A,124,3
6,N/A,N/A,N/A,382,388,N/A,129,2
5,N/A,N/A,N/A,377,382,N/A,135,2
4,N/A,N/A,N/A,879,883,N/A,6,2
4,N/A,N/A,N/A,875,879,N/A,11,1
11,N/A,N/A,N/A,864,875,N/A,15,5
12,N/A,N/A,N/A,852,864,N/A,21,5
11,N/A,N/A,N/A,841,852,N/A,27,5
9,N/A,N/A,N/A,832,841,N/A,33,5
5,N/A,N/A,N/A,827,832,N/A,37,3
7,N/A,N/A,N/A,820,827,N/A,43,3
5,N/A,N/A,N/A,815,820,N/A,48,2
10,N/A,N/A,N/A,805,815,N/A,51,5
9,N/A,N/A,N/A,796,805,N/A,57,5
8,N/A,N/A,N/A,788,796,N/A,62,4
4,N/A,N/A,N/A,784,788,N/A,65,1
12,N/A,N/A,N/A,772,784,N/A,69,5
5,N/A,N/A,N/A,767,772,N/A,72,2
4,N/A,N/A,N/A,763,767,N/A,77,1
4,N/A,N/A,N/A,759,763,N/A,83,1
7,N/A,N/A,N/A,752,759,N/A,86,4
5,N/A,N/A,N/A,747,752,N/A,89,1
4,N/A,N/A,N/A,743,747,N/A,95,1
18,N/A,N/A,N/A,725,743,N/A,100,6
5,N/A,N/A,N/A,720,725,N/A,106,0
7,N/A,N/A,N/A,713,720,N/A,109,3
16,N/A,N/A,N/A,697,713,N/A,112,6
12,N/A,N/A,N/A,685,697,N/A,117,5
7,N/A,N/A,N/A,678,685,N/A,120,2
17,N/A,N/A,N/A,661,678,N/A,124,6
5,N/A,N/A,N/A,656,661,N/A,127,3
5,N/A,N/A,N/A,651,656,N/A,131,1
4,N/A,N/A,N/A,647,651,N/A,137,1
7,N/A,N/A,N/A,601,608,N/A,6,2
5,N/A,N/A,N/A,596,601,N/A,12,2
10,N/A,N/A,N/A,586,596,N/A,15,5
4,N/A,N/A,N/A,582,586,N/A,18,2
13,N/A,N/A,N/A,569,582,N/A,22,6
5,N/A,N/A,N/A,564,569,N/A,25,3
12,N/A,N/A,N/A,552,564,N/A,28,6
7,N/A,N/A,N/A,545,552,N/A,32,4
5,N/A,N/A,N/A,540,545,N/A,35,1
13,N/A,N/A,N/A,527,540,N/A,40,6
7,N/A,N/A,N/A,520,527,N/A,43,3
15,N/A,N/A,N/A,505,520,N/A,46,6
6,N/A,N/A,N/A,499,505,N/A,49,3
7,N/A,N/A,N/A,492,499,N/A,54,2
5,N/A,N/A,N/A,487,492,N/A,59,1
14,N/A,N/A,N/A,473,487,N/A,64,6
5,N/A,N/A,N/A,468,473,N/A,70,0
9,N/A,N/A,N/A,459,468,N/A,75,5
11,N/A,N/A,N/A,448,459,N/A,81,5
5,N/A,N/A,N/A,443,448,N/A,86,4
5,N/A,N/A,N/A,438,443,N/A,91,3
6,N/A,N/A,N/A,432,438,N/A,97,3
4,N/A,N/A,N/A,428,432,N/A,102,2
5,N/A,N/A,N/A,423,428,N/A,107,1
5,N/A,N/A,N/A,418,423,N/A,113,1
4,N/A,N/A,N/A,414,418,N/A,119,1
7,N/A,N/A,N/A,407,414,N/A,122,4
4,N/A,N/A,N/A,403,407,N/A,126,2
5,N/A,N/A,N/A,398,403,N/A,131,1
12,N/A,N/A,N/A,386,398,N/A,135,5
6,N/A,N/A,N/A,691,697,N/A,4,2
4,N/A,N/A,N/A,687,691,N/A,9,1
19,N/A,N/A,N/A,668,687,N/A,14,6
7,N/A,N/A,N/A,661,668,N/A,18,4
6,N/A,N/A,N/A,655,661,N/A,24,4
6,N/A,N/A,N/A,649,655,N/A,29,3
5,N/A,N/A,N/A,644,649,N/A,35,3
6,N/A,N/A,N/A,638,644,N/A,40,2
10,N/A,N/A,N/A,628,638,N/A,44,6
5,N/A,N/A,N/A,623,628,N/A,47,3
4,N/A,N/A,N/A,619,623,N/A,51,1
8,N/A,N/A,N/A,611,619,N/A,54,4
7,N/A,N/A,N/A,604,611,N/A,58,2
4,N/A,N/A,N/A,600,604,N/A,63,1
19,N/A,N/A,N/A,581,600,N/A,68,6
5,N/A,N/A,N/A,576,581,N/A,74,0
6,N/A,N/A,N/A,570,576,N/A,78,4
7,N/A,N/A,N/A,563,570,N/A,82,2
5,N/A,N/A,N/A,558,563,N/A,87,1
5,N/A,N/A,N/A,553,558,N/A,93,1
14,N/A,N/A,N/A,539,553,N/A,98,6
4,N/A,N/A,N/A,535,539,N/A,104,0
18,N/A,N/A,N/A,517,535,N/A,110,6
9,N/A,N/A,N/A,508,517,N/A,115,5
10,N/A,N/A,N/A,498,508,N/A,121,5
9,N/A,N/A,N/A,489,498,N/A,127,5
5,N/A,N/A,N/A,484,489,N/A,131,3
6,N/A,N/A,N/A,478,484,N/A,136,2
10,N/A,N/A,N/A,468,478,N/A,140,6
9,N/A,N/A,N/A,459,468,N/A,145,5
4,N/A,N/A,N/A,1020,1024,N/A,5,2
4,N/A,N/A,N/A,1016,1020,N/A,11,2
12,N/A,N/A,N/A,1004,1016,N/A,14,5
5,N/A,N/A,N/A,999,1004,N/A,17,2
10,N/A,N/A,N/A,989,999,N/A,20,5
9,N/A,N/A,N/A,980,989,N/A,26,5
4,N/A,N/A,N/A,976,980,N/A,29,2
10,N/A,N/A,N/A,966,976,N/A,33,6
12,N/A,N/A,N/A,954,966,N/A,38,5
7,N/A,N/A,N/A,947,954,N/A,41,2
7,N/A,N/A,N/A,940,947,N/A,47,2
12,N/A,N/A,N/A,928,940,N/A,51,6
8,N/A,N/A,N/A,920,928,N/A,55,4
5,N/A,N/A,N/A,915,920,N/A,58,1
16,N/A,N/A,N/A,899,915,N/A,63,6
5,N/A,N/A,N/A,894,899,N/A,69,0
15,N/A,N/A,N/A,879,894,N/A,75,6
4,N/A,N/A,N/A,875,879,N/A,78,3
19,N/A,N/A,N/A,856,875,N/A,81,6
11,N/A,N/A,N/A,845,856,N/A,86,5
6,N/A,N/A,N/A,839,845,N/A,91,4
6,N/A,N/A,N/A,833,839,N/A,96,3
6,N/A,N/A,N/A,827,833,N/A,101,2
6,N/A,N/A,N/A,821,827,N/A,107,2
4,N/A,N/A,N/A,817,821,N/A,113,2
13,N/A,N/A,N/A,804,817,N/A,117,6
12,N/A,N/A,N/A,792,804,N/A,122,5
10,N/A,N/A,N/A,782,792,N/A,128,5
5,N/A,N/A,N/A,777,782,N/A,132,3
12,N/A,N/A,N/A,765,777,N/A,135,6
11,N/A,N/A,N/A,1986,1997,N/A,5,6
5,N/A,N/A,N/A,1981,1986,N/A,11,0
10,N/A,N/A,N/A,1971,1981,N/A,16,5
7,N/A,N/A,N/A,1964,1971,N/A,21,4
5,N/A,N/A,N/A,1959,1964,N/A,24,1
8,N/A,N/A,N/A,1951,1959,N/A,27,4
7,N/A,N/A,N/A,1944,1951,N/A,32,3
4,N/A,N/A,N/A,1940,1944,N/A,37,2
18,N/A,N/A,N/A,1922,1940,N/A,41,6
7,N/A,N/A,N/A,1915,1922,N/A,44,3
4,N/A,N/A,N/A,1911,1915,N/A,48,1
7,N/A,N/A,N/A,1904,1911,N/A,51,4
6,N/A,N/A,N/A,1898,1904,N/A,55,2
10,N/A,N/A,N/A,1888,1898,N/A,59,6
7,N/A,N/A,N/A,1881,1888,N/A,62,3
17,N/A,N/A,N/A,1864,1881,N/A,65,6
5,N/A,N/A,N/A,1859,1864,N/A,69,4
4,N/A,N/A,N/A,1855,1859,N/A,72,1
12,N/A,N/A,N/A,1843,1855,N/A,76,5
12,N/A,N/A,N/A,1831,1843,N/A,82,5
4,N/A,N/A,N/A,1827,1831,N/A,86,3
5,N/A,N/A,N/A,1822,1827,N/A,90,1
4,N/A,N/A,N/A,1818,1822,N/A,96,1
4,N/A,N/A,N/A,1814,1818,N/A,102,1
9,N/A,N/A,N/A,1805,1814,N/A,106,5
5,N/A,N/A,N/A,1800,1805,N/A,110,3
4,N/A,N/A,N/A,1796,1800,N/A,115,2
12,N/A,N/A,N/A,1784,1796,N/A,118,5
5,N/A,N/A,N/A,1779,1784,N/A,122,3
7,N/A,N/A,N/A,1772,1779,N/A,128,3
6,N/A,N/A,N/A,990,996,N/A,5,3
4,N/A,N/A,N/A,986,990,N/A,9,1
6,N/A,N/A,N/A,980,986,N/A,12,4
6,N/A,N/A,N/A,974,980,N/A,18,4
8,N/A,N/A,N/A,966,974,N/A,24,4
4,N/A,N/A,N/A,962,966,N/A,27,1
11,N/A,N/A,N/A,951,962,N/A,31,5
7,N/A,N/A,N/A,944,951,N/A,35,3
16,N/A,N/A,N/A,928,944,N/A,38,6
7,N/A,N/A,N/A,921,928,N/A,42,4
7,N/A,N/A,N/A,914,921,N/A,47,3
5,N/A,N/A,N/A,909,914,N/A,53,3
5,N/A,N/A,N/A,904,909,N/A,58,2
11,N/A,N/A,N/A,893,904,N/A,61,5
5,N/A,N/A,N/A,888,893,N/A,66,4
5,N/A,N/A,N/A,883,888,N/A,69,1
5,N/A,N/A,N/A,878,883,N/A,75,1
9,N/A,N/A,N/A,869,878,N/A,79,5
8,N/A,N/A,N/A,861,869,N/A,84,4
7,N/A,N/A,N/A,854,861,N/A,88,2
9,N/A,N/A,N/A,845,854,N/A,91,5
6,N/A,N/A,N/A,839,845,N/A,96,4
5,N/A,N/A,N/A,834,839,N/A,99,1
7,N/A,N/A,N/A,827,834,N/A,102,4
4,N/A,N/A,N/A,823,827,N/A,105,1
15,N/A,N/A,N/A,808,823,N/A,110,6
7,N/A,N/A,N/A,801,808,N/A,114,4
6,N/A,N/A,N/A,795,801,N/A,120,4
5,N/A,N/A,N/A,790,795,N/A,124,2
12,N/A,N/A,N/A,778,790,N/A,127,5
5,N/A,N/A,N/A,1171,1176,N/A,3,4
4,N/A,N/A,N/A,1167,1171,N/A,6,1
10,N/A,N/A,N/A,1157,1167,N/A,10,5
12,N/A,N/A,N/A,1145,1157,N/A,16,5
5,N/A,N/A,N/A,1140,1145,N/A,20,3
5,N/A,N/A,N/A,1135,1140,N/A,26,3
4,N/A,N/A,N/A,1131,1135,N/A,30,1
5,N/A,N/A,N/A,1126,1131,N/A,36,1
5,N/A,N/A,N/A,1121,1126,N/A,42,1
4,N/A,N/A,N/A,1117,1121,N/A,48,1
14,N/A,N/A,N/A,1103,1117,N/A,53,6
6,N/A,N/A,N/A,1097,1103,N/A,57,4
8,N/A,N/A,N/A,1089,1097,N/A,63,4
7,N/A,N/A,N/A,1082,1089,N/A,67,2
9,N/A,N/A,N/A,1073,1082,N/A,70,5
5,N/A,N/A,N/A,1068,1073,N/A,75,4
6,N/A,N/A,N/A,1062,1068,N/A,81,4
7,N/A,N/A,N/A,1055,1062,N/A,86,3
7,N/A,N/A,N/A,1048,1055,N/A,91,2
4,N/A,N/A,N/A,1044,1048,N/A,97,2
9,N/A,N/A,N/A,1035,1044,N/A,100,5
10,N/A,N/A,N/A,1025,1035,N/A,106,5
7,N/A,N/A,N/A,1018,1025,N/A,110,3
15,N/A,N/A,N/A,1003,1018,N/A,113,6
8,N/A,N/A,N/A,995,1003,N/A,117,4
5,N/A,N/A,N/A,990,995,N/A,123,4
5,N/A,N/A,N/A,985,990,N/A,126,1
11,N/A,N/A,N/A,974,985,N/A,131,6
6,N/A,N/A,N/A,968,974,N/A,135,4
6,N/A,N/A,N/A,962,968,N/A,141,4
8,N/A,N/A,N/A,1740,1748,N/A,4,4
7,N/A,N/A,N/A,1733,1740,N/A,8,2
5,N/A,N/A,N/A,1728,1733,N/A,14,2
9,N/A,N/A,N/A,1719,1728,N/A,17,5
6,N/A,N/A,N/A,1713,1719,N/A,20,2
14,N/A,N/A,N/A,1699,1713,N/A,24,6
5,N/A,N/A,N/A,1694,1699,N/A,27,3
16,N/A,N/A,N/A,1678,1694,N/A,30,6
12,N/A,N/A,N/A,1666,1678,N/A,35,5
7,N/A,N/A,N/A,1659,1666,N/A,39,3
5,N/A,N/A,N/A,1654,1659,N/A,43,1
5,N/A,N/A,N/A,1649,1654,N/A,49,1
6,N/A,N/A,N/A,1643,1649,N/A,52,4
4,N/A,N/A,N/A,1639,1643,N/A,55,1
7,N/A,N/A,N/A,1632,1639,N/A,58,4
5,N/A,N/A,N/A,1627,1632,N/A,62,2
4,N/A,N/A,N/A,1623,1627,N/A,67,1
14,N/A,N/A,N/A,1609,1623,N/A,72,6
12,N/A,N/A,N/A,1597,1609,N/A,77,5
6,N/A,N/A,N/A,1591,1597,N/A,81,3
4,N/A,N/A,N/A,1587,1591,N/A,86,2
5,N/A,N/A,N/A,1582,1587,N/A,91,1
5,N/A,N/A,N/A,1577,1582,N/A,97,1
4,N/A,N/A,N/A,1573,1577,N/A,103,1
11,N/A,N/A,N/A,1562,1573,N/A,107,5
5,N/A,N/A,N/A,1557,1562,N/A,112,4
6,N/A,N/A,N/A,1551,1557,N/A,117,3
7,N/A,N/A,N/A,1544,1551,N/A,122,2
5,N/A,N/A,N/A,1539,1544,N/A,127,1
14,N/A,N/A,N/A,1525,1539,N/A,132,6
12,N/A,N/A,N/A,1835,1847,N/A,4,6
4,N/A,N/A,N/A,1831,1835,N/A,10,0
8,N/A,N/A,N/A,1823,1831,N/A,14,4
7,N/A,N/A,N/A,1816,1823,N/A,18,2
11,N/A,N/A,N/A,1805,1816,N/A,21,5
10,N/A,N/A,N/A,1795,1805,N/A,27,5
7,N/A,N/A,N/A,1788,1795,N/A,31,3
5,N/A,N/A,N/A,1783,1788,N/A,35,1
13,N/A,N/A,N/A,1770,1783,N/A,40,6
6,N/A,N/A,N/A,1764,1770,N/A,44,4
5,N/A,N/A,N/A,1759,1764,N/A,49,3
7,N/A,N/A,N/A,1752,1759,N/A,55,3
19,N/A,N/A,N/A,1733,1752,N/A,58,6
4,N/A,N/A,N/A,1729,1733,N/A,61,3
6,N/A,N/A,N/A,1723,1729,N/A,67,3
5,N/A,N/A,N/A,1718,1723,N/A,71,1
8,N/A,N/A,N/A,1710,1718,N/A,74,4
6,N/A,N/A,N/A,1704,1710,N/A,79,3
11,N/A,N/A,N/A,1693,1704,N/A,82,6
5,N/A,N/A,N/A,1688,1693,N/A,85,3
7,N/A,N/A,N/A,1681,1688,N/A,90,2
11,N/A,N/A,N/A,1670,1681,N/A,93,5
6,N/A,N/A,N/A,1664,1670,N/A,98,4
5,N/A,N/A,N/A,1659,1664,N/A,104,4
5,N/A,N/A,N/A,1654,1659,N/A,110,4
5,N/A,N/A,N/A,1649,1654,N/A,115,3
5,N/A,N/A,N/A,1644,1649,N/A,119,1
5,N/A,N/A,N/A,1639,1644,N/A,125,1
15,N/A,N/A,N/A,1624,1639,N/A,130,6
6,N/A,N/A,N/A,1618,1624,N/A,134,4
9,N/A,N/A,N/A,1303,1312,N/A,5,5
5,N/A,N/A,N/A,1298,1303,N/A,9,3
7,N/A,N/A,N/A,1291,1298,N/A,15,3
5,N/A,N/A,N/A,1286,1291,N/A,21,3
6,N/A,N/A,N/A,1280,1286,N/A,26,2
7,N/A,N/A,N/A,1273,1280,N/A,32,2
5,N/A,N/A,N/A,1268,1273,N/A,37,1
11,N/A,N/A,N/A,1257,1268,N/A,41,5
10,N/A,N/A,N/A,1247,1257,N/A,47,5
6,N/A,N/A,N/A,1241,1247,N/A,50,2
5,N/A,N/A,N/A,1236,1241,N/A,56,2
9,N/A,N/A,N/A,1227,1236,N/A,59,5
5,N/A,N/A,N/A,1222,1227,N/A,63,3
13,N/A,N/A,N/A,1209,1222,N/A,66,6
5,N/A,N/A,N/A,1204,1209,N/A,70,4
6,N/A,N/A,N/A,1198,1204,N/A,76,4
6,N/A,N/A,N/A,1192,1198,N/A,82,4
7,N/A,N/A,N/A,1185,1192,N/A,86,2
4,N/A,N/A,N/A,1181,1185,N/A,92,2
5,N/A,N/A,N/A,1176,1181,N/A,97,1
17,N/A,N/A,N/A,1159,1176,N/A,102,6
6,N/A,N/A,N/A,1153,1159,N/A,105,3
5,N/A,N/A,N/A,1148,1153,N/A,111,3
4,N/A,N/A,N/A,1144,1148,N/A,115,1
8,N/A,N/A,N/A,1136,1144,N/A,118,4
5,N/A,N/A,N/A,1131,1136,N/A,123,3
5,N/A,N/A,N/A,1126,1131,N/A,129,3
7,N/A,N/A,N/A,1119,1126,N/A,135,3
7,N/A,N/A,N/A,1112,1119,N/A,141,3
5,N/A,N/A,N/A,1107,1112,N/A,146,2
7,N/A,N/A,N/A,1251,1258,N/A,6,2
5,N/A,N/A,N/A,1246,1251,N/A,11,1
5,N/A,N/A,N/A,1241,1246,N/A,14,4
7,N/A,N/A,N/A,1234,1241,N/A,18,2
7,N/A,N/A,N/A,1227,1234,N/A,24,2
5,N/A,N/A,N/A,1222,1227,N/A,29,1
7,N/A,N/A,N/A,1215,1222,N/A,32,4
4,N/A,N/A,N/A,1211,1215,N/A,37,3
15,N/A,N/A,N/A,1196,1211,N/A,40,6
5,N/A,N/A,N/A,1191,1196,N/A,43,3
13,N/A,N/A,N/A,1178,1191,N/A,46,6
4,N/A,N/A,N/A,1174,1178,N/A,52,0
7,N/A,N/A,N/A,1167,1174,N/A,55,3
5,N/A,N/A,N/A,1162,1167,N/A,59,1
8,N/A,N/A,N/A,1154,1162,N/A,62,4
5,N/A,N/A,N/A,1149,1154,N/A,65,1
10,N/A,N/A,N/A,1139,1149,N/A,70,6
12,N/A,N/A,N/A,1127,1139,N/A,75,5
6,N/A,N/A,N/A,1121,1127,N/A,78,2
5,N/A,N/A,N/A,1116,1121,N/A,84,2
9,N/A,N/A,N/A,1107,1116,N/A,87,5
7,N/A,N/A,N/A,1100,1107,N/A,92,4
8,N/A,N/A,N/A,1092,1100,N/A,98,4
4,N/A,N/A,N/A,1088,1092,N/A,101,1
19,N/A,N/A,N/A,1069,1088,N/A,106,6
12,N/A,N/A,N/A,1057,1069,N/A,111,5
6,N/A,N/A,N/A,1051,1057,N/A,116,4
5,N/A,N/A,N/A,1046,1051,N/A,121,3
14,N/A,N/A,N/A,1032,1046,N/A,124,6
5,N/A,N/A,N/A,1027,1032,N/A,130,0
7,N/A,N/A,N/A,923,930,N/A,5,3
5,N/A,N/A,N/A,918,923,N/A,10,2
10,N/A,N/A,N/A,908,918,N/A,14,6
5,N/A,N/A,N/A,903,908,N/A,20,0
13,N/A,N/A,N/A,890,903,N/A,26,6
7,N/A,N/A,N/A,883,890,N/A,29,3
5,N/A,N/A,N/A,878,883,N/A,35,3
7,N/A,N/A,N/A,871,878,N/A,41,3
6,N/A,N/A,N/A,865,871,N/A,47,3
4,N/A,N/A,N/A,861,865,N/A,51,1
5,N/A,N/A,N/A,856,861,N/A,57,1
9,N/A,N/A,N/A,847,856,N/A,61,5
6,N/A,N/A,N/A,841,847,N/A,66,4
7,N/A,N/A,N/A,834,841,N/A,70,2
17,N/A,N/A,N/A,817,834,N/A,74,6
9,N/A,N/A,N/A,808,817,N/A,79,5
9,N/A,N/A,N/A,799,808,N/A,85,5
4,N/A,N/A,N/A,795,799,N/A,88,2
4,N/A,N/A,N/A,791,795,N/A,94,2
7,N/A,N/A,N/A,784,791,N/A,100,2
13,N/A,N/A,N/A,771,784,N/A,104,6
7,N/A,N/A,N/A,764,771,N/A,108,4
6,N/A,N/A,N/A,758,764,N/A,114,4
7,N/A,N/A,N/A,751,758,N/A,120,4
6,N/A,N/A,N/A,745,751,N/A,124,2
5,N/A,N/A,N/A,740,745,N/A,129,1
11,N/A,N/A,N/A,729,740,N/A,133,5
4,N/A,N/A,N/A,725,729,N/A,136,2
4,N/A,N/A,N/A,721,725,N/A,141,1
5,N/A,N/A,N/A,716,721,N/A,144,4
7,N/A,N/A,N/A,1081,1088,N/A,6,4
7,N/A,N/A,N/A,1074,1081,N/A,10,2
5,N/A,N/A,N/A,1069,1074,N/A,15,1
7,N/A,N/A,N/A,1062,1069,N/A,18,4
5,N/A,N/A,N/A,1057,1062,N/A,21,1
10,N/A,N/A,N/A,1047,1057,N/A,25,5
5,N/A,N/A,N/A,1042,1047,N/A,29,3
11,N/A,N/A,N/A,1031,1042,N/A,32,6
5,N/A,N/A,N/A,1026,1031,N/A,38,0
9,N/A,N/A,N/A,1017,1026,N/A,43,5
4,N/A,N/A,N/A,1013,1017,N/A,46,2
5,N/A,N/A,N/A,1008,1013,N/A,51,1
11,N/A,N/A,N/A,997,1008,N/A,55,5
11,N/A,N/A,N/A,986,997,N/A,61,5
10,N/A,N/A,N/A,976,986,N/A,67,5
7,N/A,N/A,N/A,969,976,N/A,71,3
14,N/A,N/A,N/A,955,969,N/A,74,6
11,N/A,N/A,N/A,944,955,N/A,79,5
7,N/A,N/A,N/A,937,944,N/A,84,4
5,N/A,N/A,N/A,932,937,N/A,87,1
9,N/A,N/A,N/A,923,932,N/A,91,5
5,N/A,N/A,N/A,918,923,N/A,95,3
11,N/A,N/A,N/A,907,918,N/A,98,6
7,N/A,N/A,N/A,900,907,N/A,101,3
6,N/A,N/A,N/A,894,900,N/A,107,3
4,N/A,N/A,N/A,890,894,N/A,112,2
12,N/A,N/A,N/A,878,890,N/A,115,5
4,N/A,N/A,N/A,874,878,N/A,119,3
6,N/A,N/A,N/A,868,874,N/A,125,3
4,N/A,N/A,N/A,864,868,N/A,131,3
4,N/A,N/A,N/A,1225,1229,N/A,4,2
5,N/A,N/A,N/A,1220,1225,N/A,9,1
7,N/A,N/A,N/A,1213,1220,N/A,12,4
6,N/A,N/A,N/A,1207,1213,N/A,18,4
7,N/A,N/A,N/A,1200,1207,N/A,23,3
6,N/A,N/A,N/A,1194,1200,N/A,28,2
18,N/A,N/A,N/A,1176,1194,N/A,32,6
7,N/A,N/A,N/A,1169,1176,N/A,36,4
7,N/A,N/A,N/A,1162,1169,N/A,42,4
4,N/A,N/A,N/A,1158,1162,N/A,46,2
18,N/A,N/A,N/A,1140,1158,N/A,50,6
7,N/A,N/A,N/A,1133,1140,N/A,54,4
5,N/A,N/A,N/A,1128,1133,N/A,59,3
4,N/A,N/A,N/A,1124,1128,N/A,63,1
19,N/A,N/A,N/A,1105,1124,N/A,68,6
5,N/A,N/A,N/A,1100,1105,N/A,71,3
4,N/A,N/A,N/A,1096,1100,N/A,77,3
5,N/A,N/A,N/A,1091,1096,N/A,82,2
19,N/A,N/A,N/A,1072,1091,N/A,86,6
4,N/A,N/A,N/A,1068,1072,N/A,92,0
16,N/A,N/A,N/A,1052,1068,N/A,98,6
6,N/A,N/A,N/A,1046,1052,N/A,102,4
8,N/A,N/A,N/A,1038,1046,N/A,108,4
5,N/A,N/A,N/A,1033,1038,N/A,114,4
6,N/A,N/A,N/A,1027,1033,N/A,118,2
9,N/A,N/A,N/A,1018,1027,N/A,121,5
11,N/A,N/A,N/A,1007,1018,N/A,127,5
6,N/A,N/A,N/A,1001,1007,N/A,132,4
4,N/A,N/A,N/A,997,1001,N/A,136,2
6,N/A,N/A,N/A,991,997,N/A,142,2
9,N/A,N/A,N/A,1865,1874,N/A,4,5
9,N/A,N/A,N/A,1856,1865,N/A,10,5
6,N/A,N/A,N/A,1850,1856,N/A,14,3
4,N/A,N/A,N/A,1846,1850,N/A,20,3
11,N/A,N/A,N/A,1835,1846,N/A,23,6
9,N/A,N/A,N/A,1826,1835,N/A,28,5
7,N/A,N/A,N/A,1819,1826,N/A,32,3
18,N/A,N/A,N/A,1801,1819,N/A,35,6
9,N/A,N/A,N/A,1792,1801,N/A,40,5
5,N/A,N/A,N/A,1787,1792,N/A,44,3
5,N/A,N/A,N/A,1782,1787,N/A,50,3
17,N/A,N/A,N/A,1765,1782,N/A,53,6
5,N/A,N/A,N/A,1760,1765,N/A,59,0
7,N/A,N/A,N/A,1753,1760,N/A,62,3
4,N/A,N/A,N/A,1749,1753,N/A,67,2
12,N/A,N/A,N/A,1737,1749,N/A,70,5
4,N/A,N/A,N/A,1733,1737,N/A,74,3
6,N/A,N/A,N/A,1727,1733,N/A,80,3
6,N/A,N/A,N/A,1721,1727,N/A,86,3
10,N/A,N/A,N/A,1711,1721,N/A,89,6
8,N/A,N/A,N/A,1703,1711,N/A,93,4
5,N/A,N/A,N/A,1698,1703,N/A,96,1
8,N/A,N/A,N/A,1690,1698,N/A,99,4
7,N/A,N/A,N/A,1683,1690,N/A,103,2
4,N/A,N/A,N/A,1679,1683,N/A,108,1
8,N/A,N/A,N/A,1671,1679,N/A,111,4
6,N/A,N/A,N/A,1665,1671,N/A,115,2
13,N/A,N/A,N/A,1652,1665,N/A,119,6
11,N/A,N/A,N/A,1641,1652,N/A,124,5
9,N/A,N/A,N/A,1632,1641,N/A,130,5
4,N/A,N/A,N/A,1544,1548,N/A,5,1
12,N/A,N/A,N/A,1532,1544,N/A,9,5
6,N/A,N/A,N/A,1526,1532,N/A,14,4
4,N/A,N/A,N/A,1522,1526,N/A,19,3
5,N/A,N/A,N/A,1517,1522,N/A,24,2
9,N/A,N/A,N/A,1508,1517,N/A,27,5
7,N/A,N/A,N/A,1501,1508,N/A,32,4
7,N/A,N/A,N/A,1494,1501,N/A,36,2
6,N/A,N/A,N/A,1488,1494,N/A,42,2
5,N/A,N/A,N/A,1483,1488,N/A,47,1
10,N/A,N/A,N/A,1473,1483,N/A,51,5
9,N/A,N/A,N/A,1464,1473,N/A,57,5
6,N/A,N/A,N/A,1458,1464,N/A,61,3
5,N/A,N/A,N/A,1453,1458,N/A,65,1
5,N/A,N/A,N/A,1448,1453,N/A,71,1
5,N/A,N/A,N/A,1443,1448,N/A,77,1
11,N/A,N/A,N/A,1432,1443,N/A,81,5
7,N/A,N/A,N/A,1425,1432,N/A,86,4
5,N/A,N/A,N/A,1420,1425,N/A,91,3
6,N/A,N/A,N/A,1414,1420,N/A,96,2
19,N/A,N/A,N/A,1395,1414,N/A,100,6
10,N/A,N/A,N/A,1385,1395,N/A,105,5
5,N/A,N/A,N/A,1380,1385,N/A,110,4
6,N/A,N/A,N/A,1374,1380,N/A,114,2
11,N/A,N/A,N/A,1363,1374,N/A,117,5
7,N/A,N/A,N/A,1356,1363,N/A,120,2
7,N/A,N/A,N/A,1349,1356,N/A,126,2
4,N/A,N/A,N/A,1345,1349,N/A,131,1
10,N/A,N/A,N/A,1335,1345,N/A,136,6
8,N/A,N/A,N/A,1327,1335,N/A,140,4
7,N/A,N/A,N/A,873,880,N/A,6,4
4,N/A,N/A,N/A,869,873,N/A,9,1
16,N/A,N/A,N/A,853,869,N/A,14,6
7,N/A,N/A,N/A,846,853,N/A,18,4
7,N/A,N/A,N/A,839,846,N/A,24,4
4,N/A,N/A,N/A,835,839,N/A,27,1
5,N/A,N/A,N/A,830,835,N/A,30,4
4,N/A,N/A,N/A,826,830,N/A,34,2
12,N/A,N/A,N/A,814,826,N/A,37,5
7,N/A,N/A,N/A,807,814,N/A,42,4
7,N/A,N/A,N/A,800,807,N/A,46,2
12,N/A,N/A,N/A,788,800,N/A,50,6
8,N/A,N/A,N/A,780,788,N/A,54,4
7,N/A,N/A,N/A,773,780,N/A,60,4
4,N/A,N/A,N/A,769,773,N/A,65,3
7,N/A,N/A,N/A,762,769,N/A,70,2
4,N/A,N/A,N/A,758,762,N/A,75,1
5,N/A,N/A,N/A,753,758,N/A,81,1
5,N/A,N/A,N/A,748,753,N/A,84,4
5,N/A,N/A,N/A,743,748,N/A,87,1
4,N/A,N/A,N/A,739,743,N/A,93,1
19,N/A,N/A,N/A,720,739,N/A,98,6
6,N/A,N/A,N/A,714,720,N/A,102,4
5,N/A,N/A,N/A,709,714,N/A,105,1
12,N/A,N/A,N/A,697,709,N/A,109,5
6,N/A,N/A,N/A,691,697,N/A,112,2
14,N/A,N/A,N/A,677,691,N/A,116,6
5,N/A,N/A,N/A,672,677,N/A,122,0
9,N/A,N/A,N/A,663,672,N/A,127,5
4,N/A,N/A,N/A,659,663,N/A,131,3
4,N/A,N/A,N/A,601,605,N/A,6,1
12,N/A,N/A,N/A,589,601,N/A,10,5
6,N/A,N/A,N/A,583,589,N/A,14,3
5,N/A,N/A,N/A,578,583,N/A,20,3
5,N/A,N/A,N/A,573,578,N/A,26,3
18,N/A,N/A,N/A,555,573,N/A,29,6
6,N/A,N/A,N/A,549,555,N/A,33,4
4,N/A,N/A,N/A,545,549,N/A,36,1
14,N/A,N/A,N/A,531,545,N/A,41,6
5,N/A,N/A,N/A,526,531,N/A,44,3
17,N/A,N/A,N/A,509,526,N/A,47,6
4,N/A,N/A,N/A,505,509,N/A,53,0
10,N/A,N/A,N/A,495,505,N/A,58,5
7,N/A,N/A,N/A,488,495,N/A,62,3
4,N/A,N/A,N/A,484,488,N/A,68,3
6,N/A,N/A,N/A,478,484,N/A,74,3
7,N/A,N/A,N/A,471,478,N/A,79,2
5,N/A,N/A,N/A,466,471,N/A,85,2
7,N/A,N/A,N/A,459,466,N/A,91,2
11,N/A,N/A,N/A,448,459,N/A,94,5
9,N/A,N/A,N/A,439,448,N/A,100,5
6,N/A,N/A,N/A,433,439,N/A,105,4
4,N/A,N/A,N/A,429,433,N/A,108,1
11,N/A,N/A,N/A,418,429,N/A,112,5
6,N/A,N/A,N/A,412,418,N/A,117,4
5,N/A,N/A,N/A,407,412,N/A,120,1
17,N/A,N/A,N/A,390,407,N/A,125,6
4,N/A,N/A,N/A,386,390,N/A,131,0
6,N/A,N/A,N/A,380,386,N/A,135,4
7,N/A,N/A,N/A,373,380,N/A,141,4
18,N/A,N/A,N/A,1477,1495,N/A,3,6
11,N/A,N/A,N/A,1466,1477,N/A,8,5
4,N/A,N/A,N/A,1462,1466,N/A,11,2
14,N/A,N/A,N/A,1448,1462,N/A,15,6
6,N/A,N/A,N/A,1442,1448,N/A,19,4
8,N/A,N/A,N/A,1434,1442,N/A,25,4
6,N/A,N/A,N/A,1428,1434,N/A,30,3
6,N/A,N/A,N/A,1422,1428,N/A,35,2
11,N/A,N/A,N/A,1411,1422,N/A,39,6
5,N/A,N/A,N/A,1406,1411,N/A,42,3
4,N/A,N/A,N/A,1402,1406,N/A,46,1
5,N/A,N/A,N/A,1397,1402,N/A,49,4
5,N/A,N/A,N/A,1392,1397,N/A,53,2
9,N/A,N/A,N/A,1383,1392,N/A,56,5
7,N/A,N/A,N/A,1376,1383,N/A,59,2
10,N/A,N/A,N/A,1366,1376,N/A,62,5
5,N/A,N/A,N/A,1361,1366,N/A,67,4
5,N/A,N/A,N/A,1356,1361,N/A,73,4
5,N/A,N/A,N/A,1351,1356,N/A,78,3
5,N/A,N/A,N/A,1346,1351,N/A,82,1
9,N/A,N/A,N/A,1337,1346,N/A,86,5
6,N/A,N/A,N/A,1331,1337,N/A,91,4
5,N/A,N/A,N/A,1326,1331,N/A,94,1
15,N/A,N/A,N/A,1311,1326,N/A,99,6
7,N/A,N/A,N/A,1304,1311,N/A,102,3
13,N/A,N/A,N/A,1291,1304,N/A,105,6
7,N/A,N/A,N/A,1284,1291,N/A,109,4
4,N/A,N/A,N/A,1280,1284,N/A,112,1
7,N/A,N/A,N/A,1273,1280,N/A,115,4
4,N/A,N/A,N/A,1269,1273,N/A,119,2
5,N/A,N/A,N/A,1919,1924,N/A,3,3
4,N/A,N/A,N/A,1915,1919,N/A,7,1
5,N/A,N/A,N/A,1910,1915,N/A,13,1
7,N/A,N/A,N/A,1903,1910,N/A,16,4
5,N/A,N/A,N/A,1898,1903,N/A,22,4
5,N/A,N/A,N/A,1893,1898,N/A,25,1
14,N/A,N/A,N/A,1879,1893,N/A,30,6
4,N/A,N/A,N/A,1875,1879,N/A,33,3
17,N/A,N/A,N/A,1858,1875,N/A,36,6
4,N/A,N/A,N/A,1854,1858,N/A,39,3
17,N/A,N/A,N/A,1837,1854,N/A,42,6
10,N/A,N/A,N/A,1827,1837,N/A,47,5
9,N/A,N/A,N/A,1818,1827,N/A,53,5
12,N/A,N/A,N/A,1806,1818,N/A,59,5
8,N/A,N/A,N/A,1798,1806,N/A,64,4
6,N/A,N/A,N/A,1792,1798,N/A,69,3
4,N/A,N/A,N/A,1788,1792,N/A,73,1
5,N/A,N/A,N/A,1783,1788,N/A,79,1
18,N/A,N/A,N/A,1765,1783,N/A,84,6
7,N/A,N/A,N/A,1758,1765,N/A,87,3
5,N/A,N/A,N/A,1753,1758,N/A,91,1
11,N/A,N/A,N/A,1742,1753,N/A,95,5
5,N/A,N/A,N/A,1737,1742,N/A,99,3
5,N/A,N/A,N/A,1732,1737,N/A,105,3
13,N/A,N/A,N/A,1719,1732,N/A,108,6
7,N/A,N/A,N/A,1712,1719,N/A,111,3
4,N/A,N/A,N/A,1708,1712,N/A,115,1
13,N/A,N/A,N/A,1695,1708,N/A,120,6
7,N/A,N/A,N/A,1688,1695,N/A,124,4
5,N/A,N/A,N/A,1683,1688,N/A,129,3
5,N/A,N/A,N/A,883,888,N/A,3,1
4,N/A,N/A,N/A,879,883,N/A,9,1
8,N/A,N/A,N/A,871,879,N/A,12,4
6,N/A,N/A,N/A,865,871,N/A,18,4
5,N/A,N/A,N/A,860,865,N/A,21,1
7,N/A,N/A,N/A,853,860,N/A,24,4
6,N/A,N/A,N/A,847,853,N/A,29,3
4,N/A,N/A,N/A,843,847,N/A,33,1
19,N/A,N/A,N/A,824,843,N/A,38,6
4,N/A,N/A,N/A,820,824,N/A,44,0
17,N/A,N/A,N/A,803,820,N/A,50,6
5,N/A,N/A,N/A,798,803,N/A,54,4
7,N/A,N/A,N/A,791,798,N/A,58,2
15,N/A,N/A,N/A,776,791,N/A,62,6
11,N/A,N/A,N/A,765,776,N/A,67,5
11,N/A,N/A,N/A,754,765,N/A,73,5
6,N/A,N/A,N/A,748,754,N/A,77,3
18,N/A,N/A,N/A,730,748,N/A,80,6
8,N/A,N/A,N/A,722,730,N/A,84,4
5,N/A,N/A,N/A,717,722,N/A,89,3
5,N/A,N/A,N/A,712,717,N/A,93,1
13,N/A,N/A,N/A,699,712,N/A,98,6
5,N/A,N/A,N/A,694,699,N/A,104,0
5,N/A,N/A,N/A,689,694,N/A,107,3
14,N/A,N/A,N/A,675,689,N/A,110,6
5,N/A,N/A,N/A,670,675,N/A,113,3
4,N/A,N/A,N/A,666,670,N/A,118,2
10,N/A,N/A,N/A,656,666,N/A,121,5
5,N/A,N/A,N/A,651,656,N/A,125,3
6,N/A,N/A,N/A,645,651,N/A,130,2
6,N/A,N/A,N/A,1853,1859,N/A,3,3
7,N/A,N/A,N/A,1846,1853,N/A,9,3
15,N/A,N/A,N/A,1831,1846,N/A,12,6
7,N/A,N/A,N/A,1824,1831,N/A,16,4
4,N/A,N/A,N/A,1820,1824,N/A,19,1
19,N/A,N/A,N/A,1801,1820,N/A,24,6
5,N/A,N/A,N/A,1796,1801,N/A,28,4
4,N/A,N/A,N/A,1792,1796,N/A,32,2
18,N/A,N/A,N/A,1774,1792,N/A,36,6
5,N/A,N/A,N/A,1769,1774,N/A,39,3
5,N/A,N/A,N/A,1764,1769,N/A,44,2
10,N/A,N/A,N/A,1754,1764,N/A,47,5
6,N/A,N/A,N/A,1748,1754,N/A,50,2
16,N/A,N/A,N/A,1732,1748,N/A,54,6
8,N/A,N/A,N/A,1724,1732,N/A,58,4
8,N/A,N/A,N/A,1716,1724,N/A,64,4
4,N/A,N/A,N/A,1712,1716,N/A,67,1
12,N/A,N/A,N/A,1700,1712,N/A,71,5
6,N/A,N/A,N/A,1694,1700,N/A,76,4
5,N/A,N/A,N/A,1689,1694,N/A,81,3
6,N/A,N/A,N/A,1683,1689,N/A,86,2
7,N/A,N/A,N/A,1676,1683,N/A,92,2
6,N/A,N/A,N/A,1670,1676,N/A,98,2
11,N/A,N/A,N/A,1659,1670,N/A,101,5
5,N/A,N/A,N/A,1654,1659,N/A,106,4
7,N/A,N/A,N/A,1647,1654,N/A,110,2
6,N/A,N/A,N/A,1641,1647,N/A,116,2
18,N/A,N/A,N/A,1623,1641,N/A,120,6
4,N/A,N/A,N/A,1619,1623,N/A,123,3
5,N/A,N/A,N/A,1614,1619,N/A,127,1
12,N/A,N/A,N/A,1180,1192,N/A,5,5
6,N/A,N/A,N/A,1174,1180,N/A,8,2
4,N/A,N/A,N/A,1170,1174,N/A,13,1
16,N/A,N/A,N/A,1154,1170,N/A,18,6
11,N/A,N/A,N/A,1143,1154,N/A,23,5
4,N/A,N/A,N/A,1139,1143,N/A,27,3
7,N/A,N/A,N/A,1132,1139,N/A,32,2
12,N/A,N/A,N/A,1120,1132,N/A,35,5
4,N/A,N/A,N/A,1116,1120,N/A,38,2
4,N/A,N/A,N/A,1112,1116,N/A,43,1
17,N/A,N/A,N/A,1095,1112,N/A,48,6
11,N/A,N/A,N/A,1084,1095,N/A,53,5
7,N/A,N/A,N/A,1077,1084,N/A,58,4
5,N/A,N/A,N/A,1072,1077,N/A,64,4
4,N/A,N/A,N/A,1068,1072,N/A,69,3
19,N/A,N/A,N/A,1049,1068,N/A,72,6
4,N/A,N/A,N/A,1045,1049,N/A,78,0
19,N/A,N/A,N/A,1026,1045,N/A,84,6
6,N/A,N/A,N/A,1020,1026,N/A,87,3
6,N/A,N/A,N/A,1014,1020,N/A,93,3
5,N/A,N/A,N/A,1009,1014,N/A,98,2
5,N/A,N/A,N/A,1004,1009,N/A,103,1
14,N/A,N/A,N/A,990,1004,N/A,108,6
10,N/A,N/A,N/A,980,990,N/A,113,5
11,N/A,N/A,N/A,969,980,N/A,119,5
7,N/A,N/A,N/A,962,969,N/A,122,2
5,N/A,N/A,N/A,957,962,N/A,127,1
5,N/A,N/A,N/A,952,957,N/A,133,1
5,N/A,N/A,N/A,947,952,N/A,139,1
14,N/A,N/A,N/A,933,947,N/A,144,6
7,N/A,N/A,N/A,1262,1269,N/A,3,3
4,N/A,N/A,N/A,1258,1262,N/A,7,1
5,N/A,N/A,N/A,1253,1258,N/A,13,1
4,N/A,N/A,N/A,1249,1253,N/A,19,1
4,N/A,N/A,N/A,1245,1249,N/A,25,1
7,N/A,N/A,N/A,1238,1245,N/A,28,4
4,N/A,N/A,N/A,1234,1238,N/A,31,1
16,N/A,N/A,N/A,1218,1234,N/A,36,6
7,N/A,N/A,N/A,1211,1218,N/A,40,4
7,N/A,N/A,N/A,1204,1211,N/A,45,3
14,N/A,N/A,N/A,1190,1204,N/A,48,6
4,N/A,N/A,N/A,1186,1190,N/A,54,0
6,N/A,N/A,N/A,1180,1186,N/A,58,4
5,N/A,N/A,N/A,1175,1180,N/A,64,4
4,N/A,N/A,N/A,1171,1175,N/A,67,1
6,N/A,N/A,N/A,1165,1171,N/A,70,4
4,N/A,N/A,N/A,1161,1165,N/A,75,3
6,N/A,N/A,N/A,1155,1161,N/A,80,2
4,N/A,N/A,N/A,1151,1155,N/A,85,1
6,N/A,N/A,N/A,1145,1151,N/A,88,4
7,N/A,N/A,N/A,1138,1145,N/A,94,4
6,N/A,N/A,N/A,1132,1138,N/A,98,2
5,N/A,N/A,N/A,1127,1132,N/A,103,1
7,N/A,N/A,N/A,1120,1127,N/A,106,4
6,N/A,N/A,N/A,1114,1120,N/A,111,3
5,N/A,N/A,N/A,1109,1114,N/A,117,3
7,N/A,N/A,N/A,1102,1109,N/A,122,2
5,N/A,N/A,N/A,1097,1102,N/A,128,2
5,N/A,N/A,N/A,1092,1097,N/A,134,2
5,N/A,N/A,N/A,1087,1092,N/A,139,1
5,N/A,N/A,N/A,653,658,N/A,4,1
11,N/A,N/A,N/A,642,653,N/A,8,5
5,N/A,N/A,N/A,637,642,N/A,12,3
5,N/A,N/A,N/A,632,637,N/A,18,3
5,N/A,N/A,N/A,627,632,N/A,22,1
16,N/A,N/A,N/A,611,627,N/A,27,6
12,N/A,N/A,N/A,599,611,N/A,32,5
7,N/A,N/A,N/A,592,599,N/A,36,3
15,N/A,N/A,N/A,577,592,N/A,39,6
7,N/A,N/A,N/A,570,577,N/A,42,3
17,N/A,N/A,N/A,553,570,N/A,45,6
4,N/A,N/A,N/A,549,553,N/A,51,0
5,N/A,N/A,N/A,544,549,N/A,54,3
5,N/A,N/A,N/A,539,544,N/A,58,1
8,N/A,N/A,N/A,531,539,N/A,61,4
5,N/A,N/A,N/A,526,531,N/A,66,3
4,N/A,N/A,N/A,522,526,N/A,70,1
6,N/A,N/A,N/A,516,522,N/A,73,4
7,N/A,N/A,N/A,509,516,N/A,78,3
7,N/A,N/A,N/A,502,509,N/A,83,2
4,N/A,N/A,N/A,498,502,N/A,89,2
9,N/A,N/A,N/A,489,498,N/A,92,5
5,N/A,N/A,N/A,484,489,N/A,96,3
11,N/A,N/A,N/A,473,484,N/A,99,6
6,N/A,N/A,N/A,467,473,N/A,103,4
7,N/A,N/A,N/A,460,467,N/A,108,3
6,N/A,N/A,N/A,454,460,N/A,113,2
7,N/A,N/A,N/A,447,454,N/A,119,2
10,N/A,N/A,N/A,437,447,N/A,122,5
6,N/A,N/A,N/A,431,437,N/A,125,2
4,N/A,N/A,N/A,1227,1231,N/A,5,3
5,N/A,N/A,N/A,1222,1227,N/A,10,2
12,N/A,N/A,N/A,1210,1222,N/A,13,5
5,N/A,N/A,N/A,1205,1210,N/A,18,4
4,N/A,N/A,N/A,1201,1205,N/A,21,1
5,N/A,N/A,N/A,1196,1201,N/A,27,1
11,N/A,N/A,N/A,1185,1196,N/A,31,5
10,N/A,N/A,N/A,1175,1185,N/A,37,5
4,N/A,N/A,N/A,1171,1175,N/A,40,2
11,N/A,N/A,N/A,1160,1171,N/A,43,5
7,N/A,N/A,N/A,1153,1160,N/A,46,2
12,N/A,N/A,N/A,1141,1153,N/A,49,5
5,N/A,N/A,N/A,1136,1141,N/A,52,2
5,N/A,N/A,N/A,1131,1136,N/A,58,2
5,N/A,N/A,N/A,1126,1131,N/A,63,1
18,N/A,N/A,N/A,1108,1126,N/A,68,6
8,N/A,N/A,N/A,1100,1108,N/A,72,4
4,N/A,N/A,N/A,1096,1100,N/A,75,1
6,N/A,N/A,N/A,1090,1096,N/A,78,4
6,N/A,N/A,N/A,1084,1090,N/A,82,2
13,N/A,N/A,N/A,1071,1084,N/A,86,6
10,N/A,N/A,N/A,1061,1071,N/A,91,5
7,N/A,N/A,N/A,1054,1061,N/A,96,4
4,N/A,N/A,N/A,1050,1054,N/A,101,3
11,N/A,N/A,N/A,1039,1050,N/A,104,6
4,N/A,N/A,N/A,1035,1039,N/A,107,3
4,N/A,N/A,N/A,1031,1035,N/A,113,3
7,N/A,N/A,N/A,1024,1031,N/A,118,2
11,N/A,N/A,N/A,1013,1024,N/A,121,5
6,N/A,N/A,N/A,1007,1013,N/A,124,2
7,N/A,N/A,N/A,427,434,N/A,6,4
4,N/A,N/A,N/A,423,427,N/A,11,3
16,N/A,N/A,N/A,407,423,N/A,14,6
6,N/A,N/A,N/A,401,407,N/A,17,3
16,N/A,N/A,N/A,385,401,N/A,20,6
12,N/A,N/A,N/A,373,385,N/A,25,5
4,N/A,N/A,N/A,369,373,N/A,29,3
4,N/A,N/A,N/A,365,369,N/A,33,1
13,N/A,N/A,N/A,352,365,N/A,38,6
6,N/A,N/A,N/A,346,352,N/A,42,4
5,N/A,N/A,N/A,341,346,N/A,46,2
5,N/A,N/A,N/A,336,341,N/A,52,2
5,N/A,N/A,N/A,331,336,N/A,57,1
4,N/A,N/A,N/A,327,331,N/A,63,1
4,N/A,N/A,N/A,323,327,N/A,69,1
5,N/A,N/A,N/A,318,323,N/A,72,4
5,N/A,N/A,N/A,313,318,N/A,76,2
10,N/A,N/A,N/A,303,313,N/A,80,6
6,N/A,N/A,N/A,297,303,N/A,83,3
6,N/A,N/A,N/A,291,297,N/A,89,3
12,N/A,N/A,N/A,279,291,N/A,92,6
5,N/A,N/A,N/A,274,279,N/A,98,0
6,N/A,N/A,N/A,268,274,N/A,102,4
4,N/A,N/A,N/A,264,268,N/A,107,3
17,N/A,N/A,N/A,247,264,N/A,110,6
5,N/A,N/A,N/A,242,247,N/A,116,0
4,N/A,N/A,N/A,238,242,N/A,119,3
7,N/A,N/A,N/A,231,238,N/A,124,2
12,N/A,N/A,N/A,219,231,N/A,127,5
6,N/A,N/A,N/A,213,219,N/A,132,4
7,N/A,N/A,N/A,1641,1648,N/A,3,3
15,N/A,N/A,N/A,1626,1641,N/A,6,6
5,N/A,N/A,N/A,1621,1626,N/A,12,0
5,N/A,N/A,N/A,1616,1621,N/A,15,3
6,N/A,N/A,N/A,1610,1616,N/A,21,3
4,N/A,N/A,N/A,1606,1610,N/A,25,1
14,N/A,N/A,N/A,1592,1606,N/A,30,6
5,N/A,N/A,N/A,1587,1592,N/A,36,0
6,N/A,N/A,N/A,1581,1587,N/A,40,4
6,N/A,N/A,N/A,1575,1581,N/A,46,4
7,N/A,N/A,N/A,1568,1575,N/A,51,3
4,N/A,N/A,N/A,1564,1568,N/A,56,2
4,N/A,N/A,N/A,1560,1564,N/A,61,1
4,N/A,N/A,N/A,1556,1560,N/A,67,1
8,N/A,N/A,N/A,1548,1556,N/A,70,4
4,N/A,N/A,N/A,1544,1548,N/A,73,1
5,N/A,N/A,N/A,1539,1544,N/A,79,1
10,N/A,N/A,N/A,1529,1539,N/A,84,6
5,N/A,N/A,N/A,1524,1529,N/A,90,0
5,N/A,N/A,N/A,1519,1524,N/A,93,3
18,N/A,N/A,N/A,1501,1519,N/A,96,6
6,N/A,N/A,N/A,1495,1501,N/A,100,4
4,N/A,N/A,N/A,1491,1495,N/A,104,2
10,N/A,N/A,N/A,1481,1491,N/A,108,6
5,N/A,N/A,N/A,1476,1481,N/A,114,0
11,N/A,N/A,N/A,1465,1476,N/A,119,5
5,N/A,N/A,N/A,1460,1465,N/A,122,2
9,N/A,N/A,N/A,1451,1460,N/A,125,5
9,N/A,N/A,N/A,1442,1451,N/A,131,5
6,N/A,N/A,N/A,1436,1442,N/A,136,4
6,N/A,N/A,N/A,1569,1575,N/A,4,2
5,N/A,N/A,N/A,1564,1569,N/A,9,1
5,N/A,N/A,N/A,1559,1564,N/A,12,4
5,N/A,N/A,N/A,1554,1559,N/A,15,1
5,N/A,N/A,N/A,1549,1554,N/A,21,1
12,N/A,N/A,N/A,1537,1549,N/A,26,6
4,N/A,N/A,N/A,1533,1537,N/A,32,0
12,N/A,N/A,N/A,1521,1533,N/A,37,5
12,N/A,N/A,N/A,1509,1521,N/A,43,5
9,N/A,N/A,N/A,1500,1509,N/A,49,5
8,N/A,N/A,N/A,1492,1500,N/A,54,4
4,N/A,N/A,N/A,1488,1492,N/A,57,1
4,N/A,N/A,N/A,1484,1488,N/A,63,1
12,N/A,N/A,N/A,1472,1484,N/A,68,6
9,N/A,N/A,N/A,1463,1472,N/A,73,5
5,N/A,N/A,N/A,1458,1463,N/A,78,4
7,N/A,N/A,N/A,1451,1458,N/A,83,3
7,N/A,N/A,N/A,1444,1451,N/A,89,3
11,N/A,N/A,N/A,1433,1444,N/A,92,6
4,N/A,N/A,N/A,1429,1433,N/A,98,0
10,N/A,N/A,N/A,1419,1429,N/A,103,5
6,N/A,N/A,N/A,1413,1419,N/A,107,3
4,N/A,N/A,N/A,1409,1413,N/A,111,1
10,N/A,N/A,N/A,1399,1409,N/A,116,6
6,N/A,N/A,N/A,1393,1399,N/A,120,4
7,N/A,N/A,N/A,1386,1393,N/A,125,3
4,N/A,N/A,N/A,1382,1386,N/A,130,2
12,N/A,N/A,N/A,1370,1382,N/A,134,6
9,N/A,N/A,N/A,1361,1370,N/A,139,5
5,N/A,N/A,N/A,1356,1361,N/A,144,4
10,N/A,N/A,N/A,1460,1470,N/A,4,5
4,N/A,N/A,N/A,1456,1460,N/A,7,2
10,N/A,N/A,N/A,1446,1456,N/A,10,5
6,N/A,N/A,N/A,1440,1446,N/A,14,3
5,N/A,N/A,N/A,1435,1440,N/A,18,1
7,N/A,N/A,N/A,1428,1435,N/A,21,4
6,N/A,N/A,N/A,1422,1428,N/A,25,2
16,N/A,N/A,N/A,1406,1422,N/A,29,6
4,N/A,N/A,N/A,1402,1406,N/A,32,3
10,N/A,N/A,N/A,1392,1402,N/A,35,6
9,N/A,N/A,N/A,1383,1392,N/A,40,5
5,N/A,N/A,N/A,1378,1383,N/A,45,4
5,N/A,N/A,N/A,1373,1378,N/A,49,2
12,N/A,N/A,N/A,1361,1373,N/A,53,6
5,N/A,N/A,N/A,1356,1361,N/A,57,4
5,N/A,N/A,N/A,1351,1356,N/A,60,1
15,N/A,N/A,N/A,1336,1351,N/A,65,6
7,N/A,N/A,N/A,1329,1336,N/A,69,4
5,N/A,N/A,N/A,1324,1329,N/A,73,2
9,N/A,N/A,N/A,1315,1324,N/A,76,5
5,N/A,N/A,N/A,1310,1315,N/A,81,4
7,N/A,N/A,N/A,1303,1310,N/A,87,4
8,N/A,N/A,N/A,1295,1303,N/A,93,4
7,N/A,N/A,N/A,1288,1295,N/A,98,3
5,N/A,N/A,N/A,1283,1288,N/A,104,3
16,N/A,N/A,N/A,1267,1283,N/A,107,6
5,N/A,N/A,N/A,1262,1267,N/A,113,0
6,N/A,N/A,N/A,1256,1262,N/A,117,4
4,N/A,N/A,N/A,1252,1256,N/A,120,1
16,N/A,N/A,N/A,1236,1252,N/A,125,6
8,N/A,N/A,N/A,831,839,N/A,5,4
5,N/A,N/A,N/A,826,831,N/A,9,2
4,N/A,N/A,N/A,822,826,N/A,15,2
13,N/A,N/A,N/A,809,822,N/A,19,6
9,N/A,N/A,N/A,800,809,N/A,24,5
11,N/A,N/A,N/A,789,800,N/A,30,5
5,N/A,N/A,N/A,784,789,N/A,35,4
4,N/A,N/A,N/A,780,784,N/A,38,1
15,N/A,N/A,N/A,765,780,N/A,43,6
5,N/A,N/A,N/A,760,765,N/A,49,0
6,N/A,N/A,N/A,754,760,N/A,53,4
8,N/A,N/A,N/A,746,754,N/A,59,4
4,N/A,N/A,N/A,742,746,N/A,62,1
4,N/A,N/A,N/A,738,742,N/A,68,1
8,N/A,N/A,N/A,730,738,N/A,71,4
5,N/A,N/A,N/A,725,730,N/A,74,1
10,N/A,N/A,N/A,715,725,N/A,78,5
4,N/A,N/A,N/A,711,715,N/A,81,2
7,N/A,N/A,N/A,704,711,N/A,87,2
12,N/A,N/A,N/A,692,704,N/A,90,5
12,N/A,N/A,N/A,680,692,N/A,96,5
6,N/A,N/A,N/A,674,680,N/A,99,2
16,N/A,N/A,N/A,658,674,N/A,103,6
6,N/A,N/A,N/A,652,658,N/A,106,3
4,N/A,N/A,N/A,648,652,N/A,111,2
12,N/A,N/A,N/A,636,648,N/A,114,5
7,N/A,N/A,N/A,629,636,N/A,118,3
4,N/A,N/A,N/A,625,629,N/A,123,2
12,N/A,N/A,N/A,613,625,N/A,126,5
5,N/A,N/A,N/A,608,613,N/A,130,3
15,N/A,N/A,N/A,735,750,N/A,3,6
6,N/A,N/A,N/A,729,735,N/A,6,3
5,N/A,N/A,N/A,724,729,N/A,10,1
5,N/A,N/A,N/A,719,724,N/A,16,1
4,N/A,N/A,N/A,715,719,N/A,22,1
15,N/A,N/A,N/A,700,715,N/A,27,6
10,N/A,N/A,N/A,690,700,N/A,32,5
6,N/A,N/A,N/A,684,690,N/A,35,2
4,N/A,N/A,N/A,680,684,N/A,41,2
11,N/A,N/A,N/A,669,680,N/A,45,6
4,N/A,N/A,N/A,665,669,N/A,48,3
4,N/A,N/A,N/A,661,665,N/A,52,1
13,N/A,N/A,N/A,648,661,N/A,57,6
11,N/A,N/A,N/A,637,648,N/A,62,5
6,N/A,N/A,N/A,631,637,N/A,67,4
6,N/A,N/A,N/A,625,631,N/A,73,4
6,N/A,N/A,N/A,619,625,N/A,79,4
5,N/A,N/A,N/A,614,619,N/A,82,1
5,N/A,N/A,N/A,609,614,N/A,88,1
5,N/A,N/A,N/A,604,609,N/A,91,4
4,N/A,N/A,N/A,600,604,N/A,96,3
6,N/A,N/A,N/A,594,600,N/A,102,3
4,N/A,N/A,N/A,590,594,N/A,106,1
12,N/A,N/A,N/A,578,590,N/A,111,6
10,N/A,N/A,N/A,568,578,N/A,116,5
7,N/A,N/A,N/A,561,568,N/A,119,2
5,N/A,N/A,N/A,556,561,N/A,124,1
12,N/A,N/A,N/A,544,556,N/A,129,6
4,N/A,N/A,N/A,540,544,N/A,132,3
18,N/A,N/A,N/A,522,540,N/A,135,6
6,N/A,N/A,N/A,1789,1795,N/A,4,2
10,N/A,N/A,N/A,1779,1789,N/A,7,5
8,N/A,N/A,N/A,1771,1779,N/A,12,4
6,N/A,N/A,N/A,1765,1771,N/A,17,3
5,N/A,N/A,N/A,1760,1765,N/A,21,1
5,N/A,N/A,N/A,1755,1760,N/A,24,4
4,N/A,N/A,N/A,1751,1755,N/A,27,1
4,N/A,N/A,N/A,1747,1751,N/A,33,1
5,N/A,N/A,N/A,1742,1747,N/A,39,1
6,N/A,N/A,N/A,1736,1742,N/A,42,4
5,N/A,N/A,N/A,1731,1736,N/A,47,3
7,N/A,N/A,N/A,1724,1731,N/A,53,3
7,N/A,N/A,N/A,1717,1724,N/A,59,3
16,N/A,N/A,N/A,1701,1717,N/A,62,6
6,N/A,N/A,N/A,1695,1701,N/A,65,3
4,N/A,N/A,N/A,1691,1695,N/A,70,2
11,N/A,N/A,N/A,1680,1691,N/A,74,6
12,N/A,N/A,N/A,1668,1680,N/A,79,5
4,N/A,N/A,N/A,1664,1668,N/A,83,3
7,N/A,N/A,N/A,1657,1664,N/A,89,3
5,N/A,N/A,N/A,1652,1657,N/A,93,1
14,N/A,N/A,N/A,1638,1652,N/A,98,6
6,N/A,N/A,N/A,1632,1638,N/A,101,3
4,N/A,N/A,N/A,1628,1632,N/A,105,1
18,N/A,N/A,N/A,1610,1628,N/A,110,6
4,N/A,N/A,N/A,1606,1610,N/A,113,3
4,N/A,N/A,N/A,1602,1606,N/A,119,3
6,N/A,N/A,N/A,1596,1602,N/A,125,3
10,N/A,N/A,N/A,1586,1596,N/A,128,6
12,N/A,N/A,N/A,1574,1586,N/A,133,5
4,N/A,N/A,N/A,896,900,N/A,3,2
13,N/A,N/A,N/A,883,896,N/A,7,6
5,N/A,N/A,N/A,878,883,N/A,13,0
10,N/A,N/A,N/A,868,878,N/A,18,5
10,N/A,N/A,N/A,858,868,N/A,24,5
5,N/A,N/A,N/A,853,858,N/A,29,4
8,N/A,N/A,N/A,845,853,N/A,35,4
7,N/A,N/A,N/A,838,845,N/A,41,4
5,N/A,N/A,N/A,833,838,N/A,44,1
4,N/A,N/A,N/A,829,833,N/A,50,1
5,N/A,N/A,N/A,824,829,N/A,53,4
5,N/A,N/A,N/A,819,824,N/A,57,2
9,N/A,N/A,N/A,810,819,N/A,60,5
4,N/A,N/A,N/A,806,810,N/A,63,2
5,N/A,N/A,N/A,801,806,N/A,69,2
11,N/A,N/A,N/A,790,801,N/A,72,5
5,N/A,N/A,N/A,785,790,N/A,77,4
8,N/A,N/A,N/A,777,785,N/A,83,4
7,N/A,N/A,N/A,770,777,N/A,87,2
6,N/A,N/A,N/A,764,770,N/A,93,2
6,N/A,N/A,N/A,758,764,N/A,99,2
5,N/A,N/A,N/A,753,758,N/A,104,1
5,N/A,N/A,N/A,748,753,N/A,110,1
9,N/A,N/A,N/A,739,748,N/A,114,5
11,N/A,N/A,N/A,728,739,N/A,120,5
4,N/A,N/A,N/A,724,728,N/A,123,2
5,N/A,N/A,N/A,719,724,N/A,129,2
4,N/A,N/A,N/A,715,719,N/A,135,2
5,N/A,N/A,N/A,710,715,N/A,140,1
16,N/A,N/A,N/A,694,710,N/A,145,6
4,N/A,N/A,N/A,1277,1281,N/A,6,1
11,N/A,N/A,N/A,1266,1277,N/A,11,6
7,N/A,N/A,N/A,1259,1266,N/A,14,3
6,N/A,N/A,N/A,1253,1259,N/A,19,2
9,N/A,N/A,N/A,1244,1253,N/A,22,5
6,N/A,N/A,N/A,1238,1244,N/A,27,4
6,N/A,N/A,N/A,1232,1238,N/A,32,3
4,N/A,N/A,N/A,1228,1232,N/A,37,2
10,N/A,N/A,N/A,1218,1228,N/A,40,5
6,N/A,N/A,N/A,1212,1218,N/A,44,3
5,N/A,N/A,N/A,1207,1212,N/A,48,1
11,N/A,N/A,N/A,1196,1207,N/A,52,5
7,N/A,N/A,N/A,1189,1196,N/A,57,4
6,N/A,N/A,N/A,1183,1189,N/A,61,2
12,N/A,N/A,N/A,1171,1183,N/A,65,6
6,N/A,N/A,N/A,1165,1171,N/A,69,4
5,N/A,N/A,N/A,1160,1165,N/A,72,1
11,N/A,N/A,N/A,1149,1160,N/A,76,5
4,N/A,N/A,N/A,1145,1149,N/A,80,3
18,N/A,N/A,N/A,1127,1145,N/A,83,6
7,N/A,N/A,N/A,1120,1127,N/A,86,3
5,N/A,N/A,N/A,1115,1120,N/A,90,1
11,N/A,N/A,N/A,1104,1115,N/A,94,5
6,N/A,N/A,N/A,1098,1104,N/A,98,3
6,N/A,N/A,N/A,1092,1098,N/A,104,3
5,N/A,N/A,N/A,1087,1092,N/A,109,2
12,N/A,N/A,N/A,1075,1087,N/A,112,5
11,N/A,N/A,N/A,1064,1075,N/A,118,5
7,N/A,N/A,N/A,1057,1064,N/A,122,3
4,N/A,N/A,N/A,1053,1057,N/A,126,1
11,N/A,N/A,N/A,1793,1804,N/A,3,5
4,N/A,N/A,N/A,1789,1793,N/A,6,2
10,N/A,N/A,N/A,1779,1789,N/A,10,6
5,N/A,N/A,N/A,1774,1779,N/A,13,3
6,N/A,N/A,N/A,1768,1774,N/A,19,3
5,N/A,N/A,N/A,1763,1768,N/A,23,1
19,N/A,N/A,N/A,1744,1763,N/A,28,6
5,N/A,N/A,N/A,1739,1744,N/A,34,0
6,N/A,N/A,N/A,1733,1739,N/A,38,4
7,N/A,N/A,N/A,1726,1733,N/A,43,3
12,N/A,N/A,N/A,1714,1726,N/A,46,6
9,N/A,N/A,N/A,1705,1714,N/A,51,5
11,N/A,N/A,N/A,1694,1705,N/A,57,5
11,N/A,N/A,N/A,1683,1694,N/A,63,5
8,N/A,N/A,N/A,1675,1683,N/A,68,4
4,N/A,N/A,N/A,1671,1675,N/A,73,3
4,N/A,N/A,N/A,1667,1671,N/A,77,1
7,N/A,N/A,N/A,1660,1667,N/A,80,4
6,N/A,N/A,N/A,1654,1660,N/A,85,3
5,N/A,N/A,N/A,1649,1654,N/A,89,1
4,N/A,N/A,N/A,1645,1649,N/A,95,1
11,N/A,N/A,N/A,1634,1645,N/A,99,5
4,N/A,N/A,N/A,1630,1634,N/A,103,3
7,N/A,N/A,N/A,1623,1630,N/A,108,2
14,N/A,N/A,N/A,1609,1623,N/A,112,6
5,N/A,N/A,N/A,1604,1609,N/A,116,4
6,N/A,N/A,N/A,1598,1604,N/A,121,3
4,N/A,N/A,N/A,1594,1598,N/A,127,3
6,N/A,N/A,N/A,1588,1594,N/A,133,3
5,N/A,N/A,N/A,1583,1588,N/A,137,1
4,N/A,N/A,N/A,1002,1006,N/A,5,3
4,N/A,N/A,N/A,998,1002,N/A,10,2
13,N/A,N/A,N/A,985,998,N/A,14,6
5,N/A,N/A,N/A,980,985,N/A,20,0
18,N/A,N/A,N/A,962,980,N/A,26,6
4,N/A,N/A,N/A,958,962,N/A,32,0
17,N/A,N/A,N/A,941,958,N/A,38,6
4,N/A,N/A,N/A,937,941,N/A,44,0
15,N/A,N/A,N/A,922,937,N/A,50,6
5,N/A,N/A,N/A,917,922,N/A,54,4
8,N/A,N/A,N/A,909,917,N/A,60,4
5,N/A,N/A,N/A,904,909,N/A,66,4
6,N/A,N/A,N/A,898,904,N/A,70,2
11,N/A,N/A,N/A,887,898,N/A,73,5
6,N/A,N/A,N/A,881,887,N/A,76,2
4,N/A,N/A,N/A,877,881,N/A,81,1
6,N/A,N/A,N/A,871,877,N/A,84,4
4,N/A,N/A,N/A,867,871,N/A,89,3
6,N/A,N/A,N/A,861,867,N/A,95,3
11,N/A,N/A,N/A,850,861,N/A,98,6
9,N/A,N/A,N/A,841,850,N/A,103,5
7,N/A,N/A,N/A,834,841,N/A,107,3
11,N/A,N/A,N/A,823,834,N/A,110,6
6,N/A,N/A,N/A,817,823,N/A,113,3
4,N/A,N/A,N/A,813,817,N/A,119,3
4,N/A,N/A,N/A,809,813,N/A,123,1
5,N/A,N/A,N/A,804,809,N/A,129,1
4,N/A,N/A,N/A,800,804,N/A,135,1
5,N/A,N/A,N/A,795,800,N/A,141,1
15,N/A,N/A,N/A,780,795,N/A,146,6
15,N/A,N/A,N/A,1242,1257,N/A,6,6
5,N/A,N/A,N/A,1237,1242,N/A,10,4
5,N/A,N/A,N/A,1232,1237,N/A,13,1
4,N/A,N/A,N/A,1228,1232,N/A,19,1
9,N/A,N/A,N/A,1219,1228,N/A,23,5
7,N/A,N/A,N/A,1212,1219,N/A,27,3
6,N/A,N/A,N/A,1206,1212,N/A,33,3
5,N/A,N/A,N/A,1201,1206,N/A,38,2
9,N/A,N/A,N/A,1192,1201,N/A,41,5
6,N/A,N/A,N/A,1186,1192,N/A,46,4
6,N/A,N/A,N/A,1180,1186,N/A,51,3
7,N/A,N/A,N/A,1173,1180,N/A,56,2
12,N/A,N/A,N/A,1161,1173,N/A,59,5
7,N/A,N/A,N/A,1154,1161,N/A,63,3
5,N/A,N/A,N/A,1149,1154,N/A,68,2
4,N/A,N/A,N/A,1145,1149,N/A,73,1
5,N/A,N/A,N/A,1140,1145,N/A,79,1
11,N/A,N/A,N/A,1129,1140,N/A,83,5
7,N/A,N/A,N/A,1122,1129,N/A,87,3
5,N/A,N/A,N/A,1117,1122,N/A,91,1
5,N/A,N/A,N/A,1112,1117,N/A,97,1
7,N/A,N/A,N/A,1105,1112,N/A,100,4
7,N/A,N/A,N/A,1098,1105,N/A,105,3
4,N/A,N/A,N/A,1094,1098,N/A,111,3
6,N/A,N/A,N/A,1088,1094,N/A,117,3
7,N/A,N/A,N/A,1081,1088,N/A,122,2
4,N/A,N/A,N/A,1077,1081,N/A,127,1
12,N/A,N/A,N/A,1065,1077,N/A,131,5
4,N/A,N/A,N/A,1061,1065,N/A,134,2
5,N/A,N/A,N/A,1056,1061,N/A,139,1
4,N/A,N/A,N/A,1939,1943,N/A,6,1
8,N/A,N/A,N/A,1931,1939,N/A,9,4
5,N/A,N/A,N/A,1926,1931,N/A,12,1
7,N/A,N/A,N/A,1919,1926,N/A,15,4
5,N/A,N/A,N/A,1914,1919,N/A,20,3
6,N/A,N/A,N/A,1908,1914,N/A,25,2
11,N/A,N/A,N/A,1897,1908,N/A,28,5
6,N/A,N/A,N/A,1891,1897,N/A,31,2
11,N/A,N/A,N/A,1880,1891,N/A,34,5
8,N/A,N/A,N/A,1872,1880,N/A,39,4
8,N/A,N/A,N/A,1864,1872,N/A,45,4
5,N/A,N/A,N/A,1859,1864,N/A,51,4
5,N/A,N/A,N/A,1854,1859,N/A,56,3
4,N/A,N/A,N/A,1850,1854,N/A,61,2
5,N/A,N/A,N/A,1845,1850,N/A,66,1
11,N/A,N/A,N/A,1834,1845,N/A,71,6
12,N/A,N/A,N/A,1822,1834,N/A,76,5
9,N/A,N/A,N/A,1813,1822,N/A,82,5
5,N/A,N/A,N/A,1808,1813,N/A,87,4
4,N/A,N/A,N/A,1804,1808,N/A,90,1
5,N/A,N/A,N/A,1799,1804,N/A,93,4
7,N/A,N/A,N/A,1792,1799,N/A,97,2
5,N/A,N/A,N/A,1787,1792,N/A,103,2
6,N/A,N/A,N/A,1781,1787,N/A,109,2
14,N/A,N/A,N/A,1767,1781,N/A,113,6
4,N/A,N/A,N/A,1763,1767,N/A,119,0
5,N/A,N/A,N/A,1758,1763,N/A,123,4
8,N/A,N/A,N/A,1750,1758,N/A,129,4
7,N/A,N/A,N/A,1743,1750,N/A,134,3
15,N/A,N/A,N/A,1728,1743,N/A,137,6
4,N/A,N/A,N/A,1103,1107,N/A,3,3
7,N/A,N/A,N/A,1096,1103,N/A,8,2
5,N/A,N/A,N/A,1091,1096,N/A,13,1
19,N/A,N/A,N/A,1072,1091,N/A,18,6
8,N/A,N/A,N/A,1064,1072,N/A,22,4
5,N/A,N/A,N/A,1059,1064,N/A,25,1
6,N/A,N/A,N/A,1053,1059,N/A,28,4
4,N/A,N/A,N/A,1049,1053,N/A,33,3
5,N/A,N/A,N/A,1044,1049,N/A,37,1
9,N/A,N/A,N/A,1035,1044,N/A,41,5
6,N/A,N/A,N/A,1029,1035,N/A,46,4
4,N/A,N/A,N/A,1025,1029,N/A,51,3
10,N/A,N/A,N/A,1015,1025,N/A,54,6
5,N/A,N/A,N/A,1010,1015,N/A,57,3
5,N/A,N/A,N/A,1005,1010,N/A,63,3
5,N/A,N/A,N/A,1000,1005,N/A,67,1
18,N/A,N/A,N/A,982,1000,N/A,72,6
4,N/A,N/A,N/A,978,982,N/A,75,3
4,N/A,N/A,N/A,974,978,N/A,79,1
17,N/A,N/A,N/A,957,974,N/A,84,6
12,N/A,N/A,N/A,945,957,N/A,89,5
6,N/A,N/A,N/A,939,945,N/A,94,4
5,N/A,N/A,N/A,934,939,N/A,99,3
4,N/A,N/A,N/A,930,934,N/A,104,2
11,N/A,N/A,N/A,919,930,N/A,107,5
4,N/A,N/A,N/A,915,919,N/A,111,3
7,N/A,N/A,N/A,908,915,N/A,116,2
7,N/A,N/A,N/A,901,908,N/A,122,2
12,N/A,N/A,N/A,889,901,N/A,126,6
4,N/A,N/A,N/A,885,889,N/A,132,0
4,N/A,N/A,N/A,742,746,N/A,5,1
5,N/A,N/A,N/A,737,742,N/A,8,4
5,N/A,N/A,N/A,732,737,N/A,11,1
10,N/A,N/A,N/A,722,732,N/A,15,5
4,N/A,N/A,N/A,718,722,N/A,19,3
5,N/A,N/A,N/A,713,718,N/A,23,1
5,N/A,N/A,N/A,708,713,N/A,26,4
4,N/A,N/A,N/A,704,708,N/A,30,2
16,N/A,N/A,N/A,688,704,N/A,34,6
5,N/A,N/A,N/A,683,688,N/A,37,3
19,N/A,N/A,N/A,664,683,N/A,40,6
7,N/A,N/A,N/A,657,664,N/A,44,4
7,N/A,N/A,N/A,650,657,N/A,48,2
4,N/A,N/A,N/A,646,650,N/A,53,1
9,N/A,N/A,N/A,637,646,N/A,57,5
6,N/A,N/A,N/A,631,637,N/A,61,3
13,N/A,N/A,N/A,618,631,N/A,64,6
7,N/A,N/A,N/A,611,618,N/A,68,4
6,N/A,N/A,N/A,605,611,N/A,72,2
19,N/A,N/A,N/A,586,605,N/A,76,6
4,N/A,N/A,N/A,582,586,N/A,82,0
5,N/A,N/A,N/A,577,582,N/A,86,4
7,N/A,N/A,N/A,570,577,N/A,91,3
4,N/A,N/A,N/A,566,570,N/A,95,1
6,N/A,N/A,N/A,560,566,N/A,98,4
5,N/A,N/A,N/A,555,560,N/A,101,1
18,N/A,N/A,N/A,537,555,N/A,106,6
4,N/A,N/A,N/A,533,537,N/A,109,3
4,N/A,N/A,N/A,529,533,N/A,114,2
4,N/A,N/A,N/A,525,529,N/A,119,1
7,N/A,N/A,N/A,1518,1525,N/A,5,2
14,N/A,N/A,N/A,1504,1518,N/A,9,6
5,N/A,N/A,N/A,1499,1504,N/A,15,0
11,N/A,N/A,N/A,1488,1499,N/A,21,6
4,N/A,N/A,N/A,1484,1488,N/A,27,0
11,N/A,N/A,N/A,1473,1484,N/A,33,6
5,N/A,N/A,N/A,1468,1473,N/A,37,4
4,N/A,N/A,N/A,1464,1468,N/A,40,1
5,N/A,N/A,N/A,1459,1464,N/A,43,4
7,N/A,N/A,N/A,1452,1459,N/A,47,2
6,N/A,N/A,N/A,1446,1452,N/A,53,2
12,N/A,N/A,N/A,1434,1446,N/A,56,5
8,N/A,N/A,N/A,1426,1434,N/A,61,4
5,N/A,N/A,N/A,1421,1426,N/A,64,1
10,N/A,N/A,N/A,1411,1421,N/A,69,6
6,N/A,N/A,N/A,1405,1411,N/A,73,4
6,N/A,N/A,N/A,1399,1405,N/A,78,3
4,N/A,N/A,N/A,1395,1399,N/A,82,1
4,N/A,N/A,N/A,1391,1395,N/A,88,1
5,N/A,N/A,N/A,1386,1391,N/A,91,4
4,N/A,N/A,N/A,1382,1386,N/A,94,1
11,N/A,N/A,N/A,1371,1382,N/A,98,5
7,N/A,N/A,N/A,1364,1371,N/A,103,4
7,N/A,N/A,N/A,1357,1364,N/A,107,2
5,N/A,N/A,N/A,1352,1357,N/A,113,2
17,N/A,N/A,N/A,1335,1352,N/A,117,6
12,N/A,N/A,N/A,1323,1335,N/A,122,5
11,N/A,N/A,N/A,1312,1323,N/A,128,5
11,N/A,N/A,N/A,1301,1312,N/A,134,5
6,N/A,N/A,N/A,1295,1301,N/A,137,2
5,N/A,N/A,N/A,1938,1943,N/A,5,3
5,N/A,N/A,N/A,1933,1938,N/A,9,1
10,N/A,N/A,N/A,1923,1933,N/A,13,5
6,N/A,N/A,N/A,1917,1923,N/A,16,2
4,N/A,N/A,N/A,1913,1917,N/A,21,1
12,N/A,N/A,N/A,1901,1913,N/A,26,6
4,N/A,N/A,N/A,1897,1901,N/A,29,3
4,N/A,N/A,N/A,1893,1897,N/A,33,1
18,N/A,N/A,N/A,1875,1893,N/A,38,6
8,N/A,N/A,N/A,1867,1875,N/A,42,4
6,N/A,N/A,N/A,1861,1867,N/A,48,4
5,N/A,N/A,N/A,1856,1861,N/A,51,1
14,N/A,N/A,N/A,1842,1856,N/A,56,6
4,N/A,N/A,N/A,1838,1842,N/A,62,0
19,N/A,N/A,N/A,1819,1838,N/A,68,6
7,N/A,N/A,N/A,1812,1819,N/A,72,4
4,N/A,N/A,N/A,1808,1812,N/A,76,2
11,N/A,N/A,N/A,1797,1808,N/A,79,5
7,N/A,N/A,N/A,1790,1797,N/A,84,4
6,N/A,N/A,N/A,1784,1790,N/A,89,3
5,N/A,N/A,N/A,1779,1784,N/A,93,1
16,N/A,N/A,N/A,1763,1779,N/A,98,6
5,N/A,N/A,N/A,1758,1763,N/A,104,0
5,N/A,N/A,N/A,1753,1758,N/A,108,4
4,N/A,N/A,N/A,1749,1753,N/A,112,2
17,N/A,N/A,N/A,1732,1749,N/A,116,6
5,N/A,N/A,N/A,1727,1732,N/A,122,0
6,N/A,N/A,N/A,1721,1727,N/A,125,3
4,N/A,N/A,N/A,1717,1721,N/A,129,1
9,N/A,N/A,N/A,1708,1717,N/A,133,5
5,N/A,N/A,N/A,1511,1516,N/A,4,4
7,N/A,N/A,N/A,1504,1511,N/A,9,3
5,N/A,N/A,N/A,1499,1504,N/A,13,1
12,N/A,N/A,N/A,1487,1499,N/A,17,5
8,N/A,N/A,N/A,1479,1487,N/A,22,4
4,N/A,N/A,N/A,1475,1479,N/A,27,3
7,N/A,N/A,N/A,1468,1475,N/A,32,2
17,N/A,N/A,N/A,1451,1468,N/A,36,6
7,N/A,N/A,N/A,1444,1451,N/A,40,4
5,N/A,N/A,N/A,1439,1444,N/A,45,3
13,N/A,N/A,N/A,1426,1439,N/A,48,6
9,N/A,N/A,N/A,1417,1426,N/A,53,5
6,N/A,N/A,N/A,1411,1417,N/A,58,4
4,N/A,N/A,N/A,1407,1411,N/A,62,2
9,N/A,N/A,N/A,1398,1407,N/A,65,5
5,N/A,N/A,N/A,1393,1398,N/A,68,2
7,N/A,N/A,N/A,1386,1393,N/A,74,2
7,N/A,N/A,N/A,1379,1386,N/A,80,2
6,N/A,N/A,N/A,1373,1379,N/A,86,2
6,N/A,N/A,N/A,1367,1373,N/A,92,2
5,N/A,N/A,N/A,1362,1367,N/A,98,2
17,N/A,N/A,N/A,1345,1362,N/A,102,6
8,N/A,N/A,N/A,1337,1345,N/A,106,4
4,N/A,N/A,N/A,1333,1337,N/A,111,3
4,N/A,N/A,N/A,1329,1333,N/A,115,1
5,N/A,N/A,N/A,1324,1329,N/A,121,1
14,N/A,N/A,N/A,1310,1324,N/A,126,6
12,N/A,N/A,N/A,1298,1310,N/A,131,5
4,N/A,N/A,N/A,1294,1298,N/A,135,3
5,N/A,N/A,N/A,1289,1294,N/A,139,1
9,N/A,N/A,N/A,740,749,N/A,4,5
12,N/A,N/A,N/A,728,740,N/A,10,5
5,N/A,N/A,N/A,723,728,N/A,15,4
7,N/A,N/A,N/A,716,723,N/A,19,2
18,N/A,N/A,N/A,698,716,N/A,23,6
5,N/A,N/A,N/A,693,698,N/A,27,4
7,N/A,N/A,N/A,686,693,N/A,33,4
5,N/A,N/A,N/A,681,686,N/A,38,3
5,N/A,N/A,N/A,676,681,N/A,43,2
9,N/A,N/A,N/A,667,676,N/A,46,5
11,N/A,N/A,N/A,656,667,N/A,52,5
5,N/A,N/A,N/A,651,656,N/A,56,3
5,N/A,N/A,N/A,646,651,N/A,60,1
4,N/A,N/A,N/A,642,646,N/A,66,1
5,N/A,N/A,N/A,637,642,N/A,72,1
19,N/A,N/A,N/A,618,637,N/A,77,6
11,N/A,N/A,N/A,607,618,N/A,82,5
8,N/A,N/A,N/A,599,607,N/A,87,4
4,N/A,N/A,N/A,595,599,N/A,91,2
16,N/A,N/A,N/A,579,595,N/A,95,6
9,N/A,N/A,N/A,570,579,N/A,100,5
6,N/A,N/A,N/A,564,570,N/A,103,2
5,N/A,N/A,N/A,559,564,N/A,109,2
4,N/A,N/A,N/A,555,559,N/A,114,1
16,N/A,N/A,N/A,539,555,N/A,119,6
10,N/A,N/A,N/A,529,539,N/A,124,5
4,N/A,N/A,N/A,525,529,N/A,127,2
5,N/A,N/A,N/A,520,525,N/A,133,2
6,N/A,N/A,N/A,514,520,N/A,139,2
11,N/A,N/A,N/A,503,514,N/A,142,5
11,N/A,N/A,N/A,946,957,N/A,4,5
6,N/A,N/A,N/A,940,946,N/A,8,3
5,N/A,N/A,N/A,935,940,N/A,12,1
5,N/A,N/A,N/A,930,935,N/A,18,1
4,N/A,N/A,N/A,926,930,N/A,24,1
5,N/A,N/A,N/A,921,926,N/A,30,1
8,N/A,N/A,N/A,913,921,N/A,33,4
5,N/A,N/A,N/A,908,913,N/A,36,1
5,N/A,N/A,N/A,903,908,N/A,42,1
18,N/A,N/A,N/A,885,903,N/A,47,6
4,N/A,N/A,N/A,881,885,N/A,53,0
4,N/A,N/A,N/A,877,881,N/A,56,3
5,N/A,N/A,N/A,872,877,N/A,60,1
10,N/A,N/A,N/A,862,872,N/A,64,5
7,N/A,N/A,N/A,855,862,N/A,67,2
5,N/A,N/A,N/A,850,855,N/A,72,1
15,N/A,N/A,N/A,835,850,N/A,77,6
4,N/A,N/A,N/A,831,835,N/A,83,0
17,N/A,N/A,N/A,814,831,N/A,89,6
5,N/A,N/A,N/A,809,814,N/A,95,0
17,N/A,N/A,N/A,792,809,N/A,101,6
4,N/A,N/A,N/A,788,792,N/A,107,0
12,N/A,N/A,N/A,776,788,N/A,113,6
6,N/A,N/A,N/A,770,776,N/A,116,3
19,N/A,N/A,N/A,751,770,N/A,119,6
7,N/A,N/A,N/A,744,751,N/A,122,3
13,N/A,N/A,N/A,731,744,N/A,125,6
7,N/A,N/A,N/A,724,731,N/A,128,3
6,N/A,N/A,N/A,718,724,N/A,133,2
10,N/A,N/A,N/A,708,718,N/A,136,5
6,N/A,N/A,N/A,1006,1012,N/A,5,4
6,N/A,N/A,N/A,1000,1006,N/A,11,4
5,N/A,N/A,N/A,995,1000,N/A,14,1
18,N/A,N/A,N/A,977,995,N/A,19,6
5,N/A,N/A,N/A,972,977,N/A,25,0
13,N/A,N/A,N/A,959,972,N/A,31,6
4,N/A,N/A,N/A,955,959,N/A,34,3
7,N/A,N/A,N/A,948,955,N/A,40,3
5,N/A,N/A,N/A,943,948,N/A,44,1
12,N/A,N/A,N/A,931,943,N/A,48,5
9,N/A,N/A,N/A,922,931,N/A,54,5
5,N/A,N/A,N/A,917,922,N/A,59,4
6,N/A,N/A,N/A,911,917,N/A,63,2
11,N/A,N/A,N/A,900,911,N/A,66,5
5,N/A,N/A,N/A,895,900,N/A,71,4
5,N/A,N/A,N/A,890,895,N/A,75,2
4,N/A,N/A,N/A,886,890,N/A,80,1
10,N/A,N/A,N/A,876,886,N/A,84,5
7,N/A,N/A,N/A,869,876,N/A,87,2
12,N/A,N/A,N/A,857,869,N/A,90,5
5,N/A,N/A,N/A,852,857,N/A,95,4
4,N/A,N/A,N/A,848,852,N/A,98,1
11,N/A,N/A,N/A,837,848,N/A,103,6
10,N/A,N/A,N/A,827,837,N/A,108,5
6,N/A,N/A,N/A,821,827,N/A,113,4
4,N/A,N/A,N/A,817,821,N/A,116,1
17,N/A,N/A,N/A,800,817,N/A,121,6
7,N/A,N/A,N/A,793,800,N/A,124,3
5,N/A,N/A,N/A,788,793,N/A,128,1
13,N/A,N/A,N/A,775,788,N/A,133,6
4,N/A,N/A,N/A,1769,1773,N/A,6,3
6,N/A,N/A,N/A,1763,1769,N/A,12,3
5,N/A,N/A,N/A,1758,1763,N/A,16,1
8,N/A,N/A,N/A,1750,1758,N/A,19,4
6,N/A,N/A,N/A,1744,1750,N/A,24,3
7,N/A,N/A,N/A,1737,1744,N/A,30,3
4,N/A,N/A,N/A,1733,1737,N/A,34,1
4,N/A,N/A,N/A,1729,1733,N/A,40,1
10,N/A,N/A,N/A,1719,1729,N/A,44,5
4,N/A,N/A,N/A,1715,1719,N/A,47,2
4,N/A,N/A,N/A,1711,1715,N/A,52,1
9,N/A,N/A,N/A,1702,1711,N/A,56,5
5,N/A,N/A,N/A,1697,1702,N/A,59,2
6,N/A,N/A,N/A,1691,1697,N/A,65,2
11,N/A,N/A,N/A,1680,1691,N/A,68,5
5,N/A,N/A,N/A,1675,1680,N/A,71,2
5,N/A,N/A,N/A,1670,1675,N/A,76,1
11,N/A,N/A,N/A,1659,1670,N/A,80,5
7,N/A,N/A,N/A,1652,1659,N/A,85,4
4,N/A,N/A,N/A,1648,1652,N/A,88,1
17,N/A,N/A,N/A,1631,1648,N/A,93,6
9,N/A,N/A,N/A,1622,1631,N/A,98,5
8,N/A,N/A,N/A,1614,1622,N/A,103,4
4,N/A,N/A,N/A,1610,1614,N/A,108,3
5,N/A,N/A,N/A,1605,1610,N/A,114,3
18,N/A,N/A,N/A,1587,1605,N/A,117,6
7,N/A,N/A,N/A,1580,1587,N/A,121,4
6,N/A,N/A,N/A,1574,1580,N/A,126,3
7,N/A,N/A,N/A,1567,1574,N/A,131,2
4,N/A,N/A,N/A,1563,1567,N/A,137,2
11,N/A,N/A,N/A,775,786,N/A,6,5
4,N/A,N/A,N/A,771,775,N/A,9,2
11,N/A,N/A,N/A,760,771,N/A,12,5
10,N/A,N/A,N/A,750,760,N/A,18,5
8,N/A,N/A,N/A,742,750,N/A,23,4
6,N/A,N/A,N/A,736,742,N/A,28,3
4,N/A,N/A,N/A,732,736,N/A,32,1
6,N/A,N/A,N/A,726,732,N/A,35,4
5,N/A,N/A,N/A,721,726,N/A,41,4
5,N/A,N/A,N/A,716,721,N/A,46,3
4,N/A,N/A,N/A,712,716,N/A,52,3
4,N/A,N/A,N/A,708,712,N/A,56,1
4,N/A,N/A,N/A,704,708,N/A,62,1
8,N/A,N/A,N/A,696,704,N/A,65,4
6,N/A,N/A,N/A,690,696,N/A,71,4
7,N/A,N/A,N/A,683,690,N/A,76,3
5,N/A,N/A,N/A,678,683,N/A,82,3
10,N/A,N/A,N/A,668,678,N/A,85,6
5,N/A,N/A,N/A,663,668,N/A,89,4
6,N/A,N/A,N/A,657,663,N/A,95,4
6,N/A,N/A,N/A,651,657,N/A,99,2
10,N/A,N/A,N/A,641,651,N/A,102,5
6,N/A,N/A,N/A,635,641,N/A,107,4
5,N/A,N/A,N/A,630,635,N/A,111,2
11,N/A,N/A,N/A,619,630,N/A,115,6
7,N/A,N/A,N/A,612,619,N/A,119,4
5,N/A,N/A,N/A,607,612,N/A,122,1
7,N/A,N/A,N/A,600,607,N/A,125,4
5,N/A,N/A,N/A,595,600,N/A,131,4
6,N/A,N/A,N/A,589,595,N/A,135,2
7,N/A,N/A,N/A,1445,1452,N/A,3,3
5,N/A,N/A,N/A,1440,1445,N/A,9,3
5,N/A,N/A,N/A,1435,1440,N/A,13,1
15,N/A,N/A,N/A,1420,1435,N/A,18,6
5,N/A,N/A,N/A,1415,1420,N/A,24,0
11,N/A,N/A,N/A,1404,1415,N/A,29,5
7,N/A,N/A,N/A,1397,1404,N/A,33,3
5,N/A,N/A,N/A,1392,1397,N/A,37,1
19,N/A,N/A,N/A,1373,1392,N/A,42,6
12,N/A,N/A,N/A,1361,1373,N/A,47,5
10,N/A,N/A,N/A,1351,1361,N/A,53,5
6,N/A,N/A,N/A,1345,1351,N/A,57,3
6,N/A,N/A,N/A,1339,1345,N/A,62,2
10,N/A,N/A,N/A,1329,1339,N/A,65,5
7,N/A,N/A,N/A,1322,1329,N/A,68,2
12,N/A,N/A,N/A,1310,1322,N/A,71,5
6,N/A,N/A,N/A,1304,1310,N/A,74,2
5,N/A,N/A,N/A,1299,1304,N/A,79,1
4,N/A,N/A,N/A,1295,1299,N/A,85,1
6,N/A,N/A,N/A,1289,1295,N/A,88,4
6,N/A,N/A,N/A,1283,1289,N/A,93,3
11,N/A,N/A,N/A,1272,1283,N/A,96,6
4,N/A,N/A,N/A,1268,1272,N/A,102,0
11,N/A,N/A,N/A,1257,1268,N/A,107,5
4,N/A,N/A,N/A,1253,1257,N/A,111,3
5,N/A,N/A,N/A,1248,1253,N/A,115,1
5,N/A,N/A,N/A,1243,1248,N/A,121,1
4,N/A,N/A,N/A,1239,1243,N/A,127,1
4,N/A,N/A,N/A,1235,1239,N/A,133,1
5,N/A,N/A,N/A,1230,1235,N/A,139,1
4,N/A,N/A,N/A,1840,1844,N/A,4,1
5,N/A,N/A,N/A,1835,1840,N/A,7,4
7,N/A,N/A,N/A,1828,1835,N/A,12,3
6,N/A,N/A,N/A,1822,1828,N/A,18,3
7,N/A,N/A,N/A,1815,1822,N/A,23,2
5,N/A,N/A,N/A,1810,1815,N/A,28,1
11,N/A,N/A,N/A,1799,1810,N/A,33,6
4,N/A,N/A,N/A,1795,1799,N/A,39,0
13,N/A,N/A,N/A,1782,1795,N/A,45,6
9,N/A,N/A,N/A,1773,1782,N/A,50,5
8,N/A,N/A,N/A,1765,1773,N/A,55,4
7,N/A,N/A,N/A,1758,1765,N/A,61,4
5,N/A,N/A,N/A,1753,1758,N/A,66,3
5,N/A,N/A,N/A,1748,1753,N/A,71,2
4,N/A,N/A,N/A,1744,1748,N/A,76,1
4,N/A,N/A,N/A,1740,1744,N/A,82,1
4,N/A,N/A,N/A,1736,1740,N/A,88,1
11,N/A,N/A,N/A,1725,1736,N/A,92,5
5,N/A,N/A,N/A,1720,1725,N/A,97,4
4,N/A,N/A,N/A,1716,1720,N/A,102,3
6,N/A,N/A,N/A,1710,1716,N/A,108,3
7,N/A,N/A,N/A,1703,1710,N/A,113,2
5,N/A,N/A,N/A,1698,1703,N/A,118,1
17,N/A,N/A,N/A,1681,1698,N/A,123,6
10,N/A,N/A,N/A,1671,1681,N/A,128,5
7,N/A,N/A,N/A,1664,1671,N/A,133,4
7,N/A,N/A,N/A,1657,1664,N/A,137,2
11,N/A,N/A,N/A,1646,1657,N/A,141,6
4,N/A,N/A,N/A,1642,1646,N/A,147,0
6,N/A,N/A,N/A,1636,1642,N/A,150,3
7,N/A,N/A,N/A,674,681,N/A,6,2
4,N/A,N/A,N/A,670,674,N/A,11,1
11,N/A,N/A,N/A,659,670,N/A,16,6
11,N/A,N/A,N/A,648,659,N/A,21,5
6,N/A,N/A,N/A,642,648,N/A,25,3
16,N/A,N/A,N/A,626,642,N/A,28,6
4,N/A,N/A,N/A,622,626,N/A,34,0
7,N/A,N/A,N/A,615,622,N/A,38,4
7,N/A,N/A,N/A,608,615,N/A,43,3
5,N/A,N/A,N/A,603,608,N/A,47,1
15,N/A,N/A,N/A,588,603,N/A,52,6
5,N/A,N/A,N/A,583,588,N/A,55,3
7,N/A,N/A,N/A,576,583,N/A,61,3
12,N/A,N/A,N/A,564,576,N/A,64,6
5,N/A,N/A,N/A,559,564,N/A,67,3
10,N/A,N/A,N/A,549,559,N/A,70,6
4,N/A,N/A,N/A,545,549,N/A,76,0
5,N/A,N/A,N/A,540,545,N/A,80,4
5,N/A,N/A,N/A,535,540,N/A,86,4
5,N/A,N/A,N/A,530,535,N/A,89,1
5,N/A,N/A,N/A,525,530,N/A,95,1
4,N/A,N/A,N/A,521,525,N/A,101,1
14,N/A,N/A,N/A,507,521,N/A,106,6
6,N/A,N/A,N/A,501,507,N/A,109,3
6,N/A,N/A,N/A,495,501,N/A,114,2
5,N/A,N/A,N/A,490,495,N/A,119,1
5,N/A,N/A,N/A,485,490,N/A,125,1
5,N/A,N/A,N/A,480,485,N/A,131,1
9,N/A,N/A,N/A,471,480,N/A,135,5
11,N/A,N/A,N/A,460,471,N/A,141,5
12,N/A,N/A,N/A,1139,1151,N/A,3,5
5,N/A,N/A,N/A,1134,1139,N/A,7,3
16,N/A,N/A,N/A,1118,1134,N/A,10,6
10,N/A,N/A,N/A,1108,1118,N/A,15,5
5,N/A,N/A,N/A,1103,1108,N/A,20,4
4,N/A,N/A,N/A,1099,1103,N/A,24,2
17,N/A,N/A,N/A,1082,1099,N/A,28,6
7,N/A,N/A,N/A,1075,1082,N/A,31,3
7,N/A,N/A,N/A,1068,1075,N/A,37,3
7,N/A,N/A,N/A,1061,1068,N/A,43,3
16,N/A,N/A,N/A,1045,1061,N/A,46,6
4,N/A,N/A,N/A,1041,1045,N/A,49,3
5,N/A,N/A,N/A,1036,1041,N/A,53,1
4,N/A,N/A,N/A,1032,1036,N/A,59,1
12,N/A,N/A,N/A,1020,1032,N/A,63,5
7,N/A,N/A,N/A,1013,1020,N/A,68,4
5,N/A,N/A,N/A,1008,1013,N/A,74,4
4,N/A,N/A,N/A,1004,1008,N/A,78,2
4,N/A,N/A,N/A,1000,1004,N/A,83,1
19,N/A,N/A,N/A,981,1000,N/A,88,6
5,N/A,N/A,N/A,976,981,N/A,92,4
4,N/A,N/A,N/A,972,976,N/A,96,2
14,N/A,N/A,N/A,958,972,N/A,100,6
4,N/A,N/A,N/A,954,958,N/A,106,0
5,N/A,N/A,N/A,949,954,N/A,110,4
4,N/A,N/A,N/A,945,949,N/A,113,1
11,N/A,N/A,N/A,934,945,N/A,118,6
4,N/A,N/A,N/A,930,934,N/A,124,0
7,N/A,N/A,N/A,923,930,N/A,127,3
4,N/A,N/A,N/A,919,923,N/A,132,2
8,N/A,N/A,N/A,1135,1143,N/A,6,4
4,N/A,N/A,N/A,1131,1135,N/A,11,3
6,N/A,N/A,N/A,1125,1131,N/A,16,2
16,N/A,N/A,N/A,1109,1125,N/A,20,6
6,N/A,N/A,N/A,1103,1109,N/A,24,4
4,N/A,N/A,N/A,1099,1103,N/A,28,2
5,N/A,N/A,N/A,1094,1099,N/A,33,1
5,N/A,N/A,N/A,1089,1094,N/A,39,1
16,N/A,N/A,N/A,1073,1089,N/A,44,6
4,N/A,N/A,N/A,1069,1073,N/A,50,0
12,N/A,N/A,N/A,1057,1069,N/A,55,5
6,N/A,N/A,N/A,1051,1057,N/A,58,2
7,N/A,N/A,N/A,1044,1051,N/A,64,2
11,N/A,N/A,N/A,1033,1044,N/A,67,5
8,N/A,N/A,N/A,1025,1033,N/A,72,4
4,N/A,N/A,N/A,1021,1025,N/A,75,1
4,N/A,N/A,N/A,1017,1021,N/A,81,1
12,N/A,N/A,N/A,1005,1017,N/A,86,6
5,N/A,N/A,N/A,1000,1005,N/A,89,3
7,N/A,N/A,N/A,993,1000,N/A,94,2
4,N/A,N/A,N/A,989,993,N/A,100,2
6,N/A,N/A,N/A,983,989,N/A,106,2
10,N/A,N/A,N/A,973,983,N/A,109,5
5,N/A,N/A,N/A,968,973,N/A,114,4
6,N/A,N/A,N/A,962,968,N/A,119,3
4,N/A,N/A,N/A,958,962,N/A,124,2
5,N/A,N/A,N/A,953,958,N/A,129,1
9,N/A,N/A,N/A,944,953,N/A,133,5
4,N/A,N/A,N/A,940,944,N/A,136,2
4,N/A,N/A,N/A,936,940,N/A,142,2
4,N/A,N/A,N/A,1659,1663,N/A,4,1
4,N/A,N/A,N/A,1655,1659,N/A,10,1
5,N/A,N/A,N/A,1650,1655,N/A,16,1
10,N/A,N/A,N/A,1640,1650,N/A,20,5
11,N/A,N/A,N/A,1629,1640,N/A,26,5
6,N/A,N/A,N/A,1623,1629,N/A,31,4
5,N/A,N/A,N/A,1618,1623,N/A,34,1
18,N/A,N/A,N/A,1600,1618,N/A,39,6
6,N/A,N/A,N/A,1594,1600,N/A,43,4
5,N/A,N/A,N/A,1589,1594,N/A,46,1
8,N/A,N/A,N/A,1581,1589,N/A,49,4
5,N/A,N/A,N/A,1576,1581,N/A,55,4
4,N/A,N/A,N/A,1572,1576,N/A,60,3
4,N/A,N/A,N/A,1568,1572,N/A,65,2
4,N/A,N/A,N/A,1564,1568,N/A,70,1
11,N/A,N/A,N/A,1553,1564,N/A,75,6
5,N/A,N/A,N/A,1548,1553,N/A,81,0
11,N/A,N/A,N/A,1537,1548,N/A,87,6
5,N/A,N/A,N/A,1532,1537,N/A,90,3
4,N/A,N/A,N/A,1528,1532,N/A,94,1
10,N/A,N/A,N/A,1518,1528,N/A,99,6
7,N/A,N/A,N/A,1511,1518,N/A,102,3
5,N/A,N/A,N/A,1506,1511,N/A,108,3
5,N/A,N/A,N/A,1501,1506,N/A,112,1
4,N/A,N/A,N/A,1497,1501,N/A,118,1
8,N/A,N/A,N/A,1489,1497,N/A,121,4
8,N/A,N/A,N/A,1481,1489,N/A,127,4
7,N/A,N/A,N/A,1474,1481,N/A,133,4
5,N/A,N/A,N/A,1469,1474,N/A,136,1
4,N/A,N/A,N/A,1465,1469,N/A,142,1
7,N/A,N/A,N/A,1699,1706,N/A,3,3
5,N/A,N/A,N/A,1694,1699,N/A,8,2
5,N/A,N/A,N/A,1689,1694,N/A,13,1
5,N/A,N/A,N/A,1684,1689,N/A,19,1
13,N/A,N/A,N/A,1671,1684,N/A,24,6
4,N/A,N/A,N/A,1667,1671,N/A,27,3
4,N/A,N/A,N/A,1663,1667,N/A,32,2
5,N/A,N/A,N/A,1658,1663,N/A,38,2
5,N/A,N/A,N/A,1653,1658,N/A,43,1
15,N/A,N/A,N/A,1638,1653,N/A,48,6
5,N/A,N/A,N/A,1633,1638,N/A,52,4
6,N/A,N/A,N/A,1627,1633,N/A,56,2
4,N/A,N/A,N/A,1623,1627,N/A,62,2
10,N/A,N/A,N/A,1613,1623,N/A,66,6
9,N/A,N/A,N/A,1604,1613,N/A,71,5
5,N/A,N/A,N/A,1599,1604,N/A,75,3
5,N/A,N/A,N/A,1594,1599,N/A,80,2
5,N/A,N/A,N/A,1589,1594,N/A,85,1
8,N/A,N/A,N/A,1581,1589,N/A,88,4
5,N/A,N/A,N/A,1576,1581,N/A,94,4
4,N/A,N/A,N/A,1572,1576,N/A,97,1
11,N/A,N/A,N/A,1561,1572,N/A,102,6
5,N/A,N/A,N/A,1556,1561,N/A,108,0
18,N/A,N/A,N/A,1538,1556,N/A,114,6
9,N/A,N/A,N/A,1529,1538,N/A,119,5
5,N/A,N/A,N/A,1524,1529,N/A,123,3
7,N/A,N/A,N/A,1517,1524,N/A,128,2
12,N/A,N/A,N/A,1505,1517,N/A,132,6
4,N/A,N/A,N/A,1501,1505,N/A,138,0
10,N/A,N/A,N/A,1491,1501,N/A,143,5
6,N/A,N/A,N/A,1906,1912,N/A,4,3
17,N/A,N/A,N/A,1889,1906,N/A,7,6
5,N/A,N/A,N/A,1884,1889,N/A,13,0
5,N/A,N/A,N/A,1879,1884,N/A,16,3
18,N/A,N/A,N/A,1861,1879,N/A,19,6
5,N/A,N/A,N/A,1856,1861,N/A,25,0
7,N/A,N/A,N/A,1849,1856,N/A,28,3
4,N/A,N/A,N/A,1845,1849,N/A,34,3
4,N/A,N/A,N/A,1841,1845,N/A,39,2
4,N/A,N/A,N/A,1837,1841,N/A,45,2
4,N/A,N/A,N/A,1833,1837,N/A,50,1
4,N/A,N/A,N/A,1829,1833,N/A,56,1
5,N/A,N/A,N/A,1824,1829,N/A,59,4
8,N/A,N/A,N/A,1816,1824,N/A,65,4
5,N/A,N/A,N/A,1811,1816,N/A,71,4
4,N/A,N/A,N/A,1807,1811,N/A,74,1
4,N/A,N/A,N/A,1803,1807,N/A,80,1
10,N/A,N/A,N/A,1793,1803,N/A,84,5
5,N/A,N/A,N/A,1788,1793,N/A,89,4
5,N/A,N/A,N/A,1783,1788,N/A,92,1
16,N/A,N/A,N/A,1767,1783,N/A,97,6
5,N/A,N/A,N/A,1762,1767,N/A,103,0
17,N/A,N/A,N/A,1745,1762,N/A,109,6
7,N/A,N/A,N/A,1738,1745,N/A,113,4
7,N/A,N/A,N/A,1731,1738,N/A,118,3
5,N/A,N/A,N/A,1726,1731,N/A,122,1
9,N/A,N/A,N/A,1717,1726,N/A,126,5
7,N/A,N/A,N/A,1710,1717,N/A,131,4
5,N/A,N/A,N/A,1705,1710,N/A,137,4
6,N/A,N/A,N/A,1699,1705,N/A,141,2
7,N/A,N/A,N/A,431,438,N/A,6,2
5,N/A,N/A,N/A,426,431,N/A,11,1
4,N/A,N/A,N/A,422,426,N/A,17,1
4,N/A,N/A,N/A,418,422,N/A,23,1
6,N/A,N/A,N/A,412,418,N/A,26,4
5,N/A,N/A,N/A,407,412,N/A,32,4
5,N/A,N/A,N/A,402,407,N/A,38,4
6,N/A,N/A,N/A,396,402,N/A,44,4
4,N/A,N/A,N/A,392,396,N/A,49,3
5,N/A,N/A,N/A,387,392,N/A,55,3
5,N/A,N/A,N/A,382,387,N/A,61,3
17,N/A,N/A,N/A,365,382,N/A,64,6
10,N/A,N/A,N/A,355,365,N/A,69,5
10,N/A,N/A,N/A,345,355,N/A,75,5
6,N/A,N/A,N/A,339,345,N/A,80,4
7,N/A,N/A,N/A,332,339,N/A,85,3
6,N/A,N/A,N/A,326,332,N/A,90,2
17,N/A,N/A,N/A,309,326,N/A,94,6
5,N/A,N/A,N/A,304,309,N/A,98,4
5,N/A,N/A,N/A,299,304,N/A,102,2
7,N/A,N/A,N/A,292,299,N/A,108,2
9,N/A,N/A,N/A,283,292,N/A,111,5
12,N/A,N/A,N/A,271,283,N/A,117,5
5,N/A,N/A,N/A,266,271,N/A,121,3
14,N/A,N/A,N/A,252,266,N/A,124,6
4,N/A,N/A,N/A,248,252,N/A,130,0
5,N/A,N/A,N/A,243,248,N/A,134,4
5,N/A,N/A,N/A,238,243,N/A,138,2
5,N/A,N/A,N/A,233,238,N/A,143,1
10,N/A,N/A,N/A,223,233,N/A,147,5
12,N/A,N/A,N/A,645,657,N/A,3,5
5,N/A,N/A,N/A,640,645,N/A,6,2
4,N/A,N/A,N/A,636,640,N/A,11,1
17,N/A,N/A,N/A,619,636,N/A,16,6
4,N/A,N/A,N/A,615,619,N/A,19,3
4,N/A,N/A,N/A,611,615,N/A,24,2
14,N/A,N/A,N/A,597,611,N/A,28,6
4,N/A,N/A,N/A,593,597,N/A,34,0
7,N/A,N/A,N/A,586,593,N/A,38,4
5,N/A,N/A,N/A,581,586,N/A,41,1
11,N/A,N/A,N/A,570,581,N/A,46,6
7,N/A,N/A,N/A,563,570,N/A,49,3
4,N/A,N/A,N/A,559,563,N/A,54,2
12,N/A,N/A,N/A,547,559,N/A,57,5
7,N/A,N/A,N/A,540,547,N/A,61,3
17,N/A,N/A,N/A,523,540,N/A,64,6
7,N/A,N/A,N/A,516,523,N/A,67,3
7,N/A,N/A,N/A,509,516,N/A,72,2
13,N/A,N/A,N/A,496,509,N/A,76,6
4,N/A,N/A,N/A,492,496,N/A,79,3
6,N/A,N/A,N/A,486,492,N/A,84,2
11,N/A,N/A,N/A,475,486,N/A,88,6
5,N/A,N/A,N/A,470,475,N/A,94,0
15,N/A,N/A,N/A,455,470,N/A,100,6
5,N/A,N/A,N/A,450,455,N/A,106,0
17,N/A,N/A,N/A,433,450,N/A,112,6
4,N/A,N/A,N/A,429,433,N/A,115,3
4,N/A,N/A,N/A,425,429,N/A,121,3
4,N/A,N/A,N/A,421,425,N/A,125,1
8,N/A,N/A,N/A,413,421,N/A,128,4
7,N/A,N/A,N/A,1490,1497,N/A,5,2
6,N/A,N/A,N/A,1484,1490,N/A,11,2
15,N/A,N/A,N/A,1469,1484,N/A,15,6
11,N/A,N/A,N/A,1458,1469,N/A,20,5
7,N/A,N/A,N/A,1451,1458,N/A,23,2
6,N/A,N/A,N/A,1445,1451,N/A,29,2
15,N/A,N/A,N/A,1430,1445,N/A,33,6
6,N/A,N/A,N/A,1424,1430,N/A,36,3
7,N/A,N/A,N/A,1417,1424,N/A,42,3
6,N/A,N/A,N/A,1411,1417,N/A,47,2
15,N/A,N/A,N/A,1396,1411,N/A,51,6
10,N/A,N/A,N/A,1386,1396,N/A,56,5
5,N/A,N/A,N/A,1381,1386,N/A,59,2
11,N/A,N/A,N/A,1370,1381,N/A,63,6
11,N/A,N/A,N/A,1359,1370,N/A,68,5
5,N/A,N/A,N/A,1354,1359,N/A,73,4
6,N/A,N/A,N/A,1348,1354,N/A,79,4
6,N/A,N/A,N/A,1342,1348,N/A,84,3
7,N/A,N/A,N/A,1335,1342,N/A,89,2
9,N/A,N/A,N/A,1326,1335,N/A,92,5
7,N/A,N/A,N/A,1319,1326,N/A,95,2
5,N/A,N/A,N/A,1314,1319,N/A,101,2
13,N/A,N/A,N/A,1301,1314,N/A,105,6
4,N/A,N/A,N/A,1297,1301,N/A,111,0
9,N/A,N/A,N/A,1288,1297,N/A,116,5
7,N/A,N/A,N/A,1281,1288,N/A,119,2
5,N/A,N/A,N/A,1276,1281,N/A,124,1
12,N/A,N/A,N/A,1264,1276,N/A,128,5
9,N/A,N/A,N/A,1255,1264,N/A,134,5
6,N/A,N/A,N/A,1249,1255,N/A,138,3
5,N/A,N/A,N/A,318,323,N/A,3,4
5,N/A,N/A,N/A,313,318,N/A,6,1
8,N/A,N/A,N/A,305,313,N/A,9,4
5,N/A,N/A,N/A,300,305,N/A,12,1
9,N/A,N/A,N/A,291,300,N/A,16,5
7,N/A,N/A,N/A,284,291,N/A,20,3
5,N/A,N/A,N/A,279,284,N/A,24,1
5,N/A,N/A,N/A,274,279,N/A,27,4
5,N/A,N/A,N/A,269,274,N/A,30,1
13,N/A,N/A,N/A,256,269,N/A,35,6
6,N/A,N/A,N/A,250,256,N/A,39,4
7,N/A,N/A,N/A,243,250,N/A,44,3
11,N/A,N/A,N/A,232,243,N/A,47,6
11,N/A,N/A,N/A,221,232,N/A,52,5
7,N/A,N/A,N/A,214,221,N/A,55,2
5,N/A,N/A,N/A,209,214,N/A,60,1
5,N/A,N/A,N/A,204,209,N/A,63,4
7,N/A,N/A,N/A,197,204,N/A,68,3
5,N/A,N/A,N/A,192,197,N/A,73,2
11,N/A,N/A,N/A,181,192,N/A,77,6
5,N/A,N/A,N/A,176,181,N/A,83,0
5,N/A,N/A,N/A,171,176,N/A,87,4
4,N/A,N/A,N/A,167,171,N/A,90,1
11,N/A,N/A,N/A,156,167,N/A,94,5
7,N/A,N/A,N/A,149,156,N/A,97,2
11,N/A,N/A,N/A,138,149,N/A,100,5
11,N/A,N/A,N/A,127,138,N/A,106,5
8,N/A,N/A,N/A,119,127,N/A,111,4
5,N/A,N/A,N/A,114,119,N/A,114,1
5,N/A,N/A,N/A,109,114,N/A,120,1
7,N/A,N/A,N/A,1199,1206,N/A,5,3
10,N/A,N/A,N/A,1189,1199,N/A,8,6
12,N/A,N/A,N/A,1177,1189,N/A,13,5
5,N/A,N/A,N/A,1172,1177,N/A,18,4
6,N/A,N/A,N/A,1166,1172,N/A,22,2
10,N/A,N/A,N/A,1156,1166,N/A,25,5
6,N/A,N/A,N/A,1150,1156,N/A,29,3
4,N/A,N/A,N/A,1146,1150,N/A,33,1
5,N/A,N/A,N/A,1141,1146,N/A,39,1
11,N/A,N/A,N/A,1130,1141,N/A,43,5
5,N/A,N/A,N/A,1125,1130,N/A,48,4
7,N/A,N/A,N/A,1118,1125,N/A,53,3
5,N/A,N/A,N/A,1113,1118,N/A,57,1
10,N/A,N/A,N/A,1103,1113,N/A,62,6
6,N/A,N/A,N/A,1097,1103,N/A,65,3
4,N/A,N/A,N/A,1093,1097,N/A,70,2
11,N/A,N/A,N/A,1082,1093,N/A,73,5
10,N/A,N/A,N/A,1072,1082,N/A,79,5
8,N/A,N/A,N/A,1064,1072,N/A,84,4
6,N/A,N/A,N/A,1058,1064,N/A,89,3
5,N/A,N/A,N/A,1053,1058,N/A,95,3
15,N/A,N/A,N/A,1038,1053,N/A,98,6
8,N/A,N/A,N/A,1030,1038,N/A,102,4
7,N/A,N/A,N/A,1023,1030,N/A,108,4
4,N/A,N/A,N/A,1019,1023,N/A,111,1
5,N/A,N/A,N/A,1014,1019,N/A,114,4
8,N/A,N/A,N/A,1006,1014,N/A,120,4
5,N/A,N/A,N/A,1001,1006,N/A,125,3
4,N/A,N/A,N/A,997,1001,N/A,130,2
4,N/A,N/A,N/A,993,997,N/A,136,2
5,N/A,N/A,N/A,1481,1486,N/A,3,3
4,N/A,N/A,N/A,1477,1481,N/A,9,3
7,N/A,N/A,N/A,1470,1477,N/A,14,2
5,N/A,N/A,N/A,1465,1470,N/A,20,2
6,N/A,N/A,N/A,1459,1465,N/A,26,2
10,N/A,N/A,N/A,1449,1459,N/A,29,5
6,N/A,N/A,N/A,1443,1449,N/A,34,4
7,N/A,N/A,N/A,1436,1443,N/A,38,2
4,N/A,N/A,N/A,1432,1436,N/A,43,1
5,N/A,N/A,N/A,1427,1432,N/A,49,1
7,N/A,N/A,N/A,1420,1427,N/A,52,4
8,N/A,N/A,N/A,1412,1420,N/A,58,4
4,N/A,N/A,N/A,1408,1412,N/A,61,1
7,N/A,N/A,N/A,1401,1408,N/A,64,4
5,N/A,N/A,N/A,1396,1401,N/A,70,4
7,N/A,N/A,N/A,1389,1396,N/A,76,4
7,N/A,N/A,N/A,1382,1389,N/A,80,2
10,N/A,N/A,N/A,1372,1382,N/A,83,5
12,N/A,N/A,N/A,1360,1372,N/A,89,5
6,N/A,N/A,N/A,1354,1360,N/A,92,2
11,N/A,N/A,N/A,1343,1354,N/A,95,5
5,N/A,N/A,N/A,1338,1343,N/A,99,3
5,N/A,N/A,N/A,1333,1338,N/A,103,1
11,N/A,N/A,N/A,1322,1333,N/A,107,5
9,N/A,N/A,N/A,1313,1322,N/A,113,5
7,N/A,N/A,N/A,1306,1313,N/A,116,2
19,N/A,N/A,N/A,1287,1306,N/A,120,6
8,N/A,N/A,N/A,1279,1287,N/A,124,4
6,N/A,N/A,N/A,1273,1279,N/A,129,3
7,N/A,N/A,N/A,1266,1273,N/A,134,2
4,N/A,N/A,N/A,585,589,N/A,6,1
4,N/A,N/A,N/A,581,585,N/A,12,1
12,N/A,N/A,N/A,569,581,N/A,16,5
6,N/A,N/A,N/A,563,569,N/A,21,4
5,N/A,N/A,N/A,558,563,N/A,26,3
13,N/A,N/A,N/A,545,558,N/A,29,6
8,N/A,N/A,N/A,537,545,N/A,33,4
5,N/A,N/A,N/A,532,537,N/A,36,1
4,N/A,N/A,N/A,528,532,N/A,42,1
10,N/A,N/A,N/A,518,528,N/A,46,5
11,N/A,N/A,N/A,507,518,N/A,52,5
4,N/A,N/A,N/A,503,507,N/A,55,2
11,N/A,N/A,N/A,492,503,N/A,59,6
10,N/A,N/A,N/A,482,492,N/A,64,5
5,N/A,N/A,N/A,477,482,N/A,69,4
4,N/A,N/A,N/A,473,477,N/A,72,1
10,N/A,N/A,N/A,463,473,N/A,76,5
6,N/A,N/A,N/A,457,463,N/A,80,3
5,N/A,N/A,N/A,452,457,N/A,85,2
4,N/A,N/A,N/A,448,452,N/A,90,1
10,N/A,N/A,N/A,438,448,N/A,94,5
5,N/A,N/A,N/A,433,438,N/A,99,4
5,N/A,N/A,N/A,428,433,N/A,105,4
7,N/A,N/A,N/A,421,428,N/A,110,3
4,N/A,N/A,N/A,417,421,N/A,114,1
14,N/A,N/A,N/A,403,417,N/A,119,6
4,N/A,N/A,N/A,399,403,N/A,125,0
6,N/A,N/A,N/A,393,399,N/A,129,4
5,N/A,N/A,N/A,388,393,N/A,133,2
5,N/A,N/A,N/A,383,388,N/A,139,2
4,N/A,N/A,N/A,1631,1635,N/A,6,1
10,N/A,N/A,N/A,1621,1631,N/A,10,5
5,N/A,N/A,N/A,1616,1621,N/A,15,4
7,N/A,N/A,N/A,1609,1616,N/A,20,3
6,N/A,N/A,N/A,1603,1609,N/A,25,2
11,N/A,N/A,N/A,1592,1603,N/A,28,5
9,N/A,N/A,N/A,1583,1592,N/A,34,5
10,N/A,N/A,N/A,1573,1583,N/A,40,5
10,N/A,N/A,N/A,1563,1573,N/A,46,5
11,N/A,N/A,N/A,1552,1563,N/A,52,5
4,N/A,N/A,N/A,1548,1552,N/A,56,3
5,N/A,N/A,N/A,1543,1548,N/A,60,1
6,N/A,N/A,N/A,1537,1543,N/A,63,4
5,N/A,N/A,N/A,1532,1537,N/A,66,1
8,N/A,N/A,N/A,1524,1532,N/A,69,4
4,N/A,N/A,N/A,1520,1524,N/A,73,2
6,N/A,N/A,N/A,1514,1520,N/A,79,2
9,N/A,N/A,N/A,1505,1514,N/A,82,5
4,N/A,N/A,N/A,1501,1505,N/A,85,2
4,N/A,N/A,N/A,1497,1501,N/A,90,1
5,N/A,N/A,N/A,1492,1497,N/A,96,1
18,N/A,N/A,N/A,1474,1492,N/A,101,6
7,N/A,N/A,N/A,1467,1474,N/A,104,3
14,N/A,N/A,N/A,1453,1467,N/A,107,6
7,N/A,N/A,N/A,1446,1453,N/A,110,3
7,N/A,N/A,N/A,1439,1446,N/A,115,2
7,N/A,N/A,N/A,1432,1439,N/A,121,2
6,N/A,N/A,N/A,1426,1432,N/A,127,2
7,N/A,N/A,N/A,1419,1426,N/A,133,2
10,N/A,N/A,N/A,1409,1419,N/A,136,5
4,N/A,N/A,N/A,1420,1424,N/A,4,1
4,N/A,N/A,N/A,1416,1420,N/A,10,1
5,N/A,N/A,N/A,1411,1416,N/A,16,1
4,N/A,N/A,N/A,1407,1411,N/A,22,1
5,N/A,N/A,N/A,1402,1407,N/A,28,1
4,N/A,N/A,N/A,1398,1402,N/A,34,1
8,N/A,N/A,N/A,1390,1398,N/A,37,4
4,N/A,N/A,N/A,1386,1390,N/A,40,1
8,N/A,N/A,N/A,1378,1386,N/A,43,4
5,N/A,N/A,N/A,1373,1378,N/A,47,2
9,N/A,N/A,N/A,1364,1373,N/A,50,5
11,N/A,N/A,N/A,1353,1364,N/A,56,5
5,N/A,N/A,N/A,1348,1353,N/A,60,3
15,N/A,N/A,N/A,1333,1348,N/A,63,6
6,N/A,N/A,N/A,1327,1333,N/A,66,3
4,N/A,N/A,N/A,1323,1327,N/A,72,3
18,N/A,N/A,N/A,1305,1323,N/A,75,6
4,N/A,N/A,N/A,1301,1305,N/A,78,3
7,N/A,N/A,N/A,1294,1301,N/A,84,3
6,N/A,N/A,N/A,1288,1294,N/A,90,3
4,N/A,N/A,N/A,1284,1288,N/A,95,2
10,N/A,N/A,N/A,1274,1284,N/A,99,6
7,N/A,N/A,N/A,1267,1274,N/A,103,4
5,N/A,N/A,N/A,1262,1267,N/A,106,1
12,N/A,N/A,N/A,1250,1262,N/A,111,6
8,N/A,N/A,N/A,1242,1250,N/A,115,4
4,N/A,N/A,N/A,1238,1242,N/A,118,1
7,N/A,N/A,N/A,1231,1238,N/A,121,4
7,N/A,N/A,N/A,1224,1231,N/A,126,3
6,N/A,N/A,N/A,1218,1224,N/A,132,3
5,N/A,N/A,N/A,1354,1359,N/A,4,3
4,N/A,N/A,N/A,1350,1354,N/A,8,1
4,N/A,N/A,N/A,1346,1350,N/A,14,1
16,N/A,N/A,N/A,1330,1346,N/A,19,6
6,N/A,N/A,N/A,1324,1330,N/A,22,3
7,N/A,N/A,N/A,1317,1324,N/A,28,3
17,N/A,N/A,N/A,1300,1317,N/A,31,6
7,N/A,N/A,N/A,1293,1300,N/A,34,3
6,N/A,N/A,N/A,1287,1293,N/A,40,3
6,N/A,N/A,N/A,1281,1287,N/A,46,3
6,N/A,N/A,N/A,1275,1281,N/A,51,2
10,N/A,N/A,N/A,1265,1275,N/A,54,5
8,N/A,N/A,N/A,1257,1265,N/A,59,4
7,N/A,N/A,N/A,1250,1257,N/A,65,4
6,N/A,N/A,N/A,1244,1250,N/A,70,3
7,N/A,N/A,N/A,1237,1244,N/A,76,3
6,N/A,N/A,N/A,1231,1237,N/A,81,2
6,N/A,N/A,N/A,1225,1231,N/A,87,2
4,N/A,N/A,N/A,1221,1225,N/A,92,1
10,N/A,N/A,N/A,1211,1221,N/A,97,6
5,N/A,N/A,N/A,1206,1211,N/A,103,0
8,N/A,N/A,N/A,1198,1206,N/A,107,4
5,N/A,N/A,N/A,1193,1198,N/A,113,4
8,N/A,N/A,N/A,1185,1193,N/A,119,4
8,N/A,N/A,N/A,1177,1185,N/A,125,4
5,N/A,N/A,N/A,1172,1177,N/A,129,2
11,N/A,N/A,N/A,1161,1172,N/A,132,5
7,N/A,N/A,N/A,1154,1161,N/A,136,3
6,N/A,N/A,N/A,1148,1154,N/A,142,3
13,N/A,N/A,N/A,1135,1148,N/A,145,6
13,N/A,N/A,N/A,1913,1926,N/A,6,6
5,N/A,N/A,N/A,1908,1913,N/A,12,0
7,N/A,N/A,N/A,1901,1908,N/A,16,4
6,N/A,N/A,N/A,1895,1901,N/A,22,4
7,N/A,N/A,N/A,1888,1895,N/A,27,3
13,N/A,N/A,N/A,1875,1888,N/A,30,6
4,N/A,N/A,N/A,1871,1875,N/A,33,3
4,N/A,N/A,N/A,1867,1871,N/A,37,1
9,N/A,N/A,N/A,1858,1867,N/A,41,5
4,N/A,N/A,N/A,1854,1858,N/A,44,2
4,N/A,N/A,N/A,1850,1854,N/A,49,1
10,N/A,N/A,N/A,1840,1850,N/A,53,5
4,N/A,N/A,N/A,1836,1840,N/A,56,2
5,N/A,N/A,N/A,1831,1836,N/A,61,1
12,N/A,N/A,N/A,1819,1831,N/A,65,5
5,N/A,N/A,N/A,1814,1819,N/A,70,4
5,N/A,N/A,N/A,1809,1814,N/A,73,1
6,N/A,N/A,N/A,1803,1809,N/A,76,4
7,N/A,N/A,N/A,1796,1803,N/A,81,3
10,N/A,N/A,N/A,1786,1796,N/A,84,6
5,N/A,N/A,N/A,1781,1786,N/A,88,4
7,N/A,N/A,N/A,1774,1781,N/A,92,2
12,N/A,N/A,N/A,1762,1774,N/A,95,5
4,N/A,N/A,N/A,1758,1762,N/A,99,3
12,N/A,N/A,N/A,1746,1758,N/A,102,6
7,N/A,N/A,N/A,1739,1746,N/A,106,4
5,N/A,N/A,N/A,1734,1739,N/A,111,3
5,N/A,N/A,N/A,1729,1734,N/A,117,3
14,N/A,N/A,N/A,1715,1729,N/A,120,6
7,N/A,N/A,N/A,1708,1715,N/A,123,3
6,N/A,N/A,N/A,491,497,N/A,3,4
6,N/A,N/A,N/A,485,491,N/A,9,4
5,N/A,N/A,N/A,480,485,N/A,12,1
16,N/A,N/A,N/A,464,480,N/A,17,6
8,N/A,N/A,N/A,456,464,N/A,21,4
6,N/A,N/A,N/A,450,456,N/A,27,4
5,N/A,N/A,N/A,445,450,N/A,30,1
14,N/A,N/A,N/A,431,445,N/A,35,6
11,N/A,N/A,N/A,420,431,N/A,40,5
4,N/A,N/A,N/A,416,420,N/A,44,3
4,N/A,N/A,N/A,412,416,N/A,48,1
15,N/A,N/A,N/A,397,412,N/A,53,6
5,N/A,N/A,N/A,392,397,N/A,56,3
6,N/A,N/A,N/A,386,392,N/A,62,3
6,N/A,N/A,N/A,380,386,N/A,67,2
19,N/A,N/A,N/A,361,380,N/A,71,6
11,N/A,N/A,N/A,350,361,N/A,76,5
5,N/A,N/A,N/A,345,350,N/A,81,4
4,N/A,N/A,N/A,341,345,N/A,86,3
5,N/A,N/A,N/A,336,341,N/A,91,2
9,N/A,N/A,N/A,327,336,N/A,94,5
6,N/A,N/A,N/A,321,327,N/A,97,2
11,N/A,N/A,N/A,310,321,N/A,100,5
5,N/A,N/A,N/A,305,310,N/A,103,2
4,N/A,N/A,N/A,301,305,N/A,109,2
7,N/A,N/A,N/A,294,301,N/A,115,2
9,N/A,N/A,N/A,285,294,N/A,118,5
12,N/A,N/A,N/A,273,285,N/A,124,5
5,N/A,N/A,N/A,268,273,N/A,128,3
4,N/A,N/A,N/A,264,268,N/A,132,1
8,N/A,N/A,N/A,1785,1793,N/A,5,4
7,N/A,N/A,N/A,1778,1785,N/A,10,3
10,N/A,N/A,N/A,1768,1778,N/A,13,6
9,N/A,N/A,N/A,1759,1768,N/A,18,5
7,N/A,N/A,N/A,1752,1759,N/A,22,3
18,N/A,N/A,N/A,1734,1752,N/A,25,6
11,N/A,N/A,N/A,1723,1734,N/A,30,5
5,N/A,N/A,N/A,1718,1723,N/A,34,3
7,N/A,N/A,N/A,1711,1718,N/A,39,2
5,N/A,N/A,N/A,1706,1711,N/A,44,1
5,N/A,N/A,N/A,1701,1706,N/A,50,1
4,N/A,N/A,N/A,1697,1701,N/A,56,1
13,N/A,N/A,N/A,1684,1697,N/A,61,6
7,N/A,N/A,N/A,1677,1684,N/A,64,3
5,N/A,N/A,N/A,1672,1677,N/A,68,1
16,N/A,N/A,N/A,1656,1672,N/A,73,6
5,N/A,N/A,N/A,1651,1656,N/A,77,4
6,N/A,N/A,N/A,1645,1651,N/A,83,4
5,N/A,N/A,N/A,1640,1645,N/A,86,1
8,N/A,N/A,N/A,1632,1640,N/A,89,4
4,N/A,N/A,N/A,1628,1632,N/A,92,1
17,N/A,N/A,N/A,1611,1628,N/A,97,6
5,N/A,N/A,N/A,1606,1611,N/A,100,3
7,N/A,N/A,N/A,1599,1606,N/A,105,2
4,N/A,N/A,N/A,1595,1599,N/A,111,2
15,N/A,N/A,N/A,1580,1595,N/A,115,6
5,N/A,N/A,N/A,1575,1580,N/A,121,0
10,N/A,N/A,N/A,1565,1575,N/A,126,5
7,N/A,N/A,N/A,1558,1565,N/A,131,4
6,N/A,N/A,N/A,1552,1558,N/A,135,2
6,N/A,N/A,N/A,872,878,N/A,4,2
7,N/A,N/A,N/A,865,872,N/A,10,2
4,N/A,N/A,N/A,861,865,N/A,16,2
6,N/A,N/A,N/A,855,861,N/A,22,2
11,N/A,N/A,N/A,844,855,N/A,26,6
4,N/A,N/A,N/A,840,844,N/A,29,3
12,N/A,N/A,N/A,828,840,N/A,32,6
5,N/A,N/A,N/A,823,828,N/A,35,3
4,N/A,N/A,N/A,819,823,N/A,39,1
7,N/A,N/A,N/A,812,819,N/A,42,4
8,N/A,N/A,N/A,804,812,N/A,48,4
4,N/A,N/A,N/A,800,804,N/A,51,1
11,N/A,N/A,N/A,789,800,N/A,56,6
4,N/A,N/A,N/A,785,789,N/A,59,3
5,N/A,N/A,N/A,780,785,N/A,64,2
10,N/A,N/A,N/A,770,780,N/A,68,6
11,N/A,N/A,N/A,759,770,N/A,73,5
5,N/A,N/A,N/A,754,759,N/A,77,3
4,N/A,N/A,N/A,750,754,N/A,83,3
5,N/A,N/A,N/A,745,750,N/A,87,1
12,N/A,N/A,N/A,733,745,N/A,91,5
6,N/A,N/A,N/A,727,733,N/A,95,3
5,N/A,N/A,N/A,722,727,N/A,99,1
19,N/A,N/A,N/A,703,722,N/A,104,6
8,N/A,N/A,N/A,695,703,N/A,108,4
6,N/A,N/A,N/A,689,695,N/A,113,3
5,N/A,N/A,N/A,684,689,N/A,119,3
5,N/A,N/A,N/A,679,684,N/A,124,2
5,N/A,N/A,N/A,674,679,N/A,129,1
10,N/A,N/A,N/A,664,674,N/A,134,6
4,N/A,N/A,N/A,1715,1719,N/A,6,1
6,N/A,N/A,N/A,1709,1715,N/A,9,4
4,N/A,N/A,N/A,1705,1709,N/A,13,2
4,N/A,N/A,N/A,1701,1705,N/A,19,2
12,N/A,N/A,N/A,1689,1701,N/A,23,6
11,N/A,N/A,N/A,1678,1689,N/A,28,5
7,N/A,N/A,N/A,1671,1678,N/A,32,3
18,N/A,N/A,N/A,1653,1671,N/A,35,6
12,N/A,N/A,N/A,1641,1653,N/A,40,5
5,N/A,N/A,N/A,1636,1641,N/A,43,2
7,N/A,N/A,N/A,1629,1636,N/A,49,2
16,N/A,N/A,N/A,1613,1629,N/A,53,6
4,N/A,N/A,N/A,1609,1613,N/A,59,0
4,N/A,N/A,N/A,1605,1609,N/A,62,3
7,N/A,N/A,N/A,1598,1605,N/A,68,3
5,N/A,N/A,N/A,1593,1598,N/A,74,3
11,N/A,N/A,N/A,1582,1593,N/A,77,6
10,N/A,N/A,N/A,1572,1582,N/A,82,5
6,N/A,N/A,N/A,1566,1572,N/A,85,2
13,N/A,N/A,N/A,1553,1566,N/A,89,6
4,N/A,N/A,N/A,1549,1553,N/A,95,0
10,N/A,N/A,N/A,1539,1549,N/A,100,5
11,N/A,N/A,N/A,1528,1539,N/A,106,5
4,N/A,N/A,N/A,1524,1528,N/A,109,2
10,N/A,N/A,N/A,1514,1524,N/A,112,5
10,N/A,N/A,N/A,1504,1514,N/A,118,5
12,N/A,N/A,N/A,1492,1504,N/A,124,5
8,N/A,N/A,N/A,1484,1492,N/A,129,4
6,N/A,N/A,N/A,1478,1484,N/A,135,4
6,N/A,N/A,N/A,1472,1478,N/A,140,3
4,N/A,N/A,N/A,849,853,N/A,6,2
5,N/A,N/A,N/A,844,849,N/A,12,2
6,N/A,N/A,N/A,838,844,N/A,18,2
10,N/A,N/A,N/A,828,838,N/A,21,5
4,N/A,N/A,N/A,824,828,N/A,25,3
7,N/A,N/A,N/A,817,824,N/A,30,2
19,N/A,N/A,N/A,798,817,N/A,34,6
4,N/A,N/A,N/A,794,798,N/A,40,0
4,N/A,N/A,N/A,790,794,N/A,43,3
5,N/A,N/A,N/A,785,790,N/A,47,1
10,N/A,N/A,N/A,775,785,N/A,51,5
6,N/A,N/A,N/A,769,775,N/A,56,4
7,N/A,N/A,N/A,762,769,N/A,61,3
13,N/A,N/A,N/A,749,762,N/A,64,6
4,N/A,N/A,N/A,745,749,N/A,70,0
9,N/A,N/A,N/A,736,745,N/A,75,5
7,N/A,N/A,N/A,729,736,N/A,78,2
9,N/A,N/A,N/A,720,729,N/A,81,5
5,N/A,N/A,N/A,715,720,N/A,84,2
11,N/A,N/A,N/A,704,715,N/A,88,6
6,N/A,N/A,N/A,698,704,N/A,92,4
6,N/A,N/A,N/A,692,698,N/A,98,4
6,N/A,N/A,N/A,686,692,N/A,103,3
4,N/A,N/A,N/A,682,686,N/A,107,1
5,N/A,N/A,N/A,677,682,N/A,110,4
4,N/A,N/A,N/A,673,677,N/A,113,1
12,N/A,N/A,N/A,661,673,N/A,117,5
9,N/A,N/A,N/A,652,661,N/A,123,5
10,N/A,N/A,N/A,642,652,N/A,129,5
8,N/A,N/A,N/A,634,642,N/A,134,4
5,N/A,N/A,N/A,442,447,N/A,3,4
5,N/A,N/A,N/A,437,442,N/A,7,2
4,N/A,N/A,N/A,433,437,N/A,12,1
8,N/A,N/A,N/A,425,433,N/A,15,4
4,N/A,N/A,N/A,421,425,N/A,19,2
7,N/A,N/A,N/A,414,421,N/A,25,2
10,N/A,N/A,N/A,404,414,N/A,29,6
6,N/A,N/A,N/A,398,404,N/A,33,4
7,N/A,N/A,N/A,391,398,N/A,37,2
9,N/A,N/A,N/A,382,391,N/A,40,5
6,N/A,N/A,N/A,376,382,N/A,44,3
13,N/A,N/A,N/A,363,376,N/A,47,6
5,N/A,N/A,N/A,358,363,N/A,51,4
8,N/A,N/A,N/A,350,358,N/A,57,4
5,N/A,N/A,N/A,345,350,N/A,60,1
9,N/A,N/A,N/A,336,345,N/A,64,5
9,N/A,N/A,N/A,327,336,N/A,70,5
8,N/A,N/A,N/A,319,327,N/A,75,4
6,N/A,N/A,N/A,313,319,N/A,79,2
6,N/A,N/A,N/A,307,313,N/A,85,2
16,N/A,N/A,N/A,291,307,N/A,89,6
5,N/A,N/A,N/A,286,291,N/A,92,3
6,N/A,N/A,N/A,280,286,N/A,97,2
6,N/A,N/A,N/A,274,280,N/A,103,2
12,N/A,N/A,N/A,262,274,N/A,106,5
11,N/A,N/A,N/A,251,262,N/A,112,5
5,N/A,N/A,N/A,246,251,N/A,115,2
6,N/A,N/A,N/A,240,246,N/A,121,2
18,N/A,N/A,N/A,222,240,N/A,125,6
6,N/A,N/A,N/A,216,222,N/A,128,3
5,N/A,N/A,N/A,1836,1841,N/A,4,3
4,N/A,N/A,N/A,1832,1836,N/A,10,3
4,N/A,N/A,N/A,1828,1832,N/A,16,3
11,N/A,N/A,N/A,1817,1828,N/A,19,6
5,N/A,N/A,N/A,1812,1817,N/A,25,0
14,N/A,N/A,N/A,1798,1812,N/A,31,6
12,N/A,N/A,N/A,1786,1798,N/A,36,5
5,N/A,N/A,N/A,1781,1786,N/A,39,2
4,N/A,N/A,N/A,1777,1781,N/A,44,1
10,N/A,N/A,N/A,1767,1777,N/A,48,5
6,N/A,N/A,N/A,1761,1767,N/A,51,2
5,N/A,N/A,N/A,1756,1761,N/A,57,2
4,N/A,N/A,N/A,1752,1756,N/A,62,1
4,N/A,N/A,N/A,1748,1752,N/A,68,1
11,N/A,N/A,N/A,1737,1748,N/A,73,6
10,N/A,N/A,N/A,1727,1737,N/A,78,5
11,N/A,N/A,N/A,1716,1727,N/A,84,5
8,N/A,N/A,N/A,1708,1716,N/A,89,4
6,N/A,N/A,N/A,1702,1708,N/A,94,3
18,N/A,N/A,N/A,1684,1702,N/A,97,6
5,N/A,N/A,N/A,1679,1684,N/A,101,4
8,N/A,N/A,N/A,1671,1679,N/A,107,4
6,N/A,N/A,N/A,1665,1671,N/A,112,3
7,N/A,N/A,N/A,1658,1665,N/A,118,3
4,N/A,N/A,N/A,1654,1658,N/A,122,1
16,N/A,N/A,N/A,1638,1654,N/A,127,6
8,N/A,N/A,N/A,1630,1638,N/A,131,4
4,N/A,N/A,N/A,1626,1630,N/A,134,1
12,N/A,N/A,N/A,1614,1626,N/A,138,5
4,N/A,N/A,N/A,1610,1614,N/A,141,2
7,N/A,N/A,N/A,1611,1618,N/A,6,3
4,N/A,N/A,N/A,1607,1611,N/A,12,3
4,N/A,N/A,N/A,1603,1607,N/A,18,3
16,N/A,N/A,N/A,1587,1603,N/A,21,6
12,N/A,N/A,N/A,1575,1587,N/A,26,5
7,N/A,N/A,N/A,1568,1575,N/A,31,4
5,N/A,N/A,N/A,1563,1568,N/A,34,1
4,N/A,N/A,N/A,1559,1563,N/A,40,1
5,N/A,N/A,N/A,1554,1559,N/A,46,1
17,N/A,N/A,N/A,1537,1554,N/A,51,6
4,N/A,N/A,N/A,1533,1537,N/A,57,0
11,N/A,N/A,N/A,1522,1533,N/A,62,5
7,N/A,N/A,N/A,1515,1522,N/A,67,4
5,N/A,N/A,N/A,1510,1515,N/A,70,1
4,N/A,N/A,N/A,1506,1510,N/A,76,1
9,N/A,N/A,N/A,1497,1506,N/A,80,5
4,N/A,N/A,N/A,1493,1497,N/A,83,2
5,N/A,N/A,N/A,1488,1493,N/A,89,2
5,N/A,N/A,N/A,1483,1488,N/A,95,2
12,N/A,N/A,N/A,1471,1483,N/A,98,5
7,N/A,N/A,N/A,1464,1471,N/A,101,2
18,N/A,N/A,N/A,1446,1464,N/A,105,6
11,N/A,N/A,N/A,1435,1446,N/A,110,5
5,N/A,N/A,N/A,1430,1435,N/A,115,4
7,N/A,N/A,N/A,1423,1430,N/A,120,3
11,N/A,N/A,N/A,1412,1423,N/A,123,6
5,N/A,N/A,N/A,1407,1412,N/A,129,0
7,N/A,N/A,N/A,1400,1407,N/A,133,4
4,N/A,N/A,N/A,1396,1400,N/A,136,1
10,N/A,N/A,N/A,1386,1396,N/A,140,5
6,N/A,N/A,N/A,880,886,N/A,4,2
9,N/A,N/A,N/A,871,880,N/A,7,5
9,N/A,N/A,N/A,862,871,N/A,13,5
5,N/A,N/A,N/A,857,862,N/A,16,2
5,N/A,N/A,N/A,852,857,N/A,22,2
4,N/A,N/A,N/A,848,852,N/A,27,1
8,N/A,N/A,N/A,840,848,N/A,30,4
4,N/A,N/A,N/A,836,840,N/A,34,2
10,N/A,N/A,N/A,826,836,N/A,38,6
6,N/A,N/A,N/A,820,826,N/A,42,4
7,N/A,N/A,N/A,813,820,N/A,46,2
4,N/A,N/A,N/A,809,813,N/A,51,1
4,N/A,N/A,N/A,805,809,N/A,57,1
7,N/A,N/A,N/A,798,805,N/A,60,4
7,N/A,N/A,N/A,791,798,N/A,64,2
9,N/A,N/A,N/A,782,791,N/A,67,5
4,N/A,N/A,N/A,778,782,N/A,71,3
4,N/A,N/A,N/A,774,778,N/A,76,2
5,N/A,N/A,N/A,769,774,N/A,82,2
5,N/A,N/A,N/A,764,769,N/A,87,1
11,N/A,N/A,N/A,753,764,N/A,91,5
7,N/A,N/A,N/A,746,753,N/A,94,2
4,N/A,N/A,N/A,742,746,N/A,99,1
6,N/A,N/A,N/A,736,742,N/A,102,4
6,N/A,N/A,N/A,730,736,N/A,106,2
4,N/A,N/A,N/A,726,730,N/A,111,1
6,N/A,N/A,N/A,720,726,N/A,114,4
5,N/A,N/A,N/A,715,720,N/A,117,1
11,N/A,N/A,N/A,704,715,N/A,122,6
6,N/A,N/A,N/A,698,704,N/A,125,3
10,N/A,N/A,N/A,1055,1065,N/A,4,5
6,N/A,N/A,N/A,1049,1055,N/A,8,3
4,N/A,N/A,N/A,1045,1049,N/A,12,1
11,N/A,N/A,N/A,1034,1045,N/A,17,6
5,N/A,N/A,N/A,1029,1034,N/A,20,3
6,N/A,N/A,N/A,1023,1029,N/A,25,2
15,N/A,N/A,N/A,1008,1023,N/A,29,6
8,N/A,N/A,N/A,1000,1008,N/A,33,4
4,N/A,N/A,N/A,996,1000,N/A,38,3
13,N/A,N/A,N/A,983,996,N/A,41,6
5,N/A,N/A,N/A,978,983,N/A,45,4
5,N/A,N/A,N/A,973,978,N/A,51,4
5,N/A,N/A,N/A,968,973,N/A,54,1
10,N/A,N/A,N/A,958,968,N/A,58,5
4,N/A,N/A,N/A,954,958,N/A,61,2
11,N/A,N/A,N/A,943,954,N/A,64,5
7,N/A,N/A,N/A,936,943,N/A,68,3
4,N/A,N/A,N/A,932,936,N/A,72,1
10,N/A,N/A,N/A,922,932,N/A,76,5
5,N/A,N/A,N/A,917,922,N/A,81,4
8,N/A,N/A,N/A,909,917,N/A,87,4
7,N/A,N/A,N/A,902,909,N/A,93,4
7,N/A,N/A,N/A,895,902,N/A,98,3
4,N/A,N/A,N/A,891,895,N/A,102,1
11,N/A,N/A,N/A,880,891,N/A,106,5
9,N/A,N/A,N/A,871,880,N/A,112,5
4,N/A,N/A,N/A,867,871,N/A,115,2
6,N/A,N/A,N/A,861,867,N/A,121,2
5,N/A,N/A,N/A,856,861,N/A,127,2
7,N/A,N/A,N/A,849,856,N/A,133,2
12,N/A,N/A,N/A,859,871,N/A,5,5
12,N/A,N/A,N/A,847,859,N/A,11,5
5,N/A,N/A,N/A,842,847,N/A,14,2
9,N/A,N/A,N/A,833,842,N/A,17,5
5,N/A,N/A,N/A,828,833,N/A,20,2
12,N/A,N/A,N/A,816,828,N/A,24,6
4,N/A,N/A,N/A,812,816,N/A,30,0
10,N/A,N/A,N/A,802,812,N/A,35,5
8,N/A,N/A,N/A,794,802,N/A,40,4
8,N/A,N/A,N/A,786,794,N/A,46,4
4,N/A,N/A,N/A,782,786,N/A,49,1
12,N/A,N/A,N/A,770,782,N/A,53,5
11,N/A,N/A,N/A,759,770,N/A,59,5
12,N/A,N/A,N/A,747,759,N/A,65,5
7,N/A,N/A,N/A,740,747,N/A,69,3
6,N/A,N/A,N/A,734,740,N/A,74,2
18,N/A,N/A,N/A,716,734,N/A,78,6
12,N/A,N/A,N/A,704,716,N/A,83,5
12,N/A,N/A,N/A,692,704,N/A,89,5
11,N/A,N/A,N/A,681,692,N/A,95,5
4,N/A,N/A,N/A,677,681,N/A,98,2
4,N/A,N/A,N/A,673,677,N/A,103,1
17,N/A,N/A,N/A,656,673,N/A,108,6
5,N/A,N/A,N/A,651,656,N/A,112,4
6,N/A,N/A,N/A,645,651,N/A,116,2
5,N/A,N/A,N/A,640,645,N/A,122,2
5,N/A,N/A,N/A,635,640,N/A,127,1
5,N/A,N/A,N/A,630,635,N/A,133,1
5,N/A,N/A,N/A,625,630,N/A,136,4
4,N/A,N/A,N/A,621,625,N/A,139,1
7,N/A,N/A,N/A,456,463,N/A,6,3
7,N/A,N/A,N/A,449,456,N/A,11,2
4,N/A,N/A,N/A,445,449,N/A,17,2
7,N/A,N/A,N/A,438,445,N/A,23,2
11,N/A,N/A,N/A,427,438,N/A,27,6
6,N/A,N/A,N/A,421,427,N/A,31,4
8,N/A,N/A,N/A,413,421,N/A,37,4
6,N/A,N/A,N/A,407,413,N/A,41,2
11,N/A,N/A,N/A,396,407,N/A,44,5
11,N/A,N/A,N/A,385,396,N/A,50,5
6,N/A,N/A,N/A,379,385,N/A,53,2
18,N/A,N/A,N/A,361,379,N/A,57,6
7,N/A,N/A,N/A,354,361,N/A,61,4
7,N/A,N/A,N/A,347,354,N/A,65,2
4,N/A,N/A,N/A,343,347,N/A,70,1
4,N/A,N/A,N/A,339,343,N/A,76,1
4,N/A,N/A,N/A,335,339,N/A,82,1
5,N/A,N/A,N/A,330,335,N/A,88,1
5,N/A,N/A,N/A,325,330,N/A,94,1
11,N/A,N/A,N/A,314,325,N/A,98,5
9,N/A,N/A,N/A,305,314,N/A,104,5
4,N/A,N/A,N/A,301,305,N/A,107,2
13,N/A,N/A,N/A,288,301,N/A,111,6
5,N/A,N/A,N/A,283,288,N/A,117,0
5,N/A,N/A,N/A,278,283,N/A,121,4
6,N/A,N/A,N/A,272,278,N/A,127,4
5,N/A,N/A,N/A,267,272,N/A,130,1
10,N/A,N/A,N/A,257,267,N/A,134,5
4,N/A,N/A,N/A,253,257,N/A,138,3
5,N/A,N/A,N/A,248,253,N/A,143,2
5,N/A,N/A,N/A,1841,1846,N/A,3,2
16,N/A,N/A,N/A,1825,1841,N/A,7,6
8,N/A,N/A,N/A,1817,1825,N/A,11,4
6,N/A,N/A,N/A,1811,1817,N/A,15,2
10,N/A,N/A,N/A,1801,1811,N/A,18,5
6,N/A,N/A,N/A,1795,1801,N/A,22,3
4,N/A,N/A,N/A,1791,1795,N/A,28,3
6,N/A,N/A,N/A,1785,1791,N/A,33,2
17,N/A,N/A,N/A,1768,1785,N/A,37,6
10,N/A,N/A,N/A,1758,1768,N/A,42,5
4,N/A,N/A,N/A,1754,1758,N/A,45,2
7,N/A,N/A,N/A,1747,1754,N/A,51,2
10,N/A,N/A,N/A,1737,1747,N/A,54,5
6,N/A,N/A,N/A,1731,1737,N/A,58,3
5,N/A,N/A,N/A,1726,1731,N/A,62,1
8,N/A,N/A,N/A,1718,1726,N/A,65,4
5,N/A,N/A,N/A,1713,1718,N/A,70,3
5,N/A,N/A,N/A,1708,1713,N/A,75,2
12,N/A,N/A,N/A,1696,1708,N/A,78,5
9,N/A,N/A,N/A,1687,1696,N/A,84,5
7,N/A,N/A,N/A,1680,1687,N/A,87,2
4,N/A,N/A,N/A,1676,1680,N/A,92,1
7,N/A,N/A,N/A,1669,1676,N/A,95,4
5,N/A,N/A,N/A,1664,1669,N/A,98,1
11,N/A,N/A,N/A,1653,1664,N/A,102,5
5,N/A,N/A,N/A,1648,1653,N/A,106,3
5,N/A,N/A,N/A,1643,1648,N/A,110,1
8,N/A,N/A,N/A,1635,1643,N/A,113,4
6,N/A,N/A,N/A,1629,1635,N/A,119,4
6,N/A,N/A,N/A,1623,1629,N/A,125,4
19,N/A,N/A,N/A,1670,1689,N/A,5,6
7,N/A,N/A,N/A,1663,1670,N/A,8,3
6,N/A,N/A,N/A,1657,1663,N/A,13,2
9,N/A,N/A,N/A,1648,1657,N/A,16,5
7,N/A,N/A,N/A,1641,1648,N/A,21,4
7,N/A,N/A,N/A,1634,1641,N/A,26,3
4,N/A,N/A,N/A,1630,1634,N/A,31,2
11,N/A,N/A,N/A,1619,1630,N/A,34,5
5,N/A,N/A,N/A,1614,1619,N/A,37,2
11,N/A,N/A,N/A,1603,1614,N/A,40,5
5,N/A,N/A,N/A,1598,1603,N/A,43,2
10,N/A,N/A,N/A,1588,1598,N/A,47,6
4,N/A,N/A,N/A,1584,1588,N/A,53,0
12,N/A,N/A,N/A,1572,1584,N/A,59,6
7,N/A,N/A,N/A,1565,1572,N/A,62,3
5,N/A,N/A,N/A,1560,1565,N/A,66,1
4,N/A,N/A,N/A,1556,1560,N/A,72,1
4,N/A,N/A,N/A,1552,1556,N/A,78,1
10,N/A,N/A,N/A,1542,1552,N/A,82,5
8,N/A,N/A,N/A,1534,1542,N/A,87,4
4,N/A,N/A,N/A,1530,1534,N/A,92,3
11,N/A,N/A,N/A,1519,1530,N/A,95,6
5,N/A,N/A,N/A,1514,1519,N/A,101,0
8,N/A,N/A,N/A,1506,1514,N/A,105,4
5,N/A,N/A,N/A,1501,1506,N/A,110,3
11,N/A,N/A,N/A,1490,1501,N/A,113,6
5,N/A,N/A,N/A,1485,1490,N/A,117,4
7,N/A,N/A,N/A,1478,1485,N/A,123,4
4,N/A,N/A,N/A,1474,1478,N/A,128,3
4,N/A,N/A,N/A,1470,1474,N/A,132,1
16,N/A,N/A,N/A,1064,1080,N/A,5,6
4,N/A,N/A,N/A,1060,1064,N/A,8,3
10,N/A,N/A,N/A,1050,1060,N/A,11,6
5,N/A,N/A,N/A,1045,1050,N/A,14,3
5,N/A,N/A,N/A,1040,1045,N/A,19,2
4,N/A,N/A,N/A,1036,1040,N/A,25,2
12,N/A,N/A,N/A,1024,1036,N/A,28,5
6,N/A,N/A,N/A,1018,1024,N/A,33,4
4,N/A,N/A,N/A,1014,1018,N/A,36,1
4,N/A,N/A,N/A,1010,1014,N/A,42,1
4,N/A,N/A,N/A,1006,1010,N/A,48,1
10,N/A,N/A,N/A,996,1006,N/A,52,5
5,N/A,N/A,N/A,991,996,N/A,55,2
5,N/A,N/A,N/A,986,991,N/A,61,2
13,N/A,N/A,N/A,973,986,N/A,65,6
4,N/A,N/A,N/A,969,973,N/A,71,0
5,N/A,N/A,N/A,964,969,N/A,75,4
5,N/A,N/A,N/A,959,964,N/A,79,2
5,N/A,N/A,N/A,954,959,N/A,84,1
5,N/A,N/A,N/A,949,954,N/A,90,1
5,N/A,N/A,N/A,944,949,N/A,96,1
9,N/A,N/A,N/A,935,944,N/A,100,5
5,N/A,N/A,N/A,930,935,N/A,105,4
6,N/A,N/A,N/A,924,930,N/A,111,4
4,N/A,N/A,N/A,920,924,N/A,114,1
5,N/A,N/A,N/A,915,920,N/A,117,4
4,N/A,N/A,N/A,911,915,N/A,120,1
4,N/A,N/A,N/A,907,911,N/A,126,1
8,N/A,N/A,N/A,899,907,N/A,129,4
7,N/A,N/A,N/A,892,899,N/A,135,4
11,N/A,N/A,N/A,455,466,N/A,4,5
7,N/A,N/A,N/A,448,455,N/A,8,3
16,N/A,N/A,N/A,432,448,N/A,11,6
6,N/A,N/A,N/A,426,432,N/A,15,4
5,N/A,N/A,N/A,421,426,N/A,21,4
8,N/A,N/A,N/A,413,421,N/A,27,4
6,N/A,N/A,N/A,407,413,N/A,33,4
8,N/A,N/A,N/A,399,407,N/A,39,4
4,N/A,N/A,N/A,395,399,N/A,44,3
4,N/A,N/A,N/A,391,395,N/A,49,2
18,N/A,N/A,N/A,373,391,N/A,53,6
11,N/A,N/A,N/A,362,373,N/A,58,5
5,N/A,N/A,N/A,357,362,N/A,62,3
4,N/A,N/A,N/A,353,357,N/A,66,1
4,N/A,N/A,N/A,349,353,N/A,72,1
13,N/A,N/A,N/A,336,349,N/A,77,6
6,N/A,N/A,N/A,330,336,N/A,81,4
5,N/A,N/A,N/A,325,330,N/A,85,2
7,N/A,N/A,N/A,318,325,N/A,91,2
4,N/A,N/A,N/A,314,318,N/A,96,1
7,N/A,N/A,N/A,307,314,N/A,99,4
5,N/A,N/A,N/A,302,307,N/A,105,4
6,N/A,N/A,N/A,296,302,N/A,110,3
12,N/A,N/A,N/A,284,296,N/A,113,6
6,N/A,N/A,N/A,278,284,N/A,116,3
4,N/A,N/A,N/A,274,278,N/A,121,2
4,N/A,N/A,N/A,270,274,N/A,126,1
6,N/A,N/A,N/A,264,270,N/A,129,4
6,N/A,N/A,N/A,258,264,N/A,134,3
4,N/A,N/A,N/A,254,258,N/A,139,2
5,N/A,N/A,N/A,1548,1553,N/A,3,1
12,N/A,N/A,N/A,1536,1548,N/A,7,5
6,N/A,N/A,N/A,1530,1536,N/A,12,4
5,N/A,N/A,N/A,1525,1530,N/A,17,3
4,N/A,N/A,N/A,1521,1525,N/A,21,1
10,N/A,N/A,N/A,1511,1521,N/A,25,5
6,N/A,N/A,N/A,1505,1511,N/A,28,2
12,N/A,N/A,N/A,1493,1505,N/A,31,5
9,N/A,N/A,N/A,1484,1493,N/A,37,5
6,N/A,N/A,N/A,1478,1484,N/A,42,4
7,N/A,N/A,N/A,1471,1478,N/A,47,3
5,N/A,N/A,N/A,1466,1471,N/A,51,1
11,N/A,N/A,N/A,1455,1466,N/A,55,5
9,N/A,N/A,N/A,1446,1455,N/A,61,5
5,N/A,N/A,N/A,1441,1446,N/A,65,3
6,N/A,N/A,N/A,1435,1441,N/A,70,2
4,N/A,N/A,N/A,1431,1435,N/A,76,2
5,N/A,N/A,N/A,1426,1431,N/A,82,2
14,N/A,N/A,N/A,1412,1426,N/A,86,6
6,N/A,N/A,N/A,1406,1412,N/A,89,3
7,N/A,N/A,N/A,1399,1406,N/A,94,2
5,N/A,N/A,N/A,1394,1399,N/A,99,1
8,N/A,N/A,N/A,1386,1394,N/A,102,4
6,N/A,N/A,N/A,1380,1386,N/A,107,3
18,N/A,N/A,N/A,1362,1380,N/A,110,6
9,N/A,N/A,N/A,1353,1362,N/A,115,5
7,N/A,N/A,N/A,1346,1353,N/A,119,3
4,N/A,N/A,N/A,1342,1346,N/A,124,2
18,N/A,N/A,N/A,1324,1342,N/A,128,6
11,N/A,N/A,N/A,1313,1324,N/A,133,5
7,N/A,N/A,N/A,1478,1485,N/A,4,2
5,N/A,N/A,N/A,1473,1478,N/A,9,1
5,N/A,N/A,N/A,1468,1473,N/A,15,1
8,N/A,N/A,N/A,1460,1468,N/A,18,4
7,N/A,N/A,N/A,1453,1460,N/A,24,4
5,N/A,N/A,N/A,1448,1453,N/A,27,1
8,N/A,N/A,N/A,1440,1448,N/A,30,4
7,N/A,N/A,N/A,1433,1440,N/A,36,4
8,N/A,N/A,N/A,1425,1433,N/A,42,4
4,N/A,N/A,N/A,1421,1425,N/A,47,3
4,N/A,N/A,N/A,1417,1421,N/A,51,1
5,N/A,N/A,N/A,1412,1417,N/A,57,1
9,N/A,N/A,N/A,1403,1412,N/A,61,5
6,N/A,N/A,N/A,1397,1403,N/A,65,3
5,N/A,N/A,N/A,1392,1397,N/A,71,3
5,N/A,N/A,N/A,1387,1392,N/A,77,3
7,N/A,N/A,N/A,1380,1387,N/A,83,3
7,N/A,N/A,N/A,1373,1380,N/A,88,2
5,N/A,N/A,N/A,1368,1373,N/A,94,2
6,N/A,N/A,N/A,1362,1368,N/A,100,2
5,N/A,N/A,N/A,1357,1362,N/A,105,1
10,N/A,N/A,N/A,1347,1357,N/A,109,5
9,N/A,N/A,N/A,1338,1347,N/A,115,5
6,N/A,N/A,N/A,1332,1338,N/A,120,4
5,N/A,N/A,N/A,1327,1332,N/A,124,2
4,N/A,N/A,N/A,1323,1327,N/A,129,1
9,N/A,N/A,N/A,1314,1323,N/A,133,5
6,N/A,N/A,N/A,1308,1314,N/A,136,2
4,N/A,N/A,N/A,1304,1308,N/A,141,1
5,N/A,N/A,N/A,1299,1304,N/A,147,1
7,N/A,N/A,N/A,1159,1166,N/A,4,2
4,N/A,N/A,N/A,1155,1159,N/A,10,2
5,N/A,N/A,N/A,1150,1155,N/A,15,1
5,N/A,N/A,N/A,1145,1150,N/A,21,1
9,N/A,N/A,N/A,1136,1145,N/A,25,5
5,N/A,N/A,N/A,1131,1136,N/A,28,2
4,N/A,N/A,N/A,1127,1131,N/A,33,1
5,N/A,N/A,N/A,1122,1127,N/A,36,4
8,N/A,N/A,N/A,1114,1122,N/A,42,4
6,N/A,N/A,N/A,1108,1114,N/A,46,2
12,N/A,N/A,N/A,1096,1108,N/A,49,5
7,N/A,N/A,N/A,1089,1096,N/A,52,2
5,N/A,N/A,N/A,1084,1089,N/A,57,1
6,N/A,N/A,N/A,1078,1084,N/A,60,4
4,N/A,N/A,N/A,1074,1078,N/A,63,1
5,N/A,N/A,N/A,1069,1074,N/A,69,1
5,N/A,N/A,N/A,1064,1069,N/A,75,1
5,N/A,N/A,N/A,1059,1064,N/A,78,4
4,N/A,N/A,N/A,1055,1059,N/A,81,1
18,N/A,N/A,N/A,1037,1055,N/A,86,6
5,N/A,N/A,N/A,1032,1037,N/A,89,3
5,N/A,N/A,N/A,1027,1032,N/A,93,1
5,N/A,N/A,N/A,1022,1027,N/A,99,1
8,N/A,N/A,N/A,1014,1022,N/A,102,4
7,N/A,N/A,N/A,1007,1014,N/A,106,2
5,N/A,N/A,N/A,1002,1007,N/A,111,1
6,N/A,N/A,N/A,996,1002,N/A,114,4
7,N/A,N/A,N/A,989,996,N/A,118,2
12,N/A,N/A,N/A,977,989,N/A,121,5
11,N/A,N/A,N/A,966,977,N/A,127,5
11,N/A,N/A,N/A,1517,1528,N/A,3,5
7,N/A,N/A,N/A,1510,1517,N/A,6,2
10,N/A,N/A,N/A,1500,1510,N/A,9,5
7,N/A,N/A,N/A,1493,1500,N/A,12,2
5,N/A,N/A,N/A,1488,1493,N/A,17,1
12,N/A,N/A,N/A,1476,1488,N/A,22,6
7,N/A,N/A,N/A,1469,1476,N/A,25,3
5,N/A,N/A,N/A,1464,1469,N/A,31,3
5,N/A,N/A,N/A,1459,1464,N/A,35,1
4,N/A,N/A,N/A,1455,1459,N/A,41,1
4,N/A,N/A,N/A,1451,1455,N/A,47,1
12,N/A,N/A,N/A,1439,1451,N/A,51,5
5,N/A,N/A,N/A,1434,1439,N/A,54,2
5,N/A,N/A,N/A,1429,1434,N/A,59,1
4,N/A,N/A,N/A,1425,1429,N/A,65,1
5,N/A,N/A,N/A,1420,1425,N/A,68,4
5,N/A,N/A,N/A,1415,1420,N/A,74,4
5,N/A,N/A,N/A,1410,1415,N/A,78,2
4,N/A,N/A,N/A,1406,1410,N/A,84,2
6,N/A,N/A,N/A,1400,1406,N/A,90,2
4,N/A,N/A,N/A,1396,1400,N/A,95,1
6,N/A,N/A,N/A,1390,1396,N/A,98,4
4,N/A,N/A,N/A,1386,1390,N/A,102,2
17,N/A,N/A,N/A,1369,1386,N/A,106,6
5,N/A,N/A,N/A,1364,1369,N/A,109,3
4,N/A,N/A,N/A,1360,1364,N/A,113,1
5,N/A,N/A,N/A,1355,1360,N/A,116,4
6,N/A,N/A,N/A,1349,1355,N/A,121,3
15,N/A,N/A,N/A,1334,1349,N/A,124,6
5,N/A,N/A,N/A,1329,1334,N/A,130,0
10,N/A,N/A,N/A,302,312,N/A,5,5
7,N/A,N/A,N/A,295,302,N/A,8,2
7,N/A,N/A,N/A,288,295,N/A,14,2
5,N/A,N/A,N/A,283,288,N/A,19,1
4,N/A,N/A,N/A,279,283,N/A,25,1
13,N/A,N/A,N/A,266,279,N/A,30,6
4,N/A,N/A,N/A,262,266,N/A,36,0
6,N/A,N/A,N/A,256,262,N/A,40,4
6,N/A,N/A,N/A,250,256,N/A,45,3
4,N/A,N/A,N/A,246,250,N/A,51,3
13,N/A,N/A,N/A,233,246,N/A,54,6
6,N/A,N/A,N/A,227,233,N/A,57,3
6,N/A,N/A,N/A,221,227,N/A,63,3
5,N/A,N/A,N/A,216,221,N/A,67,1
5,N/A,N/A,N/A,211,216,N/A,73,1
9,N/A,N/A,N/A,202,211,N/A,77,5
7,N/A,N/A,N/A,195,202,N/A,80,2
5,N/A,N/A,N/A,190,195,N/A,85,1
4,N/A,N/A,N/A,186,190,N/A,91,1
5,N/A,N/A,N/A,181,186,N/A,94,4
4,N/A,N/A,N/A,177,181,N/A,98,2
7,N/A,N/A,N/A,170,177,N/A,104,2
7,N/A,N/A,N/A,163,170,N/A,110,2
4,N/A,N/A,N/A,159,163,N/A,115,1
8,N/A,N/A,N/A,151,159,N/A,118,4
8,N/A,N/A,N/A,143,151,N/A,124,4
4,N/A,N/A,N/A,139,143,N/A,129,3
4,N/A,N/A,N/A,135,139,N/A,134,2
17,N/A,N/A,N/A,118,135,N/A,138,6
4,N/A,N/A,N/A,114,118,N/A,144,0
6,N/A,N/A,N/A,1656,1662,N/A,4,2
10,N/A,N/A,N/A,1646,1656,N/A,7,5
12,N/A,N/A,N/A,1634,1646,N/A,13,5
5,N/A,N/A,N/A,1629,1634,N/A,16,2
11,N/A,N/A,N/A,1618,1629,N/A,19,5
7,N/A,N/A,N/A,1611,1618,N/A,24,4
4,N/A,N/A,N/A,1607,1611,N/A,27,1
5,N/A,N/A,N/A,1602,1607,N/A,33,1
10,N/A,N/A,N/A,1592,1602,N/A,38,6
7,N/A,N/A,N/A,1585,1592,N/A,41,3
5,N/A,N/A,N/A,1580,1585,N/A,45,1
8,N/A,N/A,N/A,1572,1580,N/A,48,4
4,N/A,N/A,N/A,1568,1572,N/A,51,1
9,N/A,N/A,N/A,1559,1568,N/A,55,5
8,N/A,N/A,N/A,1551,1559,N/A,60,4
5,N/A,N/A,N/A,1546,1551,N/A,64,2
4,N/A,N/A,N/A,1542,1546,N/A,69,1
5,N/A,N/A,N/A,1537,1542,N/A,72,4
6,N/A,N/A,N/A,1531,1537,N/A,77,3
16,N/A,N/A,N/A,1515,1531,N/A,80,6
12,N/A,N/A,N/A,1503,1515,N/A,85,5
7,N/A,N/A,N/A,1496,1503,N/A,88,2
11,N/A,N/A,N/A,1485,1496,N/A,91,5
4,N/A,N/A,N/A,1481,1485,N/A,95,3
4,N/A,N/A,N/A,1477,1481,N/A,99,1
11,N/A,N/A,N/A,1466,1477,N/A,103,5
7,N/A,N/A,N/A,1459,1466,N/A,106,2
11,N/A,N/A,N/A,1448,1459,N/A,109,5
6,N/A,N/A,N/A,1442,1448,N/A,114,4
5,N/A,N/A,N/A,1437,1442,N/A,118,2
5,N/A,N/A,N/A,1050,1055,N/A,3,1
8,N/A,N/A,N/A,1042,1050,N/A,6,4
4,N/A,N/A,N/A,1038,1042,N/A,10,2
6,N/A,N/A,N/A,1032,1038,N/A,16,2
4,N/A,N/A,N/A,1028,1032,N/A,21,1
7,N/A,N/A,N/A,1021,1028,N/A,24,4
6,N/A,N/A,N/A,1015,1021,N/A,29,3
18,N/A,N/A,N/A,997,1015,N/A,32,6
4,N/A,N/A,N/A,993,997,N/A,35,3
4,N/A,N/A,N/A,989,993,N/A,40,2
18,N/A,N/A,N/A,971,989,N/A,44,6
9,N/A,N/A,N/A,962,971,N/A,49,5
6,N/A,N/A,N/A,956,962,N/A,53,3
4,N/A,N/A,N/A,952,956,N/A,59,3
4,N/A,N/A,N/A,948,952,N/A,63,1
6,N/A,N/A,N/A,942,948,N/A,66,4
6,N/A,N/A,N/A,936,942,N/A,72,4
4,N/A,N/A,N/A,932,936,N/A,76,2
9,N/A,N/A,N/A,923,932,N/A,79,5
6,N/A,N/A,N/A,917,923,N/A,82,2
13,N/A,N/A,N/A,904,917,N/A,86,6
12,N/A,N/A,N/A,892,904,N/A,91,5
5,N/A,N/A,N/A,887,892,N/A,95,3
4,N/A,N/A,N/A,883,887,N/A,101,3
11,N/A,N/A,N/A,872,883,N/A,104,6
4,N/A,N/A,N/A,868,872,N/A,110,0
18,N/A,N/A,N/A,850,868,N/A,116,6
9,N/A,N/A,N/A,841,850,N/A,121,5
9,N/A,N/A,N/A,832,841,N/A,127,5
8,N/A,N/A,N/A,824,832,N/A,132,4
7,N/A,N/A,N/A,1544,1551,N/A,4,3
16,N/A,N/A,N/A,1528,1544,N/A,7,6
5,N/A,N/A,N/A,1523,1528,N/A,13,0
11,N/A,N/A,N/A,1512,1523,N/A,19,6
11,N/A,N/A,N/A,1501,1512,N/A,24,5
4,N/A,N/A,N/A,1497,1501,N/A,27,2
10,N/A,N/A,N/A,1487,1497,N/A,30,5
11,N/A,N/A,N/A,1476,1487,N/A,36,5
5,N/A,N/A,N/A,1471,1476,N/A,41,4
7,N/A,N/A,N/A,1464,1471,N/A,46,3
5,N/A,N/A,N/A,1459,1464,N/A,51,2
15,N/A,N/A,N/A,1444,1459,N/A,55,6
4,N/A,N/A,N/A,1440,1444,N/A,61,0
7,N/A,N/A,N/A,1433,1440,N/A,65,4
7,N/A,N/A,N/A,1426,1433,N/A,70,3
7,N/A,N/A,N/A,1419,1426,N/A,76,3
6,N/A,N/A,N/A,1413,1419,N/A,82,3
4,N/A,N/A,N/A,1409,1413,N/A,86,1
17,N/A,N/A,N/A,1392,1409,N/A,91,6
7,N/A,N/A,N/A,1385,1392,N/A,94,3
4,N/A,N/A,N/A,1381,1385,N/A,98,1
14,N/A,N/A,N/A,1367,1381,N/A,103,6
4,N/A,N/A,N/A,1363,1367,N/A,109,0
19,N/A,N/A,N/A,1344,1363,N/A,115,6
7,N/A,N/A,N/A,1337,1344,N/A,118,3
4,N/A,N/A,N/A,1333,1337,N/A,122,1
16,N/A,N/A,N/A,1317,1333,N/A,127,6
5,N/A,N/A,N/A,1312,1317,N/A,130,3
6,N/A,N/A,N/A,1306,1312,N/A,135,2
5,N/A,N/A,N/A,1301,1306,N/A,141,2
7,N/A,N/A,N/A,729,736,N/A,4,2
6,N/A,N/A,N/A,723,729,N/A,10,2
5,N/A,N/A,N/A,718,723,N/A,15,1
17,N/A,N/A,N/A,701,718,N/A,20,6
5,N/A,N/A,N/A,696,701,N/A,26,0
6,N/A,N/A,N/A,690,696,N/A,30,4
5,N/A,N/A,N/A,685,690,N/A,36,4
6,N/A,N/A,N/A,679,685,N/A,41,3
6,N/A,N/A,N/A,673,679,N/A,47,3
15,N/A,N/A,N/A,658,673,N/A,50,6
6,N/A,N/A,N/A,652,658,N/A,54,4
5,N/A,N/A,N/A,647,652,N/A,57,1
5,N/A,N/A,N/A,642,647,N/A,60,4
6,N/A,N/A,N/A,636,642,N/A,66,4
4,N/A,N/A,N/A,632,636,N/A,69,1
10,N/A,N/A,N/A,622,632,N/A,73,5
6,N/A,N/A,N/A,616,622,N/A,76,2
10,N/A,N/A,N/A,606,616,N/A,79,5
6,N/A,N/A,N/A,600,606,N/A,83,3
17,N/A,N/A,N/A,583,600,N/A,86,6
4,N/A,N/A,N/A,579,583,N/A,92,0
7,N/A,N/A,N/A,572,579,N/A,96,4
7,N/A,N/A,N/A,565,572,N/A,100,2
4,N/A,N/A,N/A,561,565,N/A,106,2
16,N/A,N/A,N/A,545,561,N/A,110,6
6,N/A,N/A,N/A,539,545,N/A,114,4
7,N/A,N/A,N/A,532,539,N/A,118,2
6,N/A,N/A,N/A,526,532,N/A,124,2
9,N/A,N/A,N/A,517,526,N/A,127,5
4,N/A,N/A,N/A,513,517,N/A,130,2
5,N/A,N/A,N/A,987,992,N/A,4,1
5,N/A,N/A,N/A,982,987,N/A,10,1
12,N/A,N/A,N/A,970,982,N/A,15,6
7,N/A,N/A,N/A,963,970,N/A,18,3
16,N/A,N/A,N/A,947,963,N/A,21,6
11,N/A,N/A,N/A,936,947,N/A,26,5
12,N/A,N/A,N/A,924,936,N/A,32,5
5,N/A,N/A,N/A,919,924,N/A,35,2
11,N/A,N/A,N/A,908,919,N/A,38,5
4,N/A,N/A,N/A,904,908,N/A,41,2
10,N/A,N/A,N/A,894,904,N/A,44,5
6,N/A,N/A,N/A,888,894,N/A,49,4
7,N/A,N/A,N/A,881,888,N/A,55,4
7,N/A,N/A,N/A,874,881,N/A,60,3
10,N/A,N/A,N/A,864,874,N/A,63,6
6,N/A,N/A,N/A,858,864,N/A,66,3
13,N/A,N/A,N/A,845,858,N/A,69,6
6,N/A,N/A,N/A,839,845,N/A,73,4
4,N/A,N/A,N/A,835,839,N/A,78,3
19,N/A,N/A,N/A,816,835,N/A,81,6
6,N/A,N/A,N/A,810,816,N/A,85,4
5,N/A,N/A,N/A,805,810,N/A,90,3
18,N/A,N/A,N/A,787,805,N/A,93,6
4,N/A,N/A,N/A,783,787,N/A,99,0
7,N/A,N/A,N/A,776,783,N/A,102,3
16,N/A,N/A,N/A,760,776,N/A,105,6
4,N/A,N/A,N/A,756,760,N/A,108,3
5,N/A,N/A,N/A,751,756,N/A,113,2
18,N/A,N/A,N/A,733,751,N/A,117,6
10,N/A,N/A,N/A,723,733,N/A,122,5
4,N/A,N/A,N/A,1678,1682,N/A,6,2
10,N/A,N/A,N/A,1668,1678,N/A,9,5
7,N/A,N/A,N/A,1661,1668,N/A,12,2
7,N/A,N/A,N/A,1654,1661,N/A,18,2
5,N/A,N/A,N/A,1649,1654,N/A,24,2
9,N/A,N/A,N/A,1640,1649,N/A,27,5
12,N/A,N/A,N/A,1628,1640,N/A,33,5
12,N/A,N/A,N/A,1616,1628,N/A,39,5
9,N/A,N/A,N/A,1607,1616,N/A,45,5
4,N/A,N/A,N/A,1603,1607,N/A,49,3
4,N/A,N/A,N/A,1599,1603,N/A,55,3
4,N/A,N/A,N/A,1595,1599,N/A,59,1
17,N/A,N/A,N/A,1578,1595,N/A,64,6
4,N/A,N/A,N/A,1574,1578,N/A,70,0
4,N/A,N/A,N/A,1570,1574,N/A,73,3
7,N/A,N/A,N/A,1563,1570,N/A,78,2
15,N/A,N/A,N/A,1548,1563,N/A,82,6
5,N/A,N/A,N/A,1543,1548,N/A,86,4
5,N/A,N/A,N/A,1538,1543,N/A,90,2
14,N/A,N/A,N/A,1524,1538,N/A,94,6
5,N/A,N/A,N/A,1519,1524,N/A,97,3
4,N/A,N/A,N/A,1515,1519,N/A,101,1
12,N/A,N/A,N/A,1503,1515,N/A,105,5
5,N/A,N/A,N/A,1498,1503,N/A,108,2
5,N/A,N/A,N/A,1493,1498,N/A,114,2
4,N/A,N/A,N/A,1489,1493,N/A,120,2
5,N/A,N/A,N/A,1484,1489,N/A,126,2
7,N/A,N/A,N/A,1477,1484,N/A,132,2
6,N/A,N/A,N/A,1471,1477,N/A,138,2
12,N/A,N/A,N/A,1459,1471,N/A,141,5
6,N/A,N/A,N/A,1288,1294,N/A,5,2
13,N/A,N/A,N/A,1275,1288,N/A,9,6
4,N/A,N/A,N/A,1271,1275,N/A,12,3
18,N/A,N/A,N/A,1253,1271,N/A,15,6
9,N/A,N/A,N/A,1244,1253,N/A,20,5
7,N/A,N/A,N/A,1237,1244,N/A,25,4
6,N/A,N/A,N/A,1231,1237,N/A,31,4
4,N/A,N/A,N/A,1227,1231,N/A,35,2
19,N/A,N/A,N/A,1208,1227,N/A,39,6
5,N/A,N/A,N/A,1203,1208,N/A,42,3
19,N/A,N/A,N/A,1184,1203,N/A,45,6
8,N/A,N/A,N/A,1176,1184,N/A,49,4
6,N/A,N/A,N/A,1170,1176,N/A,55,4
4,N/A,N/A,N/A,1166,1170,N/A,60,3
6,N/A,N/A,N/A,1160,1166,N/A,65,2
5,N/A,N/A,N/A,1155,1160,N/A,71,2
6,N/A,N/A,N/A,1149,1155,N/A,77,2
10,N/A,N/A,N/A,1139,1149,N/A,81,6
10,N/A,N/A,N/A,1129,1139,N/A,86,5
10,N/A,N/A,N/A,1119,1129,N/A,92,5
9,N/A,N/A,N/A,1110,1119,N/A,98,5
6,N/A,N/A,N/A,1104,1110,N/A,102,3
4,N/A,N/A,N/A,1100,1104,N/A,108,3
7,N/A,N/A,N/A,1093,1100,N/A,113,2
9,N/A,N/A,N/A,1084,1093,N/A,116,5
5,N/A,N/A,N/A,1079,1084,N/A,120,3
4,N/A,N/A,N/A,1075,1079,N/A,124,1
4,N/A,N/A,N/A,1071,1075,N/A,130,1
17,N/A,N/A,N/A,1054,1071,N/A,135,6
5,N/A,N/A,N/A,1049,1054,N/A,141,0
10,N/A,N/A,N/A,857,867,N/A,4,5
5,N/A,N/A,N/A,852,857,N/A,9,4
5,N/A,N/A,N/A,847,852,N/A,12,1
4,N/A,N/A,N/A,843,847,N/A,18,1
15,N/A,N/A,N/A,828,843,N/A,23,6
12,N/A,N/A,N/A,816,828,N/A,28,5
6,N/A,N/A,N/A,810,816,N/A,32,3
6,N/A,N/A,N/A,804,810,N/A,38,3
4,N/A,N/A,N/A,800,804,N/A,43,2
5,N/A,N/A,N/A,795,800,N/A,48,1
5,N/A,N/A,N/A,790,795,N/A,54,1
4,N/A,N/A,N/A,786,790,N/A,60,1
8,N/A,N/A,N/A,778,786,N/A,63,4
4,N/A,N/A,N/A,774,778,N/A,67,2
11,N/A,N/A,N/A,763,774,N/A,70,5
7,N/A,N/A,N/A,756,763,N/A,73,2
5,N/A,N/A,N/A,751,756,N/A,78,1
8,N/A,N/A,N/A,743,751,N/A,81,4
4,N/A,N/A,N/A,739,743,N/A,84,1
5,N/A,N/A,N/A,734,739,N/A,87,4
5,N/A,N/A,N/A,729,734,N/A,93,4
4,N/A,N/A,N/A,725,729,N/A,96,1
5,N/A,N/A,N/A,720,725,N/A,99,4
5,N/A,N/A,N/A,715,720,N/A,102,1
14,N/A,N/A,N/A,701,715,N/A,107,6
8,N/A,N/A,N/A,693,701,N/A,111,4
5,N/A,N/A,N/A,688,693,N/A,114,1
15,N/A,N/A,N/A,673,688,N/A,119,6
11,N/A,N/A,N/A,662,673,N/A,124,5
5,N/A,N/A,N/A,657,662,N/A,127,2
7,N/A,N/A,N/A,413,420,N/A,4,3
16,N/A,N/A,N/A,397,413,N/A,7,6
4,N/A,N/A,N/A,393,397,N/A,13,0
7,N/A,N/A,N/A,386,393,N/A,17,4
7,N/A,N/A,N/A,379,386,N/A,22,3
12,N/A,N/A,N/A,367,379,N/A,25,6
4,N/A,N/A,N/A,363,367,N/A,31,0
11,N/A,N/A,N/A,352,363,N/A,36,5
6,N/A,N/A,N/A,346,352,N/A,41,4
5,N/A,N/A,N/A,341,346,N/A,46,3
6,N/A,N/A,N/A,335,341,N/A,51,2
12,N/A,N/A,N/A,323,335,N/A,54,5
4,N/A,N/A,N/A,319,323,N/A,57,2
9,N/A,N/A,N/A,310,319,N/A,60,5
6,N/A,N/A,N/A,304,310,N/A,65,4
5,N/A,N/A,N/A,299,304,N/A,69,2
9,N/A,N/A,N/A,290,299,N/A,72,5
5,N/A,N/A,N/A,285,290,N/A,76,3
5,N/A,N/A,N/A,280,285,N/A,81,2
4,N/A,N/A,N/A,276,280,N/A,87,2
7,N/A,N/A,N/A,269,276,N/A,93,2
4,N/A,N/A,N/A,265,269,N/A,98,1
4,N/A,N/A,N/A,261,265,N/A,104,1
5,N/A,N/A,N/A,256,261,N/A,110,1
7,N/A,N/A,N/A,249,256,N/A,113,4
4,N/A,N/A,N/A,245,249,N/A,116,1
5,N/A,N/A,N/A,240,245,N/A,119,4
6,N/A,N/A,N/A,234,240,N/A,123,2
4,N/A,N/A,N/A,230,234,N/A,129,2
6,N/A,N/A,N/A,224,230,N/A,135,2
6,N/A,N/A,N/A,333,339,N/A,3,2
7,N/A,N/A,N/A,326,333,N/A,9,2
15,N/A,N/A,N/A,311,326,N/A,13,6
5,N/A,N/A,N/A,306,311,N/A,19,0
5,N/A,N/A,N/A,301,306,N/A,23,4
5,N/A,N/A,N/A,296,301,N/A,26,1
18,N/A,N/A,N/A,278,296,N/A,31,6
5,N/A,N/A,N/A,273,278,N/A,34,3
6,N/A,N/A,N/A,267,273,N/A,40,3
7,N/A,N/A,N/A,260,267,N/A,45,2
11,N/A,N/A,N/A,249,260,N/A,49,6
7,N/A,N/A,N/A,242,249,N/A,52,3
4,N/A,N/A,N/A,238,242,N/A,56,1
7,N/A,N/A,N/A,231,238,N/A,59,4
4,N/A,N/A,N/A,227,231,N/A,62,1
12,N/A,N/A,N/A,215,227,N/A,66,5
8,N/A,N/A,N/A,207,215,N/A,71,4
4,N/A,N/A,N/A,203,207,N/A,74,1
5,N/A,N/A,N/A,198,203,N/A,77,4
5,N/A,N/A,N/A,193,198,N/A,82,3
12,N/A,N/A,N/A,181,193,N/A,85,6
4,N/A,N/A,N/A,177,181,N/A,88,3
12,N/A,N/A,N/A,165,177,N/A,91,6
12,N/A,N/A,N/A,153,165,N/A,96,5
5,N/A,N/A,N/A,148,153,N/A,99,2
11,N/A,N/A,N/A,137,148,N/A,103,6
5,N/A,N/A,N/A,132,137,N/A,106,3
4,N/A,N/A,N/A,128,132,N/A,111,2
4,N/A,N/A,N/A,124,128,N/A,116,1
10,N/A,N/A,N/A,114,124,N/A,120,5
10,N/A,N/A,N/A,995,1005,N/A,4,6
4,N/A,N/A,N/A,991,995,N/A,10,0
6,N/A,N/A,N/A,985,991,N/A,13,3
5,N/A,N/A,N/A,980,985,N/A,18,2
5,N/A,N/A,N/A,975,980,N/A,24,2
5,N/A,N/A,N/A,970,975,N/A,29,1
12,N/A,N/A,N/A,958,970,N/A,34,6
5,N/A,N/A,N/A,953,958,N/A,38,4
8,N/A,N/A,N/A,945,953,N/A,44,4
7,N/A,N/A,N/A,938,945,N/A,50,4
7,N/A,N/A,N/A,931,938,N/A,56,4
4,N/A,N/A,N/A,927,931,N/A,59,1
4,N/A,N/A,N/A,923,927,N/A,65,1
14,N/A,N/A,N/A,909,923,N/A,70,6
6,N/A,N/A,N/A,903,909,N/A,74,4
6,N/A,N/A,N/A,897,903,N/A,79,3
13,N/A,N/A,N/A,884,897,N/A,82,6
5,N/A,N/A,N/A,879,884,N/A,88,0
10,N/A,N/A,N/A,869,879,N/A,94,6
10,N/A,N/A,N/A,859,869,N/A,99,5
5,N/A,N/A,N/A,854,859,N/A,104,4
5,N/A,N/A,N/A,849,854,N/A,110,4
7,N/A,N/A,N/A,842,849,N/A,114,2
10,N/A,N/A,N/A,832,842,N/A,117,5
4,N/A,N/A,N/A,828,832,N/A,121,3
13,N/A,N/A,N/A,815,828,N/A,124,6
7,N/A,N/A,N/A,808,815,N/A,128,4
5,N/A,N/A,N/A,803,808,N/A,131,1
5,N/A,N/A,N/A,798,803,N/A,134,4
6,N/A,N/A,N/A,792,798,N/A,139,3
7,N/A,N/A,N/A,820,827,N/A,4,3
4,N/A,N/A,N/A,816,820,N/A,8,1
5,N/A,N/A,N/A,811,816,N/A,14,1
5,N/A,N/A,N/A,806,811,N/A,20,1
4,N/A,N/A,N/A,802,806,N/A,26,1
13,N/A,N/A,N/A,789,802,N/A,31,6
9,N/A,N/A,N/A,780,789,N/A,36,5
9,N/A,N/A,N/A,771,780,N/A,42,5
7,N/A,N/A,N/A,764,771,N/A,45,2
10,N/A,N/A,N/A,754,764,N/A,48,5
8,N/A,N/A,N/A,746,754,N/A,53,4
6,N/A,N/A,N/A,740,746,N/A,57,2
11,N/A,N/A,N/A,729,740,N/A,60,5
5,N/A,N/A,N/A,724,729,N/A,65,4
7,N/A,N/A,N/A,717,724,N/A,70,3
5,N/A,N/A,N/A,712,717,N/A,74,1
6,N/A,N/A,N/A,706,712,N/A,77,4
4,N/A,N/A,N/A,702,706,N/A,82,3
5,N/A,N/A,N/A,697,702,N/A,86,1
10,N/A,N/A,N/A,687,697,N/A,90,5
7,N/A,N/A,N/A,680,687,N/A,93,2
15,N/A,N/A,N/A,665,680,N/A,97,6
5,N/A,N/A,N/A,660,665,N/A,101,4
6,N/A,N/A,N/A,654,660,N/A,105,2
4,N/A,N/A,N/A,650,654,N/A,110,1
7,N/A,N/A,N/A,643,650,N/A,113,4
4,N/A,N/A,N/A,639,643,N/A,118,3
15,N/A,N/A,N/A,624,639,N/A,121,6
5,N/A,N/A,N/A,619,624,N/A,127,0
17,N/A,N/A,N/A,602,619,N/A,133,6
4,N/A,N/A,N/A,341,345,N/A,4,1
8,N/A,N/A,N/A,333,341,N/A,7,4
4,N/A,N/A,N/A,329,333,N/A,10,1
5,N/A,N/A,N/A,324,329,N/A,16,1
9,N/A,N/A,N/A,315,324,N/A,20,5
4,N/A,N/A,N/A,311,315,N/A,24,3
4,N/A,N/A,N/A,307,311,N/A,28,1
11,N/A,N/A,N/A,296,307,N/A,32,5
7,N/A,N/A,N/A,289,296,N/A,37,4
7,N/A,N/A,N/A,282,289,N/A,43,4
6,N/A,N/A,N/A,276,282,N/A,48,3
5,N/A,N/A,N/A,271,276,N/A,52,1
5,N/A,N/A,N/A,266,271,N/A,58,1
9,N/A,N/A,N/A,257,266,N/A,62,5
7,N/A,N/A,N/A,250,257,N/A,67,4
4,N/A,N/A,N/A,246,250,N/A,72,3
4,N/A,N/A,N/A,242,246,N/A,78,3
4,N/A,N/A,N/A,238,242,N/A,83,2
17,N/A,N/A,N/A,221,238,N/A,87,6
5,N/A,N/A,N/A,216,221,N/A,91,4
5,N/A,N/A,N/A,211,216,N/A,94,1
4,N/A,N/A,N/A,207,211,N/A,100,1
12,N/A,N/A,N/A,195,207,N/A,105,6
9,N/A,N/A,N/A,186,195,N/A,110,5
10,N/A,N/A,N/A,176,186,N/A,116,5
7,N/A,N/A,N/A,169,176,N/A,121,4
5,N/A,N/A,N/A,164,169,N/A,124,1
8,N/A,N/A,N/A,156,164,N/A,127,4
4,N/A,N/A,N/A,152,156,N/A,132,3
12,N/A,N/A,N/A,140,152,N/A,135,6
12,N/A,N/A,N/A,924,936,N/A,4,5
9,N/A,N/A,N/A,915,924,N/A,10,5
5,N/A,N/A,N/A,910,915,N/A,13,2
13,N/A,N/A,N/A,897,910,N/A,17,6
7,N/A,N/A,N/A,890,897,N/A,20,3
19,N/A,N/A,N/A,871,890,N/A,23,6
5,N/A,N/A,N/A,866,871,N/A,27,4
6,N/A,N/A,N/A,860,866,N/A,33,4
6,N/A,N/A,N/A,854,860,N/A,39,4
8,N/A,N/A,N/A,846,854,N/A,45,4
5,N/A,N/A,N/A,841,846,N/A,51,4
7,N/A,N/A,N/A,834,841,N/A,57,4
5,N/A,N/A,N/A,829,834,N/A,60,1
6,N/A,N/A,N/A,823,829,N/A,63,4
4,N/A,N/A,N/A,819,823,N/A,68,3
7,N/A,N/A,N/A,812,819,N/A,73,2
14,N/A,N/A,N/A,798,812,N/A,77,6
6,N/A,N/A,N/A,792,798,N/A,81,4
8,N/A,N/A,N/A,784,792,N/A,87,4
5,N/A,N/A,N/A,779,784,N/A,93,4
4,N/A,N/A,N/A,775,779,N/A,96,1
11,N/A,N/A,N/A,764,775,N/A,100,5
10,N/A,N/A,N/A,754,764,N/A,106,5
6,N/A,N/A,N/A,748,754,N/A,110,3
6,N/A,N/A,N/A,742,748,N/A,115,2
9,N/A,N/A,N/A,733,742,N/A,118,5
6,N/A,N/A,N/A,727,733,N/A,122,3
4,N/A,N/A,N/A,723,727,N/A,127,2
5,N/A,N/A,N/A,718,723,N/A,133,2
19,N/A,N/A,N/A,699,718,N/A,137,6
6,N/A,N/A,N/A,1292,1298,N/A,5,2
14,N/A,N/A,N/A,1278,1292,N/A,9,6
4,N/A,N/A,N/A,1274,1278,N/A,12,3
4,N/A,N/A,N/A,1270,1274,N/A,16,1
9,N/A,N/A,N/A,1261,1270,N/A,20,5
9,N/A,N/A,N/A,1252,1261,N/A,26,5
9,N/A,N/A,N/A,1243,1252,N/A,32,5
6,N/A,N/A,N/A,1237,1243,N/A,36,3
11,N/A,N/A,N/A,1226,1237,N/A,39,6
6,N/A,N/A,N/A,1220,1226,N/A,43,4
8,N/A,N/A,N/A,1212,1220,N/A,49,4
5,N/A,N/A,N/A,1207,1212,N/A,53,2
12,N/A,N/A,N/A,1195,1207,N/A,56,5
9,N/A,N/A,N/A,1186,1195,N/A,62,5
7,N/A,N/A,N/A,1179,1186,N/A,66,3
5,N/A,N/A,N/A,1174,1179,N/A,70,1
8,N/A,N/A,N/A,1166,1174,N/A,73,4
5,N/A,N/A,N/A,1161,1166,N/A,79,4
5,N/A,N/A,N/A,1156,1161,N/A,83,2
5,N/A,N/A,N/A,1151,1156,N/A,88,1
5,N/A,N/A,N/A,1146,1151,N/A,94,1
6,N/A,N/A,N/A,1140,1146,N/A,97,4
7,N/A,N/A,N/A,1133,1140,N/A,103,4
4,N/A,N/A,N/A,1129,1133,N/A,108,3
6,N/A,N/A,N/A,1123,1129,N/A,114,3
5,N/A,N/A,N/A,1118,1123,N/A,118,1
12,N/A,N/A,N/A,1106,1118,N/A,122,5
11,N/A,N/A,N/A,1095,1106,N/A,128,5
7,N/A,N/A,N/A,1088,1095,N/A,133,4
5,N/A,N/A,N/A,1083,1088,N/A,137,2
5,N/A,N/A,N/A,1591,1596,N/A,3,4
5,N/A,N/A,N/A,1586,1591,N/A,9,4
4,N/A,N/A,N/A,1582,1586,N/A,12,1
4,N/A,N/A,N/A,1578,1582,N/A,18,1
14,N/A,N/A,N/A,1564,1578,N/A,23,6
6,N/A,N/A,N/A,1558,1564,N/A,26,3
5,N/A,N/A,N/A,1553,1558,N/A,30,1
5,N/A,N/A,N/A,1548,1553,N/A,36,1
8,N/A,N/A,N/A,1540,1548,N/A,39,4
5,N/A,N/A,N/A,1535,1540,N/A,42,1
7,N/A,N/A,N/A,1528,1535,N/A,45,4
4,N/A,N/A,N/A,1524,1528,N/A,48,1
15,N/A,N/A,N/A,1509,1524,N/A,53,6
4,N/A,N/A,N/A,1505,1509,N/A,59,0
7,N/A,N/A,N/A,1498,1505,N/A,63,4
4,N/A,N/A,N/A,1494,1498,N/A,67,2
19,N/A,N/A,N/A,1475,1494,N/A,71,6
5,N/A,N/A,N/A,1470,1475,N/A,77,0
12,N/A,N/A,N/A,1458,1470,N/A,82,5
6,N/A,N/A,N/A,1452,1458,N/A,87,4
7,N/A,N/A,N/A,1445,1452,N/A,92,3
4,N/A,N/A,N/A,1441,1445,N/A,96,1
5,N/A,N/A,N/A,1436,1441,N/A,99,4
5,N/A,N/A,N/A,1431,1436,N/A,102,1
14,N/A,N/A,N/A,1417,1431,N/A,107,6
10,N/A,N/A,N/A,1407,1417,N/A,112,5
5,N/A,N/A,N/A,1402,1407,N/A,115,2
5,N/A,N/A,N/A,1397,1402,N/A,120,1
16,N/A,N/A,N/A,1381,1397,N/A,125,6
5,N/A,N/A,N/A,1376,1381,N/A,131,0
5,N/A,N/A,N/A,948,953,N/A,3,1
15,N/A,N/A,N/A,933,948,N/A,8,6
7,N/A,N/A,N/A,926,933,N/A,11,3
4,N/A,N/A,N/A,922,926,N/A,17,3
19,N/A,N/A,N/A,903,922,N/A,20,6
6,N/A,N/A,N/A,897,903,N/A,24,4
5,N/A,N/A,N/A,892,897,N/A,29,3
6,N/A,N/A,N/A,886,892,N/A,34,2
11,N/A,N/A,N/A,875,886,N/A,37,5
4,N/A,N/A,N/A,871,875,N/A,40,2
11,N/A,N/A,N/A,860,871,N/A,44,6
6,N/A,N/A,N/A,854,860,N/A,47,3
7,N/A,N/A,N/A,847,854,N/A,53,3
12,N/A,N/A,N/A,835,847,N/A,56,6
8,N/A,N/A,N/A,827,835,N/A,60,4
5,N/A,N/A,N/A,822,827,N/A,64,2
9,N/A,N/A,N/A,813,822,N/A,67,5
5,N/A,N/A,N/A,808,813,N/A,71,3
7,N/A,N/A,N/A,801,808,N/A,77,3
6,N/A,N/A,N/A,795,801,N/A,83,3
12,N/A,N/A,N/A,783,795,N/A,86,6
12,N/A,N/A,N/A,771,783,N/A,91,5
7,N/A,N/A,N/A,764,771,N/A,96,4
4,N/A,N/A,N/A,760,764,N/A,101,3
7,N/A,N/A,N/A,753,760,N/A,106,2
4,N/A,N/A,N/A,749,753,N/A,111,1
7,N/A,N/A,N/A,742,749,N/A,114,4
5,N/A,N/A,N/A,737,742,N/A,117,1
6,N/A,N/A,N/A,731,737,N/A,120,4
5,N/A,N/A,N/A,726,731,N/A,126,4
14,N/A,N/A,N/A,1232,1246,N/A,4,6
4,N/A,N/A,N/A,1228,1232,N/A,10,0
7,N/A,N/A,N/A,1221,1228,N/A,14,4
7,N/A,N/A,N/A,1214,1221,N/A,18,2
18,N/A,N/A,N/A,1196,1214,N/A,22,6
6,N/A,N/A,N/A,1190,1196,N/A,26,4
4,N/A,N/A,N/A,1186,1190,N/A,31,3
6,N/A,N/A,N/A,1180,1186,N/A,37,3
7,N/A,N/A,N/A,1173,1180,N/A,42,2
12,N/A,N/A,N/A,1161,1173,N/A,45,5
4,N/A,N/A,N/A,1157,1161,N/A,49,3
4,N/A,N/A,N/A,1153,1157,N/A,53,1
4,N/A,N/A,N/A,1149,1153,N/A,59,1
6,N/A,N/A,N/A,1143,1149,N/A,62,4
4,N/A,N/A,N/A,1139,1143,N/A,66,2
7,N/A,N/A,N/A,1132,1139,N/A,72,2
5,N/A,N/A,N/A,1127,1132,N/A,77,1
11,N/A,N/A,N/A,1116,1127,N/A,81,5
9,N/A,N/A,N/A,1107,1116,N/A,87,5
6,N/A,N/A,N/A,1101,1107,N/A,92,4
7,N/A,N/A,N/A,1094,1101,N/A,98,4
6,N/A,N/A,N/A,1088,1094,N/A,102,2
11,N/A,N/A,N/A,1077,1088,N/A,105,5
8,N/A,N/A,N/A,1069,1077,N/A,110,4
5,N/A,N/A,N/A,1064,1069,N/A,113,1
4,N/A,N/A,N/A,1060,1064,N/A,119,1
10,N/A,N/A,N/A,1050,1060,N/A,124,6
5,N/A,N/A,N/A,1045,1050,N/A,130,0
8,N/A,N/A,N/A,1037,1045,N/A,134,4
5,N/A,N/A,N/A,1032,1037,N/A,137,1
7,N/A,N/A,N/A,740,747,N/A,3,3
4,N/A,N/A,N/A,736,740,N/A,9,3
4,N/A,N/A,N/A,732,736,N/A,13,1
6,N/A,N/A,N/A,726,732,N/A,16,4
4,N/A,N/A,N/A,722,726,N/A,21,3
5,N/A,N/A,N/A,717,722,N/A,25,1
11,N/A,N/A,N/A,706,717,N/A,29,5
6,N/A,N/A,N/A,700,706,N/A,34,4
5,N/A,N/A,N/A,695,700,N/A,37,1
13,N/A,N/A,N/A,682,695,N/A,42,6
4,N/A,N/A,N/A,678,682,N/A,45,3
18,N/A,N/A,N/A,660,678,N/A,48,6
4,N/A,N/A,N/A,656,660,N/A,54,0
11,N/A,N/A,N/A,645,656,N/A,60,6
5,N/A,N/A,N/A,640,645,N/A,63,3
6,N/A,N/A,N/A,634,640,N/A,68,2
7,N/A,N/A,N/A,627,634,N/A,74,2
14,N/A,N/A,N/A,613,627,N/A,78,6
6,N/A,N/A,N/A,607,613,N/A,82,4
4,N/A,N/A,N/A,603,607,N/A,85,1
13,N/A,N/A,N/A,590,603,N/A,90,6
4,N/A,N/A,N/A,586,590,N/A,96,0
10,N/A,N/A,N/A,576,586,N/A,101,5
6,N/A,N/A,N/A,570,576,N/A,104,2
7,N/A,N/A,N/A,563,570,N/A,110,2
14,N/A,N/A,N/A,549,563,N/A,114,6
5,N/A,N/A,N/A,544,549,N/A,120,0
7,N/A,N/A,N/A,537,544,N/A,124,4
4,N/A,N/A,N/A,533,537,N/A,127,1
8,N/A,N/A,N/A,525,533,N/A,130,4
5,N/A,N/A,N/A,1684,1689,N/A,4,1
9,N/A,N/A,N/A,1675,1684,N/A,8,5
9,N/A,N/A,N/A,1666,1675,N/A,14,5
7,N/A,N/A,N/A,1659,1666,N/A,17,2
4,N/A,N/A,N/A,1655,1659,N/A,23,2
10,N/A,N/A,N/A,1645,1655,N/A,26,5
6,N/A,N/A,N/A,1639,1645,N/A,31,4
5,N/A,N/A,N/A,1634,1639,N/A,35,2
5,N/A,N/A,N/A,1629,1634,N/A,40,1
12,N/A,N/A,N/A,1617,1629,N/A,44,5
9,N/A,N/A,N/A,1608,1617,N/A,50,5
6,N/A,N/A,N/A,1602,1608,N/A,53,2
7,N/A,N/A,N/A,1595,1602,N/A,59,2
10,N/A,N/A,N/A,1585,1595,N/A,63,6
4,N/A,N/A,N/A,1581,1585,N/A,69,0
9,N/A,N/A,N/A,1572,1581,N/A,74,5
6,N/A,N/A,N/A,1566,1572,N/A,79,4
5,N/A,N/A,N/A,1561,1566,N/A,82,1
4,N/A,N/A,N/A,1557,1561,N/A,88,1
8,N/A,N/A,N/A,1549,1557,N/A,91,4
5,N/A,N/A,N/A,1544,1549,N/A,94,1
5,N/A,N/A,N/A,1539,1544,N/A,97,4
5,N/A,N/A,N/A,1534,1539,N/A,101,2
4,N/A,N/A,N/A,1530,1534,N/A,107,2
5,N/A,N/A,N/A,1525,1530,N/A,113,2
16,N/A,N/A,N/A,1509,1525,N/A,117,6
12,N/A,N/A,N/A,1497,1509,N/A,122,5
6,N/A,N/A,N/A,1491,1497,N/A,125,2
4,N/A,N/A,N/A,1487,1491,N/A,130,1
12,N/A,N/A,N/A,1475,1487,N/A,134,5
5,N/A,N/A,N/A,972,977,N/A,6,3
6,N/A,N/A,N/A,966,972,N/A,11,2
7,N/A,N/A,N/A,959,966,N/A,17,2
6,N/A,N/A,N/A,953,959,N/A,23,2
5,N/A,N/A,N/A,948,953,N/A,29,2
10,N/A,N/A,N/A,938,948,N/A,32,5
11,N/A,N/A,N/A,927,938,N/A,38,5
10,N/A,N/A,N/A,917,927,N/A,44,5
5,N/A,N/A,N/A,912,917,N/A,47,2
11,N/A,N/A,N/A,901,912,N/A,50,5
12,N/A,N/A,N/A,889,901,N/A,56,5
6,N/A,N/A,N/A,883,889,N/A,61,4
6,N/A,N/A,N/A,877,883,N/A,66,3
5,N/A,N/A,N/A,872,877,N/A,70,1
13,N/A,N/A,N/A,859,872,N/A,75,6
12,N/A,N/A,N/A,847,859,N/A,80,5
7,N/A,N/A,N/A,840,847,N/A,85,4
6,N/A,N/A,N/A,834,840,N/A,91,4
5,N/A,N/A,N/A,829,834,N/A,95,2
10,N/A,N/A,N/A,819,829,N/A,98,5
9,N/A,N/A,N/A,810,819,N/A,104,5
5,N/A,N/A,N/A,805,810,N/A,109,4
5,N/A,N/A,N/A,800,805,N/A,115,4
7,N/A,N/A,N/A,793,800,N/A,120,3
16,N/A,N/A,N/A,777,793,N/A,123,6
4,N/A,N/A,N/A,773,777,N/A,126,3
4,N/A,N/A,N/A,769,773,N/A,130,1
11,N/A,N/A,N/A,758,769,N/A,135,6
5,N/A,N/A,N/A,753,758,N/A,139,4
7,N/A,N/A,N/A,746,753,N/A,144,3
5,N/A,N/A,N/A,536,541,N/A,6,2
9,N/A,N/A,N/A,527,536,N/A,9,5
10,N/A,N/A,N/A,517,527,N/A,15,5
7,N/A,N/A,N/A,510,517,N/A,19,3
4,N/A,N/A,N/A,506,510,N/A,23,1
4,N/A,N/A,N/A,502,506,N/A,29,1
5,N/A,N/A,N/A,497,502,N/A,35,1
11,N/A,N/A,N/A,486,497,N/A,39,5
5,N/A,N/A,N/A,481,486,N/A,42,2
6,N/A,N/A,N/A,475,481,N/A,48,2
5,N/A,N/A,N/A,470,475,N/A,54,2
5,N/A,N/A,N/A,465,470,N/A,59,1
4,N/A,N/A,N/A,461,465,N/A,65,1
8,N/A,N/A,N/A,453,461,N/A,68,4
4,N/A,N/A,N/A,449,453,N/A,71,1
5,N/A,N/A,N/A,444,449,N/A,77,1
5,N/A,N/A,N/A,439,444,N/A,83,1
11,N/A,N/A,N/A,428,439,N/A,87,5
8,N/A,N/A,N/A,420,428,N/A,92,4
5,N/A,N/A,N/A,415,420,N/A,96,2
5,N/A,N/A,N/A,410,415,N/A,101,1
5,N/A,N/A,N/A,405,410,N/A,107,1
17,N/A,N/A,N/A,388,405,N/A,112,6
7,N/A,N/A,N/A,381,388,N/A,115,3
7,N/A,N/A,N/A,374,381,N/A,121,3
11,N/A,N/A,N/A,363,374,N/A,124,6
4,N/A,N/A,N/A,359,363,N/A,127,3
4,N/A,N/A,N/A,355,359,N/A,132,2
4,N/A,N/A,N/A,351,355,N/A,138,2
4,N/A,N/A,N/A,347,351,N/A,143,1
6,N/A,N/A,N/A,990,996,N/A,6,2
5,N/A,N/A,N/A,985,990,N/A,12,2
4,N/A,N/A,N/A,981,985,N/A,18,2
14,N/A,N/A,N/A,967,981,N/A,22,6
6,N/A,N/A,N/A,961,967,N/A,25,3
4,N/A,N/A,N/A,957,961,N/A,29,1
12,N/A,N/A,N/A,945,957,N/A,33,5
9,N/A,N/A,N/A,936,945,N/A,39,5
6,N/A,N/A,N/A,930,936,N/A,44,4
4,N/A,N/A,N/A,926,930,N/A,49,3
5,N/A,N/A,N/A,921,926,N/A,53,1
16,N/A,N/A,N/A,905,921,N/A,58,6
9,N/A,N/A,N/A,896,905,N/A,63,5
10,N/A,N/A,N/A,886,896,N/A,69,5
9,N/A,N/A,N/A,877,886,N/A,75,5
6,N/A,N/A,N/A,871,877,N/A,80,4
4,N/A,N/A,N/A,867,871,N/A,83,1
12,N/A,N/A,N/A,855,867,N/A,87,5
5,N/A,N/A,N/A,850,855,N/A,92,4
5,N/A,N/A,N/A,845,850,N/A,96,2
4,N/A,N/A,N/A,841,845,N/A,102,2
5,N/A,N/A,N/A,836,841,N/A,108,2
6,N/A,N/A,N/A,830,836,N/A,114,2
4,N/A,N/A,N/A,826,830,N/A,120,2
10,N/A,N/A,N/A,816,826,N/A,123,5
4,N/A,N/A,N/A,812,816,N/A,126,2
6,N/A,N/A,N/A,806,812,N/A,132,2
14,N/A,N/A,N/A,792,806,N/A,136,6
10,N/A,N/A,N/A,782,792,N/A,141,5
8,N/A,N/A,N/A,774,782,N/A,146,4
