amount,category,date,name,newBalance,previousBalance,reference,timeDiff,dayOfWeek
39,N/A,N/A,N/A,931,970,N/A,3,5
36,N/A,N/A,N/A,895,931,N/A,9,5
12,N/A,N/A,N/A,883,895,N/A,12,2
8,N/A,N/A,N/A,875,883,N/A,17,1
43,N/A,N/A,N/A,832,875,N/A,22,6
6,N/A,N/A,N/A,826,832,N/A,28,0
30,N/A,N/A,N/A,796,826,N/A,32,4
14,N/A,N/A,N/A,782,796,N/A,36,2
16,N/A,N/A,N/A,766,782,N/A,42,2
43,N/A,N/A,N/A,723,766,N/A,46,6
28,N/A,N/A,N/A,695,723,N/A,50,4
10,N/A,N/A,N/A,685,695,N/A,53,1
34,N/A,N/A,N/A,651,685,N/A,57,5
33,N/A,N/A,N/A,618,651,N/A,63,5
19,N/A,N/A,N/A,599,618,N/A,67,3
21,N/A,N/A,N/A,578,599,N/A,73,3
13,N/A,N/A,N/A,565,578,N/A,77,1
38,N/A,N/A,N/A,527,565,N/A,81,5
10,N/A,N/A,N/A,517,527,N/A,84,2
38,N/A,N/A,N/A,479,517,N/A,87,5
32,N/A,N/A,N/A,447,479,N/A,92,4
19,N/A,N/A,N/A,428,447,N/A,97,3
17,N/A,N/A,N/A,411,428,N/A,102,2
39,N/A,N/A,N/A,372,411,N/A,105,5
22,N/A,N/A,N/A,350,372,N/A,110,4
9,N/A,N/A,N/A,341,350,N/A,113,1
36,N/A,N/A,N/A,305,341,N/A,117,5
21,N/A,N/A,N/A,284,305,N/A,121,3
8,N/A,N/A,N/A,276,284,N/A,125,1
7,N/A,N/A,N/A,269,276,N/A,131,1
9,N/A,N/A,N/A,1144,1153,N/A,3,1
26,N/A,N/A,N/A,1118,1144,N/A,6,4
13,N/A,N/A,N/A,1105,1118,N/A,10,2
41,N/A,N/A,N/A,1064,1105,N/A,14,6
28,N/A,N/A,N/A,1036,1064,N/A,18,4
14,N/A,N/A,N/A,1022,1036,N/A,22,2
13,N/A,N/A,N/A,1009,1022,N/A,28,2
12,N/A,N/A,N/A,997,1009,N/A,33,1
41,N/A,N/A,N/A,956,997,N/A,38,6
9,N/A,N/A,N/A,947,956,N/A,44,0
25,N/A,N/A,N/A,922,947,N/A,48,4
12,N/A,N/A,N/A,910,922,N/A,52,2
37,N/A,N/A,N/A,873,910,N/A,55,5
35,N/A,N/A,N/A,838,873,N/A,61,5
13,N/A,N/A,N/A,825,838,N/A,64,2
11,N/A,N/A,N/A,814,825,N/A,70,2
42,N/A,N/A,N/A,772,814,N/A,74,6
16,N/A,N/A,N/A,756,772,N/A,77,3
7,N/A,N/A,N/A,749,756,N/A,81,1
12,N/A,N/A,N/A,737,749,N/A,87,1
25,N/A,N/A,N/A,712,737,N/A,90,4
14,N/A,N/A,N/A,698,712,N/A,93,1
35,N/A,N/A,N/A,663,698,N/A,97,5
34,N/A,N/A,N/A,629,663,N/A,103,5
15,N/A,N/A,N/A,614,629,N/A,106,2
43,N/A,N/A,N/A,571,614,N/A,110,6
21,N/A,N/A,N/A,550,571,N/A,113,3
16,N/A,N/A,N/A,534,550,N/A,118,2
8,N/A,N/A,N/A,526,534,N/A,123,1
8,N/A,N/A,N/A,518,526,N/A,129,1
27,N/A,N/A,N/A,1342,1369,N/A,4,4
19,N/A,N/A,N/A,1323,1342,N/A,9,3
42,N/A,N/A,N/A,1281,1323,N/A,12,6
35,N/A,N/A,N/A,1246,1281,N/A,17,5
16,N/A,N/A,N/A,1230,1246,N/A,20,2
39,N/A,N/A,N/A,1191,1230,N/A,23,5
38,N/A,N/A,N/A,1153,1191,N/A,29,5
16,N/A,N/A,N/A,1137,1153,N/A,33,3
19,N/A,N/A,N/A,1118,1137,N/A,39,3
12,N/A,N/A,N/A,1106,1118,N/A,43,1
44,N/A,N/A,N/A,1062,1106,N/A,48,6
36,N/A,N/A,N/A,1026,1062,N/A,53,5
12,N/A,N/A,N/A,1014,1026,N/A,56,2
7,N/A,N/A,N/A,1007,1014,N/A,61,1
11,N/A,N/A,N/A,996,1007,N/A,67,1
42,N/A,N/A,N/A,954,996,N/A,72,6
22,N/A,N/A,N/A,932,954,N/A,76,4
15,N/A,N/A,N/A,917,932,N/A,81,3
13,N/A,N/A,N/A,904,917,N/A,85,1
28,N/A,N/A,N/A,876,904,N/A,88,4
32,N/A,N/A,N/A,844,876,N/A,94,4
30,N/A,N/A,N/A,814,844,N/A,100,4
14,N/A,N/A,N/A,800,814,N/A,104,2
13,N/A,N/A,N/A,787,800,N/A,110,2
12,N/A,N/A,N/A,775,787,N/A,115,1
42,N/A,N/A,N/A,733,775,N/A,120,6
5,N/A,N/A,N/A,728,733,N/A,126,0
36,N/A,N/A,N/A,692,728,N/A,131,5
18,N/A,N/A,N/A,674,692,N/A,135,3
44,N/A,N/A,N/A,630,674,N/A,138,6
10,N/A,N/A,N/A,649,659,N/A,3,2
33,N/A,N/A,N/A,616,649,N/A,6,5
19,N/A,N/A,N/A,597,616,N/A,10,3
41,N/A,N/A,N/A,556,597,N/A,13,6
23,N/A,N/A,N/A,533,556,N/A,17,4
21,N/A,N/A,N/A,512,533,N/A,22,3
20,N/A,N/A,N/A,492,512,N/A,28,3
22,N/A,N/A,N/A,470,492,N/A,34,3
42,N/A,N/A,N/A,428,470,N/A,37,6
5,N/A,N/A,N/A,423,428,N/A,43,0
28,N/A,N/A,N/A,395,423,N/A,47,4
25,N/A,N/A,N/A,370,395,N/A,53,4
27,N/A,N/A,N/A,343,370,N/A,59,4
29,N/A,N/A,N/A,314,343,N/A,65,4
21,N/A,N/A,N/A,293,314,N/A,70,3
20,N/A,N/A,N/A,273,293,N/A,76,3
15,N/A,N/A,N/A,258,273,N/A,82,3
43,N/A,N/A,N/A,215,258,N/A,85,6
6,N/A,N/A,N/A,209,215,N/A,91,0
37,N/A,N/A,N/A,172,209,N/A,96,5
22,N/A,N/A,N/A,150,172,N/A,101,4
21,N/A,N/A,N/A,129,150,N/A,106,3
15,N/A,N/A,N/A,114,129,N/A,111,2
41,N/A,N/A,N/A,73,114,N/A,115,6
21,N/A,N/A,N/A,52,73,N/A,118,3
14,N/A,N/A,N/A,38,52,N/A,123,2
13,N/A,N/A,N/A,25,38,N/A,129,2
8,N/A,N/A,N/A,17,25,N/A,134,1
33,N/A,N/A,N/A,-16,17,N/A,138,5
17,N/A,N/A,N/A,1378,1395,N/A,4,2
16,N/A,N/A,N/A,1362,1378,N/A,10,2
8,N/A,N/A,N/A,1354,1362,N/A,15,1
38,N/A,N/A,N/A,1316,1354,N/A,19,5
38,N/A,N/A,N/A,1278,1316,N/A,25,5
10,N/A,N/A,N/A,1268,1278,N/A,28,2
7,N/A,N/A,N/A,1261,1268,N/A,33,1
10,N/A,N/A,N/A,1251,1261,N/A,39,1
10,N/A,N/A,N/A,1241,1251,N/A,45,1
41,N/A,N/A,N/A,1200,1241,N/A,50,6
28,N/A,N/A,N/A,1172,1200,N/A,54,4
13,N/A,N/A,N/A,1159,1172,N/A,58,2
10,N/A,N/A,N/A,1149,1159,N/A,63,1
44,N/A,N/A,N/A,1105,1149,N/A,68,6
39,N/A,N/A,N/A,1066,1105,N/A,73,5
16,N/A,N/A,N/A,1050,1066,N/A,76,2
41,N/A,N/A,N/A,1009,1050,N/A,80,6
7,N/A,N/A,N/A,1002,1009,N/A,86,0
16,N/A,N/A,N/A,986,1002,N/A,89,3
9,N/A,N/A,N/A,977,986,N/A,93,1
12,N/A,N/A,N/A,965,977,N/A,99,1
25,N/A,N/A,N/A,940,965,N/A,102,4
30,N/A,N/A,N/A,910,940,N/A,108,4
23,N/A,N/A,N/A,887,910,N/A,114,4
12,N/A,N/A,N/A,875,887,N/A,118,2
16,N/A,N/A,N/A,859,875,N/A,124,2
39,N/A,N/A,N/A,820,859,N/A,127,5
18,N/A,N/A,N/A,802,820,N/A,131,3
9,N/A,N/A,N/A,793,802,N/A,135,1
43,N/A,N/A,N/A,750,793,N/A,140,6
11,N/A,N/A,N/A,1345,1356,N/A,5,1
35,N/A,N/A,N/A,1310,1345,N/A,9,5
35,N/A,N/A,N/A,1275,1310,N/A,15,5
32,N/A,N/A,N/A,1243,1275,N/A,21,5
27,N/A,N/A,N/A,1216,1243,N/A,26,4
14,N/A,N/A,N/A,1202,1216,N/A,29,1
43,N/A,N/A,N/A,1159,1202,N/A,34,6
23,N/A,N/A,N/A,1136,1159,N/A,38,4
8,N/A,N/A,N/A,1128,1136,N/A,41,1
22,N/A,N/A,N/A,1106,1128,N/A,44,4
10,N/A,N/A,N/A,1096,1106,N/A,47,1
22,N/A,N/A,N/A,1074,1096,N/A,50,4
30,N/A,N/A,N/A,1044,1074,N/A,56,4
9,N/A,N/A,N/A,1035,1044,N/A,59,1
26,N/A,N/A,N/A,1009,1035,N/A,62,4
19,N/A,N/A,N/A,990,1009,N/A,67,3
42,N/A,N/A,N/A,948,990,N/A,70,6
20,N/A,N/A,N/A,928,948,N/A,73,3
7,N/A,N/A,N/A,921,928,N/A,77,1
32,N/A,N/A,N/A,889,921,N/A,81,5
23,N/A,N/A,N/A,866,889,N/A,85,3
16,N/A,N/A,N/A,850,866,N/A,90,2
13,N/A,N/A,N/A,837,850,N/A,95,1
10,N/A,N/A,N/A,827,837,N/A,101,1
32,N/A,N/A,N/A,795,827,N/A,105,5
12,N/A,N/A,N/A,783,795,N/A,108,2
7,N/A,N/A,N/A,776,783,N/A,113,1
41,N/A,N/A,N/A,735,776,N/A,118,6
30,N/A,N/A,N/A,705,735,N/A,122,4
14,N/A,N/A,N/A,691,705,N/A,127,3
24,N/A,N/A,N/A,1861,1885,N/A,3,4
17,N/A,N/A,N/A,1844,1861,N/A,7,2
12,N/A,N/A,N/A,1832,1844,N/A,13,2
44,N/A,N/A,N/A,1788,1832,N/A,17,6
28,N/A,N/A,N/A,1760,1788,N/A,21,4
16,N/A,N/A,N/A,1744,1760,N/A,26,3
10,N/A,N/A,N/A,1734,1744,N/A,31,2
17,N/A,N/A,N/A,1717,1734,N/A,37,2
41,N/A,N/A,N/A,1676,1717,N/A,41,6
19,N/A,N/A,N/A,1657,1676,N/A,44,3
16,N/A,N/A,N/A,1641,1657,N/A,49,2
34,N/A,N/A,N/A,1607,1641,N/A,52,5
20,N/A,N/A,N/A,1587,1607,N/A,56,3
13,N/A,N/A,N/A,1574,1587,N/A,60,1
32,N/A,N/A,N/A,1542,1574,N/A,64,5
14,N/A,N/A,N/A,1528,1542,N/A,67,2
33,N/A,N/A,N/A,1495,1528,N/A,70,5
29,N/A,N/A,N/A,1466,1495,N/A,75,4
28,N/A,N/A,N/A,1438,1466,N/A,81,4
14,N/A,N/A,N/A,1424,1438,N/A,84,1
29,N/A,N/A,N/A,1395,1424,N/A,87,4
13,N/A,N/A,N/A,1382,1395,N/A,91,2
42,N/A,N/A,N/A,1340,1382,N/A,95,6
6,N/A,N/A,N/A,1334,1340,N/A,101,0
44,N/A,N/A,N/A,1290,1334,N/A,107,6
8,N/A,N/A,N/A,1282,1290,N/A,113,0
43,N/A,N/A,N/A,1239,1282,N/A,119,6
22,N/A,N/A,N/A,1217,1239,N/A,122,3
11,N/A,N/A,N/A,1206,1217,N/A,126,1
8,N/A,N/A,N/A,1198,1206,N/A,132,1
37,N/A,N/A,N/A,418,455,N/A,4,5
28,N/A,N/A,N/A,390,418,N/A,9,4
11,N/A,N/A,N/A,379,390,N/A,13,2
8,N/A,N/A,N/A,371,379,N/A,18,1
34,N/A,N/A,N/A,337,371,N/A,22,5
11,N/A,N/A,N/A,326,337,N/A,25,2
32,N/A,N/A,N/A,294,326,N/A,28,5
39,N/A,N/A,N/A,255,294,N/A,34,5
26,N/A,N/A,N/A,229,255,N/A,39,4
28,N/A,N/A,N/A,201,229,N/A,45,4
24,N/A,N/A,N/A,177,201,N/A,51,4
18,N/A,N/A,N/A,159,177,N/A,56,3
21,N/A,N/A,N/A,138,159,N/A,62,3
23,N/A,N/A,N/A,115,138,N/A,68,3
19,N/A,N/A,N/A,96,115,N/A,74,3
11,N/A,N/A,N/A,85,96,N/A,78,1
41,N/A,N/A,N/A,44,85,N/A,83,6
35,N/A,N/A,N/A,9,44,N/A,88,5
24,N/A,N/A,N/A,-15,9,N/A,93,4
14,N/A,N/A,N/A,838,852,N/A,4,2
43,N/A,N/A,N/A,795,838,N/A,8,6
30,N/A,N/A,N/A,765,795,N/A,12,4
27,N/A,N/A,N/A,738,765,N/A,18,4
20,N/A,N/A,N/A,718,738,N/A,23,3
41,N/A,N/A,N/A,677,718,N/A,26,6
27,N/A,N/A,N/A,650,677,N/A,30,4
10,N/A,N/A,N/A,640,650,N/A,34,2
44,N/A,N/A,N/A,596,640,N/A,38,6
22,N/A,N/A,N/A,574,596,N/A,41,3
42,N/A,N/A,N/A,532,574,N/A,44,6
5,N/A,N/A,N/A,527,532,N/A,50,0
36,N/A,N/A,N/A,491,527,N/A,55,5
18,N/A,N/A,N/A,473,491,N/A,59,3
41,N/A,N/A,N/A,432,473,N/A,62,6
20,N/A,N/A,N/A,412,432,N/A,65,3
44,N/A,N/A,N/A,368,412,N/A,68,6
23,N/A,N/A,N/A,345,368,N/A,72,4
18,N/A,N/A,N/A,327,345,N/A,77,3
17,N/A,N/A,N/A,310,327,N/A,82,2
44,N/A,N/A,N/A,266,310,N/A,86,6
32,N/A,N/A,N/A,234,266,N/A,91,5
32,N/A,N/A,N/A,202,234,N/A,97,5
35,N/A,N/A,N/A,167,202,N/A,103,5
23,N/A,N/A,N/A,144,167,N/A,107,3
44,N/A,N/A,N/A,100,144,N/A,110,6
6,N/A,N/A,N/A,94,100,N/A,116,0
31,N/A,N/A,N/A,63,94,N/A,120,4
8,N/A,N/A,N/A,55,63,N/A,123,1
25,N/A,N/A,N/A,30,55,N/A,126,4
17,N/A,N/A,N/A,893,910,N/A,3,3
22,N/A,N/A,N/A,871,893,N/A,9,3
41,N/A,N/A,N/A,830,871,N/A,12,6
39,N/A,N/A,N/A,791,830,N/A,17,5
22,N/A,N/A,N/A,769,791,N/A,21,3
19,N/A,N/A,N/A,750,769,N/A,27,3
44,N/A,N/A,N/A,706,750,N/A,30,6
23,N/A,N/A,N/A,683,706,N/A,33,3
16,N/A,N/A,N/A,667,683,N/A,38,2
43,N/A,N/A,N/A,624,667,N/A,42,6
8,N/A,N/A,N/A,616,624,N/A,48,0
23,N/A,N/A,N/A,593,616,N/A,52,4
12,N/A,N/A,N/A,581,593,N/A,55,1
11,N/A,N/A,N/A,570,581,N/A,61,1
26,N/A,N/A,N/A,544,570,N/A,64,4
13,N/A,N/A,N/A,531,544,N/A,68,2
11,N/A,N/A,N/A,520,531,N/A,74,2
10,N/A,N/A,N/A,510,520,N/A,80,2
8,N/A,N/A,N/A,502,510,N/A,85,1
36,N/A,N/A,N/A,466,502,N/A,89,5
38,N/A,N/A,N/A,428,466,N/A,95,5
16,N/A,N/A,N/A,412,428,N/A,98,2
41,N/A,N/A,N/A,371,412,N/A,102,6
32,N/A,N/A,N/A,339,371,N/A,106,4
13,N/A,N/A,N/A,326,339,N/A,110,2
43,N/A,N/A,N/A,283,326,N/A,114,6
18,N/A,N/A,N/A,265,283,N/A,117,3
11,N/A,N/A,N/A,254,265,N/A,122,2
11,N/A,N/A,N/A,243,254,N/A,128,2
14,N/A,N/A,N/A,229,243,N/A,134,2
13,N/A,N/A,N/A,1005,1018,N/A,3,2
33,N/A,N/A,N/A,972,1005,N/A,6,5
15,N/A,N/A,N/A,957,972,N/A,10,3
23,N/A,N/A,N/A,934,957,N/A,16,3
12,N/A,N/A,N/A,922,934,N/A,21,2
8,N/A,N/A,N/A,914,922,N/A,26,1
14,N/A,N/A,N/A,900,914,N/A,32,1
43,N/A,N/A,N/A,857,900,N/A,37,6
31,N/A,N/A,N/A,826,857,N/A,41,4
16,N/A,N/A,N/A,810,826,N/A,46,3
11,N/A,N/A,N/A,799,810,N/A,50,1
24,N/A,N/A,N/A,775,799,N/A,53,4
13,N/A,N/A,N/A,762,775,N/A,56,1
23,N/A,N/A,N/A,739,762,N/A,59,4
22,N/A,N/A,N/A,717,739,N/A,65,4
15,N/A,N/A,N/A,702,717,N/A,69,2
11,N/A,N/A,N/A,691,702,N/A,74,1
30,N/A,N/A,N/A,661,691,N/A,77,4
18,N/A,N/A,N/A,643,661,N/A,82,3
14,N/A,N/A,N/A,629,643,N/A,88,3
11,N/A,N/A,N/A,618,629,N/A,92,1
36,N/A,N/A,N/A,582,618,N/A,96,5
25,N/A,N/A,N/A,557,582,N/A,101,4
23,N/A,N/A,N/A,534,557,N/A,106,3
12,N/A,N/A,N/A,522,534,N/A,111,2
36,N/A,N/A,N/A,486,522,N/A,114,5
20,N/A,N/A,N/A,466,486,N/A,118,3
42,N/A,N/A,N/A,424,466,N/A,121,6
22,N/A,N/A,N/A,402,424,N/A,124,3
42,N/A,N/A,N/A,360,402,N/A,127,6
15,N/A,N/A,N/A,718,733,N/A,4,2
10,N/A,N/A,N/A,708,718,N/A,10,2
44,N/A,N/A,N/A,664,708,N/A,14,6
16,N/A,N/A,N/A,648,664,N/A,17,3
12,N/A,N/A,N/A,636,648,N/A,21,1
31,N/A,N/A,N/A,605,636,N/A,24,4
28,N/A,N/A,N/A,577,605,N/A,30,4
11,N/A,N/A,N/A,566,577,N/A,33,1
43,N/A,N/A,N/A,523,566,N/A,38,6
6,N/A,N/A,N/A,517,523,N/A,44,0
34,N/A,N/A,N/A,483,517,N/A,49,5
14,N/A,N/A,N/A,469,483,N/A,53,3
8,N/A,N/A,N/A,461,469,N/A,57,1
14,N/A,N/A,N/A,447,461,N/A,63,1
28,N/A,N/A,N/A,419,447,N/A,66,4
16,N/A,N/A,N/A,403,419,N/A,70,2
37,N/A,N/A,N/A,366,403,N/A,73,5
37,N/A,N/A,N/A,329,366,N/A,79,5
33,N/A,N/A,N/A,296,329,N/A,85,5
17,N/A,N/A,N/A,279,296,N/A,88,2
14,N/A,N/A,N/A,265,279,N/A,94,2
13,N/A,N/A,N/A,252,265,N/A,100,2
33,N/A,N/A,N/A,219,252,N/A,103,5
19,N/A,N/A,N/A,200,219,N/A,107,3
11,N/A,N/A,N/A,189,200,N/A,111,1
25,N/A,N/A,N/A,164,189,N/A,114,4
29,N/A,N/A,N/A,135,164,N/A,120,4
17,N/A,N/A,N/A,118,135,N/A,124,2
33,N/A,N/A,N/A,85,118,N/A,127,5
35,N/A,N/A,N/A,50,85,N/A,133,5
10,N/A,N/A,N/A,1676,1686,N/A,6,1
43,N/A,N/A,N/A,1633,1676,N/A,11,6
18,N/A,N/A,N/A,1615,1633,N/A,14,3
12,N/A,N/A,N/A,1603,1615,N/A,18,1
24,N/A,N/A,N/A,1579,1603,N/A,21,4
13,N/A,N/A,N/A,1566,1579,N/A,25,2
34,N/A,N/A,N/A,1532,1566,N/A,28,5
17,N/A,N/A,N/A,1515,1532,N/A,31,2
32,N/A,N/A,N/A,1483,1515,N/A,34,5
13,N/A,N/A,N/A,1470,1483,N/A,37,2
12,N/A,N/A,N/A,1458,1470,N/A,42,1
8,N/A,N/A,N/A,1450,1458,N/A,48,1
43,N/A,N/A,N/A,1407,1450,N/A,53,6
6,N/A,N/A,N/A,1401,1407,N/A,59,0
16,N/A,N/A,N/A,1385,1401,N/A,62,3
9,N/A,N/A,N/A,1376,1385,N/A,66,1
36,N/A,N/A,N/A,1340,1376,N/A,70,5
15,N/A,N/A,N/A,1325,1340,N/A,73,2
41,N/A,N/A,N/A,1284,1325,N/A,77,6
23,N/A,N/A,N/A,1261,1284,N/A,80,3
10,N/A,N/A,N/A,1251,1261,N/A,85,2
44,N/A,N/A,N/A,1207,1251,N/A,89,6
15,N/A,N/A,N/A,1192,1207,N/A,92,3
12,N/A,N/A,N/A,1180,1192,N/A,97,2
8,N/A,N/A,N/A,1172,1180,N/A,102,1
41,N/A,N/A,N/A,1131,1172,N/A,107,6
9,N/A,N/A,N/A,1122,1131,N/A,113,0
23,N/A,N/A,N/A,1099,1122,N/A,116,3
23,N/A,N/A,N/A,1076,1099,N/A,122,3
16,N/A,N/A,N/A,1060,1076,N/A,127,2
9,N/A,N/A,N/A,1726,1735,N/A,6,1
10,N/A,N/A,N/A,1716,1726,N/A,12,1
38,N/A,N/A,N/A,1678,1716,N/A,16,5
19,N/A,N/A,N/A,1659,1678,N/A,20,3
10,N/A,N/A,N/A,1649,1659,N/A,25,2
11,N/A,N/A,N/A,1638,1649,N/A,31,2
13,N/A,N/A,N/A,1625,1638,N/A,37,2
34,N/A,N/A,N/A,1591,1625,N/A,40,5
32,N/A,N/A,N/A,1559,1591,N/A,46,5
31,N/A,N/A,N/A,1528,1559,N/A,51,4
29,N/A,N/A,N/A,1499,1528,N/A,57,4
16,N/A,N/A,N/A,1483,1499,N/A,62,3
41,N/A,N/A,N/A,1442,1483,N/A,65,6
8,N/A,N/A,N/A,1434,1442,N/A,71,0
42,N/A,N/A,N/A,1392,1434,N/A,77,6
8,N/A,N/A,N/A,1384,1392,N/A,83,0
39,N/A,N/A,N/A,1345,1384,N/A,88,5
15,N/A,N/A,N/A,1330,1345,N/A,91,2
41,N/A,N/A,N/A,1289,1330,N/A,95,6
8,N/A,N/A,N/A,1281,1289,N/A,101,0
22,N/A,N/A,N/A,1259,1281,N/A,105,4
14,N/A,N/A,N/A,1245,1259,N/A,109,2
37,N/A,N/A,N/A,1208,1245,N/A,112,5
37,N/A,N/A,N/A,1171,1208,N/A,118,5
17,N/A,N/A,N/A,1154,1171,N/A,122,3
12,N/A,N/A,N/A,1142,1154,N/A,126,1
30,N/A,N/A,N/A,1112,1142,N/A,129,4
12,N/A,N/A,N/A,1100,1112,N/A,132,1
41,N/A,N/A,N/A,1059,1100,N/A,137,6
24,N/A,N/A,N/A,1035,1059,N/A,141,4
9,N/A,N/A,N/A,1603,1612,N/A,6,1
43,N/A,N/A,N/A,1560,1603,N/A,11,6
23,N/A,N/A,N/A,1537,1560,N/A,14,3
7,N/A,N/A,N/A,1530,1537,N/A,18,1
23,N/A,N/A,N/A,1507,1530,N/A,21,4
12,N/A,N/A,N/A,1495,1507,N/A,24,1
41,N/A,N/A,N/A,1454,1495,N/A,29,6
31,N/A,N/A,N/A,1423,1454,N/A,33,4
20,N/A,N/A,N/A,1403,1423,N/A,38,3
44,N/A,N/A,N/A,1359,1403,N/A,41,6
5,N/A,N/A,N/A,1354,1359,N/A,47,0
39,N/A,N/A,N/A,1315,1354,N/A,52,5
16,N/A,N/A,N/A,1299,1315,N/A,56,3
42,N/A,N/A,N/A,1257,1299,N/A,59,6
7,N/A,N/A,N/A,1250,1257,N/A,65,0
24,N/A,N/A,N/A,1226,1250,N/A,69,4
30,N/A,N/A,N/A,1196,1226,N/A,75,4
19,N/A,N/A,N/A,1177,1196,N/A,80,3
12,N/A,N/A,N/A,1165,1177,N/A,84,1
41,N/A,N/A,N/A,1124,1165,N/A,89,6
14,N/A,N/A,N/A,1110,1124,N/A,92,3
23,N/A,N/A,N/A,1087,1110,N/A,98,3
21,N/A,N/A,N/A,1066,1087,N/A,104,3
16,N/A,N/A,N/A,1050,1066,N/A,110,3
44,N/A,N/A,N/A,1006,1050,N/A,113,6
36,N/A,N/A,N/A,970,1006,N/A,118,5
11,N/A,N/A,N/A,959,970,N/A,121,2
37,N/A,N/A,N/A,922,959,N/A,124,5
36,N/A,N/A,N/A,886,922,N/A,130,5
38,N/A,N/A,N/A,848,886,N/A,136,5
44,N/A,N/A,N/A,957,1001,N/A,6,6
17,N/A,N/A,N/A,940,957,N/A,9,3
13,N/A,N/A,N/A,927,940,N/A,14,2
39,N/A,N/A,N/A,888,927,N/A,17,5
35,N/A,N/A,N/A,853,888,N/A,23,5
15,N/A,N/A,N/A,838,853,N/A,27,3
13,N/A,N/A,N/A,825,838,N/A,31,1
22,N/A,N/A,N/A,803,825,N/A,34,4
23,N/A,N/A,N/A,780,803,N/A,40,4
13,N/A,N/A,N/A,767,780,N/A,43,1
44,N/A,N/A,N/A,723,767,N/A,48,6
16,N/A,N/A,N/A,707,723,N/A,51,3
17,N/A,N/A,N/A,690,707,N/A,56,2
17,N/A,N/A,N/A,673,690,N/A,62,2
10,N/A,N/A,N/A,663,673,N/A,68,2
44,N/A,N/A,N/A,619,663,N/A,72,6
22,N/A,N/A,N/A,597,619,N/A,76,4
23,N/A,N/A,N/A,574,597,N/A,82,4
13,N/A,N/A,N/A,561,574,N/A,86,2
43,N/A,N/A,N/A,518,561,N/A,90,6
33,N/A,N/A,N/A,485,518,N/A,95,5
14,N/A,N/A,N/A,471,485,N/A,98,2
8,N/A,N/A,N/A,463,471,N/A,103,1
11,N/A,N/A,N/A,452,463,N/A,109,1
42,N/A,N/A,N/A,410,452,N/A,114,6
25,N/A,N/A,N/A,385,410,N/A,118,4
23,N/A,N/A,N/A,362,385,N/A,123,3
19,N/A,N/A,N/A,343,362,N/A,129,3
42,N/A,N/A,N/A,301,343,N/A,132,6
30,N/A,N/A,N/A,271,301,N/A,136,4
19,N/A,N/A,N/A,591,610,N/A,5,3
13,N/A,N/A,N/A,578,591,N/A,9,1
7,N/A,N/A,N/A,571,578,N/A,15,1
43,N/A,N/A,N/A,528,571,N/A,20,6
37,N/A,N/A,N/A,491,528,N/A,25,5
33,N/A,N/A,N/A,458,491,N/A,31,5
16,N/A,N/A,N/A,442,458,N/A,35,3
43,N/A,N/A,N/A,399,442,N/A,38,6
19,N/A,N/A,N/A,380,399,N/A,41,3
22,N/A,N/A,N/A,358,380,N/A,47,3
23,N/A,N/A,N/A,335,358,N/A,53,3
17,N/A,N/A,N/A,318,335,N/A,59,3
44,N/A,N/A,N/A,274,318,N/A,62,6
19,N/A,N/A,N/A,255,274,N/A,65,3
13,N/A,N/A,N/A,242,255,N/A,70,2
34,N/A,N/A,N/A,208,242,N/A,73,5
35,N/A,N/A,N/A,173,208,N/A,79,5
33,N/A,N/A,N/A,140,173,N/A,85,5
16,N/A,N/A,N/A,124,140,N/A,89,3
41,N/A,N/A,N/A,83,124,N/A,92,6
31,N/A,N/A,N/A,52,83,N/A,96,4
30,N/A,N/A,N/A,22,52,N/A,102,4
17,N/A,N/A,N/A,5,22,N/A,107,3
16,N/A,N/A,N/A,-11,5,N/A,113,3
16,N/A,N/A,N/A,630,646,N/A,3,2
14,N/A,N/A,N/A,616,630,N/A,9,2
12,N/A,N/A,N/A,604,616,N/A,14,1
29,N/A,N/A,N/A,575,604,N/A,17,4
23,N/A,N/A,N/A,552,575,N/A,23,4
26,N/A,N/A,N/A,526,552,N/A,29,4
13,N/A,N/A,N/A,513,526,N/A,33,2
33,N/A,N/A,N/A,480,513,N/A,36,5
35,N/A,N/A,N/A,445,480,N/A,42,5
31,N/A,N/A,N/A,414,445,N/A,47,4
11,N/A,N/A,N/A,403,414,N/A,51,2
36,N/A,N/A,N/A,367,403,N/A,54,5
28,N/A,N/A,N/A,339,367,N/A,59,4
11,N/A,N/A,N/A,328,339,N/A,62,1
44,N/A,N/A,N/A,284,328,N/A,67,6
35,N/A,N/A,N/A,249,284,N/A,72,5
23,N/A,N/A,N/A,226,249,N/A,76,3
44,N/A,N/A,N/A,182,226,N/A,79,6
36,N/A,N/A,N/A,146,182,N/A,84,5
13,N/A,N/A,N/A,133,146,N/A,87,2
8,N/A,N/A,N/A,125,133,N/A,92,1
9,N/A,N/A,N/A,116,125,N/A,98,1
23,N/A,N/A,N/A,93,116,N/A,101,4
19,N/A,N/A,N/A,74,93,N/A,106,3
17,N/A,N/A,N/A,57,74,N/A,112,3
11,N/A,N/A,N/A,46,57,N/A,116,1
8,N/A,N/A,N/A,38,46,N/A,122,1
38,N/A,N/A,N/A,0,38,N/A,126,5
34,N/A,N/A,N/A,1224,1258,N/A,3,5
14,N/A,N/A,N/A,1210,1224,N/A,6,2
13,N/A,N/A,N/A,1197,1210,N/A,12,2
16,N/A,N/A,N/A,1181,1197,N/A,18,2
15,N/A,N/A,N/A,1166,1181,N/A,24,2
39,N/A,N/A,N/A,1127,1166,N/A,27,5
10,N/A,N/A,N/A,1117,1127,N/A,30,2
44,N/A,N/A,N/A,1073,1117,N/A,34,6
23,N/A,N/A,N/A,1050,1073,N/A,37,3
9,N/A,N/A,N/A,1041,1050,N/A,41,1
42,N/A,N/A,N/A,999,1041,N/A,46,6
16,N/A,N/A,N/A,983,999,N/A,49,3
16,N/A,N/A,N/A,967,983,N/A,54,2
35,N/A,N/A,N/A,932,967,N/A,57,5
33,N/A,N/A,N/A,899,932,N/A,63,5
16,N/A,N/A,N/A,883,899,N/A,66,2
16,N/A,N/A,N/A,867,883,N/A,72,2
42,N/A,N/A,N/A,825,867,N/A,76,6
36,N/A,N/A,N/A,789,825,N/A,81,5
29,N/A,N/A,N/A,760,789,N/A,86,4
22,N/A,N/A,N/A,738,760,N/A,92,4
23,N/A,N/A,N/A,715,738,N/A,98,4
17,N/A,N/A,N/A,698,715,N/A,103,3
17,N/A,N/A,N/A,681,698,N/A,108,2
42,N/A,N/A,N/A,639,681,N/A,112,6
26,N/A,N/A,N/A,613,639,N/A,116,4
17,N/A,N/A,N/A,596,613,N/A,121,3
8,N/A,N/A,N/A,588,596,N/A,125,1
44,N/A,N/A,N/A,544,588,N/A,130,6
5,N/A,N/A,N/A,539,544,N/A,136,0
43,N/A,N/A,N/A,457,500,N/A,3,6
23,N/A,N/A,N/A,434,457,N/A,6,3
14,N/A,N/A,N/A,420,434,N/A,12,3
15,N/A,N/A,N/A,405,420,N/A,18,3
15,N/A,N/A,N/A,390,405,N/A,24,3
42,N/A,N/A,N/A,348,390,N/A,27,6
22,N/A,N/A,N/A,326,348,N/A,30,3
13,N/A,N/A,N/A,313,326,N/A,34,1
44,N/A,N/A,N/A,269,313,N/A,39,6
14,N/A,N/A,N/A,255,269,N/A,42,3
18,N/A,N/A,N/A,237,255,N/A,48,3
41,N/A,N/A,N/A,196,237,N/A,51,6
14,N/A,N/A,N/A,182,196,N/A,54,3
41,N/A,N/A,N/A,141,182,N/A,57,6
14,N/A,N/A,N/A,127,141,N/A,60,3
41,N/A,N/A,N/A,86,127,N/A,63,6
38,N/A,N/A,N/A,48,86,N/A,68,5
13,N/A,N/A,N/A,35,48,N/A,71,2
16,N/A,N/A,N/A,19,35,N/A,77,2
33,N/A,N/A,N/A,-14,19,N/A,80,5
24,N/A,N/A,N/A,904,928,N/A,5,4
9,N/A,N/A,N/A,895,904,N/A,8,1
42,N/A,N/A,N/A,853,895,N/A,13,6
22,N/A,N/A,N/A,831,853,N/A,16,3
11,N/A,N/A,N/A,820,831,N/A,21,2
13,N/A,N/A,N/A,807,820,N/A,27,2
39,N/A,N/A,N/A,768,807,N/A,30,5
16,N/A,N/A,N/A,752,768,N/A,33,2
38,N/A,N/A,N/A,714,752,N/A,36,5
17,N/A,N/A,N/A,697,714,N/A,39,2
14,N/A,N/A,N/A,683,697,N/A,45,2
34,N/A,N/A,N/A,649,683,N/A,48,5
23,N/A,N/A,N/A,626,649,N/A,52,3
44,N/A,N/A,N/A,582,626,N/A,55,6
23,N/A,N/A,N/A,559,582,N/A,58,3
13,N/A,N/A,N/A,546,559,N/A,62,1
27,N/A,N/A,N/A,519,546,N/A,65,4
20,N/A,N/A,N/A,499,519,N/A,70,3
7,N/A,N/A,N/A,492,499,N/A,74,1
31,N/A,N/A,N/A,461,492,N/A,77,4
15,N/A,N/A,N/A,446,461,N/A,82,3
16,N/A,N/A,N/A,430,446,N/A,87,2
10,N/A,N/A,N/A,420,430,N/A,93,2
9,N/A,N/A,N/A,411,420,N/A,98,1
31,N/A,N/A,N/A,380,411,N/A,101,4
17,N/A,N/A,N/A,363,380,N/A,105,2
36,N/A,N/A,N/A,327,363,N/A,108,5
36,N/A,N/A,N/A,291,327,N/A,114,5
15,N/A,N/A,N/A,276,291,N/A,117,2
35,N/A,N/A,N/A,241,276,N/A,120,5
42,N/A,N/A,N/A,794,836,N/A,5,6
7,N/A,N/A,N/A,787,794,N/A,11,0
41,N/A,N/A,N/A,746,787,N/A,17,6
18,N/A,N/A,N/A,728,746,N/A,20,3
10,N/A,N/A,N/A,718,728,N/A,24,1
24,N/A,N/A,N/A,694,718,N/A,27,4
10,N/A,N/A,N/A,684,694,N/A,31,2
41,N/A,N/A,N/A,643,684,N/A,35,6
34,N/A,N/A,N/A,609,643,N/A,40,5
10,N/A,N/A,N/A,599,609,N/A,43,2
43,N/A,N/A,N/A,556,599,N/A,47,6
18,N/A,N/A,N/A,538,556,N/A,50,3
15,N/A,N/A,N/A,523,538,N/A,56,3
13,N/A,N/A,N/A,510,523,N/A,60,1
31,N/A,N/A,N/A,479,510,N/A,63,4
17,N/A,N/A,N/A,462,479,N/A,67,2
36,N/A,N/A,N/A,426,462,N/A,70,5
14,N/A,N/A,N/A,412,426,N/A,73,2
13,N/A,N/A,N/A,399,412,N/A,79,2
39,N/A,N/A,N/A,360,399,N/A,82,5
39,N/A,N/A,N/A,321,360,N/A,88,5
15,N/A,N/A,N/A,306,321,N/A,91,2
10,N/A,N/A,N/A,296,306,N/A,96,1
29,N/A,N/A,N/A,267,296,N/A,99,4
17,N/A,N/A,N/A,250,267,N/A,104,3
14,N/A,N/A,N/A,236,250,N/A,108,1
37,N/A,N/A,N/A,199,236,N/A,112,5
17,N/A,N/A,N/A,182,199,N/A,115,2
11,N/A,N/A,N/A,171,182,N/A,120,1
41,N/A,N/A,N/A,130,171,N/A,125,6
20,N/A,N/A,N/A,914,934,N/A,5,3
23,N/A,N/A,N/A,891,914,N/A,11,3
14,N/A,N/A,N/A,877,891,N/A,16,2
11,N/A,N/A,N/A,866,877,N/A,22,2
37,N/A,N/A,N/A,829,866,N/A,25,5
17,N/A,N/A,N/A,812,829,N/A,28,2
33,N/A,N/A,N/A,779,812,N/A,31,5
34,N/A,N/A,N/A,745,779,N/A,37,5
14,N/A,N/A,N/A,731,745,N/A,40,2
33,N/A,N/A,N/A,698,731,N/A,43,5
38,N/A,N/A,N/A,660,698,N/A,49,5
13,N/A,N/A,N/A,647,660,N/A,52,2
44,N/A,N/A,N/A,603,647,N/A,56,6
9,N/A,N/A,N/A,594,603,N/A,62,0
32,N/A,N/A,N/A,562,594,N/A,66,4
12,N/A,N/A,N/A,550,562,N/A,70,2
9,N/A,N/A,N/A,541,550,N/A,75,1
33,N/A,N/A,N/A,508,541,N/A,79,5
31,N/A,N/A,N/A,477,508,N/A,84,4
21,N/A,N/A,N/A,456,477,N/A,89,3
23,N/A,N/A,N/A,433,456,N/A,95,3
16,N/A,N/A,N/A,417,433,N/A,100,2
14,N/A,N/A,N/A,403,417,N/A,106,2
15,N/A,N/A,N/A,388,403,N/A,112,2
12,N/A,N/A,N/A,376,388,N/A,118,2
16,N/A,N/A,N/A,360,376,N/A,124,2
11,N/A,N/A,N/A,349,360,N/A,130,2
9,N/A,N/A,N/A,340,349,N/A,135,1
37,N/A,N/A,N/A,303,340,N/A,139,5
14,N/A,N/A,N/A,289,303,N/A,143,3
38,N/A,N/A,N/A,1572,1610,N/A,6,5
13,N/A,N/A,N/A,1559,1572,N/A,9,2
43,N/A,N/A,N/A,1516,1559,N/A,13,6
24,N/A,N/A,N/A,1492,1516,N/A,17,4
18,N/A,N/A,N/A,1474,1492,N/A,22,3
42,N/A,N/A,N/A,1432,1474,N/A,25,6
26,N/A,N/A,N/A,1406,1432,N/A,29,4
15,N/A,N/A,N/A,1391,1406,N/A,34,3
42,N/A,N/A,N/A,1349,1391,N/A,37,6
22,N/A,N/A,N/A,1327,1349,N/A,40,3
11,N/A,N/A,N/A,1316,1327,N/A,44,1
43,N/A,N/A,N/A,1273,1316,N/A,49,6
23,N/A,N/A,N/A,1250,1273,N/A,52,3
22,N/A,N/A,N/A,1228,1250,N/A,58,3
11,N/A,N/A,N/A,1217,1228,N/A,62,1
32,N/A,N/A,N/A,1185,1217,N/A,66,5
14,N/A,N/A,N/A,1171,1185,N/A,70,3
23,N/A,N/A,N/A,1148,1171,N/A,76,3
17,N/A,N/A,N/A,1131,1148,N/A,81,2
11,N/A,N/A,N/A,1120,1131,N/A,87,2
32,N/A,N/A,N/A,1088,1120,N/A,90,5
17,N/A,N/A,N/A,1071,1088,N/A,93,2
39,N/A,N/A,N/A,1032,1071,N/A,96,5
16,N/A,N/A,N/A,1016,1032,N/A,100,3
41,N/A,N/A,N/A,975,1016,N/A,103,6
37,N/A,N/A,N/A,938,975,N/A,108,5
14,N/A,N/A,N/A,924,938,N/A,111,2
12,N/A,N/A,N/A,912,924,N/A,117,2
41,N/A,N/A,N/A,871,912,N/A,121,6
7,N/A,N/A,N/A,864,871,N/A,127,0
17,N/A,N/A,N/A,1924,1941,N/A,5,2
17,N/A,N/A,N/A,1907,1924,N/A,11,2
42,N/A,N/A,N/A,1865,1907,N/A,15,6
32,N/A,N/A,N/A,1833,1865,N/A,19,4
23,N/A,N/A,N/A,1810,1833,N/A,24,3
12,N/A,N/A,N/A,1798,1810,N/A,29,2
13,N/A,N/A,N/A,1785,1798,N/A,34,1
32,N/A,N/A,N/A,1753,1785,N/A,38,5
16,N/A,N/A,N/A,1737,1753,N/A,42,3
22,N/A,N/A,N/A,1715,1737,N/A,48,3
23,N/A,N/A,N/A,1692,1715,N/A,54,3
11,N/A,N/A,N/A,1681,1692,N/A,58,1
43,N/A,N/A,N/A,1638,1681,N/A,63,6
32,N/A,N/A,N/A,1606,1638,N/A,68,5
39,N/A,N/A,N/A,1567,1606,N/A,74,5
19,N/A,N/A,N/A,1548,1567,N/A,78,3
13,N/A,N/A,N/A,1535,1548,N/A,83,2
39,N/A,N/A,N/A,1496,1535,N/A,86,5
17,N/A,N/A,N/A,1479,1496,N/A,89,2
43,N/A,N/A,N/A,1436,1479,N/A,93,6
6,N/A,N/A,N/A,1430,1436,N/A,99,0
23,N/A,N/A,N/A,1407,1430,N/A,102,3
41,N/A,N/A,N/A,1366,1407,N/A,105,6
31,N/A,N/A,N/A,1335,1366,N/A,109,4
12,N/A,N/A,N/A,1323,1335,N/A,112,1
26,N/A,N/A,N/A,1297,1323,N/A,115,4
12,N/A,N/A,N/A,1285,1297,N/A,119,2
11,N/A,N/A,N/A,1274,1285,N/A,124,1
22,N/A,N/A,N/A,1252,1274,N/A,127,4
26,N/A,N/A,N/A,1226,1252,N/A,133,4
17,N/A,N/A,N/A,1951,1968,N/A,6,2
17,N/A,N/A,N/A,1934,1951,N/A,12,2
44,N/A,N/A,N/A,1890,1934,N/A,16,6
33,N/A,N/A,N/A,1857,1890,N/A,21,5
37,N/A,N/A,N/A,1820,1857,N/A,27,5
34,N/A,N/A,N/A,1786,1820,N/A,33,5
26,N/A,N/A,N/A,1760,1786,N/A,38,4
12,N/A,N/A,N/A,1748,1760,N/A,42,2
17,N/A,N/A,N/A,1731,1748,N/A,48,2
13,N/A,N/A,N/A,1718,1731,N/A,53,1
37,N/A,N/A,N/A,1681,1718,N/A,57,5
11,N/A,N/A,N/A,1670,1681,N/A,60,2
11,N/A,N/A,N/A,1659,1670,N/A,66,2
13,N/A,N/A,N/A,1646,1659,N/A,72,2
44,N/A,N/A,N/A,1602,1646,N/A,76,6
7,N/A,N/A,N/A,1595,1602,N/A,82,0
44,N/A,N/A,N/A,1551,1595,N/A,88,6
18,N/A,N/A,N/A,1533,1551,N/A,91,3
44,N/A,N/A,N/A,1489,1533,N/A,94,6
5,N/A,N/A,N/A,1484,1489,N/A,100,0
32,N/A,N/A,N/A,1452,1484,N/A,104,4
10,N/A,N/A,N/A,1442,1452,N/A,108,2
13,N/A,N/A,N/A,1429,1442,N/A,113,1
22,N/A,N/A,N/A,1407,1429,N/A,116,4
12,N/A,N/A,N/A,1395,1407,N/A,119,1
7,N/A,N/A,N/A,1388,1395,N/A,125,1
8,N/A,N/A,N/A,1380,1388,N/A,131,1
34,N/A,N/A,N/A,1346,1380,N/A,135,5
34,N/A,N/A,N/A,1312,1346,N/A,141,5
27,N/A,N/A,N/A,1285,1312,N/A,146,4
11,N/A,N/A,N/A,1849,1860,N/A,3,1
42,N/A,N/A,N/A,1807,1849,N/A,8,6
35,N/A,N/A,N/A,1772,1807,N/A,13,5
33,N/A,N/A,N/A,1739,1772,N/A,19,5
34,N/A,N/A,N/A,1705,1739,N/A,25,5
24,N/A,N/A,N/A,1681,1705,N/A,30,4
26,N/A,N/A,N/A,1655,1681,N/A,36,4
17,N/A,N/A,N/A,1638,1655,N/A,40,2
13,N/A,N/A,N/A,1625,1638,N/A,45,1
42,N/A,N/A,N/A,1583,1625,N/A,50,6
39,N/A,N/A,N/A,1544,1583,N/A,55,5
18,N/A,N/A,N/A,1526,1544,N/A,59,3
44,N/A,N/A,N/A,1482,1526,N/A,62,6
34,N/A,N/A,N/A,1448,1482,N/A,67,5
23,N/A,N/A,N/A,1425,1448,N/A,71,3
11,N/A,N/A,N/A,1414,1425,N/A,75,1
43,N/A,N/A,N/A,1371,1414,N/A,80,6
8,N/A,N/A,N/A,1363,1371,N/A,86,0
32,N/A,N/A,N/A,1331,1363,N/A,91,5
16,N/A,N/A,N/A,1315,1331,N/A,95,3
43,N/A,N/A,N/A,1272,1315,N/A,98,6
7,N/A,N/A,N/A,1265,1272,N/A,104,0
41,N/A,N/A,N/A,1224,1265,N/A,110,6
5,N/A,N/A,N/A,1219,1224,N/A,116,0
42,N/A,N/A,N/A,1177,1219,N/A,122,6
25,N/A,N/A,N/A,1152,1177,N/A,126,4
21,N/A,N/A,N/A,1131,1152,N/A,131,3
22,N/A,N/A,N/A,1109,1131,N/A,137,3
44,N/A,N/A,N/A,1065,1109,N/A,140,6
32,N/A,N/A,N/A,1033,1065,N/A,145,5
28,N/A,N/A,N/A,598,626,N/A,5,4
14,N/A,N/A,N/A,584,598,N/A,8,1
28,N/A,N/A,N/A,556,584,N/A,11,4
28,N/A,N/A,N/A,528,556,N/A,17,4
7,N/A,N/A,N/A,521,528,N/A,20,1
23,N/A,N/A,N/A,498,521,N/A,23,4
12,N/A,N/A,N/A,486,498,N/A,27,2
8,N/A,N/A,N/A,478,486,N/A,32,1
42,N/A,N/A,N/A,436,478,N/A,37,6
9,N/A,N/A,N/A,427,436,N/A,43,0
27,N/A,N/A,N/A,400,427,N/A,47,4
13,N/A,N/A,N/A,387,400,N/A,51,2
32,N/A,N/A,N/A,355,387,N/A,54,5
14,N/A,N/A,N/A,341,355,N/A,58,3
16,N/A,N/A,N/A,325,341,N/A,63,2
44,N/A,N/A,N/A,281,325,N/A,67,6
25,N/A,N/A,N/A,256,281,N/A,71,4
27,N/A,N/A,N/A,229,256,N/A,77,4
22,N/A,N/A,N/A,207,229,N/A,82,3
13,N/A,N/A,N/A,194,207,N/A,86,1
7,N/A,N/A,N/A,187,194,N/A,92,1
29,N/A,N/A,N/A,158,187,N/A,95,4
16,N/A,N/A,N/A,142,158,N/A,100,3
17,N/A,N/A,N/A,125,142,N/A,105,2
38,N/A,N/A,N/A,87,125,N/A,108,5
30,N/A,N/A,N/A,57,87,N/A,113,4
11,N/A,N/A,N/A,46,57,N/A,117,2
11,N/A,N/A,N/A,35,46,N/A,123,2
9,N/A,N/A,N/A,26,35,N/A,128,1
32,N/A,N/A,N/A,-6,26,N/A,132,5
7,N/A,N/A,N/A,317,324,N/A,4,1
32,N/A,N/A,N/A,285,317,N/A,8,5
32,N/A,N/A,N/A,253,285,N/A,14,5
14,N/A,N/A,N/A,239,253,N/A,18,3
10,N/A,N/A,N/A,229,239,N/A,23,2
43,N/A,N/A,N/A,186,229,N/A,27,6
5,N/A,N/A,N/A,181,186,N/A,33,0
25,N/A,N/A,N/A,156,181,N/A,37,4
13,N/A,N/A,N/A,143,156,N/A,41,2
12,N/A,N/A,N/A,131,143,N/A,47,2
17,N/A,N/A,N/A,114,131,N/A,53,2
12,N/A,N/A,N/A,102,114,N/A,58,1
42,N/A,N/A,N/A,60,102,N/A,63,6
6,N/A,N/A,N/A,54,60,N/A,69,0
38,N/A,N/A,N/A,16,54,N/A,74,5
21,N/A,N/A,N/A,-5,16,N/A,78,3
10,N/A,N/A,N/A,581,591,N/A,4,1
41,N/A,N/A,N/A,540,581,N/A,9,6
5,N/A,N/A,N/A,535,540,N/A,15,0
19,N/A,N/A,N/A,516,535,N/A,18,3
23,N/A,N/A,N/A,493,516,N/A,24,3
12,N/A,N/A,N/A,481,493,N/A,28,1
41,N/A,N/A,N/A,440,481,N/A,33,6
26,N/A,N/A,N/A,414,440,N/A,37,4
13,N/A,N/A,N/A,401,414,N/A,41,2
12,N/A,N/A,N/A,389,401,N/A,47,2
33,N/A,N/A,N/A,356,389,N/A,50,5
28,N/A,N/A,N/A,328,356,N/A,55,4
13,N/A,N/A,N/A,315,328,N/A,59,2
35,N/A,N/A,N/A,280,315,N/A,62,5
38,N/A,N/A,N/A,242,280,N/A,68,5
22,N/A,N/A,N/A,220,242,N/A,73,4
8,N/A,N/A,N/A,212,220,N/A,76,1
7,N/A,N/A,N/A,205,212,N/A,82,1
29,N/A,N/A,N/A,176,205,N/A,85,4
9,N/A,N/A,N/A,167,176,N/A,88,1
39,N/A,N/A,N/A,128,167,N/A,92,5
22,N/A,N/A,N/A,106,128,N/A,96,3
9,N/A,N/A,N/A,97,106,N/A,100,1
33,N/A,N/A,N/A,64,97,N/A,104,5
34,N/A,N/A,N/A,30,64,N/A,110,5
37,N/A,N/A,N/A,-7,30,N/A,116,5
16,N/A,N/A,N/A,488,504,N/A,6,3
9,N/A,N/A,N/A,479,488,N/A,10,1
37,N/A,N/A,N/A,442,479,N/A,14,5
26,N/A,N/A,N/A,416,442,N/A,19,4
32,N/A,N/A,N/A,384,416,N/A,25,4
21,N/A,N/A,N/A,363,384,N/A,30,3
14,N/A,N/A,N/A,349,363,N/A,35,2
11,N/A,N/A,N/A,338,349,N/A,40,1
44,N/A,N/A,N/A,294,338,N/A,45,6
26,N/A,N/A,N/A,268,294,N/A,49,4
26,N/A,N/A,N/A,242,268,N/A,55,4
24,N/A,N/A,N/A,218,242,N/A,61,4
14,N/A,N/A,N/A,204,218,N/A,65,2
38,N/A,N/A,N/A,166,204,N/A,68,5
35,N/A,N/A,N/A,131,166,N/A,74,5
34,N/A,N/A,N/A,97,131,N/A,80,5
16,N/A,N/A,N/A,81,97,N/A,84,3
41,N/A,N/A,N/A,40,81,N/A,87,6
22,N/A,N/A,N/A,18,40,N/A,91,4
24,N/A,N/A,N/A,-6,18,N/A,97,4
34,N/A,N/A,N/A,1793,1827,N/A,3,5
24,N/A,N/A,N/A,1769,1793,N/A,8,4
15,N/A,N/A,N/A,1754,1769,N/A,12,2
11,N/A,N/A,N/A,1743,1754,N/A,18,2
7,N/A,N/A,N/A,1736,1743,N/A,23,1
8,N/A,N/A,N/A,1728,1736,N/A,29,1
36,N/A,N/A,N/A,1692,1728,N/A,33,5
14,N/A,N/A,N/A,1678,1692,N/A,36,2
11,N/A,N/A,N/A,1667,1678,N/A,42,2
37,N/A,N/A,N/A,1630,1667,N/A,45,5
25,N/A,N/A,N/A,1605,1630,N/A,50,4
25,N/A,N/A,N/A,1580,1605,N/A,56,4
15,N/A,N/A,N/A,1565,1580,N/A,61,3
41,N/A,N/A,N/A,1524,1565,N/A,64,6
26,N/A,N/A,N/A,1498,1524,N/A,68,4
7,N/A,N/A,N/A,1491,1498,N/A,71,1
9,N/A,N/A,N/A,1482,1491,N/A,77,1
30,N/A,N/A,N/A,1452,1482,N/A,80,4
23,N/A,N/A,N/A,1429,1452,N/A,86,4
19,N/A,N/A,N/A,1410,1429,N/A,91,3
22,N/A,N/A,N/A,1388,1410,N/A,97,3
12,N/A,N/A,N/A,1376,1388,N/A,102,2
34,N/A,N/A,N/A,1342,1376,N/A,105,5
37,N/A,N/A,N/A,1305,1342,N/A,111,5
24,N/A,N/A,N/A,1281,1305,N/A,116,4
21,N/A,N/A,N/A,1260,1281,N/A,121,3
20,N/A,N/A,N/A,1240,1260,N/A,127,3
14,N/A,N/A,N/A,1226,1240,N/A,131,1
24,N/A,N/A,N/A,1202,1226,N/A,134,4
16,N/A,N/A,N/A,1186,1202,N/A,139,3
32,N/A,N/A,N/A,1756,1788,N/A,4,5
18,N/A,N/A,N/A,1738,1756,N/A,8,3
12,N/A,N/A,N/A,1726,1738,N/A,12,1
44,N/A,N/A,N/A,1682,1726,N/A,17,6
5,N/A,N/A,N/A,1677,1682,N/A,23,0
37,N/A,N/A,N/A,1640,1677,N/A,28,5
24,N/A,N/A,N/A,1616,1640,N/A,33,4
22,N/A,N/A,N/A,1594,1616,N/A,39,4
15,N/A,N/A,N/A,1579,1594,N/A,44,3
43,N/A,N/A,N/A,1536,1579,N/A,47,6
23,N/A,N/A,N/A,1513,1536,N/A,50,3
10,N/A,N/A,N/A,1503,1513,N/A,54,1
29,N/A,N/A,N/A,1474,1503,N/A,57,4
25,N/A,N/A,N/A,1449,1474,N/A,63,4
20,N/A,N/A,N/A,1429,1449,N/A,68,3
44,N/A,N/A,N/A,1385,1429,N/A,71,6
22,N/A,N/A,N/A,1363,1385,N/A,75,4
11,N/A,N/A,N/A,1352,1363,N/A,79,2
41,N/A,N/A,N/A,1311,1352,N/A,83,6
30,N/A,N/A,N/A,1281,1311,N/A,87,4
17,N/A,N/A,N/A,1264,1281,N/A,91,2
34,N/A,N/A,N/A,1230,1264,N/A,94,5
20,N/A,N/A,N/A,1210,1230,N/A,98,3
17,N/A,N/A,N/A,1193,1210,N/A,103,2
15,N/A,N/A,N/A,1178,1193,N/A,109,2
14,N/A,N/A,N/A,1164,1178,N/A,115,2
37,N/A,N/A,N/A,1127,1164,N/A,118,5
35,N/A,N/A,N/A,1092,1127,N/A,124,5
22,N/A,N/A,N/A,1070,1092,N/A,129,4
27,N/A,N/A,N/A,1043,1070,N/A,135,4
34,N/A,N/A,N/A,1657,1691,N/A,4,5
27,N/A,N/A,N/A,1630,1657,N/A,9,4
27,N/A,N/A,N/A,1603,1630,N/A,15,4
20,N/A,N/A,N/A,1583,1603,N/A,20,3
13,N/A,N/A,N/A,1570,1583,N/A,25,2
43,N/A,N/A,N/A,1527,1570,N/A,29,6
31,N/A,N/A,N/A,1496,1527,N/A,33,4
14,N/A,N/A,N/A,1482,1496,N/A,38,3
16,N/A,N/A,N/A,1466,1482,N/A,44,3
20,N/A,N/A,N/A,1446,1466,N/A,50,3
10,N/A,N/A,N/A,1436,1446,N/A,54,1
43,N/A,N/A,N/A,1393,1436,N/A,59,6
6,N/A,N/A,N/A,1387,1393,N/A,65,0
21,N/A,N/A,N/A,1366,1387,N/A,68,3
13,N/A,N/A,N/A,1353,1366,N/A,72,1
38,N/A,N/A,N/A,1315,1353,N/A,76,5
39,N/A,N/A,N/A,1276,1315,N/A,82,5
11,N/A,N/A,N/A,1265,1276,N/A,85,2
33,N/A,N/A,N/A,1232,1265,N/A,88,5
34,N/A,N/A,N/A,1198,1232,N/A,94,5
25,N/A,N/A,N/A,1173,1198,N/A,99,4
18,N/A,N/A,N/A,1155,1173,N/A,104,3
19,N/A,N/A,N/A,1136,1155,N/A,110,3
14,N/A,N/A,N/A,1122,1136,N/A,115,2
41,N/A,N/A,N/A,1081,1122,N/A,119,6
6,N/A,N/A,N/A,1075,1081,N/A,125,0
32,N/A,N/A,N/A,1043,1075,N/A,129,4
16,N/A,N/A,N/A,1027,1043,N/A,133,2
12,N/A,N/A,N/A,1015,1027,N/A,139,2
8,N/A,N/A,N/A,1007,1015,N/A,144,1
9,N/A,N/A,N/A,949,958,N/A,4,1
12,N/A,N/A,N/A,937,949,N/A,10,1
32,N/A,N/A,N/A,905,937,N/A,13,4
14,N/A,N/A,N/A,891,905,N/A,16,1
29,N/A,N/A,N/A,862,891,N/A,19,4
10,N/A,N/A,N/A,852,862,N/A,22,1
31,N/A,N/A,N/A,821,852,N/A,25,4
14,N/A,N/A,N/A,807,821,N/A,30,3
9,N/A,N/A,N/A,798,807,N/A,34,1
8,N/A,N/A,N/A,790,798,N/A,40,1
44,N/A,N/A,N/A,746,790,N/A,45,6
34,N/A,N/A,N/A,712,746,N/A,50,5
18,N/A,N/A,N/A,694,712,N/A,54,3
23,N/A,N/A,N/A,671,694,N/A,60,3
22,N/A,N/A,N/A,649,671,N/A,66,3
12,N/A,N/A,N/A,637,649,N/A,71,2
43,N/A,N/A,N/A,594,637,N/A,75,6
16,N/A,N/A,N/A,578,594,N/A,78,3
15,N/A,N/A,N/A,563,578,N/A,83,2
11,N/A,N/A,N/A,552,563,N/A,88,1
44,N/A,N/A,N/A,508,552,N/A,93,6
39,N/A,N/A,N/A,469,508,N/A,98,5
32,N/A,N/A,N/A,437,469,N/A,103,4
10,N/A,N/A,N/A,427,437,N/A,106,1
43,N/A,N/A,N/A,384,427,N/A,111,6
27,N/A,N/A,N/A,357,384,N/A,115,4
32,N/A,N/A,N/A,325,357,N/A,121,4
27,N/A,N/A,N/A,298,325,N/A,127,4
24,N/A,N/A,N/A,274,298,N/A,133,4
30,N/A,N/A,N/A,244,274,N/A,139,4
26,N/A,N/A,N/A,434,460,N/A,3,4
23,N/A,N/A,N/A,411,434,N/A,9,4
10,N/A,N/A,N/A,401,411,N/A,13,2
37,N/A,N/A,N/A,364,401,N/A,16,5
26,N/A,N/A,N/A,338,364,N/A,21,4
15,N/A,N/A,N/A,323,338,N/A,25,2
14,N/A,N/A,N/A,309,323,N/A,30,1
29,N/A,N/A,N/A,280,309,N/A,33,4
16,N/A,N/A,N/A,264,280,N/A,37,2
41,N/A,N/A,N/A,223,264,N/A,41,6
23,N/A,N/A,N/A,200,223,N/A,45,4
23,N/A,N/A,N/A,177,200,N/A,50,3
41,N/A,N/A,N/A,136,177,N/A,53,6
22,N/A,N/A,N/A,114,136,N/A,57,4
7,N/A,N/A,N/A,107,114,N/A,60,1
42,N/A,N/A,N/A,65,107,N/A,65,6
32,N/A,N/A,N/A,33,65,N/A,69,4
15,N/A,N/A,N/A,18,33,N/A,73,2
17,N/A,N/A,N/A,1,18,N/A,79,2
10,N/A,N/A,N/A,-9,1,N/A,84,1
15,N/A,N/A,N/A,1296,1311,N/A,4,3
8,N/A,N/A,N/A,1288,1296,N/A,8,1
8,N/A,N/A,N/A,1280,1288,N/A,14,1
33,N/A,N/A,N/A,1247,1280,N/A,18,5
33,N/A,N/A,N/A,1214,1247,N/A,24,5
11,N/A,N/A,N/A,1203,1214,N/A,27,2
15,N/A,N/A,N/A,1188,1203,N/A,33,2
17,N/A,N/A,N/A,1171,1188,N/A,39,2
14,N/A,N/A,N/A,1157,1171,N/A,45,2
43,N/A,N/A,N/A,1114,1157,N/A,49,6
6,N/A,N/A,N/A,1108,1114,N/A,55,0
36,N/A,N/A,N/A,1072,1108,N/A,60,5
38,N/A,N/A,N/A,1034,1072,N/A,66,5
33,N/A,N/A,N/A,1001,1034,N/A,72,5
31,N/A,N/A,N/A,970,1001,N/A,77,4
12,N/A,N/A,N/A,958,970,N/A,80,1
13,N/A,N/A,N/A,945,958,N/A,86,1
42,N/A,N/A,N/A,903,945,N/A,91,6
32,N/A,N/A,N/A,871,903,N/A,95,4
10,N/A,N/A,N/A,861,871,N/A,98,1
23,N/A,N/A,N/A,838,861,N/A,101,4
7,N/A,N/A,N/A,831,838,N/A,104,1
12,N/A,N/A,N/A,819,831,N/A,110,1
42,N/A,N/A,N/A,777,819,N/A,115,6
24,N/A,N/A,N/A,753,777,N/A,119,4
22,N/A,N/A,N/A,731,753,N/A,124,3
15,N/A,N/A,N/A,716,731,N/A,130,3
17,N/A,N/A,N/A,699,716,N/A,135,2
37,N/A,N/A,N/A,662,699,N/A,138,5
37,N/A,N/A,N/A,625,662,N/A,144,5
33,N/A,N/A,N/A,1196,1229,N/A,3,5
10,N/A,N/A,N/A,1186,1196,N/A,6,2
43,N/A,N/A,N/A,1143,1186,N/A,10,6
5,N/A,N/A,N/A,1138,1143,N/A,16,0
25,N/A,N/A,N/A,1113,1138,N/A,20,4
22,N/A,N/A,N/A,1091,1113,N/A,26,4
31,N/A,N/A,N/A,1060,1091,N/A,32,4
22,N/A,N/A,N/A,1038,1060,N/A,37,3
43,N/A,N/A,N/A,995,1038,N/A,40,6
17,N/A,N/A,N/A,978,995,N/A,43,3
11,N/A,N/A,N/A,967,978,N/A,47,1
43,N/A,N/A,N/A,924,967,N/A,52,6
8,N/A,N/A,N/A,916,924,N/A,58,0
44,N/A,N/A,N/A,872,916,N/A,64,6
19,N/A,N/A,N/A,853,872,N/A,67,3
14,N/A,N/A,N/A,839,853,N/A,73,3
9,N/A,N/A,N/A,830,839,N/A,77,1
44,N/A,N/A,N/A,786,830,N/A,82,6
5,N/A,N/A,N/A,781,786,N/A,88,0
20,N/A,N/A,N/A,761,781,N/A,91,3
13,N/A,N/A,N/A,748,761,N/A,96,2
9,N/A,N/A,N/A,739,748,N/A,101,1
43,N/A,N/A,N/A,696,739,N/A,106,6
37,N/A,N/A,N/A,659,696,N/A,111,5
13,N/A,N/A,N/A,646,659,N/A,114,2
41,N/A,N/A,N/A,605,646,N/A,118,6
35,N/A,N/A,N/A,570,605,N/A,123,5
37,N/A,N/A,N/A,533,570,N/A,129,5
35,N/A,N/A,N/A,498,533,N/A,135,5
17,N/A,N/A,N/A,481,498,N/A,138,2
20,N/A,N/A,N/A,579,599,N/A,3,3
21,N/A,N/A,N/A,558,579,N/A,9,3
22,N/A,N/A,N/A,536,558,N/A,15,3
43,N/A,N/A,N/A,493,536,N/A,18,6
9,N/A,N/A,N/A,484,493,N/A,24,0
43,N/A,N/A,N/A,441,484,N/A,30,6
25,N/A,N/A,N/A,416,441,N/A,34,4
15,N/A,N/A,N/A,401,416,N/A,39,3
41,N/A,N/A,N/A,360,401,N/A,42,6
6,N/A,N/A,N/A,354,360,N/A,48,0
39,N/A,N/A,N/A,315,354,N/A,53,5
38,N/A,N/A,N/A,277,315,N/A,59,5
19,N/A,N/A,N/A,258,277,N/A,63,3
10,N/A,N/A,N/A,248,258,N/A,68,2
43,N/A,N/A,N/A,205,248,N/A,72,6
23,N/A,N/A,N/A,182,205,N/A,75,3
44,N/A,N/A,N/A,138,182,N/A,78,6
7,N/A,N/A,N/A,131,138,N/A,84,0
43,N/A,N/A,N/A,88,131,N/A,90,6
35,N/A,N/A,N/A,53,88,N/A,95,5
19,N/A,N/A,N/A,34,53,N/A,99,3
19,N/A,N/A,N/A,15,34,N/A,105,3
43,N/A,N/A,N/A,-28,15,N/A,108,6
10,N/A,N/A,N/A,609,619,N/A,4,2
13,N/A,N/A,N/A,596,609,N/A,9,1
44,N/A,N/A,N/A,552,596,N/A,14,6
38,N/A,N/A,N/A,514,552,N/A,19,5
14,N/A,N/A,N/A,500,514,N/A,22,2
41,N/A,N/A,N/A,459,500,N/A,26,6
7,N/A,N/A,N/A,452,459,N/A,32,0
31,N/A,N/A,N/A,421,452,N/A,36,4
10,N/A,N/A,N/A,411,421,N/A,40,2
13,N/A,N/A,N/A,398,411,N/A,46,2
37,N/A,N/A,N/A,361,398,N/A,49,5
37,N/A,N/A,N/A,324,361,N/A,55,5
15,N/A,N/A,N/A,309,324,N/A,58,2
44,N/A,N/A,N/A,265,309,N/A,62,6
33,N/A,N/A,N/A,232,265,N/A,67,5
33,N/A,N/A,N/A,199,232,N/A,73,5
21,N/A,N/A,N/A,178,199,N/A,77,3
19,N/A,N/A,N/A,159,178,N/A,83,3
13,N/A,N/A,N/A,146,159,N/A,87,1
39,N/A,N/A,N/A,107,146,N/A,91,5
27,N/A,N/A,N/A,80,107,N/A,96,4
17,N/A,N/A,N/A,63,80,N/A,100,2
32,N/A,N/A,N/A,31,63,N/A,103,5
31,N/A,N/A,N/A,0,31,N/A,108,4
16,N/A,N/A,N/A,1818,1834,N/A,3,2
36,N/A,N/A,N/A,1782,1818,N/A,6,5
23,N/A,N/A,N/A,1759,1782,N/A,10,3
9,N/A,N/A,N/A,1750,1759,N/A,14,1
35,N/A,N/A,N/A,1715,1750,N/A,18,5
35,N/A,N/A,N/A,1680,1715,N/A,24,5
18,N/A,N/A,N/A,1662,1680,N/A,28,3
42,N/A,N/A,N/A,1620,1662,N/A,31,6
14,N/A,N/A,N/A,1606,1620,N/A,34,3
16,N/A,N/A,N/A,1590,1606,N/A,40,3
14,N/A,N/A,N/A,1576,1590,N/A,45,2
14,N/A,N/A,N/A,1562,1576,N/A,50,1
41,N/A,N/A,N/A,1521,1562,N/A,55,6
9,N/A,N/A,N/A,1512,1521,N/A,61,0
41,N/A,N/A,N/A,1471,1512,N/A,67,6
24,N/A,N/A,N/A,1447,1471,N/A,71,4
23,N/A,N/A,N/A,1424,1447,N/A,77,4
24,N/A,N/A,N/A,1400,1424,N/A,83,4
17,N/A,N/A,N/A,1383,1400,N/A,87,2
41,N/A,N/A,N/A,1342,1383,N/A,91,6
28,N/A,N/A,N/A,1314,1342,N/A,95,4
11,N/A,N/A,N/A,1303,1314,N/A,98,1
33,N/A,N/A,N/A,1270,1303,N/A,102,5
23,N/A,N/A,N/A,1247,1270,N/A,107,4
11,N/A,N/A,N/A,1236,1247,N/A,110,1
7,N/A,N/A,N/A,1229,1236,N/A,116,1
8,N/A,N/A,N/A,1221,1229,N/A,122,1
37,N/A,N/A,N/A,1184,1221,N/A,126,5
20,N/A,N/A,N/A,1164,1184,N/A,130,3
41,N/A,N/A,N/A,1123,1164,N/A,133,6
13,N/A,N/A,N/A,842,855,N/A,5,1
44,N/A,N/A,N/A,798,842,N/A,10,6
8,N/A,N/A,N/A,790,798,N/A,16,0
23,N/A,N/A,N/A,767,790,N/A,20,4
13,N/A,N/A,N/A,754,767,N/A,24,2
43,N/A,N/A,N/A,711,754,N/A,28,6
23,N/A,N/A,N/A,688,711,N/A,31,3
13,N/A,N/A,N/A,675,688,N/A,35,1
14,N/A,N/A,N/A,661,675,N/A,41,1
23,N/A,N/A,N/A,638,661,N/A,44,4
31,N/A,N/A,N/A,607,638,N/A,50,4
16,N/A,N/A,N/A,591,607,N/A,54,2
37,N/A,N/A,N/A,554,591,N/A,57,5
15,N/A,N/A,N/A,539,554,N/A,61,3
13,N/A,N/A,N/A,526,539,N/A,66,2
10,N/A,N/A,N/A,516,526,N/A,71,1
13,N/A,N/A,N/A,503,516,N/A,77,1
42,N/A,N/A,N/A,461,503,N/A,82,6
16,N/A,N/A,N/A,445,461,N/A,85,3
14,N/A,N/A,N/A,431,445,N/A,89,1
13,N/A,N/A,N/A,418,431,N/A,95,1
25,N/A,N/A,N/A,393,418,N/A,98,4
9,N/A,N/A,N/A,384,393,N/A,101,1
7,N/A,N/A,N/A,377,384,N/A,107,1
8,N/A,N/A,N/A,369,377,N/A,113,1
38,N/A,N/A,N/A,331,369,N/A,117,5
27,N/A,N/A,N/A,304,331,N/A,122,4
12,N/A,N/A,N/A,292,304,N/A,125,1
42,N/A,N/A,N/A,250,292,N/A,130,6
20,N/A,N/A,N/A,230,250,N/A,133,3
13,N/A,N/A,N/A,1605,1618,N/A,6,1
10,N/A,N/A,N/A,1595,1605,N/A,12,1
34,N/A,N/A,N/A,1561,1595,N/A,16,5
18,N/A,N/A,N/A,1543,1561,N/A,20,3
14,N/A,N/A,N/A,1529,1543,N/A,25,2
43,N/A,N/A,N/A,1486,1529,N/A,29,6
22,N/A,N/A,N/A,1464,1486,N/A,33,4
14,N/A,N/A,N/A,1450,1464,N/A,36,1
24,N/A,N/A,N/A,1426,1450,N/A,39,4
21,N/A,N/A,N/A,1405,1426,N/A,44,3
11,N/A,N/A,N/A,1394,1405,N/A,48,1
10,N/A,N/A,N/A,1384,1394,N/A,54,1
22,N/A,N/A,N/A,1362,1384,N/A,57,4
13,N/A,N/A,N/A,1349,1362,N/A,60,1
22,N/A,N/A,N/A,1327,1349,N/A,63,4
9,N/A,N/A,N/A,1318,1327,N/A,66,1
41,N/A,N/A,N/A,1277,1318,N/A,71,6
37,N/A,N/A,N/A,1240,1277,N/A,76,5
33,N/A,N/A,N/A,1207,1240,N/A,82,5
17,N/A,N/A,N/A,1190,1207,N/A,85,2
39,N/A,N/A,N/A,1151,1190,N/A,88,5
36,N/A,N/A,N/A,1115,1151,N/A,94,5
14,N/A,N/A,N/A,1101,1115,N/A,97,2
11,N/A,N/A,N/A,1090,1101,N/A,102,1
11,N/A,N/A,N/A,1079,1090,N/A,108,1
42,N/A,N/A,N/A,1037,1079,N/A,113,6
35,N/A,N/A,N/A,1002,1037,N/A,118,5
23,N/A,N/A,N/A,979,1002,N/A,123,4
31,N/A,N/A,N/A,948,979,N/A,129,4
10,N/A,N/A,N/A,938,948,N/A,133,2
22,N/A,N/A,N/A,1910,1932,N/A,4,4
29,N/A,N/A,N/A,1881,1910,N/A,10,4
23,N/A,N/A,N/A,1858,1881,N/A,16,4
23,N/A,N/A,N/A,1835,1858,N/A,22,4
27,N/A,N/A,N/A,1808,1835,N/A,28,4
8,N/A,N/A,N/A,1800,1808,N/A,31,1
39,N/A,N/A,N/A,1761,1800,N/A,35,5
30,N/A,N/A,N/A,1731,1761,N/A,40,4
15,N/A,N/A,N/A,1716,1731,N/A,44,2
17,N/A,N/A,N/A,1699,1716,N/A,50,2
43,N/A,N/A,N/A,1656,1699,N/A,54,6
6,N/A,N/A,N/A,1650,1656,N/A,60,0
38,N/A,N/A,N/A,1612,1650,N/A,65,5
37,N/A,N/A,N/A,1575,1612,N/A,71,5
36,N/A,N/A,N/A,1539,1575,N/A,77,5
10,N/A,N/A,N/A,1529,1539,N/A,80,2
42,N/A,N/A,N/A,1487,1529,N/A,84,6
22,N/A,N/A,N/A,1465,1487,N/A,87,3
13,N/A,N/A,N/A,1452,1465,N/A,91,1
42,N/A,N/A,N/A,1410,1452,N/A,96,6
37,N/A,N/A,N/A,1373,1410,N/A,101,5
20,N/A,N/A,N/A,1353,1373,N/A,105,3
41,N/A,N/A,N/A,1312,1353,N/A,108,6
23,N/A,N/A,N/A,1289,1312,N/A,111,3
9,N/A,N/A,N/A,1280,1289,N/A,115,1
43,N/A,N/A,N/A,1237,1280,N/A,120,6
7,N/A,N/A,N/A,1230,1237,N/A,126,0
41,N/A,N/A,N/A,1189,1230,N/A,132,6
7,N/A,N/A,N/A,1182,1189,N/A,138,0
43,N/A,N/A,N/A,1139,1182,N/A,144,6
7,N/A,N/A,N/A,306,313,N/A,6,1
23,N/A,N/A,N/A,283,306,N/A,9,4
21,N/A,N/A,N/A,262,283,N/A,14,3
7,N/A,N/A,N/A,255,262,N/A,18,1
33,N/A,N/A,N/A,222,255,N/A,22,5
15,N/A,N/A,N/A,207,222,N/A,25,2
14,N/A,N/A,N/A,193,207,N/A,31,2
14,N/A,N/A,N/A,179,193,N/A,37,2
44,N/A,N/A,N/A,135,179,N/A,41,6
29,N/A,N/A,N/A,106,135,N/A,45,4
22,N/A,N/A,N/A,84,106,N/A,50,3
14,N/A,N/A,N/A,70,84,N/A,55,2
35,N/A,N/A,N/A,35,70,N/A,58,5
15,N/A,N/A,N/A,20,35,N/A,61,2
16,N/A,N/A,N/A,4,20,N/A,67,2
10,N/A,N/A,N/A,-6,4,N/A,73,2
31,N/A,N/A,N/A,1761,1792,N/A,3,4
28,N/A,N/A,N/A,1733,1761,N/A,9,4
7,N/A,N/A,N/A,1726,1733,N/A,12,1
11,N/A,N/A,N/A,1715,1726,N/A,18,1
8,N/A,N/A,N/A,1707,1715,N/A,24,1
14,N/A,N/A,N/A,1693,1707,N/A,30,1
34,N/A,N/A,N/A,1659,1693,N/A,34,5
29,N/A,N/A,N/A,1630,1659,N/A,39,4
31,N/A,N/A,N/A,1599,1630,N/A,45,4
15,N/A,N/A,N/A,1584,1599,N/A,50,3
23,N/A,N/A,N/A,1561,1584,N/A,56,3
16,N/A,N/A,N/A,1545,1561,N/A,61,2
44,N/A,N/A,N/A,1501,1545,N/A,65,6
8,N/A,N/A,N/A,1493,1501,N/A,71,0
27,N/A,N/A,N/A,1466,1493,N/A,75,4
23,N/A,N/A,N/A,1443,1466,N/A,81,4
11,N/A,N/A,N/A,1432,1443,N/A,84,1
44,N/A,N/A,N/A,1388,1432,N/A,89,6
37,N/A,N/A,N/A,1351,1388,N/A,94,5
18,N/A,N/A,N/A,1333,1351,N/A,98,3
16,N/A,N/A,N/A,1317,1333,N/A,103,2
11,N/A,N/A,N/A,1306,1317,N/A,108,1
34,N/A,N/A,N/A,1272,1306,N/A,112,5
15,N/A,N/A,N/A,1257,1272,N/A,115,2
10,N/A,N/A,N/A,1247,1257,N/A,120,1
36,N/A,N/A,N/A,1211,1247,N/A,124,5
24,N/A,N/A,N/A,1187,1211,N/A,129,4
23,N/A,N/A,N/A,1164,1187,N/A,135,4
13,N/A,N/A,N/A,1151,1164,N/A,138,1
32,N/A,N/A,N/A,1119,1151,N/A,141,4
10,N/A,N/A,N/A,1742,1752,N/A,5,2
17,N/A,N/A,N/A,1725,1742,N/A,11,2
33,N/A,N/A,N/A,1692,1725,N/A,14,5
13,N/A,N/A,N/A,1679,1692,N/A,17,2
44,N/A,N/A,N/A,1635,1679,N/A,21,6
23,N/A,N/A,N/A,1612,1635,N/A,24,3
42,N/A,N/A,N/A,1570,1612,N/A,27,6
7,N/A,N/A,N/A,1563,1570,N/A,33,0
19,N/A,N/A,N/A,1544,1563,N/A,36,3
23,N/A,N/A,N/A,1521,1544,N/A,42,3
9,N/A,N/A,N/A,1512,1521,N/A,46,1
23,N/A,N/A,N/A,1489,1512,N/A,49,4
29,N/A,N/A,N/A,1460,1489,N/A,55,4
27,N/A,N/A,N/A,1433,1460,N/A,61,4
29,N/A,N/A,N/A,1404,1433,N/A,67,4
30,N/A,N/A,N/A,1374,1404,N/A,73,4
22,N/A,N/A,N/A,1352,1374,N/A,79,4
20,N/A,N/A,N/A,1332,1352,N/A,84,3
11,N/A,N/A,N/A,1321,1332,N/A,89,2
37,N/A,N/A,N/A,1284,1321,N/A,92,5
36,N/A,N/A,N/A,1248,1284,N/A,98,5
28,N/A,N/A,N/A,1220,1248,N/A,103,4
24,N/A,N/A,N/A,1196,1220,N/A,109,4
31,N/A,N/A,N/A,1165,1196,N/A,115,4
20,N/A,N/A,N/A,1145,1165,N/A,120,3
21,N/A,N/A,N/A,1124,1145,N/A,126,3
13,N/A,N/A,N/A,1111,1124,N/A,130,1
36,N/A,N/A,N/A,1075,1111,N/A,134,5
29,N/A,N/A,N/A,1046,1075,N/A,139,4
11,N/A,N/A,N/A,1035,1046,N/A,143,2
14,N/A,N/A,N/A,1313,1327,N/A,4,3
44,N/A,N/A,N/A,1269,1313,N/A,7,6
35,N/A,N/A,N/A,1234,1269,N/A,12,5
22,N/A,N/A,N/A,1212,1234,N/A,17,4
14,N/A,N/A,N/A,1198,1212,N/A,21,2
14,N/A,N/A,N/A,1184,1198,N/A,26,1
28,N/A,N/A,N/A,1156,1184,N/A,29,4
21,N/A,N/A,N/A,1135,1156,N/A,34,3
20,N/A,N/A,N/A,1115,1135,N/A,40,3
13,N/A,N/A,N/A,1102,1115,N/A,45,2
43,N/A,N/A,N/A,1059,1102,N/A,49,6
23,N/A,N/A,N/A,1036,1059,N/A,52,3
11,N/A,N/A,N/A,1025,1036,N/A,57,2
11,N/A,N/A,N/A,1014,1025,N/A,62,1
41,N/A,N/A,N/A,973,1014,N/A,67,6
16,N/A,N/A,N/A,957,973,N/A,70,3
14,N/A,N/A,N/A,943,957,N/A,75,2
43,N/A,N/A,N/A,900,943,N/A,79,6
25,N/A,N/A,N/A,875,900,N/A,83,4
17,N/A,N/A,N/A,858,875,N/A,87,2
33,N/A,N/A,N/A,825,858,N/A,90,5
11,N/A,N/A,N/A,814,825,N/A,93,2
10,N/A,N/A,N/A,804,814,N/A,98,1
29,N/A,N/A,N/A,775,804,N/A,101,4
13,N/A,N/A,N/A,762,775,N/A,105,2
8,N/A,N/A,N/A,754,762,N/A,110,1
22,N/A,N/A,N/A,732,754,N/A,113,4
19,N/A,N/A,N/A,713,732,N/A,118,3
43,N/A,N/A,N/A,670,713,N/A,121,6
24,N/A,N/A,N/A,646,670,N/A,125,4
35,N/A,N/A,N/A,1037,1072,N/A,5,5
29,N/A,N/A,N/A,1008,1037,N/A,10,4
10,N/A,N/A,N/A,998,1008,N/A,13,1
7,N/A,N/A,N/A,991,998,N/A,19,1
36,N/A,N/A,N/A,955,991,N/A,23,5
18,N/A,N/A,N/A,937,955,N/A,27,3
10,N/A,N/A,N/A,927,937,N/A,32,2
13,N/A,N/A,N/A,914,927,N/A,38,2
33,N/A,N/A,N/A,881,914,N/A,41,5
33,N/A,N/A,N/A,848,881,N/A,47,5
25,N/A,N/A,N/A,823,848,N/A,52,4
24,N/A,N/A,N/A,799,823,N/A,58,4
11,N/A,N/A,N/A,788,799,N/A,62,2
43,N/A,N/A,N/A,745,788,N/A,66,6
8,N/A,N/A,N/A,737,745,N/A,72,0
20,N/A,N/A,N/A,717,737,N/A,75,3
14,N/A,N/A,N/A,703,717,N/A,79,1
35,N/A,N/A,N/A,668,703,N/A,83,5
27,N/A,N/A,N/A,641,668,N/A,88,4
29,N/A,N/A,N/A,612,641,N/A,94,4
22,N/A,N/A,N/A,590,612,N/A,99,3
14,N/A,N/A,N/A,576,590,N/A,104,2
34,N/A,N/A,N/A,542,576,N/A,107,5
14,N/A,N/A,N/A,528,542,N/A,111,3
44,N/A,N/A,N/A,484,528,N/A,114,6
8,N/A,N/A,N/A,476,484,N/A,120,0
16,N/A,N/A,N/A,460,476,N/A,123,3
14,N/A,N/A,N/A,446,460,N/A,127,1
25,N/A,N/A,N/A,421,446,N/A,130,4
10,N/A,N/A,N/A,411,421,N/A,134,2
11,N/A,N/A,N/A,1719,1730,N/A,4,2
13,N/A,N/A,N/A,1706,1719,N/A,10,2
37,N/A,N/A,N/A,1669,1706,N/A,13,5
20,N/A,N/A,N/A,1649,1669,N/A,17,3
14,N/A,N/A,N/A,1635,1649,N/A,23,3
15,N/A,N/A,N/A,1620,1635,N/A,29,3
12,N/A,N/A,N/A,1608,1620,N/A,33,1
41,N/A,N/A,N/A,1567,1608,N/A,38,6
34,N/A,N/A,N/A,1533,1567,N/A,43,5
26,N/A,N/A,N/A,1507,1533,N/A,48,4
17,N/A,N/A,N/A,1490,1507,N/A,53,3
15,N/A,N/A,N/A,1475,1490,N/A,58,2
41,N/A,N/A,N/A,1434,1475,N/A,62,6
6,N/A,N/A,N/A,1428,1434,N/A,68,0
38,N/A,N/A,N/A,1390,1428,N/A,73,5
12,N/A,N/A,N/A,1378,1390,N/A,76,2
37,N/A,N/A,N/A,1341,1378,N/A,79,5
28,N/A,N/A,N/A,1313,1341,N/A,84,4
13,N/A,N/A,N/A,1300,1313,N/A,88,2
16,N/A,N/A,N/A,1284,1300,N/A,94,2
14,N/A,N/A,N/A,1270,1284,N/A,99,1
13,N/A,N/A,N/A,1257,1270,N/A,105,1
11,N/A,N/A,N/A,1246,1257,N/A,111,1
43,N/A,N/A,N/A,1203,1246,N/A,116,6
7,N/A,N/A,N/A,1196,1203,N/A,122,0
33,N/A,N/A,N/A,1163,1196,N/A,127,5
11,N/A,N/A,N/A,1152,1163,N/A,130,2
10,N/A,N/A,N/A,1142,1152,N/A,136,2
44,N/A,N/A,N/A,1098,1142,N/A,140,6
23,N/A,N/A,N/A,1075,1098,N/A,143,3
29,N/A,N/A,N/A,455,484,N/A,4,4
11,N/A,N/A,N/A,444,455,N/A,8,2
37,N/A,N/A,N/A,407,444,N/A,11,5
26,N/A,N/A,N/A,381,407,N/A,16,4
31,N/A,N/A,N/A,350,381,N/A,22,4
11,N/A,N/A,N/A,339,350,N/A,25,1
22,N/A,N/A,N/A,317,339,N/A,28,4
10,N/A,N/A,N/A,307,317,N/A,31,1
23,N/A,N/A,N/A,284,307,N/A,34,4
16,N/A,N/A,N/A,268,284,N/A,39,3
42,N/A,N/A,N/A,226,268,N/A,42,6
7,N/A,N/A,N/A,219,226,N/A,48,0
23,N/A,N/A,N/A,196,219,N/A,51,3
10,N/A,N/A,N/A,186,196,N/A,55,1
44,N/A,N/A,N/A,142,186,N/A,60,6
7,N/A,N/A,N/A,135,142,N/A,66,0
32,N/A,N/A,N/A,103,135,N/A,70,4
15,N/A,N/A,N/A,88,103,N/A,74,2
42,N/A,N/A,N/A,46,88,N/A,78,6
24,N/A,N/A,N/A,22,46,N/A,82,4
16,N/A,N/A,N/A,6,22,N/A,87,3
7,N/A,N/A,N/A,-1,6,N/A,91,1
25,N/A,N/A,N/A,1856,1881,N/A,5,4
14,N/A,N/A,N/A,1842,1856,N/A,10,3
44,N/A,N/A,N/A,1798,1842,N/A,13,6
38,N/A,N/A,N/A,1760,1798,N/A,18,5
35,N/A,N/A,N/A,1725,1760,N/A,24,5
38,N/A,N/A,N/A,1687,1725,N/A,30,5
26,N/A,N/A,N/A,1661,1687,N/A,35,4
11,N/A,N/A,N/A,1650,1661,N/A,38,1
23,N/A,N/A,N/A,1627,1650,N/A,41,4
10,N/A,N/A,N/A,1617,1627,N/A,44,1
42,N/A,N/A,N/A,1575,1617,N/A,49,6
37,N/A,N/A,N/A,1538,1575,N/A,54,5
31,N/A,N/A,N/A,1507,1538,N/A,59,4
18,N/A,N/A,N/A,1489,1507,N/A,64,3
41,N/A,N/A,N/A,1448,1489,N/A,67,6
26,N/A,N/A,N/A,1422,1448,N/A,71,4
15,N/A,N/A,N/A,1407,1422,N/A,76,3
41,N/A,N/A,N/A,1366,1407,N/A,79,6
32,N/A,N/A,N/A,1334,1366,N/A,83,4
8,N/A,N/A,N/A,1326,1334,N/A,86,1
38,N/A,N/A,N/A,1288,1326,N/A,90,5
14,N/A,N/A,N/A,1274,1288,N/A,93,2
43,N/A,N/A,N/A,1231,1274,N/A,97,6
29,N/A,N/A,N/A,1202,1231,N/A,101,4
7,N/A,N/A,N/A,1195,1202,N/A,104,1
7,N/A,N/A,N/A,1188,1195,N/A,110,1
43,N/A,N/A,N/A,1145,1188,N/A,115,6
22,N/A,N/A,N/A,1123,1145,N/A,118,3
9,N/A,N/A,N/A,1114,1123,N/A,122,1
26,N/A,N/A,N/A,1088,1114,N/A,125,4
29,N/A,N/A,N/A,1950,1979,N/A,3,4
26,N/A,N/A,N/A,1924,1950,N/A,9,4
21,N/A,N/A,N/A,1903,1924,N/A,14,3
17,N/A,N/A,N/A,1886,1903,N/A,20,3
42,N/A,N/A,N/A,1844,1886,N/A,23,6
14,N/A,N/A,N/A,1830,1844,N/A,26,3
44,N/A,N/A,N/A,1786,1830,N/A,29,6
36,N/A,N/A,N/A,1750,1786,N/A,34,5
23,N/A,N/A,N/A,1727,1750,N/A,39,4
31,N/A,N/A,N/A,1696,1727,N/A,45,4
27,N/A,N/A,N/A,1669,1696,N/A,51,4
14,N/A,N/A,N/A,1655,1669,N/A,54,1
44,N/A,N/A,N/A,1611,1655,N/A,59,6
32,N/A,N/A,N/A,1579,1611,N/A,63,4
23,N/A,N/A,N/A,1556,1579,N/A,68,3
12,N/A,N/A,N/A,1544,1556,N/A,73,2
43,N/A,N/A,N/A,1501,1544,N/A,77,6
8,N/A,N/A,N/A,1493,1501,N/A,83,0
41,N/A,N/A,N/A,1452,1493,N/A,89,6
33,N/A,N/A,N/A,1419,1452,N/A,94,5
35,N/A,N/A,N/A,1384,1419,N/A,100,5
14,N/A,N/A,N/A,1370,1384,N/A,103,2
10,N/A,N/A,N/A,1360,1370,N/A,109,2
38,N/A,N/A,N/A,1322,1360,N/A,112,5
15,N/A,N/A,N/A,1307,1322,N/A,116,3
16,N/A,N/A,N/A,1291,1307,N/A,121,2
43,N/A,N/A,N/A,1248,1291,N/A,125,6
30,N/A,N/A,N/A,1218,1248,N/A,129,4
14,N/A,N/A,N/A,1204,1218,N/A,132,1
37,N/A,N/A,N/A,1167,1204,N/A,136,5
15,N/A,N/A,N/A,1735,1750,N/A,3,3
23,N/A,N/A,N/A,1712,1735,N/A,9,3
44,N/A,N/A,N/A,1668,1712,N/A,12,6
26,N/A,N/A,N/A,1642,1668,N/A,16,4
16,N/A,N/A,N/A,1626,1642,N/A,20,2
36,N/A,N/A,N/A,1590,1626,N/A,23,5
37,N/A,N/A,N/A,1553,1590,N/A,29,5
15,N/A,N/A,N/A,1538,1553,N/A,33,3
10,N/A,N/A,N/A,1528,1538,N/A,37,1
41,N/A,N/A,N/A,1487,1528,N/A,42,6
25,N/A,N/A,N/A,1462,1487,N/A,46,4
15,N/A,N/A,N/A,1447,1462,N/A,50,2
43,N/A,N/A,N/A,1404,1447,N/A,54,6
33,N/A,N/A,N/A,1371,1404,N/A,59,5
21,N/A,N/A,N/A,1350,1371,N/A,63,3
11,N/A,N/A,N/A,1339,1350,N/A,68,2
10,N/A,N/A,N/A,1329,1339,N/A,74,2
10,N/A,N/A,N/A,1319,1329,N/A,80,2
14,N/A,N/A,N/A,1305,1319,N/A,86,2
10,N/A,N/A,N/A,1295,1305,N/A,91,1
13,N/A,N/A,N/A,1282,1295,N/A,97,1
26,N/A,N/A,N/A,1256,1282,N/A,100,4
28,N/A,N/A,N/A,1228,1256,N/A,106,4
8,N/A,N/A,N/A,1220,1228,N/A,109,1
43,N/A,N/A,N/A,1177,1220,N/A,114,6
23,N/A,N/A,N/A,1154,1177,N/A,118,4
15,N/A,N/A,N/A,1139,1154,N/A,122,2
14,N/A,N/A,N/A,1125,1139,N/A,127,1
14,N/A,N/A,N/A,1111,1125,N/A,133,1
12,N/A,N/A,N/A,1099,1111,N/A,139,1
42,N/A,N/A,N/A,773,815,N/A,6,6
35,N/A,N/A,N/A,738,773,N/A,11,5
34,N/A,N/A,N/A,704,738,N/A,17,5
22,N/A,N/A,N/A,682,704,N/A,21,3
13,N/A,N/A,N/A,669,682,N/A,26,2
11,N/A,N/A,N/A,658,669,N/A,31,1
22,N/A,N/A,N/A,636,658,N/A,34,4
28,N/A,N/A,N/A,608,636,N/A,40,4
14,N/A,N/A,N/A,594,608,N/A,43,1
38,N/A,N/A,N/A,556,594,N/A,47,5
32,N/A,N/A,N/A,524,556,N/A,52,4
23,N/A,N/A,N/A,501,524,N/A,57,3
13,N/A,N/A,N/A,488,501,N/A,62,2
32,N/A,N/A,N/A,456,488,N/A,65,5
19,N/A,N/A,N/A,437,456,N/A,69,3
14,N/A,N/A,N/A,423,437,N/A,74,2
35,N/A,N/A,N/A,388,423,N/A,77,5
16,N/A,N/A,N/A,372,388,N/A,80,2
38,N/A,N/A,N/A,334,372,N/A,83,5
18,N/A,N/A,N/A,316,334,N/A,87,3
16,N/A,N/A,N/A,300,316,N/A,92,2
42,N/A,N/A,N/A,258,300,N/A,96,6
35,N/A,N/A,N/A,223,258,N/A,101,5
34,N/A,N/A,N/A,189,223,N/A,107,5
39,N/A,N/A,N/A,150,189,N/A,113,5
13,N/A,N/A,N/A,137,150,N/A,116,2
16,N/A,N/A,N/A,121,137,N/A,122,2
11,N/A,N/A,N/A,110,121,N/A,128,2
42,N/A,N/A,N/A,68,110,N/A,132,6
29,N/A,N/A,N/A,39,68,N/A,136,4
41,N/A,N/A,N/A,1111,1152,N/A,6,6
35,N/A,N/A,N/A,1076,1111,N/A,11,5
34,N/A,N/A,N/A,1042,1076,N/A,17,5
36,N/A,N/A,N/A,1006,1042,N/A,23,5
31,N/A,N/A,N/A,975,1006,N/A,28,4
32,N/A,N/A,N/A,943,975,N/A,34,4
12,N/A,N/A,N/A,931,943,N/A,38,2
17,N/A,N/A,N/A,914,931,N/A,44,2
11,N/A,N/A,N/A,903,914,N/A,49,1
31,N/A,N/A,N/A,872,903,N/A,52,4
15,N/A,N/A,N/A,857,872,N/A,57,3
43,N/A,N/A,N/A,814,857,N/A,60,6
24,N/A,N/A,N/A,790,814,N/A,64,4
24,N/A,N/A,N/A,766,790,N/A,70,4
14,N/A,N/A,N/A,752,766,N/A,73,1
43,N/A,N/A,N/A,709,752,N/A,78,6
20,N/A,N/A,N/A,689,709,N/A,81,3
43,N/A,N/A,N/A,646,689,N/A,84,6
7,N/A,N/A,N/A,639,646,N/A,90,0
24,N/A,N/A,N/A,615,639,N/A,94,4
11,N/A,N/A,N/A,604,615,N/A,98,2
37,N/A,N/A,N/A,567,604,N/A,101,5
17,N/A,N/A,N/A,550,567,N/A,105,3
15,N/A,N/A,N/A,535,550,N/A,111,3
41,N/A,N/A,N/A,494,535,N/A,114,6
24,N/A,N/A,N/A,470,494,N/A,118,4
14,N/A,N/A,N/A,456,470,N/A,122,2
41,N/A,N/A,N/A,415,456,N/A,126,6
19,N/A,N/A,N/A,396,415,N/A,129,3
7,N/A,N/A,N/A,389,396,N/A,133,1
27,N/A,N/A,N/A,1368,1395,N/A,6,4
13,N/A,N/A,N/A,1355,1368,N/A,9,1
42,N/A,N/A,N/A,1313,1355,N/A,14,6
14,N/A,N/A,N/A,1299,1313,N/A,17,3
43,N/A,N/A,N/A,1256,1299,N/A,20,6
27,N/A,N/A,N/A,1229,1256,N/A,24,4
11,N/A,N/A,N/A,1218,1229,N/A,27,1
41,N/A,N/A,N/A,1177,1218,N/A,32,6
35,N/A,N/A,N/A,1142,1177,N/A,37,5
13,N/A,N/A,N/A,1129,1142,N/A,40,2
37,N/A,N/A,N/A,1092,1129,N/A,43,5
34,N/A,N/A,N/A,1058,1092,N/A,49,5
22,N/A,N/A,N/A,1036,1058,N/A,54,4
10,N/A,N/A,N/A,1026,1036,N/A,58,2
12,N/A,N/A,N/A,1014,1026,N/A,64,2
43,N/A,N/A,N/A,971,1014,N/A,68,6
21,N/A,N/A,N/A,950,971,N/A,71,3
41,N/A,N/A,N/A,909,950,N/A,74,6
6,N/A,N/A,N/A,903,909,N/A,80,0
32,N/A,N/A,N/A,871,903,N/A,85,5
16,N/A,N/A,N/A,855,871,N/A,88,2
10,N/A,N/A,N/A,845,855,N/A,94,2
12,N/A,N/A,N/A,833,845,N/A,99,1
44,N/A,N/A,N/A,789,833,N/A,104,6
35,N/A,N/A,N/A,754,789,N/A,109,5
23,N/A,N/A,N/A,731,754,N/A,114,4
15,N/A,N/A,N/A,716,731,N/A,119,3
9,N/A,N/A,N/A,707,716,N/A,123,1
33,N/A,N/A,N/A,674,707,N/A,127,5
29,N/A,N/A,N/A,645,674,N/A,132,4
33,N/A,N/A,N/A,1863,1896,N/A,4,5
33,N/A,N/A,N/A,1830,1863,N/A,10,5
20,N/A,N/A,N/A,1810,1830,N/A,14,3
16,N/A,N/A,N/A,1794,1810,N/A,19,2
43,N/A,N/A,N/A,1751,1794,N/A,23,6
39,N/A,N/A,N/A,1712,1751,N/A,28,5
36,N/A,N/A,N/A,1676,1712,N/A,34,5
19,N/A,N/A,N/A,1657,1676,N/A,38,3
22,N/A,N/A,N/A,1635,1657,N/A,44,3
8,N/A,N/A,N/A,1627,1635,N/A,48,1
32,N/A,N/A,N/A,1595,1627,N/A,52,5
17,N/A,N/A,N/A,1578,1595,N/A,56,3
22,N/A,N/A,N/A,1556,1578,N/A,62,3
9,N/A,N/A,N/A,1547,1556,N/A,66,1
39,N/A,N/A,N/A,1508,1547,N/A,70,5
17,N/A,N/A,N/A,1491,1508,N/A,74,3
16,N/A,N/A,N/A,1475,1491,N/A,80,3
20,N/A,N/A,N/A,1455,1475,N/A,86,3
44,N/A,N/A,N/A,1411,1455,N/A,89,6
33,N/A,N/A,N/A,1378,1411,N/A,94,5
39,N/A,N/A,N/A,1339,1378,N/A,100,5
17,N/A,N/A,N/A,1322,1339,N/A,103,2
43,N/A,N/A,N/A,1279,1322,N/A,107,6
5,N/A,N/A,N/A,1274,1279,N/A,113,0
33,N/A,N/A,N/A,1241,1274,N/A,118,5
16,N/A,N/A,N/A,1225,1241,N/A,122,3
43,N/A,N/A,N/A,1182,1225,N/A,125,6
7,N/A,N/A,N/A,1175,1182,N/A,131,0
43,N/A,N/A,N/A,1132,1175,N/A,137,6
25,N/A,N/A,N/A,1107,1132,N/A,141,4
19,N/A,N/A,N/A,1733,1752,N/A,6,3
14,N/A,N/A,N/A,1719,1733,N/A,11,2
42,N/A,N/A,N/A,1677,1719,N/A,15,6
31,N/A,N/A,N/A,1646,1677,N/A,19,4
10,N/A,N/A,N/A,1636,1646,N/A,23,2
42,N/A,N/A,N/A,1594,1636,N/A,27,6
25,N/A,N/A,N/A,1569,1594,N/A,31,4
21,N/A,N/A,N/A,1548,1569,N/A,36,3
12,N/A,N/A,N/A,1536,1548,N/A,40,1
25,N/A,N/A,N/A,1511,1536,N/A,43,4
27,N/A,N/A,N/A,1484,1511,N/A,49,4
16,N/A,N/A,N/A,1468,1484,N/A,54,3
12,N/A,N/A,N/A,1456,1468,N/A,59,2
32,N/A,N/A,N/A,1424,1456,N/A,62,5
18,N/A,N/A,N/A,1406,1424,N/A,66,3
9,N/A,N/A,N/A,1397,1406,N/A,70,1
44,N/A,N/A,N/A,1353,1397,N/A,75,6
6,N/A,N/A,N/A,1347,1353,N/A,81,0
26,N/A,N/A,N/A,1321,1347,N/A,85,4
29,N/A,N/A,N/A,1292,1321,N/A,91,4
22,N/A,N/A,N/A,1270,1292,N/A,97,4
16,N/A,N/A,N/A,1254,1270,N/A,102,3
13,N/A,N/A,N/A,1241,1254,N/A,107,2
44,N/A,N/A,N/A,1197,1241,N/A,111,6
39,N/A,N/A,N/A,1158,1197,N/A,116,5
22,N/A,N/A,N/A,1136,1158,N/A,120,3
42,N/A,N/A,N/A,1094,1136,N/A,123,6
20,N/A,N/A,N/A,1074,1094,N/A,126,3
18,N/A,N/A,N/A,1056,1074,N/A,132,3
43,N/A,N/A,N/A,1013,1056,N/A,135,6
10,N/A,N/A,N/A,698,708,N/A,6,2
9,N/A,N/A,N/A,689,698,N/A,11,1
9,N/A,N/A,N/A,680,689,N/A,17,1
33,N/A,N/A,N/A,647,680,N/A,21,5
10,N/A,N/A,N/A,637,647,N/A,24,2
10,N/A,N/A,N/A,627,637,N/A,30,2
42,N/A,N/A,N/A,585,627,N/A,34,6
20,N/A,N/A,N/A,565,585,N/A,37,3
13,N/A,N/A,N/A,552,565,N/A,41,1
42,N/A,N/A,N/A,510,552,N/A,46,6
5,N/A,N/A,N/A,505,510,N/A,52,0
43,N/A,N/A,N/A,462,505,N/A,58,6
9,N/A,N/A,N/A,453,462,N/A,64,0
35,N/A,N/A,N/A,418,453,N/A,69,5
38,N/A,N/A,N/A,380,418,N/A,75,5
29,N/A,N/A,N/A,351,380,N/A,80,4
12,N/A,N/A,N/A,339,351,N/A,83,1
22,N/A,N/A,N/A,317,339,N/A,86,4
32,N/A,N/A,N/A,285,317,N/A,92,4
22,N/A,N/A,N/A,263,285,N/A,98,4
16,N/A,N/A,N/A,247,263,N/A,102,2
10,N/A,N/A,N/A,237,247,N/A,108,2
16,N/A,N/A,N/A,221,237,N/A,114,2
43,N/A,N/A,N/A,178,221,N/A,118,6
20,N/A,N/A,N/A,158,178,N/A,121,3
19,N/A,N/A,N/A,139,158,N/A,127,3
14,N/A,N/A,N/A,125,139,N/A,131,1
44,N/A,N/A,N/A,81,125,N/A,136,6
6,N/A,N/A,N/A,75,81,N/A,142,0
34,N/A,N/A,N/A,41,75,N/A,147,5
21,N/A,N/A,N/A,1533,1554,N/A,6,3
14,N/A,N/A,N/A,1519,1533,N/A,11,2
44,N/A,N/A,N/A,1475,1519,N/A,15,6
30,N/A,N/A,N/A,1445,1475,N/A,19,4
19,N/A,N/A,N/A,1426,1445,N/A,24,3
11,N/A,N/A,N/A,1415,1426,N/A,28,1
25,N/A,N/A,N/A,1390,1415,N/A,31,4
26,N/A,N/A,N/A,1364,1390,N/A,37,4
9,N/A,N/A,N/A,1355,1364,N/A,40,1
29,N/A,N/A,N/A,1326,1355,N/A,43,4
26,N/A,N/A,N/A,1300,1326,N/A,49,4
29,N/A,N/A,N/A,1271,1300,N/A,55,4
29,N/A,N/A,N/A,1242,1271,N/A,61,4
16,N/A,N/A,N/A,1226,1242,N/A,66,3
8,N/A,N/A,N/A,1218,1226,N/A,70,1
32,N/A,N/A,N/A,1186,1218,N/A,73,4
17,N/A,N/A,N/A,1169,1186,N/A,77,2
11,N/A,N/A,N/A,1158,1169,N/A,82,1
7,N/A,N/A,N/A,1151,1158,N/A,88,1
42,N/A,N/A,N/A,1109,1151,N/A,93,6
26,N/A,N/A,N/A,1083,1109,N/A,97,4
12,N/A,N/A,N/A,1071,1083,N/A,100,1
42,N/A,N/A,N/A,1029,1071,N/A,105,6
21,N/A,N/A,N/A,1008,1029,N/A,108,3
42,N/A,N/A,N/A,966,1008,N/A,111,6
20,N/A,N/A,N/A,946,966,N/A,114,3
12,N/A,N/A,N/A,934,946,N/A,119,2
44,N/A,N/A,N/A,890,934,N/A,123,6
20,N/A,N/A,N/A,870,890,N/A,126,3
10,N/A,N/A,N/A,860,870,N/A,131,2
20,N/A,N/A,N/A,500,520,N/A,4,3
15,N/A,N/A,N/A,485,500,N/A,9,2
14,N/A,N/A,N/A,471,485,N/A,15,2
13,N/A,N/A,N/A,458,471,N/A,20,1
24,N/A,N/A,N/A,434,458,N/A,23,4
16,N/A,N/A,N/A,418,434,N/A,27,2
44,N/A,N/A,N/A,374,418,N/A,31,6
6,N/A,N/A,N/A,368,374,N/A,37,0
43,N/A,N/A,N/A,325,368,N/A,43,6
25,N/A,N/A,N/A,300,325,N/A,47,4
16,N/A,N/A,N/A,284,300,N/A,51,2
9,N/A,N/A,N/A,275,284,N/A,56,1
27,N/A,N/A,N/A,248,275,N/A,59,4
12,N/A,N/A,N/A,236,248,N/A,63,2
42,N/A,N/A,N/A,194,236,N/A,67,6
35,N/A,N/A,N/A,159,194,N/A,72,5
22,N/A,N/A,N/A,137,159,N/A,76,3
14,N/A,N/A,N/A,123,137,N/A,80,1
43,N/A,N/A,N/A,80,123,N/A,85,6
20,N/A,N/A,N/A,60,80,N/A,88,3
43,N/A,N/A,N/A,17,60,N/A,91,6
17,N/A,N/A,N/A,0,17,N/A,94,3
31,N/A,N/A,N/A,440,471,N/A,6,4
12,N/A,N/A,N/A,428,440,N/A,10,2
14,N/A,N/A,N/A,414,428,N/A,16,2
11,N/A,N/A,N/A,403,414,N/A,22,2
37,N/A,N/A,N/A,366,403,N/A,25,5
33,N/A,N/A,N/A,333,366,N/A,31,5
34,N/A,N/A,N/A,299,333,N/A,37,5
37,N/A,N/A,N/A,262,299,N/A,43,5
15,N/A,N/A,N/A,247,262,N/A,46,2
35,N/A,N/A,N/A,212,247,N/A,49,5
14,N/A,N/A,N/A,198,212,N/A,52,2
44,N/A,N/A,N/A,154,198,N/A,56,6
39,N/A,N/A,N/A,115,154,N/A,61,5
29,N/A,N/A,N/A,86,115,N/A,66,4
16,N/A,N/A,N/A,70,86,N/A,70,2
38,N/A,N/A,N/A,32,70,N/A,73,5
22,N/A,N/A,N/A,10,32,N/A,78,4
14,N/A,N/A,N/A,-4,10,N/A,83,3
43,N/A,N/A,N/A,1623,1666,N/A,4,6
25,N/A,N/A,N/A,1598,1623,N/A,8,4
15,N/A,N/A,N/A,1583,1598,N/A,12,2
7,N/A,N/A,N/A,1576,1583,N/A,17,1
43,N/A,N/A,N/A,1533,1576,N/A,22,6
5,N/A,N/A,N/A,1528,1533,N/A,28,0
20,N/A,N/A,N/A,1508,1528,N/A,31,3
44,N/A,N/A,N/A,1464,1508,N/A,34,6
25,N/A,N/A,N/A,1439,1464,N/A,38,4
16,N/A,N/A,N/A,1423,1439,N/A,42,2
35,N/A,N/A,N/A,1388,1423,N/A,45,5
11,N/A,N/A,N/A,1377,1388,N/A,48,2
11,N/A,N/A,N/A,1366,1377,N/A,54,2
44,N/A,N/A,N/A,1322,1366,N/A,58,6
35,N/A,N/A,N/A,1287,1322,N/A,63,5
16,N/A,N/A,N/A,1271,1287,N/A,67,3
16,N/A,N/A,N/A,1255,1271,N/A,72,2
10,N/A,N/A,N/A,1245,1255,N/A,77,1
42,N/A,N/A,N/A,1203,1245,N/A,82,6
37,N/A,N/A,N/A,1166,1203,N/A,87,5
35,N/A,N/A,N/A,1131,1166,N/A,93,5
10,N/A,N/A,N/A,1121,1131,N/A,96,2
43,N/A,N/A,N/A,1078,1121,N/A,100,6
6,N/A,N/A,N/A,1072,1078,N/A,106,0
19,N/A,N/A,N/A,1053,1072,N/A,109,3
15,N/A,N/A,N/A,1038,1053,N/A,114,2
41,N/A,N/A,N/A,997,1038,N/A,118,6
5,N/A,N/A,N/A,992,997,N/A,124,0
25,N/A,N/A,N/A,967,992,N/A,128,4
13,N/A,N/A,N/A,954,967,N/A,131,1
12,N/A,N/A,N/A,776,788,N/A,6,2
13,N/A,N/A,N/A,763,776,N/A,12,2
43,N/A,N/A,N/A,720,763,N/A,16,6
35,N/A,N/A,N/A,685,720,N/A,21,5
17,N/A,N/A,N/A,668,685,N/A,24,2
11,N/A,N/A,N/A,657,668,N/A,30,2
14,N/A,N/A,N/A,643,657,N/A,36,2
16,N/A,N/A,N/A,627,643,N/A,42,2
12,N/A,N/A,N/A,615,627,N/A,48,2
14,N/A,N/A,N/A,601,615,N/A,53,1
13,N/A,N/A,N/A,588,601,N/A,59,1
9,N/A,N/A,N/A,579,588,N/A,65,1
8,N/A,N/A,N/A,571,579,N/A,71,1
34,N/A,N/A,N/A,537,571,N/A,75,5
12,N/A,N/A,N/A,525,537,N/A,78,2
11,N/A,N/A,N/A,514,525,N/A,84,2
10,N/A,N/A,N/A,504,514,N/A,89,1
39,N/A,N/A,N/A,465,504,N/A,93,5
13,N/A,N/A,N/A,452,465,N/A,96,2
10,N/A,N/A,N/A,442,452,N/A,101,1
28,N/A,N/A,N/A,414,442,N/A,104,4
31,N/A,N/A,N/A,383,414,N/A,110,4
23,N/A,N/A,N/A,360,383,N/A,115,3
23,N/A,N/A,N/A,337,360,N/A,121,3
16,N/A,N/A,N/A,321,337,N/A,126,2
35,N/A,N/A,N/A,286,321,N/A,129,5
34,N/A,N/A,N/A,252,286,N/A,135,5
33,N/A,N/A,N/A,219,252,N/A,141,5
34,N/A,N/A,N/A,185,219,N/A,147,5
22,N/A,N/A,N/A,163,185,N/A,151,3
38,N/A,N/A,N/A,1496,1534,N/A,5,5
23,N/A,N/A,N/A,1473,1496,N/A,9,3
42,N/A,N/A,N/A,1431,1473,N/A,12,6
5,N/A,N/A,N/A,1426,1431,N/A,18,0
42,N/A,N/A,N/A,1384,1426,N/A,24,6
18,N/A,N/A,N/A,1366,1384,N/A,27,3
18,N/A,N/A,N/A,1348,1366,N/A,33,3
19,N/A,N/A,N/A,1329,1348,N/A,39,3
10,N/A,N/A,N/A,1319,1329,N/A,43,1
35,N/A,N/A,N/A,1284,1319,N/A,47,5
23,N/A,N/A,N/A,1261,1284,N/A,52,4
11,N/A,N/A,N/A,1250,1261,N/A,55,1
28,N/A,N/A,N/A,1222,1250,N/A,58,4
13,N/A,N/A,N/A,1209,1222,N/A,61,1
13,N/A,N/A,N/A,1196,1209,N/A,67,1
44,N/A,N/A,N/A,1152,1196,N/A,72,6
8,N/A,N/A,N/A,1144,1152,N/A,78,0
42,N/A,N/A,N/A,1102,1144,N/A,84,6
7,N/A,N/A,N/A,1095,1102,N/A,90,0
32,N/A,N/A,N/A,1063,1095,N/A,94,4
23,N/A,N/A,N/A,1040,1063,N/A,99,3
10,N/A,N/A,N/A,1030,1040,N/A,104,2
13,N/A,N/A,N/A,1017,1030,N/A,110,2
15,N/A,N/A,N/A,1002,1017,N/A,116,2
33,N/A,N/A,N/A,969,1002,N/A,119,5
11,N/A,N/A,N/A,958,969,N/A,122,2
44,N/A,N/A,N/A,914,958,N/A,126,6
36,N/A,N/A,N/A,878,914,N/A,131,5
32,N/A,N/A,N/A,846,878,N/A,137,5
28,N/A,N/A,N/A,818,846,N/A,142,4
25,N/A,N/A,N/A,1419,1444,N/A,4,4
30,N/A,N/A,N/A,1389,1419,N/A,10,4
18,N/A,N/A,N/A,1371,1389,N/A,15,3
22,N/A,N/A,N/A,1349,1371,N/A,21,3
13,N/A,N/A,N/A,1336,1349,N/A,26,2
10,N/A,N/A,N/A,1326,1336,N/A,32,2
42,N/A,N/A,N/A,1284,1326,N/A,36,6
21,N/A,N/A,N/A,1263,1284,N/A,39,3
16,N/A,N/A,N/A,1247,1263,N/A,44,2
35,N/A,N/A,N/A,1212,1247,N/A,47,5
17,N/A,N/A,N/A,1195,1212,N/A,50,2
39,N/A,N/A,N/A,1156,1195,N/A,53,5
15,N/A,N/A,N/A,1141,1156,N/A,56,2
35,N/A,N/A,N/A,1106,1141,N/A,59,5
14,N/A,N/A,N/A,1092,1106,N/A,63,3
11,N/A,N/A,N/A,1081,1092,N/A,67,1
30,N/A,N/A,N/A,1051,1081,N/A,70,4
13,N/A,N/A,N/A,1038,1051,N/A,73,1
34,N/A,N/A,N/A,1004,1038,N/A,77,5
16,N/A,N/A,N/A,988,1004,N/A,81,3
18,N/A,N/A,N/A,970,988,N/A,87,3
13,N/A,N/A,N/A,957,970,N/A,92,2
7,N/A,N/A,N/A,950,957,N/A,97,1
22,N/A,N/A,N/A,928,950,N/A,100,4
14,N/A,N/A,N/A,914,928,N/A,104,2
42,N/A,N/A,N/A,872,914,N/A,108,6
15,N/A,N/A,N/A,857,872,N/A,111,3
11,N/A,N/A,N/A,846,857,N/A,115,1
29,N/A,N/A,N/A,817,846,N/A,118,4
17,N/A,N/A,N/A,800,817,N/A,122,2
7,N/A,N/A,N/A,1681,1688,N/A,3,1
32,N/A,N/A,N/A,1649,1681,N/A,7,5
38,N/A,N/A,N/A,1611,1649,N/A,13,5
13,N/A,N/A,N/A,1598,1611,N/A,16,2
17,N/A,N/A,N/A,1581,1598,N/A,22,2
7,N/A,N/A,N/A,1574,1581,N/A,27,1
10,N/A,N/A,N/A,1564,1574,N/A,33,1
7,N/A,N/A,N/A,1557,1564,N/A,39,1
37,N/A,N/A,N/A,1520,1557,N/A,43,5
14,N/A,N/A,N/A,1506,1520,N/A,47,3
13,N/A,N/A,N/A,1493,1506,N/A,52,2
43,N/A,N/A,N/A,1450,1493,N/A,56,6
35,N/A,N/A,N/A,1415,1450,N/A,61,5
29,N/A,N/A,N/A,1386,1415,N/A,66,4
16,N/A,N/A,N/A,1370,1386,N/A,71,3
42,N/A,N/A,N/A,1328,1370,N/A,74,6
36,N/A,N/A,N/A,1292,1328,N/A,79,5
14,N/A,N/A,N/A,1278,1292,N/A,83,3
42,N/A,N/A,N/A,1236,1278,N/A,86,6
5,N/A,N/A,N/A,1231,1236,N/A,92,0
20,N/A,N/A,N/A,1211,1231,N/A,95,3
13,N/A,N/A,N/A,1198,1211,N/A,100,2
39,N/A,N/A,N/A,1159,1198,N/A,103,5
38,N/A,N/A,N/A,1121,1159,N/A,109,5
20,N/A,N/A,N/A,1101,1121,N/A,113,3
11,N/A,N/A,N/A,1090,1101,N/A,117,1
12,N/A,N/A,N/A,1078,1090,N/A,123,1
32,N/A,N/A,N/A,1046,1078,N/A,127,5
23,N/A,N/A,N/A,1023,1046,N/A,132,4
25,N/A,N/A,N/A,998,1023,N/A,138,4
39,N/A,N/A,N/A,1895,1934,N/A,6,5
23,N/A,N/A,N/A,1872,1895,N/A,11,4
17,N/A,N/A,N/A,1855,1872,N/A,16,3
11,N/A,N/A,N/A,1844,1855,N/A,20,1
33,N/A,N/A,N/A,1811,1844,N/A,24,5
19,N/A,N/A,N/A,1792,1811,N/A,28,3
11,N/A,N/A,N/A,1781,1792,N/A,32,1
44,N/A,N/A,N/A,1737,1781,N/A,37,6
6,N/A,N/A,N/A,1731,1737,N/A,43,0
25,N/A,N/A,N/A,1706,1731,N/A,47,4
26,N/A,N/A,N/A,1680,1706,N/A,53,4
27,N/A,N/A,N/A,1653,1680,N/A,59,4
21,N/A,N/A,N/A,1632,1653,N/A,64,3
12,N/A,N/A,N/A,1620,1632,N/A,68,1
23,N/A,N/A,N/A,1597,1620,N/A,71,4
8,N/A,N/A,N/A,1589,1597,N/A,74,1
42,N/A,N/A,N/A,1547,1589,N/A,79,6
25,N/A,N/A,N/A,1522,1547,N/A,83,4
15,N/A,N/A,N/A,1507,1522,N/A,88,3
15,N/A,N/A,N/A,1492,1507,N/A,93,2
10,N/A,N/A,N/A,1482,1492,N/A,98,1
28,N/A,N/A,N/A,1454,1482,N/A,101,4
9,N/A,N/A,N/A,1445,1454,N/A,104,1
35,N/A,N/A,N/A,1410,1445,N/A,108,5
23,N/A,N/A,N/A,1387,1410,N/A,113,4
14,N/A,N/A,N/A,1373,1387,N/A,116,1
23,N/A,N/A,N/A,1350,1373,N/A,119,4
13,N/A,N/A,N/A,1337,1350,N/A,122,1
42,N/A,N/A,N/A,1295,1337,N/A,127,6
23,N/A,N/A,N/A,1272,1295,N/A,130,3
44,N/A,N/A,N/A,917,961,N/A,4,6
20,N/A,N/A,N/A,897,917,N/A,7,3
13,N/A,N/A,N/A,884,897,N/A,11,1
8,N/A,N/A,N/A,876,884,N/A,17,1
22,N/A,N/A,N/A,854,876,N/A,20,4
28,N/A,N/A,N/A,826,854,N/A,26,4
17,N/A,N/A,N/A,809,826,N/A,31,3
13,N/A,N/A,N/A,796,809,N/A,36,2
42,N/A,N/A,N/A,754,796,N/A,40,6
8,N/A,N/A,N/A,746,754,N/A,46,0
17,N/A,N/A,N/A,729,746,N/A,49,3
12,N/A,N/A,N/A,717,729,N/A,54,2
32,N/A,N/A,N/A,685,717,N/A,57,5
34,N/A,N/A,N/A,651,685,N/A,63,5
10,N/A,N/A,N/A,641,651,N/A,66,2
36,N/A,N/A,N/A,605,641,N/A,69,5
14,N/A,N/A,N/A,591,605,N/A,73,3
16,N/A,N/A,N/A,575,591,N/A,78,2
43,N/A,N/A,N/A,532,575,N/A,82,6
22,N/A,N/A,N/A,510,532,N/A,86,4
18,N/A,N/A,N/A,492,510,N/A,91,3
14,N/A,N/A,N/A,478,492,N/A,97,3
14,N/A,N/A,N/A,464,478,N/A,101,1
12,N/A,N/A,N/A,452,464,N/A,107,1
44,N/A,N/A,N/A,408,452,N/A,112,6
34,N/A,N/A,N/A,374,408,N/A,117,5
29,N/A,N/A,N/A,345,374,N/A,122,4
10,N/A,N/A,N/A,335,345,N/A,126,2
13,N/A,N/A,N/A,322,335,N/A,131,1
30,N/A,N/A,N/A,292,322,N/A,134,4
24,N/A,N/A,N/A,881,905,N/A,6,4
22,N/A,N/A,N/A,859,881,N/A,12,4
32,N/A,N/A,N/A,827,859,N/A,18,4
24,N/A,N/A,N/A,803,827,N/A,24,4
22,N/A,N/A,N/A,781,803,N/A,29,3
20,N/A,N/A,N/A,761,781,N/A,35,3
13,N/A,N/A,N/A,748,761,N/A,39,1
13,N/A,N/A,N/A,735,748,N/A,45,1
10,N/A,N/A,N/A,725,735,N/A,51,1
11,N/A,N/A,N/A,714,725,N/A,57,1
41,N/A,N/A,N/A,673,714,N/A,62,6
27,N/A,N/A,N/A,646,673,N/A,66,4
23,N/A,N/A,N/A,623,646,N/A,71,3
16,N/A,N/A,N/A,607,623,N/A,77,3
44,N/A,N/A,N/A,563,607,N/A,80,6
8,N/A,N/A,N/A,555,563,N/A,86,0
41,N/A,N/A,N/A,514,555,N/A,92,6
23,N/A,N/A,N/A,491,514,N/A,96,4
22,N/A,N/A,N/A,469,491,N/A,101,3
17,N/A,N/A,N/A,452,469,N/A,106,2
35,N/A,N/A,N/A,417,452,N/A,109,5
23,N/A,N/A,N/A,394,417,N/A,113,3
43,N/A,N/A,N/A,351,394,N/A,116,6
8,N/A,N/A,N/A,343,351,N/A,122,0
15,N/A,N/A,N/A,328,343,N/A,125,3
10,N/A,N/A,N/A,318,328,N/A,129,1
27,N/A,N/A,N/A,291,318,N/A,132,4
14,N/A,N/A,N/A,277,291,N/A,137,3
22,N/A,N/A,N/A,255,277,N/A,143,3
43,N/A,N/A,N/A,212,255,N/A,146,6
34,N/A,N/A,N/A,688,722,N/A,5,5
34,N/A,N/A,N/A,654,688,N/A,11,5
33,N/A,N/A,N/A,621,654,N/A,17,5
15,N/A,N/A,N/A,606,621,N/A,20,2
37,N/A,N/A,N/A,569,606,N/A,23,5
11,N/A,N/A,N/A,558,569,N/A,26,2
16,N/A,N/A,N/A,542,558,N/A,32,2
11,N/A,N/A,N/A,531,542,N/A,37,1
43,N/A,N/A,N/A,488,531,N/A,42,6
23,N/A,N/A,N/A,465,488,N/A,46,4
13,N/A,N/A,N/A,452,465,N/A,50,2
41,N/A,N/A,N/A,411,452,N/A,54,6
6,N/A,N/A,N/A,405,411,N/A,60,0
42,N/A,N/A,N/A,363,405,N/A,66,6
33,N/A,N/A,N/A,330,363,N/A,71,5
17,N/A,N/A,N/A,313,330,N/A,75,3
23,N/A,N/A,N/A,290,313,N/A,81,3
17,N/A,N/A,N/A,273,290,N/A,87,3
15,N/A,N/A,N/A,258,273,N/A,92,2
38,N/A,N/A,N/A,220,258,N/A,95,5
32,N/A,N/A,N/A,188,220,N/A,100,4
13,N/A,N/A,N/A,175,188,N/A,103,1
37,N/A,N/A,N/A,138,175,N/A,107,5
33,N/A,N/A,N/A,105,138,N/A,113,5
26,N/A,N/A,N/A,79,105,N/A,118,4
8,N/A,N/A,N/A,71,79,N/A,121,1
22,N/A,N/A,N/A,49,71,N/A,124,4
8,N/A,N/A,N/A,41,49,N/A,127,1
36,N/A,N/A,N/A,5,41,N/A,131,5
23,N/A,N/A,N/A,-18,5,N/A,136,4
42,N/A,N/A,N/A,1610,1652,N/A,3,6
22,N/A,N/A,N/A,1588,1610,N/A,7,4
26,N/A,N/A,N/A,1562,1588,N/A,13,4
8,N/A,N/A,N/A,1554,1562,N/A,16,1
25,N/A,N/A,N/A,1529,1554,N/A,19,4
8,N/A,N/A,N/A,1521,1529,N/A,22,1
36,N/A,N/A,N/A,1485,1521,N/A,26,5
26,N/A,N/A,N/A,1459,1485,N/A,31,4
29,N/A,N/A,N/A,1430,1459,N/A,37,4
27,N/A,N/A,N/A,1403,1430,N/A,43,4
15,N/A,N/A,N/A,1388,1403,N/A,47,2
39,N/A,N/A,N/A,1349,1388,N/A,50,5
11,N/A,N/A,N/A,1338,1349,N/A,53,2
11,N/A,N/A,N/A,1327,1338,N/A,58,1
42,N/A,N/A,N/A,1285,1327,N/A,63,6
37,N/A,N/A,N/A,1248,1285,N/A,68,5
29,N/A,N/A,N/A,1219,1248,N/A,73,4
15,N/A,N/A,N/A,1204,1219,N/A,77,2
9,N/A,N/A,N/A,1195,1204,N/A,82,1
11,N/A,N/A,N/A,1184,1195,N/A,88,1
7,N/A,N/A,N/A,1177,1184,N/A,94,1
41,N/A,N/A,N/A,1136,1177,N/A,99,6
5,N/A,N/A,N/A,1131,1136,N/A,105,0
34,N/A,N/A,N/A,1097,1131,N/A,110,5
17,N/A,N/A,N/A,1080,1097,N/A,114,3
23,N/A,N/A,N/A,1057,1080,N/A,120,3
11,N/A,N/A,N/A,1046,1057,N/A,125,2
36,N/A,N/A,N/A,1010,1046,N/A,128,5
26,N/A,N/A,N/A,984,1010,N/A,133,4
16,N/A,N/A,N/A,968,984,N/A,138,3
42,N/A,N/A,N/A,1306,1348,N/A,3,6
32,N/A,N/A,N/A,1274,1306,N/A,8,5
37,N/A,N/A,N/A,1237,1274,N/A,14,5
11,N/A,N/A,N/A,1226,1237,N/A,17,2
41,N/A,N/A,N/A,1185,1226,N/A,21,6
7,N/A,N/A,N/A,1178,1185,N/A,27,0
16,N/A,N/A,N/A,1162,1178,N/A,30,3
14,N/A,N/A,N/A,1148,1162,N/A,35,2
13,N/A,N/A,N/A,1135,1148,N/A,40,1
42,N/A,N/A,N/A,1093,1135,N/A,45,6
17,N/A,N/A,N/A,1076,1093,N/A,48,3
43,N/A,N/A,N/A,1033,1076,N/A,51,6
14,N/A,N/A,N/A,1019,1033,N/A,54,3
11,N/A,N/A,N/A,1008,1019,N/A,59,2
17,N/A,N/A,N/A,991,1008,N/A,65,2
39,N/A,N/A,N/A,952,991,N/A,68,5
26,N/A,N/A,N/A,926,952,N/A,73,4
14,N/A,N/A,N/A,912,926,N/A,77,2
42,N/A,N/A,N/A,870,912,N/A,81,6
22,N/A,N/A,N/A,848,870,N/A,85,4
15,N/A,N/A,N/A,833,848,N/A,89,2
16,N/A,N/A,N/A,817,833,N/A,95,2
44,N/A,N/A,N/A,773,817,N/A,99,6
21,N/A,N/A,N/A,752,773,N/A,102,3
22,N/A,N/A,N/A,730,752,N/A,108,3
18,N/A,N/A,N/A,712,730,N/A,114,3
11,N/A,N/A,N/A,701,712,N/A,118,1
32,N/A,N/A,N/A,669,701,N/A,121,4
14,N/A,N/A,N/A,655,669,N/A,126,3
42,N/A,N/A,N/A,613,655,N/A,129,6
17,N/A,N/A,N/A,1604,1621,N/A,3,2
13,N/A,N/A,N/A,1591,1604,N/A,8,1
42,N/A,N/A,N/A,1549,1591,N/A,13,6
36,N/A,N/A,N/A,1513,1549,N/A,18,5
21,N/A,N/A,N/A,1492,1513,N/A,22,3
8,N/A,N/A,N/A,1484,1492,N/A,26,1
43,N/A,N/A,N/A,1441,1484,N/A,31,6
35,N/A,N/A,N/A,1406,1441,N/A,36,5
16,N/A,N/A,N/A,1390,1406,N/A,40,3
14,N/A,N/A,N/A,1376,1390,N/A,46,3
20,N/A,N/A,N/A,1356,1376,N/A,52,3
10,N/A,N/A,N/A,1346,1356,N/A,56,1
35,N/A,N/A,N/A,1311,1346,N/A,60,5
14,N/A,N/A,N/A,1297,1311,N/A,64,3
43,N/A,N/A,N/A,1254,1297,N/A,67,6
22,N/A,N/A,N/A,1232,1254,N/A,70,3
8,N/A,N/A,N/A,1224,1232,N/A,74,1
43,N/A,N/A,N/A,1181,1224,N/A,79,6
34,N/A,N/A,N/A,1147,1181,N/A,84,5
14,N/A,N/A,N/A,1133,1147,N/A,88,3
22,N/A,N/A,N/A,1111,1133,N/A,94,3
15,N/A,N/A,N/A,1096,1111,N/A,100,3
18,N/A,N/A,N/A,1078,1096,N/A,106,3
14,N/A,N/A,N/A,1064,1078,N/A,112,3
17,N/A,N/A,N/A,1047,1064,N/A,117,2
37,N/A,N/A,N/A,1010,1047,N/A,120,5
10,N/A,N/A,N/A,1000,1010,N/A,123,2
43,N/A,N/A,N/A,957,1000,N/A,127,6
20,N/A,N/A,N/A,937,957,N/A,130,3
41,N/A,N/A,N/A,896,937,N/A,133,6
12,N/A,N/A,N/A,1800,1812,N/A,3,1
44,N/A,N/A,N/A,1756,1800,N/A,8,6
22,N/A,N/A,N/A,1734,1756,N/A,12,4
24,N/A,N/A,N/A,1710,1734,N/A,18,4
23,N/A,N/A,N/A,1687,1710,N/A,23,3
12,N/A,N/A,N/A,1675,1687,N/A,28,2
33,N/A,N/A,N/A,1642,1675,N/A,31,5
23,N/A,N/A,N/A,1619,1642,N/A,35,3
7,N/A,N/A,N/A,1612,1619,N/A,39,1
10,N/A,N/A,N/A,1602,1612,N/A,45,1
10,N/A,N/A,N/A,1592,1602,N/A,51,1
42,N/A,N/A,N/A,1550,1592,N/A,56,6
8,N/A,N/A,N/A,1542,1550,N/A,62,0
42,N/A,N/A,N/A,1500,1542,N/A,68,6
29,N/A,N/A,N/A,1471,1500,N/A,72,4
14,N/A,N/A,N/A,1457,1471,N/A,76,2
43,N/A,N/A,N/A,1414,1457,N/A,80,6
29,N/A,N/A,N/A,1385,1414,N/A,84,4
17,N/A,N/A,N/A,1368,1385,N/A,89,3
41,N/A,N/A,N/A,1327,1368,N/A,92,6
39,N/A,N/A,N/A,1288,1327,N/A,97,5
23,N/A,N/A,N/A,1265,1288,N/A,101,3
14,N/A,N/A,N/A,1251,1265,N/A,106,2
13,N/A,N/A,N/A,1238,1251,N/A,112,2
42,N/A,N/A,N/A,1196,1238,N/A,116,6
20,N/A,N/A,N/A,1176,1196,N/A,119,3
10,N/A,N/A,N/A,1166,1176,N/A,124,2
13,N/A,N/A,N/A,1153,1166,N/A,130,2
14,N/A,N/A,N/A,1139,1153,N/A,136,2
39,N/A,N/A,N/A,1100,1139,N/A,139,5
32,N/A,N/A,N/A,466,498,N/A,3,5
17,N/A,N/A,N/A,449,466,N/A,7,3
17,N/A,N/A,N/A,432,449,N/A,13,3
44,N/A,N/A,N/A,388,432,N/A,16,6
8,N/A,N/A,N/A,380,388,N/A,22,0
14,N/A,N/A,N/A,366,380,N/A,25,3
13,N/A,N/A,N/A,353,366,N/A,30,2
44,N/A,N/A,N/A,309,353,N/A,34,6
23,N/A,N/A,N/A,286,309,N/A,37,3
42,N/A,N/A,N/A,244,286,N/A,40,6
7,N/A,N/A,N/A,237,244,N/A,46,0
27,N/A,N/A,N/A,210,237,N/A,50,4
30,N/A,N/A,N/A,180,210,N/A,56,4
14,N/A,N/A,N/A,166,180,N/A,59,1
42,N/A,N/A,N/A,124,166,N/A,64,6
6,N/A,N/A,N/A,118,124,N/A,70,0
19,N/A,N/A,N/A,99,118,N/A,73,3
23,N/A,N/A,N/A,76,99,N/A,79,3
41,N/A,N/A,N/A,35,76,N/A,82,6
38,N/A,N/A,N/A,-3,35,N/A,87,5
22,N/A,N/A,N/A,1815,1837,N/A,6,3
12,N/A,N/A,N/A,1803,1815,N/A,10,1
22,N/A,N/A,N/A,1781,1803,N/A,13,4
7,N/A,N/A,N/A,1774,1781,N/A,16,1
30,N/A,N/A,N/A,1744,1774,N/A,19,4
13,N/A,N/A,N/A,1731,1744,N/A,23,2
11,N/A,N/A,N/A,1720,1731,N/A,28,1
13,N/A,N/A,N/A,1707,1720,N/A,34,1
42,N/A,N/A,N/A,1665,1707,N/A,39,6
36,N/A,N/A,N/A,1629,1665,N/A,44,5
15,N/A,N/A,N/A,1614,1629,N/A,47,2
8,N/A,N/A,N/A,1606,1614,N/A,52,1
30,N/A,N/A,N/A,1576,1606,N/A,55,4
23,N/A,N/A,N/A,1553,1576,N/A,60,3
10,N/A,N/A,N/A,1543,1553,N/A,65,2
12,N/A,N/A,N/A,1531,1543,N/A,70,1
43,N/A,N/A,N/A,1488,1531,N/A,75,6
38,N/A,N/A,N/A,1450,1488,N/A,80,5
33,N/A,N/A,N/A,1417,1450,N/A,86,5
18,N/A,N/A,N/A,1399,1417,N/A,90,3
14,N/A,N/A,N/A,1385,1399,N/A,94,1
37,N/A,N/A,N/A,1348,1385,N/A,98,5
10,N/A,N/A,N/A,1338,1348,N/A,101,2
12,N/A,N/A,N/A,1326,1338,N/A,107,2
13,N/A,N/A,N/A,1313,1326,N/A,112,1
43,N/A,N/A,N/A,1270,1313,N/A,117,6
21,N/A,N/A,N/A,1249,1270,N/A,120,3
11,N/A,N/A,N/A,1238,1249,N/A,125,2
14,N/A,N/A,N/A,1224,1238,N/A,131,2
43,N/A,N/A,N/A,1181,1224,N/A,135,6
11,N/A,N/A,N/A,1606,1617,N/A,5,1
39,N/A,N/A,N/A,1567,1606,N/A,9,5
21,N/A,N/A,N/A,1546,1567,N/A,13,3
15,N/A,N/A,N/A,1531,1546,N/A,18,2
36,N/A,N/A,N/A,1495,1531,N/A,21,5
25,N/A,N/A,N/A,1470,1495,N/A,26,4
17,N/A,N/A,N/A,1453,1470,N/A,30,2
17,N/A,N/A,N/A,1436,1453,N/A,36,2
44,N/A,N/A,N/A,1392,1436,N/A,40,6
14,N/A,N/A,N/A,1378,1392,N/A,43,3
14,N/A,N/A,N/A,1364,1378,N/A,49,3
42,N/A,N/A,N/A,1322,1364,N/A,52,6
34,N/A,N/A,N/A,1288,1322,N/A,57,5
32,N/A,N/A,N/A,1256,1288,N/A,63,5
22,N/A,N/A,N/A,1234,1256,N/A,67,3
7,N/A,N/A,N/A,1227,1234,N/A,71,1
31,N/A,N/A,N/A,1196,1227,N/A,74,4
13,N/A,N/A,N/A,1183,1196,N/A,78,2
35,N/A,N/A,N/A,1148,1183,N/A,81,5
37,N/A,N/A,N/A,1111,1148,N/A,87,5
10,N/A,N/A,N/A,1101,1111,N/A,90,2
11,N/A,N/A,N/A,1090,1101,N/A,96,2
33,N/A,N/A,N/A,1057,1090,N/A,99,5
20,N/A,N/A,N/A,1037,1057,N/A,103,3
18,N/A,N/A,N/A,1019,1037,N/A,109,3
7,N/A,N/A,N/A,1012,1019,N/A,113,1
24,N/A,N/A,N/A,988,1012,N/A,116,4
13,N/A,N/A,N/A,975,988,N/A,119,1
42,N/A,N/A,N/A,933,975,N/A,124,6
25,N/A,N/A,N/A,908,933,N/A,128,4
41,N/A,N/A,N/A,906,947,N/A,5,6
39,N/A,N/A,N/A,867,906,N/A,10,5
14,N/A,N/A,N/A,853,867,N/A,14,3
8,N/A,N/A,N/A,845,853,N/A,18,1
43,N/A,N/A,N/A,802,845,N/A,23,6
35,N/A,N/A,N/A,767,802,N/A,28,5
34,N/A,N/A,N/A,733,767,N/A,34,5
33,N/A,N/A,N/A,700,733,N/A,40,5
32,N/A,N/A,N/A,668,700,N/A,46,5
15,N/A,N/A,N/A,653,668,N/A,49,2
39,N/A,N/A,N/A,614,653,N/A,52,5
14,N/A,N/A,N/A,600,614,N/A,56,3
14,N/A,N/A,N/A,586,600,N/A,61,2
13,N/A,N/A,N/A,573,586,N/A,67,2
35,N/A,N/A,N/A,538,573,N/A,70,5
20,N/A,N/A,N/A,518,538,N/A,74,3
18,N/A,N/A,N/A,500,518,N/A,80,3
16,N/A,N/A,N/A,484,500,N/A,86,3
11,N/A,N/A,N/A,473,484,N/A,90,1
39,N/A,N/A,N/A,434,473,N/A,94,5
15,N/A,N/A,N/A,419,434,N/A,98,3
9,N/A,N/A,N/A,410,419,N/A,102,1
32,N/A,N/A,N/A,378,410,N/A,106,5
36,N/A,N/A,N/A,342,378,N/A,112,5
36,N/A,N/A,N/A,306,342,N/A,118,5
12,N/A,N/A,N/A,294,306,N/A,121,2
12,N/A,N/A,N/A,282,294,N/A,126,1
42,N/A,N/A,N/A,240,282,N/A,131,6
39,N/A,N/A,N/A,201,240,N/A,136,5
37,N/A,N/A,N/A,164,201,N/A,142,5
35,N/A,N/A,N/A,1658,1693,N/A,3,5
32,N/A,N/A,N/A,1626,1658,N/A,9,5
36,N/A,N/A,N/A,1590,1626,N/A,15,5
30,N/A,N/A,N/A,1560,1590,N/A,20,4
9,N/A,N/A,N/A,1551,1560,N/A,23,1
32,N/A,N/A,N/A,1519,1551,N/A,27,5
12,N/A,N/A,N/A,1507,1519,N/A,30,2
13,N/A,N/A,N/A,1494,1507,N/A,35,1
29,N/A,N/A,N/A,1465,1494,N/A,38,4
15,N/A,N/A,N/A,1450,1465,N/A,42,2
41,N/A,N/A,N/A,1409,1450,N/A,46,6
14,N/A,N/A,N/A,1395,1409,N/A,49,3
13,N/A,N/A,N/A,1382,1395,N/A,54,2
37,N/A,N/A,N/A,1345,1382,N/A,57,5
14,N/A,N/A,N/A,1331,1345,N/A,60,2
13,N/A,N/A,N/A,1318,1331,N/A,66,2
37,N/A,N/A,N/A,1281,1318,N/A,69,5
28,N/A,N/A,N/A,1253,1281,N/A,74,4
13,N/A,N/A,N/A,1240,1253,N/A,78,2
42,N/A,N/A,N/A,1198,1240,N/A,82,6
32,N/A,N/A,N/A,1166,1198,N/A,87,5
17,N/A,N/A,N/A,1149,1166,N/A,90,2
35,N/A,N/A,N/A,1114,1149,N/A,93,5
19,N/A,N/A,N/A,1095,1114,N/A,97,3
14,N/A,N/A,N/A,1081,1095,N/A,102,2
16,N/A,N/A,N/A,1065,1081,N/A,108,2
17,N/A,N/A,N/A,1048,1065,N/A,114,2
44,N/A,N/A,N/A,1004,1048,N/A,118,6
32,N/A,N/A,N/A,972,1004,N/A,122,4
23,N/A,N/A,N/A,949,972,N/A,128,4
38,N/A,N/A,N/A,664,702,N/A,6,5
33,N/A,N/A,N/A,631,664,N/A,12,5
15,N/A,N/A,N/A,616,631,N/A,15,2
44,N/A,N/A,N/A,572,616,N/A,19,6
34,N/A,N/A,N/A,538,572,N/A,24,5
38,N/A,N/A,N/A,500,538,N/A,30,5
16,N/A,N/A,N/A,484,500,N/A,33,2
14,N/A,N/A,N/A,470,484,N/A,39,2
12,N/A,N/A,N/A,458,470,N/A,45,2
14,N/A,N/A,N/A,444,458,N/A,51,2
38,N/A,N/A,N/A,406,444,N/A,54,5
11,N/A,N/A,N/A,395,406,N/A,57,2
43,N/A,N/A,N/A,352,395,N/A,61,6
24,N/A,N/A,N/A,328,352,N/A,65,4
14,N/A,N/A,N/A,314,328,N/A,69,2
17,N/A,N/A,N/A,297,314,N/A,75,2
39,N/A,N/A,N/A,258,297,N/A,78,5
33,N/A,N/A,N/A,225,258,N/A,84,5
34,N/A,N/A,N/A,191,225,N/A,90,5
13,N/A,N/A,N/A,178,191,N/A,93,2
39,N/A,N/A,N/A,139,178,N/A,96,5
21,N/A,N/A,N/A,118,139,N/A,100,3
42,N/A,N/A,N/A,76,118,N/A,103,6
25,N/A,N/A,N/A,51,76,N/A,107,4
19,N/A,N/A,N/A,32,51,N/A,112,3
17,N/A,N/A,N/A,15,32,N/A,117,2
11,N/A,N/A,N/A,4,15,N/A,122,1
23,N/A,N/A,N/A,-19,4,N/A,125,4
15,N/A,N/A,N/A,1314,1329,N/A,5,3
43,N/A,N/A,N/A,1271,1314,N/A,8,6
20,N/A,N/A,N/A,1251,1271,N/A,11,3
12,N/A,N/A,N/A,1239,1251,N/A,15,1
24,N/A,N/A,N/A,1215,1239,N/A,18,4
22,N/A,N/A,N/A,1193,1215,N/A,23,3
43,N/A,N/A,N/A,1150,1193,N/A,26,6
17,N/A,N/A,N/A,1133,1150,N/A,29,3
17,N/A,N/A,N/A,1116,1133,N/A,35,3
7,N/A,N/A,N/A,1109,1116,N/A,39,1
27,N/A,N/A,N/A,1082,1109,N/A,42,4
11,N/A,N/A,N/A,1071,1082,N/A,45,1
44,N/A,N/A,N/A,1027,1071,N/A,50,6
7,N/A,N/A,N/A,1020,1027,N/A,56,0
32,N/A,N/A,N/A,988,1020,N/A,60,4
12,N/A,N/A,N/A,976,988,N/A,64,2
42,N/A,N/A,N/A,934,976,N/A,68,6
16,N/A,N/A,N/A,918,934,N/A,71,3
44,N/A,N/A,N/A,874,918,N/A,74,6
37,N/A,N/A,N/A,837,874,N/A,79,5
17,N/A,N/A,N/A,820,837,N/A,82,2
36,N/A,N/A,N/A,784,820,N/A,85,5
19,N/A,N/A,N/A,765,784,N/A,89,3
41,N/A,N/A,N/A,724,765,N/A,92,6
25,N/A,N/A,N/A,699,724,N/A,96,4
14,N/A,N/A,N/A,685,699,N/A,99,1
32,N/A,N/A,N/A,653,685,N/A,103,5
22,N/A,N/A,N/A,631,653,N/A,108,4
23,N/A,N/A,N/A,608,631,N/A,114,4
29,N/A,N/A,N/A,579,608,N/A,120,4
18,N/A,N/A,N/A,1098,1116,N/A,5,3
15,N/A,N/A,N/A,1083,1098,N/A,10,2
34,N/A,N/A,N/A,1049,1083,N/A,13,5
11,N/A,N/A,N/A,1038,1049,N/A,16,2
8,N/A,N/A,N/A,1030,1038,N/A,21,1
11,N/A,N/A,N/A,1019,1030,N/A,27,1
41,N/A,N/A,N/A,978,1019,N/A,32,6
9,N/A,N/A,N/A,969,978,N/A,38,0
22,N/A,N/A,N/A,947,969,N/A,41,3
8,N/A,N/A,N/A,939,947,N/A,45,1
43,N/A,N/A,N/A,896,939,N/A,50,6
35,N/A,N/A,N/A,861,896,N/A,55,5
36,N/A,N/A,N/A,825,861,N/A,61,5
22,N/A,N/A,N/A,803,825,N/A,66,4
16,N/A,N/A,N/A,787,803,N/A,71,3
18,N/A,N/A,N/A,769,787,N/A,77,3
44,N/A,N/A,N/A,725,769,N/A,80,6
8,N/A,N/A,N/A,717,725,N/A,86,0
33,N/A,N/A,N/A,684,717,N/A,91,5
33,N/A,N/A,N/A,651,684,N/A,97,5
14,N/A,N/A,N/A,637,651,N/A,100,2
38,N/A,N/A,N/A,599,637,N/A,103,5
10,N/A,N/A,N/A,589,599,N/A,106,2
10,N/A,N/A,N/A,579,589,N/A,111,1
35,N/A,N/A,N/A,544,579,N/A,115,5
14,N/A,N/A,N/A,530,544,N/A,119,3
41,N/A,N/A,N/A,489,530,N/A,122,6
7,N/A,N/A,N/A,482,489,N/A,128,0
33,N/A,N/A,N/A,449,482,N/A,133,5
21,N/A,N/A,N/A,428,449,N/A,137,3
12,N/A,N/A,N/A,1971,1983,N/A,6,2
37,N/A,N/A,N/A,1934,1971,N/A,9,5
11,N/A,N/A,N/A,1923,1934,N/A,12,2
11,N/A,N/A,N/A,1912,1923,N/A,18,2
14,N/A,N/A,N/A,1898,1912,N/A,24,2
17,N/A,N/A,N/A,1881,1898,N/A,30,2
41,N/A,N/A,N/A,1840,1881,N/A,34,6
32,N/A,N/A,N/A,1808,1840,N/A,39,5
18,N/A,N/A,N/A,1790,1808,N/A,43,3
16,N/A,N/A,N/A,1774,1790,N/A,48,2
8,N/A,N/A,N/A,1766,1774,N/A,53,1
35,N/A,N/A,N/A,1731,1766,N/A,57,5
27,N/A,N/A,N/A,1704,1731,N/A,62,4
13,N/A,N/A,N/A,1691,1704,N/A,66,2
37,N/A,N/A,N/A,1654,1691,N/A,69,5
19,N/A,N/A,N/A,1635,1654,N/A,73,3
13,N/A,N/A,N/A,1622,1635,N/A,77,1
7,N/A,N/A,N/A,1615,1622,N/A,83,1
29,N/A,N/A,N/A,1586,1615,N/A,86,4
23,N/A,N/A,N/A,1563,1586,N/A,91,3
14,N/A,N/A,N/A,1549,1563,N/A,95,1
44,N/A,N/A,N/A,1505,1549,N/A,100,6
16,N/A,N/A,N/A,1489,1505,N/A,103,3
43,N/A,N/A,N/A,1446,1489,N/A,106,6
35,N/A,N/A,N/A,1411,1446,N/A,111,5
17,N/A,N/A,N/A,1394,1411,N/A,115,3
17,N/A,N/A,N/A,1377,1394,N/A,120,2
35,N/A,N/A,N/A,1342,1377,N/A,123,5
17,N/A,N/A,N/A,1325,1342,N/A,126,2
14,N/A,N/A,N/A,1311,1325,N/A,132,2
23,N/A,N/A,N/A,603,626,N/A,5,4
21,N/A,N/A,N/A,582,603,N/A,10,3
18,N/A,N/A,N/A,564,582,N/A,16,3
11,N/A,N/A,N/A,553,564,N/A,20,1
42,N/A,N/A,N/A,511,553,N/A,25,6
22,N/A,N/A,N/A,489,511,N/A,28,3
12,N/A,N/A,N/A,477,489,N/A,33,2
7,N/A,N/A,N/A,470,477,N/A,38,1
28,N/A,N/A,N/A,442,470,N/A,41,4
29,N/A,N/A,N/A,413,442,N/A,47,4
10,N/A,N/A,N/A,403,413,N/A,50,1
24,N/A,N/A,N/A,379,403,N/A,53,4
8,N/A,N/A,N/A,371,379,N/A,56,1
8,N/A,N/A,N/A,363,371,N/A,62,1
26,N/A,N/A,N/A,337,363,N/A,65,4
14,N/A,N/A,N/A,323,337,N/A,69,2
11,N/A,N/A,N/A,312,323,N/A,74,1
41,N/A,N/A,N/A,271,312,N/A,79,6
32,N/A,N/A,N/A,239,271,N/A,84,5
35,N/A,N/A,N/A,204,239,N/A,90,5
12,N/A,N/A,N/A,192,204,N/A,93,2
35,N/A,N/A,N/A,157,192,N/A,96,5
18,N/A,N/A,N/A,139,157,N/A,100,3
43,N/A,N/A,N/A,96,139,N/A,103,6
25,N/A,N/A,N/A,71,96,N/A,107,4
11,N/A,N/A,N/A,60,71,N/A,110,1
31,N/A,N/A,N/A,29,60,N/A,113,4
7,N/A,N/A,N/A,22,29,N/A,116,1
14,N/A,N/A,N/A,8,22,N/A,122,1
10,N/A,N/A,N/A,-2,8,N/A,128,1
44,N/A,N/A,N/A,321,365,N/A,5,6
27,N/A,N/A,N/A,294,321,N/A,9,4
10,N/A,N/A,N/A,284,294,N/A,13,2
44,N/A,N/A,N/A,240,284,N/A,17,6
22,N/A,N/A,N/A,218,240,N/A,21,4
10,N/A,N/A,N/A,208,218,N/A,24,1
27,N/A,N/A,N/A,181,208,N/A,27,4
20,N/A,N/A,N/A,161,181,N/A,32,3
14,N/A,N/A,N/A,147,161,N/A,36,1
35,N/A,N/A,N/A,112,147,N/A,40,5
15,N/A,N/A,N/A,97,112,N/A,43,2
15,N/A,N/A,N/A,82,97,N/A,49,2
42,N/A,N/A,N/A,40,82,N/A,53,6
27,N/A,N/A,N/A,13,40,N/A,57,4
17,N/A,N/A,N/A,-4,13,N/A,61,2
22,N/A,N/A,N/A,1588,1610,N/A,4,3
41,N/A,N/A,N/A,1547,1588,N/A,7,6
8,N/A,N/A,N/A,1539,1547,N/A,13,0
32,N/A,N/A,N/A,1507,1539,N/A,17,4
22,N/A,N/A,N/A,1485,1507,N/A,22,3
18,N/A,N/A,N/A,1467,1485,N/A,28,3
11,N/A,N/A,N/A,1456,1467,N/A,33,2
15,N/A,N/A,N/A,1441,1456,N/A,39,2
33,N/A,N/A,N/A,1408,1441,N/A,42,5
27,N/A,N/A,N/A,1381,1408,N/A,47,4
29,N/A,N/A,N/A,1352,1381,N/A,53,4
28,N/A,N/A,N/A,1324,1352,N/A,59,4
11,N/A,N/A,N/A,1313,1324,N/A,63,2
41,N/A,N/A,N/A,1272,1313,N/A,67,6
33,N/A,N/A,N/A,1239,1272,N/A,72,5
35,N/A,N/A,N/A,1204,1239,N/A,78,5
30,N/A,N/A,N/A,1174,1204,N/A,83,4
23,N/A,N/A,N/A,1151,1174,N/A,89,4
11,N/A,N/A,N/A,1140,1151,N/A,93,2
43,N/A,N/A,N/A,1097,1140,N/A,97,6
6,N/A,N/A,N/A,1091,1097,N/A,103,0
19,N/A,N/A,N/A,1072,1091,N/A,106,3
22,N/A,N/A,N/A,1050,1072,N/A,112,3
43,N/A,N/A,N/A,1007,1050,N/A,115,6
38,N/A,N/A,N/A,969,1007,N/A,120,5
15,N/A,N/A,N/A,954,969,N/A,124,3
42,N/A,N/A,N/A,912,954,N/A,127,6
8,N/A,N/A,N/A,904,912,N/A,133,0
23,N/A,N/A,N/A,881,904,N/A,137,4
17,N/A,N/A,N/A,864,881,N/A,141,2
8,N/A,N/A,N/A,834,842,N/A,6,1
31,N/A,N/A,N/A,803,834,N/A,9,4
29,N/A,N/A,N/A,774,803,N/A,15,4
25,N/A,N/A,N/A,749,774,N/A,21,4
22,N/A,N/A,N/A,727,749,N/A,26,3
7,N/A,N/A,N/A,720,727,N/A,30,1
44,N/A,N/A,N/A,676,720,N/A,35,6
32,N/A,N/A,N/A,644,676,N/A,40,5
39,N/A,N/A,N/A,605,644,N/A,46,5
36,N/A,N/A,N/A,569,605,N/A,52,5
32,N/A,N/A,N/A,537,569,N/A,57,4
10,N/A,N/A,N/A,527,537,N/A,61,2
44,N/A,N/A,N/A,483,527,N/A,65,6
37,N/A,N/A,N/A,446,483,N/A,70,5
21,N/A,N/A,N/A,425,446,N/A,74,3
13,N/A,N/A,N/A,412,425,N/A,78,1
42,N/A,N/A,N/A,370,412,N/A,83,6
23,N/A,N/A,N/A,347,370,N/A,86,3
10,N/A,N/A,N/A,337,347,N/A,91,2
39,N/A,N/A,N/A,298,337,N/A,94,5
16,N/A,N/A,N/A,282,298,N/A,98,3
41,N/A,N/A,N/A,241,282,N/A,101,6
15,N/A,N/A,N/A,226,241,N/A,104,3
41,N/A,N/A,N/A,185,226,N/A,107,6
26,N/A,N/A,N/A,159,185,N/A,111,4
12,N/A,N/A,N/A,147,159,N/A,114,1
9,N/A,N/A,N/A,138,147,N/A,120,1
41,N/A,N/A,N/A,97,138,N/A,125,6
9,N/A,N/A,N/A,88,97,N/A,131,0
32,N/A,N/A,N/A,56,88,N/A,136,5
39,N/A,N/A,N/A,553,592,N/A,5,5
27,N/A,N/A,N/A,526,553,N/A,10,4
16,N/A,N/A,N/A,510,526,N/A,14,2
43,N/A,N/A,N/A,467,510,N/A,18,6
16,N/A,N/A,N/A,451,467,N/A,21,3
10,N/A,N/A,N/A,441,451,N/A,26,2
9,N/A,N/A,N/A,432,441,N/A,31,1
32,N/A,N/A,N/A,400,432,N/A,34,4
19,N/A,N/A,N/A,381,400,N/A,39,3
41,N/A,N/A,N/A,340,381,N/A,42,6
7,N/A,N/A,N/A,333,340,N/A,48,0
38,N/A,N/A,N/A,295,333,N/A,53,5
15,N/A,N/A,N/A,280,295,N/A,56,2
38,N/A,N/A,N/A,242,280,N/A,59,5
32,N/A,N/A,N/A,210,242,N/A,65,5
28,N/A,N/A,N/A,182,210,N/A,70,4
20,N/A,N/A,N/A,162,182,N/A,75,3
41,N/A,N/A,N/A,121,162,N/A,78,6
22,N/A,N/A,N/A,99,121,N/A,82,4
8,N/A,N/A,N/A,91,99,N/A,85,1
25,N/A,N/A,N/A,66,91,N/A,88,4
11,N/A,N/A,N/A,55,66,N/A,91,1
44,N/A,N/A,N/A,11,55,N/A,96,6
39,N/A,N/A,N/A,-28,11,N/A,101,5
19,N/A,N/A,N/A,1186,1205,N/A,5,3
13,N/A,N/A,N/A,1173,1186,N/A,10,2
35,N/A,N/A,N/A,1138,1173,N/A,13,5
12,N/A,N/A,N/A,1126,1138,N/A,16,2
41,N/A,N/A,N/A,1085,1126,N/A,20,6
32,N/A,N/A,N/A,1053,1085,N/A,24,4
14,N/A,N/A,N/A,1039,1053,N/A,28,2
42,N/A,N/A,N/A,997,1039,N/A,32,6
9,N/A,N/A,N/A,988,997,N/A,38,0
38,N/A,N/A,N/A,950,988,N/A,43,5
38,N/A,N/A,N/A,912,950,N/A,49,5
37,N/A,N/A,N/A,875,912,N/A,55,5
30,N/A,N/A,N/A,845,875,N/A,60,4
15,N/A,N/A,N/A,830,845,N/A,64,2
10,N/A,N/A,N/A,820,830,N/A,69,1
32,N/A,N/A,N/A,788,820,N/A,72,4
16,N/A,N/A,N/A,772,788,N/A,76,2
11,N/A,N/A,N/A,761,772,N/A,81,1
22,N/A,N/A,N/A,739,761,N/A,84,4
8,N/A,N/A,N/A,731,739,N/A,87,1
12,N/A,N/A,N/A,719,731,N/A,93,1
31,N/A,N/A,N/A,688,719,N/A,96,4
19,N/A,N/A,N/A,669,688,N/A,101,3
13,N/A,N/A,N/A,656,669,N/A,106,2
35,N/A,N/A,N/A,621,656,N/A,109,5
12,N/A,N/A,N/A,609,621,N/A,112,2
35,N/A,N/A,N/A,574,609,N/A,115,5
33,N/A,N/A,N/A,541,574,N/A,121,5
30,N/A,N/A,N/A,511,541,N/A,126,4
11,N/A,N/A,N/A,500,511,N/A,129,1
23,N/A,N/A,N/A,1575,1598,N/A,5,4
7,N/A,N/A,N/A,1568,1575,N/A,8,1
30,N/A,N/A,N/A,1538,1568,N/A,11,4
24,N/A,N/A,N/A,1514,1538,N/A,17,4
14,N/A,N/A,N/A,1500,1514,N/A,21,2
13,N/A,N/A,N/A,1487,1500,N/A,26,1
24,N/A,N/A,N/A,1463,1487,N/A,29,4
29,N/A,N/A,N/A,1434,1463,N/A,35,4
26,N/A,N/A,N/A,1408,1434,N/A,41,4
27,N/A,N/A,N/A,1381,1408,N/A,47,4
18,N/A,N/A,N/A,1363,1381,N/A,52,3
41,N/A,N/A,N/A,1322,1363,N/A,55,6
7,N/A,N/A,N/A,1315,1322,N/A,61,0
15,N/A,N/A,N/A,1300,1315,N/A,64,3
20,N/A,N/A,N/A,1280,1300,N/A,70,3
16,N/A,N/A,N/A,1264,1280,N/A,75,2
37,N/A,N/A,N/A,1227,1264,N/A,78,5
36,N/A,N/A,N/A,1191,1227,N/A,84,5
14,N/A,N/A,N/A,1177,1191,N/A,88,3
17,N/A,N/A,N/A,1160,1177,N/A,93,2
37,N/A,N/A,N/A,1123,1160,N/A,96,5
11,N/A,N/A,N/A,1112,1123,N/A,99,2
14,N/A,N/A,N/A,1098,1112,N/A,104,1
34,N/A,N/A,N/A,1064,1098,N/A,108,5
10,N/A,N/A,N/A,1054,1064,N/A,111,2
10,N/A,N/A,N/A,1044,1054,N/A,117,2
13,N/A,N/A,N/A,1031,1044,N/A,123,2
44,N/A,N/A,N/A,987,1031,N/A,127,6
26,N/A,N/A,N/A,961,987,N/A,131,4
17,N/A,N/A,N/A,944,961,N/A,136,3
11,N/A,N/A,N/A,1955,1966,N/A,5,2
15,N/A,N/A,N/A,1940,1955,N/A,11,2
34,N/A,N/A,N/A,1906,1940,N/A,14,5
36,N/A,N/A,N/A,1870,1906,N/A,20,5
34,N/A,N/A,N/A,1836,1870,N/A,26,5
15,N/A,N/A,N/A,1821,1836,N/A,29,2
41,N/A,N/A,N/A,1780,1821,N/A,33,6
9,N/A,N/A,N/A,1771,1780,N/A,39,0
41,N/A,N/A,N/A,1730,1771,N/A,45,6
28,N/A,N/A,N/A,1702,1730,N/A,49,4
29,N/A,N/A,N/A,1673,1702,N/A,55,4
11,N/A,N/A,N/A,1662,1673,N/A,58,1
43,N/A,N/A,N/A,1619,1662,N/A,63,6
6,N/A,N/A,N/A,1613,1619,N/A,69,0
17,N/A,N/A,N/A,1596,1613,N/A,72,3
17,N/A,N/A,N/A,1579,1596,N/A,77,2
9,N/A,N/A,N/A,1570,1579,N/A,82,1
9,N/A,N/A,N/A,1561,1570,N/A,88,1
42,N/A,N/A,N/A,1519,1561,N/A,93,6
25,N/A,N/A,N/A,1494,1519,N/A,97,4
28,N/A,N/A,N/A,1466,1494,N/A,103,4
12,N/A,N/A,N/A,1454,1466,N/A,106,1
14,N/A,N/A,N/A,1440,1454,N/A,112,1
37,N/A,N/A,N/A,1403,1440,N/A,116,5
29,N/A,N/A,N/A,1374,1403,N/A,121,4
10,N/A,N/A,N/A,1364,1374,N/A,125,2
10,N/A,N/A,N/A,1354,1364,N/A,131,2
36,N/A,N/A,N/A,1318,1354,N/A,134,5
27,N/A,N/A,N/A,1291,1318,N/A,139,4
29,N/A,N/A,N/A,1262,1291,N/A,145,4
10,N/A,N/A,N/A,779,789,N/A,3,1
12,N/A,N/A,N/A,767,779,N/A,9,1
8,N/A,N/A,N/A,759,767,N/A,15,1
38,N/A,N/A,N/A,721,759,N/A,19,5
17,N/A,N/A,N/A,704,721,N/A,23,3
16,N/A,N/A,N/A,688,704,N/A,29,3
12,N/A,N/A,N/A,676,688,N/A,33,1
11,N/A,N/A,N/A,665,676,N/A,39,1
42,N/A,N/A,N/A,623,665,N/A,44,6
33,N/A,N/A,N/A,590,623,N/A,49,5
26,N/A,N/A,N/A,564,590,N/A,54,4
31,N/A,N/A,N/A,533,564,N/A,60,4
10,N/A,N/A,N/A,523,533,N/A,64,2
14,N/A,N/A,N/A,509,523,N/A,70,2
43,N/A,N/A,N/A,466,509,N/A,74,6
32,N/A,N/A,N/A,434,466,N/A,79,5
16,N/A,N/A,N/A,418,434,N/A,82,2
13,N/A,N/A,N/A,405,418,N/A,87,1
37,N/A,N/A,N/A,368,405,N/A,91,5
11,N/A,N/A,N/A,357,368,N/A,94,2
42,N/A,N/A,N/A,315,357,N/A,98,6
25,N/A,N/A,N/A,290,315,N/A,102,4
28,N/A,N/A,N/A,262,290,N/A,108,4
10,N/A,N/A,N/A,252,262,N/A,111,1
22,N/A,N/A,N/A,230,252,N/A,114,4
11,N/A,N/A,N/A,219,230,N/A,117,1
44,N/A,N/A,N/A,175,219,N/A,122,6
28,N/A,N/A,N/A,147,175,N/A,126,4
23,N/A,N/A,N/A,124,147,N/A,131,3
42,N/A,N/A,N/A,82,124,N/A,134,6
24,N/A,N/A,N/A,1138,1162,N/A,4,4
21,N/A,N/A,N/A,1117,1138,N/A,9,3
23,N/A,N/A,N/A,1094,1117,N/A,15,3
16,N/A,N/A,N/A,1078,1094,N/A,20,2
11,N/A,N/A,N/A,1067,1078,N/A,26,2
41,N/A,N/A,N/A,1026,1067,N/A,30,6
7,N/A,N/A,N/A,1019,1026,N/A,36,0
42,N/A,N/A,N/A,977,1019,N/A,42,6
23,N/A,N/A,N/A,954,977,N/A,45,3
13,N/A,N/A,N/A,941,954,N/A,49,1
39,N/A,N/A,N/A,902,941,N/A,53,5
17,N/A,N/A,N/A,885,902,N/A,56,2
10,N/A,N/A,N/A,875,885,N/A,61,1
27,N/A,N/A,N/A,848,875,N/A,64,4
27,N/A,N/A,N/A,821,848,N/A,70,4
11,N/A,N/A,N/A,810,821,N/A,73,1
43,N/A,N/A,N/A,767,810,N/A,78,6
33,N/A,N/A,N/A,734,767,N/A,83,5
17,N/A,N/A,N/A,717,734,N/A,87,3
14,N/A,N/A,N/A,703,717,N/A,93,3
16,N/A,N/A,N/A,687,703,N/A,98,2
12,N/A,N/A,N/A,675,687,N/A,103,1
22,N/A,N/A,N/A,653,675,N/A,106,4
15,N/A,N/A,N/A,638,653,N/A,111,3
17,N/A,N/A,N/A,621,638,N/A,117,3
13,N/A,N/A,N/A,608,621,N/A,122,2
9,N/A,N/A,N/A,599,608,N/A,127,1
32,N/A,N/A,N/A,567,599,N/A,130,4
14,N/A,N/A,N/A,553,567,N/A,135,3
21,N/A,N/A,N/A,532,553,N/A,141,3
20,N/A,N/A,N/A,1445,1465,N/A,3,3
14,N/A,N/A,N/A,1431,1445,N/A,7,1
8,N/A,N/A,N/A,1423,1431,N/A,13,1
11,N/A,N/A,N/A,1412,1423,N/A,19,1
28,N/A,N/A,N/A,1384,1412,N/A,22,4
16,N/A,N/A,N/A,1368,1384,N/A,26,2
17,N/A,N/A,N/A,1351,1368,N/A,32,2
14,N/A,N/A,N/A,1337,1351,N/A,37,1
43,N/A,N/A,N/A,1294,1337,N/A,42,6
37,N/A,N/A,N/A,1257,1294,N/A,47,5
35,N/A,N/A,N/A,1222,1257,N/A,53,5
29,N/A,N/A,N/A,1193,1222,N/A,58,4
20,N/A,N/A,N/A,1173,1193,N/A,63,3
20,N/A,N/A,N/A,1153,1173,N/A,69,3
10,N/A,N/A,N/A,1143,1153,N/A,73,1
43,N/A,N/A,N/A,1100,1143,N/A,78,6
38,N/A,N/A,N/A,1062,1100,N/A,83,5
28,N/A,N/A,N/A,1034,1062,N/A,88,4
32,N/A,N/A,N/A,1002,1034,N/A,94,4
31,N/A,N/A,N/A,971,1002,N/A,100,4
30,N/A,N/A,N/A,941,971,N/A,106,4
7,N/A,N/A,N/A,934,941,N/A,109,1
37,N/A,N/A,N/A,897,934,N/A,113,5
11,N/A,N/A,N/A,886,897,N/A,116,2
13,N/A,N/A,N/A,873,886,N/A,122,2
43,N/A,N/A,N/A,830,873,N/A,126,6
17,N/A,N/A,N/A,813,830,N/A,129,3
42,N/A,N/A,N/A,771,813,N/A,132,6
6,N/A,N/A,N/A,765,771,N/A,138,0
41,N/A,N/A,N/A,724,765,N/A,144,6
30,N/A,N/A,N/A,789,819,N/A,3,4
13,N/A,N/A,N/A,776,789,N/A,7,2
39,N/A,N/A,N/A,737,776,N/A,10,5
38,N/A,N/A,N/A,699,737,N/A,16,5
29,N/A,N/A,N/A,670,699,N/A,21,4
32,N/A,N/A,N/A,638,670,N/A,27,4
8,N/A,N/A,N/A,630,638,N/A,30,1
14,N/A,N/A,N/A,616,630,N/A,36,1
43,N/A,N/A,N/A,573,616,N/A,41,6
22,N/A,N/A,N/A,551,573,N/A,44,3
11,N/A,N/A,N/A,540,551,N/A,48,1
27,N/A,N/A,N/A,513,540,N/A,51,4
10,N/A,N/A,N/A,503,513,N/A,54,1
14,N/A,N/A,N/A,489,503,N/A,60,1
42,N/A,N/A,N/A,447,489,N/A,65,6
36,N/A,N/A,N/A,411,447,N/A,70,5
32,N/A,N/A,N/A,379,411,N/A,75,4
7,N/A,N/A,N/A,372,379,N/A,78,1
10,N/A,N/A,N/A,362,372,N/A,84,1
7,N/A,N/A,N/A,355,362,N/A,90,1
26,N/A,N/A,N/A,329,355,N/A,93,4
21,N/A,N/A,N/A,308,329,N/A,98,3
14,N/A,N/A,N/A,294,308,N/A,103,2
41,N/A,N/A,N/A,253,294,N/A,107,6
27,N/A,N/A,N/A,226,253,N/A,111,4
17,N/A,N/A,N/A,209,226,N/A,115,2
38,N/A,N/A,N/A,171,209,N/A,118,5
39,N/A,N/A,N/A,132,171,N/A,124,5
39,N/A,N/A,N/A,93,132,N/A,130,5
19,N/A,N/A,N/A,74,93,N/A,134,3
14,N/A,N/A,N/A,1704,1718,N/A,3,1
39,N/A,N/A,N/A,1665,1704,N/A,7,5
29,N/A,N/A,N/A,1636,1665,N/A,12,4
12,N/A,N/A,N/A,1624,1636,N/A,16,2
13,N/A,N/A,N/A,1611,1624,N/A,21,1
23,N/A,N/A,N/A,1588,1611,N/A,24,4
20,N/A,N/A,N/A,1568,1588,N/A,29,3
13,N/A,N/A,N/A,1555,1568,N/A,33,1
44,N/A,N/A,N/A,1511,1555,N/A,38,6
20,N/A,N/A,N/A,1491,1511,N/A,41,3
13,N/A,N/A,N/A,1478,1491,N/A,45,1
44,N/A,N/A,N/A,1434,1478,N/A,50,6
20,N/A,N/A,N/A,1414,1434,N/A,53,3
42,N/A,N/A,N/A,1372,1414,N/A,56,6
37,N/A,N/A,N/A,1335,1372,N/A,61,5
29,N/A,N/A,N/A,1306,1335,N/A,66,4
10,N/A,N/A,N/A,1296,1306,N/A,70,2
10,N/A,N/A,N/A,1286,1296,N/A,76,2
8,N/A,N/A,N/A,1278,1286,N/A,81,1
13,N/A,N/A,N/A,1265,1278,N/A,87,1
35,N/A,N/A,N/A,1230,1265,N/A,91,5
16,N/A,N/A,N/A,1214,1230,N/A,94,2
15,N/A,N/A,N/A,1199,1214,N/A,100,2
10,N/A,N/A,N/A,1189,1199,N/A,106,2
15,N/A,N/A,N/A,1174,1189,N/A,112,2
9,N/A,N/A,N/A,1165,1174,N/A,117,1
43,N/A,N/A,N/A,1122,1165,N/A,122,6
32,N/A,N/A,N/A,1090,1122,N/A,127,5
18,N/A,N/A,N/A,1072,1090,N/A,131,3
15,N/A,N/A,N/A,1057,1072,N/A,137,3
12,N/A,N/A,N/A,292,304,N/A,4,1
28,N/A,N/A,N/A,264,292,N/A,7,4
10,N/A,N/A,N/A,254,264,N/A,11,2
33,N/A,N/A,N/A,221,254,N/A,14,5
18,N/A,N/A,N/A,203,221,N/A,18,3
41,N/A,N/A,N/A,162,203,N/A,21,6
9,N/A,N/A,N/A,153,162,N/A,27,0
19,N/A,N/A,N/A,134,153,N/A,30,3
15,N/A,N/A,N/A,119,134,N/A,36,3
42,N/A,N/A,N/A,77,119,N/A,39,6
32,N/A,N/A,N/A,45,77,N/A,44,5
38,N/A,N/A,N/A,7,45,N/A,50,5
38,N/A,N/A,N/A,-31,7,N/A,56,5
24,N/A,N/A,N/A,1878,1902,N/A,5,4
27,N/A,N/A,N/A,1851,1878,N/A,11,4
32,N/A,N/A,N/A,1819,1851,N/A,17,4
28,N/A,N/A,N/A,1791,1819,N/A,23,4
14,N/A,N/A,N/A,1777,1791,N/A,27,2
14,N/A,N/A,N/A,1763,1777,N/A,33,2
41,N/A,N/A,N/A,1722,1763,N/A,37,6
18,N/A,N/A,N/A,1704,1722,N/A,40,3
16,N/A,N/A,N/A,1688,1704,N/A,45,2
9,N/A,N/A,N/A,1679,1688,N/A,50,1
14,N/A,N/A,N/A,1665,1679,N/A,56,1
43,N/A,N/A,N/A,1622,1665,N/A,61,6
31,N/A,N/A,N/A,1591,1622,N/A,65,4
12,N/A,N/A,N/A,1579,1591,N/A,68,1
33,N/A,N/A,N/A,1546,1579,N/A,72,5
25,N/A,N/A,N/A,1521,1546,N/A,77,4
8,N/A,N/A,N/A,1513,1521,N/A,80,1
44,N/A,N/A,N/A,1469,1513,N/A,85,6
7,N/A,N/A,N/A,1462,1469,N/A,91,0
42,N/A,N/A,N/A,1420,1462,N/A,97,6
35,N/A,N/A,N/A,1385,1420,N/A,102,5
17,N/A,N/A,N/A,1368,1385,N/A,105,2
43,N/A,N/A,N/A,1325,1368,N/A,109,6
39,N/A,N/A,N/A,1286,1325,N/A,114,5
21,N/A,N/A,N/A,1265,1286,N/A,118,3
7,N/A,N/A,N/A,1258,1265,N/A,122,1
41,N/A,N/A,N/A,1217,1258,N/A,127,6
23,N/A,N/A,N/A,1194,1217,N/A,130,3
41,N/A,N/A,N/A,1153,1194,N/A,133,6
8,N/A,N/A,N/A,1145,1153,N/A,139,0
27,N/A,N/A,N/A,1659,1686,N/A,3,4
12,N/A,N/A,N/A,1647,1659,N/A,6,1
43,N/A,N/A,N/A,1604,1647,N/A,11,6
39,N/A,N/A,N/A,1565,1604,N/A,16,5
22,N/A,N/A,N/A,1543,1565,N/A,21,4
8,N/A,N/A,N/A,1535,1543,N/A,24,1
41,N/A,N/A,N/A,1494,1535,N/A,29,6
21,N/A,N/A,N/A,1473,1494,N/A,32,3
12,N/A,N/A,N/A,1461,1473,N/A,37,2
11,N/A,N/A,N/A,1450,1461,N/A,42,1
43,N/A,N/A,N/A,1407,1450,N/A,47,6
9,N/A,N/A,N/A,1398,1407,N/A,53,0
17,N/A,N/A,N/A,1381,1398,N/A,56,3
21,N/A,N/A,N/A,1360,1381,N/A,62,3
41,N/A,N/A,N/A,1319,1360,N/A,65,6
29,N/A,N/A,N/A,1290,1319,N/A,69,4
17,N/A,N/A,N/A,1273,1290,N/A,73,2
13,N/A,N/A,N/A,1260,1273,N/A,78,1
14,N/A,N/A,N/A,1246,1260,N/A,84,1
32,N/A,N/A,N/A,1214,1246,N/A,88,5
34,N/A,N/A,N/A,1180,1214,N/A,94,5
13,N/A,N/A,N/A,1167,1180,N/A,97,2
41,N/A,N/A,N/A,1126,1167,N/A,101,6
20,N/A,N/A,N/A,1106,1126,N/A,104,3
19,N/A,N/A,N/A,1087,1106,N/A,110,3
7,N/A,N/A,N/A,1080,1087,N/A,114,1
42,N/A,N/A,N/A,1038,1080,N/A,119,6
8,N/A,N/A,N/A,1030,1038,N/A,125,0
20,N/A,N/A,N/A,1010,1030,N/A,128,3
15,N/A,N/A,N/A,995,1010,N/A,134,3
16,N/A,N/A,N/A,993,1009,N/A,4,2
33,N/A,N/A,N/A,960,993,N/A,7,5
16,N/A,N/A,N/A,944,960,N/A,10,2
11,N/A,N/A,N/A,933,944,N/A,15,1
39,N/A,N/A,N/A,894,933,N/A,19,5
12,N/A,N/A,N/A,882,894,N/A,22,2
10,N/A,N/A,N/A,872,882,N/A,27,1
42,N/A,N/A,N/A,830,872,N/A,32,6
8,N/A,N/A,N/A,822,830,N/A,38,0
17,N/A,N/A,N/A,805,822,N/A,41,3
9,N/A,N/A,N/A,796,805,N/A,45,1
23,N/A,N/A,N/A,773,796,N/A,48,4
15,N/A,N/A,N/A,758,773,N/A,52,2
7,N/A,N/A,N/A,751,758,N/A,57,1
9,N/A,N/A,N/A,742,751,N/A,63,1
43,N/A,N/A,N/A,699,742,N/A,68,6
9,N/A,N/A,N/A,690,699,N/A,74,0
29,N/A,N/A,N/A,661,690,N/A,78,4
16,N/A,N/A,N/A,645,661,N/A,82,2
35,N/A,N/A,N/A,610,645,N/A,85,5
23,N/A,N/A,N/A,587,610,N/A,89,3
16,N/A,N/A,N/A,571,587,N/A,94,2
17,N/A,N/A,N/A,554,571,N/A,100,2
44,N/A,N/A,N/A,510,554,N/A,104,6
27,N/A,N/A,N/A,483,510,N/A,108,4
15,N/A,N/A,N/A,468,483,N/A,113,3
43,N/A,N/A,N/A,425,468,N/A,116,6
32,N/A,N/A,N/A,393,425,N/A,120,4
29,N/A,N/A,N/A,364,393,N/A,126,4
7,N/A,N/A,N/A,357,364,N/A,129,1
14,N/A,N/A,N/A,1271,1285,N/A,6,1
44,N/A,N/A,N/A,1227,1271,N/A,11,6
29,N/A,N/A,N/A,1198,1227,N/A,15,4
29,N/A,N/A,N/A,1169,1198,N/A,21,4
10,N/A,N/A,N/A,1159,1169,N/A,24,1
38,N/A,N/A,N/A,1121,1159,N/A,28,5
23,N/A,N/A,N/A,1098,1121,N/A,33,4
15,N/A,N/A,N/A,1083,1098,N/A,38,3
8,N/A,N/A,N/A,1075,1083,N/A,42,1
12,N/A,N/A,N/A,1063,1075,N/A,48,1
24,N/A,N/A,N/A,1039,1063,N/A,51,4
29,N/A,N/A,N/A,1010,1039,N/A,57,4
14,N/A,N/A,N/A,996,1010,N/A,61,2
9,N/A,N/A,N/A,987,996,N/A,66,1
23,N/A,N/A,N/A,964,987,N/A,69,4
8,N/A,N/A,N/A,956,964,N/A,72,1
8,N/A,N/A,N/A,948,956,N/A,78,1
41,N/A,N/A,N/A,907,948,N/A,83,6
32,N/A,N/A,N/A,875,907,N/A,88,5
36,N/A,N/A,N/A,839,875,N/A,94,5
34,N/A,N/A,N/A,805,839,N/A,100,5
23,N/A,N/A,N/A,782,805,N/A,104,3
44,N/A,N/A,N/A,738,782,N/A,107,6
7,N/A,N/A,N/A,731,738,N/A,113,0
16,N/A,N/A,N/A,715,731,N/A,116,3
18,N/A,N/A,N/A,697,715,N/A,122,3
15,N/A,N/A,N/A,682,697,N/A,127,2
33,N/A,N/A,N/A,649,682,N/A,130,5
36,N/A,N/A,N/A,613,649,N/A,136,5
27,N/A,N/A,N/A,586,613,N/A,141,4
12,N/A,N/A,N/A,834,846,N/A,4,2
32,N/A,N/A,N/A,802,834,N/A,7,5
15,N/A,N/A,N/A,787,802,N/A,10,2
14,N/A,N/A,N/A,773,787,N/A,16,2
35,N/A,N/A,N/A,738,773,N/A,19,5
37,N/A,N/A,N/A,701,738,N/A,25,5
23,N/A,N/A,N/A,678,701,N/A,29,3
13,N/A,N/A,N/A,665,678,N/A,34,2
14,N/A,N/A,N/A,651,665,N/A,40,2
42,N/A,N/A,N/A,609,651,N/A,44,6
26,N/A,N/A,N/A,583,609,N/A,48,4
19,N/A,N/A,N/A,564,583,N/A,53,3
8,N/A,N/A,N/A,556,564,N/A,57,1
43,N/A,N/A,N/A,513,556,N/A,62,6
28,N/A,N/A,N/A,485,513,N/A,66,4
14,N/A,N/A,N/A,471,485,N/A,70,2
14,N/A,N/A,N/A,457,471,N/A,76,2
41,N/A,N/A,N/A,416,457,N/A,80,6
25,N/A,N/A,N/A,391,416,N/A,84,4
15,N/A,N/A,N/A,376,391,N/A,89,3
41,N/A,N/A,N/A,335,376,N/A,92,6
36,N/A,N/A,N/A,299,335,N/A,97,5
38,N/A,N/A,N/A,261,299,N/A,103,5
36,N/A,N/A,N/A,225,261,N/A,109,5
32,N/A,N/A,N/A,193,225,N/A,114,4
28,N/A,N/A,N/A,165,193,N/A,120,4
22,N/A,N/A,N/A,143,165,N/A,126,4
21,N/A,N/A,N/A,122,143,N/A,131,3
10,N/A,N/A,N/A,112,122,N/A,136,2
41,N/A,N/A,N/A,71,112,N/A,140,6
15,N/A,N/A,N/A,1099,1114,N/A,5,3
23,N/A,N/A,N/A,1076,1099,N/A,11,3
41,N/A,N/A,N/A,1035,1076,N/A,14,6
33,N/A,N/A,N/A,1002,1035,N/A,19,5
36,N/A,N/A,N/A,966,1002,N/A,25,5
23,N/A,N/A,N/A,943,966,N/A,29,3
19,N/A,N/A,N/A,924,943,N/A,35,3
14,N/A,N/A,N/A,910,924,N/A,39,1
23,N/A,N/A,N/A,887,910,N/A,42,4
16,N/A,N/A,N/A,871,887,N/A,47,3
17,N/A,N/A,N/A,854,871,N/A,53,3
14,N/A,N/A,N/A,840,854,N/A,59,3
14,N/A,N/A,N/A,826,840,N/A,65,3
44,N/A,N/A,N/A,782,826,N/A,68,6
17,N/A,N/A,N/A,765,782,N/A,71,3
11,N/A,N/A,N/A,754,765,N/A,76,2
13,N/A,N/A,N/A,741,754,N/A,82,2
39,N/A,N/A,N/A,702,741,N/A,85,5
32,N/A,N/A,N/A,670,702,N/A,90,4
12,N/A,N/A,N/A,658,670,N/A,93,1
7,N/A,N/A,N/A,651,658,N/A,99,1
41,N/A,N/A,N/A,610,651,N/A,104,6
30,N/A,N/A,N/A,580,610,N/A,108,4
27,N/A,N/A,N/A,553,580,N/A,114,4
18,N/A,N/A,N/A,535,553,N/A,119,3
12,N/A,N/A,N/A,523,535,N/A,124,2
35,N/A,N/A,N/A,488,523,N/A,127,5
26,N/A,N/A,N/A,462,488,N/A,132,4
16,N/A,N/A,N/A,446,462,N/A,137,3
8,N/A,N/A,N/A,438,446,N/A,141,1
10,N/A,N/A,N/A,1689,1699,N/A,6,2
43,N/A,N/A,N/A,1646,1689,N/A,10,6
6,N/A,N/A,N/A,1640,1646,N/A,16,0
25,N/A,N/A,N/A,1615,1640,N/A,20,4
22,N/A,N/A,N/A,1593,1615,N/A,25,3
41,N/A,N/A,N/A,1552,1593,N/A,28,6
25,N/A,N/A,N/A,1527,1552,N/A,32,4
12,N/A,N/A,N/A,1515,1527,N/A,36,2
41,N/A,N/A,N/A,1474,1515,N/A,40,6
8,N/A,N/A,N/A,1466,1474,N/A,46,0
16,N/A,N/A,N/A,1450,1466,N/A,49,3
15,N/A,N/A,N/A,1435,1450,N/A,54,2
42,N/A,N/A,N/A,1393,1435,N/A,58,6
19,N/A,N/A,N/A,1374,1393,N/A,61,3
10,N/A,N/A,N/A,1364,1374,N/A,65,1
27,N/A,N/A,N/A,1337,1364,N/A,68,4
20,N/A,N/A,N/A,1317,1337,N/A,73,3
14,N/A,N/A,N/A,1303,1317,N/A,77,1
10,N/A,N/A,N/A,1293,1303,N/A,83,1
44,N/A,N/A,N/A,1249,1293,N/A,88,6
24,N/A,N/A,N/A,1225,1249,N/A,92,4
10,N/A,N/A,N/A,1215,1225,N/A,96,2
12,N/A,N/A,N/A,1203,1215,N/A,101,1
43,N/A,N/A,N/A,1160,1203,N/A,106,6
17,N/A,N/A,N/A,1143,1160,N/A,109,3
15,N/A,N/A,N/A,1128,1143,N/A,115,3
42,N/A,N/A,N/A,1086,1128,N/A,118,6
9,N/A,N/A,N/A,1077,1086,N/A,124,0
31,N/A,N/A,N/A,1046,1077,N/A,128,4
17,N/A,N/A,N/A,1029,1046,N/A,132,2
15,N/A,N/A,N/A,1793,1808,N/A,4,2
14,N/A,N/A,N/A,1779,1793,N/A,10,2
41,N/A,N/A,N/A,1738,1779,N/A,14,6
7,N/A,N/A,N/A,1731,1738,N/A,20,0
32,N/A,N/A,N/A,1699,1731,N/A,24,4
12,N/A,N/A,N/A,1687,1699,N/A,28,2
42,N/A,N/A,N/A,1645,1687,N/A,32,6
34,N/A,N/A,N/A,1611,1645,N/A,37,5
35,N/A,N/A,N/A,1576,1611,N/A,43,5
34,N/A,N/A,N/A,1542,1576,N/A,49,5
29,N/A,N/A,N/A,1513,1542,N/A,54,4
17,N/A,N/A,N/A,1496,1513,N/A,59,3
10,N/A,N/A,N/A,1486,1496,N/A,64,2
37,N/A,N/A,N/A,1449,1486,N/A,67,5
30,N/A,N/A,N/A,1419,1449,N/A,72,4
12,N/A,N/A,N/A,1407,1419,N/A,76,2
11,N/A,N/A,N/A,1396,1407,N/A,81,1
22,N/A,N/A,N/A,1374,1396,N/A,84,4
28,N/A,N/A,N/A,1346,1374,N/A,90,4
13,N/A,N/A,N/A,1333,1346,N/A,93,1
10,N/A,N/A,N/A,1323,1333,N/A,99,1
11,N/A,N/A,N/A,1312,1323,N/A,105,1
41,N/A,N/A,N/A,1271,1312,N/A,110,6
9,N/A,N/A,N/A,1262,1271,N/A,116,0
43,N/A,N/A,N/A,1219,1262,N/A,122,6
9,N/A,N/A,N/A,1210,1219,N/A,128,0
32,N/A,N/A,N/A,1178,1210,N/A,133,5
34,N/A,N/A,N/A,1144,1178,N/A,139,5
24,N/A,N/A,N/A,1120,1144,N/A,144,4
22,N/A,N/A,N/A,1098,1120,N/A,149,3
22,N/A,N/A,N/A,1593,1615,N/A,5,3
11,N/A,N/A,N/A,1582,1593,N/A,9,1
34,N/A,N/A,N/A,1548,1582,N/A,13,5
33,N/A,N/A,N/A,1515,1548,N/A,19,5
24,N/A,N/A,N/A,1491,1515,N/A,24,4
9,N/A,N/A,N/A,1482,1491,N/A,27,1
7,N/A,N/A,N/A,1475,1482,N/A,33,1
27,N/A,N/A,N/A,1448,1475,N/A,36,4
24,N/A,N/A,N/A,1424,1448,N/A,42,4
11,N/A,N/A,N/A,1413,1424,N/A,45,1
32,N/A,N/A,N/A,1381,1413,N/A,48,4
32,N/A,N/A,N/A,1349,1381,N/A,54,4
23,N/A,N/A,N/A,1326,1349,N/A,60,4
7,N/A,N/A,N/A,1319,1326,N/A,63,1
42,N/A,N/A,N/A,1277,1319,N/A,68,6
9,N/A,N/A,N/A,1268,1277,N/A,74,0
32,N/A,N/A,N/A,1236,1268,N/A,79,5
36,N/A,N/A,N/A,1200,1236,N/A,85,5
22,N/A,N/A,N/A,1178,1200,N/A,90,4
17,N/A,N/A,N/A,1161,1178,N/A,95,3
22,N/A,N/A,N/A,1139,1161,N/A,101,3
13,N/A,N/A,N/A,1126,1139,N/A,105,1
31,N/A,N/A,N/A,1095,1126,N/A,108,4
16,N/A,N/A,N/A,1079,1095,N/A,112,2
10,N/A,N/A,N/A,1069,1079,N/A,117,1
32,N/A,N/A,N/A,1037,1069,N/A,121,5
30,N/A,N/A,N/A,1007,1037,N/A,126,4
8,N/A,N/A,N/A,999,1007,N/A,129,1
39,N/A,N/A,N/A,960,999,N/A,133,5
23,N/A,N/A,N/A,937,960,N/A,138,4
10,N/A,N/A,N/A,433,443,N/A,6,2
13,N/A,N/A,N/A,420,433,N/A,11,1
7,N/A,N/A,N/A,413,420,N/A,17,1
44,N/A,N/A,N/A,369,413,N/A,22,6
27,N/A,N/A,N/A,342,369,N/A,26,4
13,N/A,N/A,N/A,329,342,N/A,29,1
44,N/A,N/A,N/A,285,329,N/A,34,6
39,N/A,N/A,N/A,246,285,N/A,39,5
37,N/A,N/A,N/A,209,246,N/A,45,5
32,N/A,N/A,N/A,177,209,N/A,51,5
11,N/A,N/A,N/A,166,177,N/A,54,2
9,N/A,N/A,N/A,157,166,N/A,59,1
23,N/A,N/A,N/A,134,157,N/A,62,4
8,N/A,N/A,N/A,126,134,N/A,65,1
25,N/A,N/A,N/A,101,126,N/A,68,4
9,N/A,N/A,N/A,92,101,N/A,71,1
9,N/A,N/A,N/A,83,92,N/A,77,1
32,N/A,N/A,N/A,51,83,N/A,80,4
9,N/A,N/A,N/A,42,51,N/A,83,1
29,N/A,N/A,N/A,13,42,N/A,86,4
13,N/A,N/A,N/A,0,13,N/A,89,1
13,N/A,N/A,N/A,1977,1990,N/A,4,2
8,N/A,N/A,N/A,1969,1977,N/A,9,1
14,N/A,N/A,N/A,1955,1969,N/A,15,1
7,N/A,N/A,N/A,1948,1955,N/A,21,1
29,N/A,N/A,N/A,1919,1948,N/A,24,4
26,N/A,N/A,N/A,1893,1919,N/A,30,4
19,N/A,N/A,N/A,1874,1893,N/A,35,3
43,N/A,N/A,N/A,1831,1874,N/A,38,6
8,N/A,N/A,N/A,1823,1831,N/A,44,0
44,N/A,N/A,N/A,1779,1823,N/A,50,6
38,N/A,N/A,N/A,1741,1779,N/A,55,5
34,N/A,N/A,N/A,1707,1741,N/A,61,5
15,N/A,N/A,N/A,1692,1707,N/A,65,3
22,N/A,N/A,N/A,1670,1692,N/A,71,3
43,N/A,N/A,N/A,1627,1670,N/A,74,6
31,N/A,N/A,N/A,1596,1627,N/A,78,4
19,N/A,N/A,N/A,1577,1596,N/A,83,3
42,N/A,N/A,N/A,1535,1577,N/A,86,6
18,N/A,N/A,N/A,1517,1535,N/A,89,3
43,N/A,N/A,N/A,1474,1517,N/A,92,6
5,N/A,N/A,N/A,1469,1474,N/A,98,0
22,N/A,N/A,N/A,1447,1469,N/A,102,4
21,N/A,N/A,N/A,1426,1447,N/A,107,3
14,N/A,N/A,N/A,1412,1426,N/A,111,1
23,N/A,N/A,N/A,1389,1412,N/A,114,4
25,N/A,N/A,N/A,1364,1389,N/A,120,4
30,N/A,N/A,N/A,1334,1364,N/A,126,4
10,N/A,N/A,N/A,1324,1334,N/A,129,1
10,N/A,N/A,N/A,1314,1324,N/A,135,1
35,N/A,N/A,N/A,1279,1314,N/A,139,5
16,N/A,N/A,N/A,1111,1127,N/A,5,3
42,N/A,N/A,N/A,1069,1111,N/A,8,6
17,N/A,N/A,N/A,1052,1069,N/A,11,3
14,N/A,N/A,N/A,1038,1052,N/A,17,3
14,N/A,N/A,N/A,1024,1038,N/A,21,1
14,N/A,N/A,N/A,1010,1024,N/A,27,1
43,N/A,N/A,N/A,967,1010,N/A,32,6
8,N/A,N/A,N/A,959,967,N/A,38,0
43,N/A,N/A,N/A,916,959,N/A,44,6
9,N/A,N/A,N/A,907,916,N/A,50,0
16,N/A,N/A,N/A,891,907,N/A,53,3
11,N/A,N/A,N/A,880,891,N/A,58,2
9,N/A,N/A,N/A,871,880,N/A,63,1
44,N/A,N/A,N/A,827,871,N/A,68,6
17,N/A,N/A,N/A,810,827,N/A,71,3
22,N/A,N/A,N/A,788,810,N/A,77,3
43,N/A,N/A,N/A,745,788,N/A,80,6
25,N/A,N/A,N/A,720,745,N/A,84,4
16,N/A,N/A,N/A,704,720,N/A,89,3
15,N/A,N/A,N/A,689,704,N/A,94,2
43,N/A,N/A,N/A,646,689,N/A,98,6
9,N/A,N/A,N/A,637,646,N/A,104,0
41,N/A,N/A,N/A,596,637,N/A,110,6
28,N/A,N/A,N/A,568,596,N/A,114,4
14,N/A,N/A,N/A,554,568,N/A,117,1
28,N/A,N/A,N/A,526,554,N/A,120,4
17,N/A,N/A,N/A,509,526,N/A,124,2
43,N/A,N/A,N/A,466,509,N/A,128,6
31,N/A,N/A,N/A,435,466,N/A,132,4
17,N/A,N/A,N/A,418,435,N/A,137,3
8,N/A,N/A,N/A,917,925,N/A,6,1
42,N/A,N/A,N/A,875,917,N/A,11,6
25,N/A,N/A,N/A,850,875,N/A,15,4
15,N/A,N/A,N/A,835,850,N/A,20,3
17,N/A,N/A,N/A,818,835,N/A,26,3
42,N/A,N/A,N/A,776,818,N/A,29,6
30,N/A,N/A,N/A,746,776,N/A,33,4
22,N/A,N/A,N/A,724,746,N/A,39,4
11,N/A,N/A,N/A,713,724,N/A,43,2
43,N/A,N/A,N/A,670,713,N/A,47,6
36,N/A,N/A,N/A,634,670,N/A,52,5
17,N/A,N/A,N/A,617,634,N/A,55,2
7,N/A,N/A,N/A,610,617,N/A,60,1
29,N/A,N/A,N/A,581,610,N/A,63,4
24,N/A,N/A,N/A,557,581,N/A,69,4
22,N/A,N/A,N/A,535,557,N/A,74,3
14,N/A,N/A,N/A,521,535,N/A,80,3
19,N/A,N/A,N/A,502,521,N/A,86,3
10,N/A,N/A,N/A,492,502,N/A,90,1
31,N/A,N/A,N/A,461,492,N/A,93,4
27,N/A,N/A,N/A,434,461,N/A,99,4
10,N/A,N/A,N/A,424,434,N/A,103,2
44,N/A,N/A,N/A,380,424,N/A,107,6
16,N/A,N/A,N/A,364,380,N/A,110,3
10,N/A,N/A,N/A,354,364,N/A,114,1
28,N/A,N/A,N/A,326,354,N/A,117,4
26,N/A,N/A,N/A,300,326,N/A,123,4
7,N/A,N/A,N/A,293,300,N/A,126,1
44,N/A,N/A,N/A,249,293,N/A,131,6
9,N/A,N/A,N/A,240,249,N/A,137,0
20,N/A,N/A,N/A,1331,1351,N/A,5,3
22,N/A,N/A,N/A,1309,1331,N/A,11,3
41,N/A,N/A,N/A,1268,1309,N/A,14,6
35,N/A,N/A,N/A,1233,1268,N/A,19,5
23,N/A,N/A,N/A,1210,1233,N/A,24,4
26,N/A,N/A,N/A,1184,1210,N/A,30,4
17,N/A,N/A,N/A,1167,1184,N/A,35,3
14,N/A,N/A,N/A,1153,1167,N/A,41,3
8,N/A,N/A,N/A,1145,1153,N/A,45,1
32,N/A,N/A,N/A,1113,1145,N/A,49,5
11,N/A,N/A,N/A,1102,1113,N/A,52,2
17,N/A,N/A,N/A,1085,1102,N/A,58,2
12,N/A,N/A,N/A,1073,1085,N/A,63,1
42,N/A,N/A,N/A,1031,1073,N/A,68,6
32,N/A,N/A,N/A,999,1031,N/A,72,4
14,N/A,N/A,N/A,985,999,N/A,75,1
28,N/A,N/A,N/A,957,985,N/A,78,4
18,N/A,N/A,N/A,939,957,N/A,83,3
11,N/A,N/A,N/A,928,939,N/A,88,2
11,N/A,N/A,N/A,917,928,N/A,93,1
37,N/A,N/A,N/A,880,917,N/A,97,5
11,N/A,N/A,N/A,869,880,N/A,100,2
39,N/A,N/A,N/A,830,869,N/A,103,5
27,N/A,N/A,N/A,803,830,N/A,108,4
16,N/A,N/A,N/A,787,803,N/A,112,2
33,N/A,N/A,N/A,754,787,N/A,115,5
35,N/A,N/A,N/A,719,754,N/A,121,5
23,N/A,N/A,N/A,696,719,N/A,126,4
9,N/A,N/A,N/A,687,696,N/A,129,1
38,N/A,N/A,N/A,649,687,N/A,133,5
15,N/A,N/A,N/A,1975,1990,N/A,3,2
11,N/A,N/A,N/A,1964,1975,N/A,9,2
42,N/A,N/A,N/A,1922,1964,N/A,13,6
30,N/A,N/A,N/A,1892,1922,N/A,17,4
14,N/A,N/A,N/A,1878,1892,N/A,22,3
14,N/A,N/A,N/A,1864,1878,N/A,27,2
10,N/A,N/A,N/A,1854,1864,N/A,32,1
42,N/A,N/A,N/A,1812,1854,N/A,37,6
14,N/A,N/A,N/A,1798,1812,N/A,40,3
23,N/A,N/A,N/A,1775,1798,N/A,46,3
11,N/A,N/A,N/A,1764,1775,N/A,50,1
36,N/A,N/A,N/A,1728,1764,N/A,54,5
19,N/A,N/A,N/A,1709,1728,N/A,58,3
13,N/A,N/A,N/A,1696,1709,N/A,63,2
43,N/A,N/A,N/A,1653,1696,N/A,67,6
32,N/A,N/A,N/A,1621,1653,N/A,72,5
16,N/A,N/A,N/A,1605,1621,N/A,75,2
15,N/A,N/A,N/A,1590,1605,N/A,81,2
11,N/A,N/A,N/A,1579,1590,N/A,86,1
10,N/A,N/A,N/A,1569,1579,N/A,92,1
38,N/A,N/A,N/A,1531,1569,N/A,96,5
21,N/A,N/A,N/A,1510,1531,N/A,100,3
44,N/A,N/A,N/A,1466,1510,N/A,103,6
6,N/A,N/A,N/A,1460,1466,N/A,109,0
19,N/A,N/A,N/A,1441,1460,N/A,112,3
7,N/A,N/A,N/A,1434,1441,N/A,116,1
22,N/A,N/A,N/A,1412,1434,N/A,119,4
10,N/A,N/A,N/A,1402,1412,N/A,122,1
27,N/A,N/A,N/A,1375,1402,N/A,125,4
16,N/A,N/A,N/A,1359,1375,N/A,130,3
10,N/A,N/A,N/A,1370,1380,N/A,4,2
13,N/A,N/A,N/A,1357,1370,N/A,9,1
12,N/A,N/A,N/A,1345,1357,N/A,15,1
14,N/A,N/A,N/A,1331,1345,N/A,21,1
13,N/A,N/A,N/A,1318,1331,N/A,27,1
13,N/A,N/A,N/A,1305,1318,N/A,33,1
31,N/A,N/A,N/A,1274,1305,N/A,36,4
32,N/A,N/A,N/A,1242,1274,N/A,42,4
11,N/A,N/A,N/A,1231,1242,N/A,45,1
26,N/A,N/A,N/A,1205,1231,N/A,48,4
10,N/A,N/A,N/A,1195,1205,N/A,51,1
36,N/A,N/A,N/A,1159,1195,N/A,55,5
39,N/A,N/A,N/A,1120,1159,N/A,61,5
21,N/A,N/A,N/A,1099,1120,N/A,65,3
8,N/A,N/A,N/A,1091,1099,N/A,69,1
32,N/A,N/A,N/A,1059,1091,N/A,73,5
11,N/A,N/A,N/A,1048,1059,N/A,76,2
15,N/A,N/A,N/A,1033,1048,N/A,82,2
41,N/A,N/A,N/A,992,1033,N/A,86,6
22,N/A,N/A,N/A,970,992,N/A,90,4
16,N/A,N/A,N/A,954,970,N/A,95,3
11,N/A,N/A,N/A,943,954,N/A,99,1
33,N/A,N/A,N/A,910,943,N/A,103,5
23,N/A,N/A,N/A,887,910,N/A,107,3
12,N/A,N/A,N/A,875,887,N/A,111,1
27,N/A,N/A,N/A,848,875,N/A,114,4
12,N/A,N/A,N/A,836,848,N/A,118,2
32,N/A,N/A,N/A,804,836,N/A,121,5
16,N/A,N/A,N/A,788,804,N/A,124,2
36,N/A,N/A,N/A,752,788,N/A,127,5
20,N/A,N/A,N/A,1514,1534,N/A,6,3
19,N/A,N/A,N/A,1495,1514,N/A,12,3
7,N/A,N/A,N/A,1488,1495,N/A,16,1
28,N/A,N/A,N/A,1460,1488,N/A,19,4
14,N/A,N/A,N/A,1446,1460,N/A,22,1
26,N/A,N/A,N/A,1420,1446,N/A,25,4
14,N/A,N/A,N/A,1406,1420,N/A,30,3
16,N/A,N/A,N/A,1390,1406,N/A,35,2
9,N/A,N/A,N/A,1381,1390,N/A,40,1
23,N/A,N/A,N/A,1358,1381,N/A,43,4
9,N/A,N/A,N/A,1349,1358,N/A,46,1
7,N/A,N/A,N/A,1342,1349,N/A,52,1
12,N/A,N/A,N/A,1330,1342,N/A,58,1
22,N/A,N/A,N/A,1308,1330,N/A,61,4
13,N/A,N/A,N/A,1295,1308,N/A,65,2
43,N/A,N/A,N/A,1252,1295,N/A,69,6
6,N/A,N/A,N/A,1246,1252,N/A,75,0
18,N/A,N/A,N/A,1228,1246,N/A,78,3
17,N/A,N/A,N/A,1211,1228,N/A,84,3
43,N/A,N/A,N/A,1168,1211,N/A,87,6
19,N/A,N/A,N/A,1149,1168,N/A,90,3
20,N/A,N/A,N/A,1129,1149,N/A,96,3
42,N/A,N/A,N/A,1087,1129,N/A,99,6
17,N/A,N/A,N/A,1070,1087,N/A,102,3
15,N/A,N/A,N/A,1055,1070,N/A,108,3
7,N/A,N/A,N/A,1048,1055,N/A,112,1
34,N/A,N/A,N/A,1014,1048,N/A,116,5
15,N/A,N/A,N/A,999,1014,N/A,119,2
10,N/A,N/A,N/A,989,999,N/A,124,1
14,N/A,N/A,N/A,975,989,N/A,130,1
18,N/A,N/A,N/A,1494,1512,N/A,5,3
44,N/A,N/A,N/A,1450,1494,N/A,8,6
35,N/A,N/A,N/A,1415,1450,N/A,13,5
14,N/A,N/A,N/A,1401,1415,N/A,17,3
44,N/A,N/A,N/A,1357,1401,N/A,20,6
37,N/A,N/A,N/A,1320,1357,N/A,25,5
20,N/A,N/A,N/A,1300,1320,N/A,29,3
19,N/A,N/A,N/A,1281,1300,N/A,35,3
43,N/A,N/A,N/A,1238,1281,N/A,38,6
36,N/A,N/A,N/A,1202,1238,N/A,43,5
14,N/A,N/A,N/A,1188,1202,N/A,47,3
13,N/A,N/A,N/A,1175,1188,N/A,52,2
14,N/A,N/A,N/A,1161,1175,N/A,57,1
32,N/A,N/A,N/A,1129,1161,N/A,60,4
18,N/A,N/A,N/A,1111,1129,N/A,65,3
15,N/A,N/A,N/A,1096,1111,N/A,70,2
17,N/A,N/A,N/A,1079,1096,N/A,76,2
10,N/A,N/A,N/A,1069,1079,N/A,82,2
33,N/A,N/A,N/A,1036,1069,N/A,85,5
38,N/A,N/A,N/A,998,1036,N/A,91,5
14,N/A,N/A,N/A,984,998,N/A,94,2
10,N/A,N/A,N/A,974,984,N/A,100,2
44,N/A,N/A,N/A,930,974,N/A,104,6
5,N/A,N/A,N/A,925,930,N/A,110,0
44,N/A,N/A,N/A,881,925,N/A,116,6
32,N/A,N/A,N/A,849,881,N/A,121,5
39,N/A,N/A,N/A,810,849,N/A,127,5
31,N/A,N/A,N/A,779,810,N/A,132,4
19,N/A,N/A,N/A,760,779,N/A,137,3
14,N/A,N/A,N/A,746,760,N/A,143,3
42,N/A,N/A,N/A,1713,1755,N/A,3,6
38,N/A,N/A,N/A,1675,1713,N/A,8,5
10,N/A,N/A,N/A,1665,1675,N/A,11,2
14,N/A,N/A,N/A,1651,1665,N/A,17,2
15,N/A,N/A,N/A,1636,1651,N/A,23,2
8,N/A,N/A,N/A,1628,1636,N/A,28,1
23,N/A,N/A,N/A,1605,1628,N/A,31,4
22,N/A,N/A,N/A,1583,1605,N/A,36,3
14,N/A,N/A,N/A,1569,1583,N/A,41,2
36,N/A,N/A,N/A,1533,1569,N/A,44,5
16,N/A,N/A,N/A,1517,1533,N/A,48,3
13,N/A,N/A,N/A,1504,1517,N/A,53,2
13,N/A,N/A,N/A,1491,1504,N/A,58,1
35,N/A,N/A,N/A,1456,1491,N/A,62,5
24,N/A,N/A,N/A,1432,1456,N/A,67,4
8,N/A,N/A,N/A,1424,1432,N/A,70,1
36,N/A,N/A,N/A,1388,1424,N/A,74,5
35,N/A,N/A,N/A,1353,1388,N/A,80,5
23,N/A,N/A,N/A,1330,1353,N/A,85,4
22,N/A,N/A,N/A,1308,1330,N/A,90,3
10,N/A,N/A,N/A,1298,1308,N/A,95,2
43,N/A,N/A,N/A,1255,1298,N/A,99,6
36,N/A,N/A,N/A,1219,1255,N/A,104,5
14,N/A,N/A,N/A,1205,1219,N/A,108,3
44,N/A,N/A,N/A,1161,1205,N/A,111,6
38,N/A,N/A,N/A,1123,1161,N/A,116,5
15,N/A,N/A,N/A,1108,1123,N/A,119,2
41,N/A,N/A,N/A,1067,1108,N/A,123,6
26,N/A,N/A,N/A,1041,1067,N/A,127,4
11,N/A,N/A,N/A,1030,1041,N/A,131,2
25,N/A,N/A,N/A,1943,1968,N/A,6,4
14,N/A,N/A,N/A,1929,1943,N/A,9,1
44,N/A,N/A,N/A,1885,1929,N/A,14,6
17,N/A,N/A,N/A,1868,1885,N/A,17,3
41,N/A,N/A,N/A,1827,1868,N/A,20,6
26,N/A,N/A,N/A,1801,1827,N/A,24,4
26,N/A,N/A,N/A,1775,1801,N/A,30,4
11,N/A,N/A,N/A,1764,1775,N/A,33,1
12,N/A,N/A,N/A,1752,1764,N/A,39,1
42,N/A,N/A,N/A,1710,1752,N/A,44,6
8,N/A,N/A,N/A,1702,1710,N/A,50,0
29,N/A,N/A,N/A,1673,1702,N/A,54,4
14,N/A,N/A,N/A,1659,1673,N/A,57,1
42,N/A,N/A,N/A,1617,1659,N/A,62,6
32,N/A,N/A,N/A,1585,1617,N/A,66,4
9,N/A,N/A,N/A,1576,1585,N/A,69,1
14,N/A,N/A,N/A,1562,1576,N/A,75,1
27,N/A,N/A,N/A,1535,1562,N/A,78,4
9,N/A,N/A,N/A,1526,1535,N/A,81,1
23,N/A,N/A,N/A,1503,1526,N/A,84,4
25,N/A,N/A,N/A,1478,1503,N/A,90,4
10,N/A,N/A,N/A,1468,1478,N/A,93,1
7,N/A,N/A,N/A,1461,1468,N/A,99,1
35,N/A,N/A,N/A,1426,1461,N/A,103,5
29,N/A,N/A,N/A,1397,1426,N/A,108,4
23,N/A,N/A,N/A,1374,1397,N/A,113,3
16,N/A,N/A,N/A,1358,1374,N/A,118,2
41,N/A,N/A,N/A,1317,1358,N/A,122,6
9,N/A,N/A,N/A,1308,1317,N/A,128,0
39,N/A,N/A,N/A,1269,1308,N/A,133,5
7,N/A,N/A,N/A,955,962,N/A,6,1
41,N/A,N/A,N/A,914,955,N/A,11,6
22,N/A,N/A,N/A,892,914,N/A,14,3
43,N/A,N/A,N/A,849,892,N/A,17,6
38,N/A,N/A,N/A,811,849,N/A,22,5
13,N/A,N/A,N/A,798,811,N/A,25,2
41,N/A,N/A,N/A,757,798,N/A,29,6
27,N/A,N/A,N/A,730,757,N/A,33,4
15,N/A,N/A,N/A,715,730,N/A,37,2
9,N/A,N/A,N/A,706,715,N/A,42,1
37,N/A,N/A,N/A,669,706,N/A,46,5
15,N/A,N/A,N/A,654,669,N/A,49,2
37,N/A,N/A,N/A,617,654,N/A,52,5
23,N/A,N/A,N/A,594,617,N/A,57,4
27,N/A,N/A,N/A,567,594,N/A,63,4
19,N/A,N/A,N/A,548,567,N/A,68,3
43,N/A,N/A,N/A,505,548,N/A,71,6
7,N/A,N/A,N/A,498,505,N/A,77,0
19,N/A,N/A,N/A,479,498,N/A,80,3
12,N/A,N/A,N/A,467,479,N/A,84,1
30,N/A,N/A,N/A,437,467,N/A,87,4
14,N/A,N/A,N/A,423,437,N/A,90,1
41,N/A,N/A,N/A,382,423,N/A,95,6
29,N/A,N/A,N/A,353,382,N/A,99,4
15,N/A,N/A,N/A,338,353,N/A,104,3
10,N/A,N/A,N/A,328,338,N/A,108,1
25,N/A,N/A,N/A,303,328,N/A,111,4
23,N/A,N/A,N/A,280,303,N/A,116,3
11,N/A,N/A,N/A,269,280,N/A,121,2
41,N/A,N/A,N/A,228,269,N/A,125,6
11,N/A,N/A,N/A,1446,1457,N/A,5,1
11,N/A,N/A,N/A,1435,1446,N/A,11,1
26,N/A,N/A,N/A,1409,1435,N/A,14,4
11,N/A,N/A,N/A,1398,1409,N/A,18,2
14,N/A,N/A,N/A,1384,1398,N/A,24,2
10,N/A,N/A,N/A,1374,1384,N/A,30,2
44,N/A,N/A,N/A,1330,1374,N/A,34,6
20,N/A,N/A,N/A,1310,1330,N/A,37,3
11,N/A,N/A,N/A,1299,1310,N/A,41,1
32,N/A,N/A,N/A,1267,1299,N/A,45,5
36,N/A,N/A,N/A,1231,1267,N/A,51,5
32,N/A,N/A,N/A,1199,1231,N/A,56,4
7,N/A,N/A,N/A,1192,1199,N/A,59,1
9,N/A,N/A,N/A,1183,1192,N/A,65,1
43,N/A,N/A,N/A,1140,1183,N/A,70,6
22,N/A,N/A,N/A,1118,1140,N/A,73,3
16,N/A,N/A,N/A,1102,1118,N/A,79,3
22,N/A,N/A,N/A,1080,1102,N/A,85,3
8,N/A,N/A,N/A,1072,1080,N/A,89,1
24,N/A,N/A,N/A,1048,1072,N/A,92,4
13,N/A,N/A,N/A,1035,1048,N/A,95,1
39,N/A,N/A,N/A,996,1035,N/A,99,5
19,N/A,N/A,N/A,977,996,N/A,103,3
18,N/A,N/A,N/A,959,977,N/A,109,3
17,N/A,N/A,N/A,942,959,N/A,115,3
10,N/A,N/A,N/A,932,942,N/A,119,1
28,N/A,N/A,N/A,904,932,N/A,122,4
24,N/A,N/A,N/A,880,904,N/A,128,4
32,N/A,N/A,N/A,848,880,N/A,134,4
14,N/A,N/A,N/A,834,848,N/A,138,2
31,N/A,N/A,N/A,514,545,N/A,5,4
25,N/A,N/A,N/A,489,514,N/A,11,4
30,N/A,N/A,N/A,459,489,N/A,17,4
14,N/A,N/A,N/A,445,459,N/A,21,2
8,N/A,N/A,N/A,437,445,N/A,26,1
43,N/A,N/A,N/A,394,437,N/A,31,6
22,N/A,N/A,N/A,372,394,N/A,35,4
11,N/A,N/A,N/A,361,372,N/A,38,1
8,N/A,N/A,N/A,353,361,N/A,44,1
32,N/A,N/A,N/A,321,353,N/A,48,5
10,N/A,N/A,N/A,311,321,N/A,51,2
14,N/A,N/A,N/A,297,311,N/A,56,1
8,N/A,N/A,N/A,289,297,N/A,62,1
43,N/A,N/A,N/A,246,289,N/A,67,6
15,N/A,N/A,N/A,231,246,N/A,70,3
7,N/A,N/A,N/A,224,231,N/A,74,1
29,N/A,N/A,N/A,195,224,N/A,77,4
23,N/A,N/A,N/A,172,195,N/A,83,4
19,N/A,N/A,N/A,153,172,N/A,88,3
19,N/A,N/A,N/A,134,153,N/A,94,3
15,N/A,N/A,N/A,119,134,N/A,100,3
7,N/A,N/A,N/A,112,119,N/A,104,1
30,N/A,N/A,N/A,82,112,N/A,107,4
12,N/A,N/A,N/A,70,82,N/A,111,2
32,N/A,N/A,N/A,38,70,N/A,114,5
17,N/A,N/A,N/A,21,38,N/A,118,3
14,N/A,N/A,N/A,7,21,N/A,123,2
10,N/A,N/A,N/A,-3,7,N/A,129,2
28,N/A,N/A,N/A,511,539,N/A,4,4
14,N/A,N/A,N/A,497,511,N/A,8,2
43,N/A,N/A,N/A,454,497,N/A,12,6
25,N/A,N/A,N/A,429,454,N/A,16,4
18,N/A,N/A,N/A,411,429,N/A,21,3
11,N/A,N/A,N/A,400,411,N/A,25,1
29,N/A,N/A,N/A,371,400,N/A,28,4
14,N/A,N/A,N/A,357,371,N/A,32,2
10,N/A,N/A,N/A,347,357,N/A,37,1
41,N/A,N/A,N/A,306,347,N/A,42,6
30,N/A,N/A,N/A,276,306,N/A,46,4
14,N/A,N/A,N/A,262,276,N/A,49,1
32,N/A,N/A,N/A,230,262,N/A,53,5
32,N/A,N/A,N/A,198,230,N/A,58,4
31,N/A,N/A,N/A,167,198,N/A,64,4
10,N/A,N/A,N/A,157,167,N/A,67,1
42,N/A,N/A,N/A,115,157,N/A,72,6
39,N/A,N/A,N/A,76,115,N/A,77,5
10,N/A,N/A,N/A,66,76,N/A,80,2
36,N/A,N/A,N/A,30,66,N/A,83,5
33,N/A,N/A,N/A,-3,30,N/A,89,5
23,N/A,N/A,N/A,902,925,N/A,3,4
12,N/A,N/A,N/A,890,902,N/A,6,1
43,N/A,N/A,N/A,847,890,N/A,11,6
17,N/A,N/A,N/A,830,847,N/A,14,3
16,N/A,N/A,N/A,814,830,N/A,19,2
11,N/A,N/A,N/A,803,814,N/A,25,2
42,N/A,N/A,N/A,761,803,N/A,29,6
8,N/A,N/A,N/A,753,761,N/A,35,0
34,N/A,N/A,N/A,719,753,N/A,40,5
35,N/A,N/A,N/A,684,719,N/A,46,5
26,N/A,N/A,N/A,658,684,N/A,51,4
27,N/A,N/A,N/A,631,658,N/A,57,4
12,N/A,N/A,N/A,619,631,N/A,60,1
39,N/A,N/A,N/A,580,619,N/A,64,5
28,N/A,N/A,N/A,552,580,N/A,69,4
17,N/A,N/A,N/A,535,552,N/A,73,2
10,N/A,N/A,N/A,525,535,N/A,79,2
38,N/A,N/A,N/A,487,525,N/A,82,5
23,N/A,N/A,N/A,464,487,N/A,87,4
26,N/A,N/A,N/A,438,464,N/A,93,4
22,N/A,N/A,N/A,416,438,N/A,98,3
14,N/A,N/A,N/A,402,416,N/A,103,2
43,N/A,N/A,N/A,359,402,N/A,107,6
35,N/A,N/A,N/A,324,359,N/A,112,5
23,N/A,N/A,N/A,301,324,N/A,116,3
42,N/A,N/A,N/A,259,301,N/A,119,6
7,N/A,N/A,N/A,252,259,N/A,125,0
44,N/A,N/A,N/A,208,252,N/A,131,6
8,N/A,N/A,N/A,200,208,N/A,137,0
43,N/A,N/A,N/A,157,200,N/A,143,6
14,N/A,N/A,N/A,792,806,N/A,5,3
22,N/A,N/A,N/A,770,792,N/A,11,3
44,N/A,N/A,N/A,726,770,N/A,14,6
8,N/A,N/A,N/A,718,726,N/A,20,0
24,N/A,N/A,N/A,694,718,N/A,24,4
9,N/A,N/A,N/A,685,694,N/A,27,1
14,N/A,N/A,N/A,671,685,N/A,33,1
8,N/A,N/A,N/A,663,671,N/A,39,1
11,N/A,N/A,N/A,652,663,N/A,45,1
30,N/A,N/A,N/A,622,652,N/A,48,4
13,N/A,N/A,N/A,609,622,N/A,51,1
22,N/A,N/A,N/A,587,609,N/A,54,4
22,N/A,N/A,N/A,565,587,N/A,59,3
19,N/A,N/A,N/A,546,565,N/A,65,3
20,N/A,N/A,N/A,526,546,N/A,71,3
20,N/A,N/A,N/A,506,526,N/A,77,3
15,N/A,N/A,N/A,491,506,N/A,83,3
9,N/A,N/A,N/A,482,491,N/A,87,1
39,N/A,N/A,N/A,443,482,N/A,91,5
16,N/A,N/A,N/A,427,443,N/A,94,2
39,N/A,N/A,N/A,388,427,N/A,97,5
15,N/A,N/A,N/A,373,388,N/A,100,2
39,N/A,N/A,N/A,334,373,N/A,103,5
35,N/A,N/A,N/A,299,334,N/A,109,5
20,N/A,N/A,N/A,279,299,N/A,113,3
12,N/A,N/A,N/A,267,279,N/A,117,1
11,N/A,N/A,N/A,256,267,N/A,123,1
9,N/A,N/A,N/A,247,256,N/A,129,1
34,N/A,N/A,N/A,213,247,N/A,133,5
32,N/A,N/A,N/A,181,213,N/A,139,5
14,N/A,N/A,N/A,1027,1041,N/A,5,3
10,N/A,N/A,N/A,1017,1027,N/A,10,2
11,N/A,N/A,N/A,1006,1017,N/A,15,1
11,N/A,N/A,N/A,995,1006,N/A,21,1
37,N/A,N/A,N/A,958,995,N/A,25,5
16,N/A,N/A,N/A,942,958,N/A,29,3
15,N/A,N/A,N/A,927,942,N/A,35,3
16,N/A,N/A,N/A,911,927,N/A,40,2
11,N/A,N/A,N/A,900,911,N/A,46,2
11,N/A,N/A,N/A,889,900,N/A,52,2
8,N/A,N/A,N/A,881,889,N/A,57,1
9,N/A,N/A,N/A,872,881,N/A,63,1
9,N/A,N/A,N/A,863,872,N/A,69,1
35,N/A,N/A,N/A,828,863,N/A,73,5
34,N/A,N/A,N/A,794,828,N/A,79,5
28,N/A,N/A,N/A,766,794,N/A,84,4
14,N/A,N/A,N/A,752,766,N/A,89,3
43,N/A,N/A,N/A,709,752,N/A,92,6
25,N/A,N/A,N/A,684,709,N/A,96,4
24,N/A,N/A,N/A,660,684,N/A,102,4
12,N/A,N/A,N/A,648,660,N/A,105,1
29,N/A,N/A,N/A,619,648,N/A,108,4
28,N/A,N/A,N/A,591,619,N/A,114,4
28,N/A,N/A,N/A,563,591,N/A,120,4
28,N/A,N/A,N/A,535,563,N/A,126,4
12,N/A,N/A,N/A,523,535,N/A,129,1
33,N/A,N/A,N/A,490,523,N/A,133,5
13,N/A,N/A,N/A,477,490,N/A,136,2
36,N/A,N/A,N/A,441,477,N/A,139,5
17,N/A,N/A,N/A,424,441,N/A,142,2
23,N/A,N/A,N/A,1313,1336,N/A,3,3
11,N/A,N/A,N/A,1302,1313,N/A,7,1
12,N/A,N/A,N/A,1290,1302,N/A,13,1
28,N/A,N/A,N/A,1262,1290,N/A,16,4
16,N/A,N/A,N/A,1246,1262,N/A,20,2
35,N/A,N/A,N/A,1211,1246,N/A,23,5
20,N/A,N/A,N/A,1191,1211,N/A,27,3
11,N/A,N/A,N/A,1180,1191,N/A,31,1
9,N/A,N/A,N/A,1171,1180,N/A,37,1
41,N/A,N/A,N/A,1130,1171,N/A,42,6
23,N/A,N/A,N/A,1107,1130,N/A,45,3
10,N/A,N/A,N/A,1097,1107,N/A,50,2
41,N/A,N/A,N/A,1056,1097,N/A,54,6
32,N/A,N/A,N/A,1024,1056,N/A,59,5
27,N/A,N/A,N/A,997,1024,N/A,64,4
14,N/A,N/A,N/A,983,997,N/A,69,3
43,N/A,N/A,N/A,940,983,N/A,72,6
38,N/A,N/A,N/A,902,940,N/A,77,5
21,N/A,N/A,N/A,881,902,N/A,81,3
10,N/A,N/A,N/A,871,881,N/A,85,1
36,N/A,N/A,N/A,835,871,N/A,89,5
19,N/A,N/A,N/A,816,835,N/A,93,3
7,N/A,N/A,N/A,809,816,N/A,97,1
42,N/A,N/A,N/A,767,809,N/A,102,6
14,N/A,N/A,N/A,753,767,N/A,105,3
42,N/A,N/A,N/A,711,753,N/A,108,6
18,N/A,N/A,N/A,693,711,N/A,111,3
13,N/A,N/A,N/A,680,693,N/A,115,1
31,N/A,N/A,N/A,649,680,N/A,118,4
27,N/A,N/A,N/A,622,649,N/A,124,4
26,N/A,N/A,N/A,898,924,N/A,5,4
25,N/A,N/A,N/A,873,898,N/A,11,4
22,N/A,N/A,N/A,851,873,N/A,17,4
16,N/A,N/A,N/A,835,851,N/A,21,2
11,N/A,N/A,N/A,824,835,N/A,27,2
41,N/A,N/A,N/A,783,824,N/A,31,6
36,N/A,N/A,N/A,747,783,N/A,36,5
32,N/A,N/A,N/A,715,747,N/A,42,5
24,N/A,N/A,N/A,691,715,N/A,47,4
13,N/A,N/A,N/A,678,691,N/A,51,2
11,N/A,N/A,N/A,667,678,N/A,56,1
27,N/A,N/A,N/A,640,667,N/A,59,4
16,N/A,N/A,N/A,624,640,N/A,64,3
10,N/A,N/A,N/A,614,624,N/A,69,2
39,N/A,N/A,N/A,575,614,N/A,72,5
21,N/A,N/A,N/A,554,575,N/A,76,3
15,N/A,N/A,N/A,539,554,N/A,81,2
33,N/A,N/A,N/A,506,539,N/A,84,5
15,N/A,N/A,N/A,491,506,N/A,88,3
14,N/A,N/A,N/A,477,491,N/A,94,3
41,N/A,N/A,N/A,436,477,N/A,97,6
15,N/A,N/A,N/A,421,436,N/A,100,3
43,N/A,N/A,N/A,378,421,N/A,103,6
36,N/A,N/A,N/A,342,378,N/A,108,5
28,N/A,N/A,N/A,314,342,N/A,113,4
13,N/A,N/A,N/A,301,314,N/A,116,1
23,N/A,N/A,N/A,278,301,N/A,119,4
10,N/A,N/A,N/A,268,278,N/A,123,2
12,N/A,N/A,N/A,256,268,N/A,128,1
41,N/A,N/A,N/A,215,256,N/A,133,6
39,N/A,N/A,N/A,507,546,N/A,4,5
31,N/A,N/A,N/A,476,507,N/A,9,4
9,N/A,N/A,N/A,467,476,N/A,12,1
34,N/A,N/A,N/A,433,467,N/A,16,5
24,N/A,N/A,N/A,409,433,N/A,21,4
15,N/A,N/A,N/A,394,409,N/A,26,3
42,N/A,N/A,N/A,352,394,N/A,29,6
30,N/A,N/A,N/A,322,352,N/A,33,4
15,N/A,N/A,N/A,307,322,N/A,38,3
17,N/A,N/A,N/A,290,307,N/A,43,2
12,N/A,N/A,N/A,278,290,N/A,49,2
42,N/A,N/A,N/A,236,278,N/A,53,6
14,N/A,N/A,N/A,222,236,N/A,56,3
13,N/A,N/A,N/A,209,222,N/A,61,2
12,N/A,N/A,N/A,197,209,N/A,66,1
41,N/A,N/A,N/A,156,197,N/A,71,6
17,N/A,N/A,N/A,139,156,N/A,74,3
16,N/A,N/A,N/A,123,139,N/A,80,3
43,N/A,N/A,N/A,80,123,N/A,83,6
9,N/A,N/A,N/A,71,80,N/A,89,0
15,N/A,N/A,N/A,56,71,N/A,92,3
9,N/A,N/A,N/A,47,56,N/A,96,1
43,N/A,N/A,N/A,4,47,N/A,101,6
34,N/A,N/A,N/A,-30,4,N/A,106,5
26,N/A,N/A,N/A,1245,1271,N/A,5,4
16,N/A,N/A,N/A,1229,1245,N/A,9,2
41,N/A,N/A,N/A,1188,1229,N/A,13,6
18,N/A,N/A,N/A,1170,1188,N/A,16,3
44,N/A,N/A,N/A,1126,1170,N/A,19,6
7,N/A,N/A,N/A,1119,1126,N/A,25,0
28,N/A,N/A,N/A,1091,1119,N/A,29,4
7,N/A,N/A,N/A,1084,1091,N/A,32,1
35,N/A,N/A,N/A,1049,1084,N/A,36,5
36,N/A,N/A,N/A,1013,1049,N/A,42,5
15,N/A,N/A,N/A,998,1013,N/A,45,2
38,N/A,N/A,N/A,960,998,N/A,48,5
30,N/A,N/A,N/A,930,960,N/A,53,4
22,N/A,N/A,N/A,908,930,N/A,59,4
31,N/A,N/A,N/A,877,908,N/A,65,4
12,N/A,N/A,N/A,865,877,N/A,68,1
41,N/A,N/A,N/A,824,865,N/A,73,6
39,N/A,N/A,N/A,785,824,N/A,78,5
22,N/A,N/A,N/A,763,785,N/A,82,3
15,N/A,N/A,N/A,748,763,N/A,88,3
42,N/A,N/A,N/A,706,748,N/A,91,6
7,N/A,N/A,N/A,699,706,N/A,97,0
28,N/A,N/A,N/A,671,699,N/A,101,4
20,N/A,N/A,N/A,651,671,N/A,106,3
42,N/A,N/A,N/A,609,651,N/A,109,6
15,N/A,N/A,N/A,594,609,N/A,112,3
23,N/A,N/A,N/A,571,594,N/A,118,3
13,N/A,N/A,N/A,558,571,N/A,122,1
44,N/A,N/A,N/A,514,558,N/A,127,6
5,N/A,N/A,N/A,509,514,N/A,133,0
36,N/A,N/A,N/A,527,563,N/A,3,5
12,N/A,N/A,N/A,515,527,N/A,6,2
44,N/A,N/A,N/A,471,515,N/A,10,6
32,N/A,N/A,N/A,439,471,N/A,15,5
11,N/A,N/A,N/A,428,439,N/A,18,2
11,N/A,N/A,N/A,417,428,N/A,24,2
42,N/A,N/A,N/A,375,417,N/A,28,6
21,N/A,N/A,N/A,354,375,N/A,31,3
43,N/A,N/A,N/A,311,354,N/A,34,6
35,N/A,N/A,N/A,276,311,N/A,39,5
15,N/A,N/A,N/A,261,276,N/A,42,2
14,N/A,N/A,N/A,247,261,N/A,48,2
13,N/A,N/A,N/A,234,247,N/A,53,1
32,N/A,N/A,N/A,202,234,N/A,57,5
23,N/A,N/A,N/A,179,202,N/A,62,4
25,N/A,N/A,N/A,154,179,N/A,68,4
26,N/A,N/A,N/A,128,154,N/A,74,4
9,N/A,N/A,N/A,119,128,N/A,77,1
42,N/A,N/A,N/A,77,119,N/A,82,6
6,N/A,N/A,N/A,71,77,N/A,88,0
25,N/A,N/A,N/A,46,71,N/A,92,4
27,N/A,N/A,N/A,19,46,N/A,98,4
10,N/A,N/A,N/A,9,19,N/A,101,1
43,N/A,N/A,N/A,-34,9,N/A,106,6
38,N/A,N/A,N/A,857,895,N/A,6,5
39,N/A,N/A,N/A,818,857,N/A,12,5
19,N/A,N/A,N/A,799,818,N/A,16,3
44,N/A,N/A,N/A,755,799,N/A,19,6
16,N/A,N/A,N/A,739,755,N/A,22,3
14,N/A,N/A,N/A,725,739,N/A,28,3
23,N/A,N/A,N/A,702,725,N/A,34,3
44,N/A,N/A,N/A,658,702,N/A,37,6
19,N/A,N/A,N/A,639,658,N/A,40,3
20,N/A,N/A,N/A,619,639,N/A,46,3
21,N/A,N/A,N/A,598,619,N/A,52,3
22,N/A,N/A,N/A,576,598,N/A,58,3
13,N/A,N/A,N/A,563,576,N/A,62,1
7,N/A,N/A,N/A,556,563,N/A,68,1
36,N/A,N/A,N/A,520,556,N/A,72,5
25,N/A,N/A,N/A,495,520,N/A,77,4
16,N/A,N/A,N/A,479,495,N/A,82,3
22,N/A,N/A,N/A,457,479,N/A,88,3
14,N/A,N/A,N/A,443,457,N/A,92,1
12,N/A,N/A,N/A,431,443,N/A,98,1
31,N/A,N/A,N/A,400,431,N/A,101,4
32,N/A,N/A,N/A,368,400,N/A,107,4
11,N/A,N/A,N/A,357,368,N/A,111,2
33,N/A,N/A,N/A,324,357,N/A,114,5
25,N/A,N/A,N/A,299,324,N/A,119,4
13,N/A,N/A,N/A,286,299,N/A,122,1
10,N/A,N/A,N/A,276,286,N/A,128,1
33,N/A,N/A,N/A,243,276,N/A,132,5
33,N/A,N/A,N/A,210,243,N/A,138,5
14,N/A,N/A,N/A,196,210,N/A,142,3
19,N/A,N/A,N/A,306,325,N/A,6,3
10,N/A,N/A,N/A,296,306,N/A,10,1
44,N/A,N/A,N/A,252,296,N/A,15,6
36,N/A,N/A,N/A,216,252,N/A,20,5
38,N/A,N/A,N/A,178,216,N/A,26,5
36,N/A,N/A,N/A,142,178,N/A,32,5
22,N/A,N/A,N/A,120,142,N/A,37,4
11,N/A,N/A,N/A,109,120,N/A,40,1
32,N/A,N/A,N/A,77,109,N/A,44,5
14,N/A,N/A,N/A,63,77,N/A,47,2
14,N/A,N/A,N/A,49,63,N/A,52,1
37,N/A,N/A,N/A,12,49,N/A,56,5
35,N/A,N/A,N/A,-23,12,N/A,62,5
38,N/A,N/A,N/A,993,1031,N/A,6,5
11,N/A,N/A,N/A,982,993,N/A,9,2
13,N/A,N/A,N/A,969,982,N/A,15,2
44,N/A,N/A,N/A,925,969,N/A,19,6
35,N/A,N/A,N/A,890,925,N/A,24,5
31,N/A,N/A,N/A,859,890,N/A,29,4
15,N/A,N/A,N/A,844,859,N/A,34,3
14,N/A,N/A,N/A,830,844,N/A,39,2
36,N/A,N/A,N/A,794,830,N/A,42,5
34,N/A,N/A,N/A,760,794,N/A,48,5
23,N/A,N/A,N/A,737,760,N/A,52,3
13,N/A,N/A,N/A,724,737,N/A,56,1
27,N/A,N/A,N/A,697,724,N/A,59,4
20,N/A,N/A,N/A,677,697,N/A,64,3
42,N/A,N/A,N/A,635,677,N/A,67,6
15,N/A,N/A,N/A,620,635,N/A,70,3
44,N/A,N/A,N/A,576,620,N/A,73,6
24,N/A,N/A,N/A,552,576,N/A,77,4
25,N/A,N/A,N/A,527,552,N/A,83,4
13,N/A,N/A,N/A,514,527,N/A,87,2
33,N/A,N/A,N/A,481,514,N/A,90,5
37,N/A,N/A,N/A,444,481,N/A,96,5
28,N/A,N/A,N/A,416,444,N/A,101,4
10,N/A,N/A,N/A,406,416,N/A,104,1
38,N/A,N/A,N/A,368,406,N/A,108,5
37,N/A,N/A,N/A,331,368,N/A,114,5
24,N/A,N/A,N/A,307,331,N/A,119,4
9,N/A,N/A,N/A,298,307,N/A,122,1
26,N/A,N/A,N/A,272,298,N/A,125,4
13,N/A,N/A,N/A,259,272,N/A,128,1
10,N/A,N/A,N/A,818,828,N/A,5,1
10,N/A,N/A,N/A,808,818,N/A,11,1
44,N/A,N/A,N/A,764,808,N/A,16,6
35,N/A,N/A,N/A,729,764,N/A,21,5
29,N/A,N/A,N/A,700,729,N/A,26,4
20,N/A,N/A,N/A,680,700,N/A,31,3
15,N/A,N/A,N/A,665,680,N/A,36,2
41,N/A,N/A,N/A,624,665,N/A,40,6
31,N/A,N/A,N/A,593,624,N/A,44,4
15,N/A,N/A,N/A,578,593,N/A,49,3
23,N/A,N/A,N/A,555,578,N/A,55,3
44,N/A,N/A,N/A,511,555,N/A,58,6
29,N/A,N/A,N/A,482,511,N/A,62,4
17,N/A,N/A,N/A,465,482,N/A,66,2
42,N/A,N/A,N/A,423,465,N/A,70,6
16,N/A,N/A,N/A,407,423,N/A,73,3
16,N/A,N/A,N/A,391,407,N/A,79,3
13,N/A,N/A,N/A,378,391,N/A,83,1
37,N/A,N/A,N/A,341,378,N/A,87,5
21,N/A,N/A,N/A,320,341,N/A,91,3
44,N/A,N/A,N/A,276,320,N/A,94,6
17,N/A,N/A,N/A,259,276,N/A,97,3
43,N/A,N/A,N/A,216,259,N/A,100,6
17,N/A,N/A,N/A,199,216,N/A,103,3
15,N/A,N/A,N/A,184,199,N/A,109,3
7,N/A,N/A,N/A,177,184,N/A,113,1
8,N/A,N/A,N/A,169,177,N/A,119,1
13,N/A,N/A,N/A,156,169,N/A,125,1
14,N/A,N/A,N/A,142,156,N/A,131,1
44,N/A,N/A,N/A,98,142,N/A,136,6
23,N/A,N/A,N/A,347,370,N/A,6,3
13,N/A,N/A,N/A,334,347,N/A,11,2
8,N/A,N/A,N/A,326,334,N/A,16,1
44,N/A,N/A,N/A,282,326,N/A,21,6
23,N/A,N/A,N/A,259,282,N/A,25,4
11,N/A,N/A,N/A,248,259,N/A,29,2
42,N/A,N/A,N/A,206,248,N/A,33,6
28,N/A,N/A,N/A,178,206,N/A,37,4
14,N/A,N/A,N/A,164,178,N/A,42,3
44,N/A,N/A,N/A,120,164,N/A,45,6
6,N/A,N/A,N/A,114,120,N/A,51,0
41,N/A,N/A,N/A,73,114,N/A,57,6
8,N/A,N/A,N/A,65,73,N/A,63,0
32,N/A,N/A,N/A,33,65,N/A,68,5
29,N/A,N/A,N/A,4,33,N/A,73,4
22,N/A,N/A,N/A,-18,4,N/A,79,4
34,N/A,N/A,N/A,1665,1699,N/A,3,5
34,N/A,N/A,N/A,1631,1665,N/A,9,5
33,N/A,N/A,N/A,1598,1631,N/A,15,5
37,N/A,N/A,N/A,1561,1598,N/A,21,5
17,N/A,N/A,N/A,1544,1561,N/A,25,3
20,N/A,N/A,N/A,1524,1544,N/A,31,3
10,N/A,N/A,N/A,1514,1524,N/A,36,2
7,N/A,N/A,N/A,1507,1514,N/A,41,1
37,N/A,N/A,N/A,1470,1507,N/A,45,5
32,N/A,N/A,N/A,1438,1470,N/A,51,5
15,N/A,N/A,N/A,1423,1438,N/A,55,3
13,N/A,N/A,N/A,1410,1423,N/A,59,1
32,N/A,N/A,N/A,1378,1410,N/A,63,5
23,N/A,N/A,N/A,1355,1378,N/A,68,4
19,N/A,N/A,N/A,1336,1355,N/A,73,3
23,N/A,N/A,N/A,1313,1336,N/A,79,3
8,N/A,N/A,N/A,1305,1313,N/A,83,1
31,N/A,N/A,N/A,1274,1305,N/A,86,4
30,N/A,N/A,N/A,1244,1274,N/A,92,4
15,N/A,N/A,N/A,1229,1244,N/A,97,3
41,N/A,N/A,N/A,1188,1229,N/A,100,6
26,N/A,N/A,N/A,1162,1188,N/A,104,4
11,N/A,N/A,N/A,1151,1162,N/A,108,2
12,N/A,N/A,N/A,1139,1151,N/A,113,1
10,N/A,N/A,N/A,1129,1139,N/A,119,1
42,N/A,N/A,N/A,1087,1129,N/A,124,6
24,N/A,N/A,N/A,1063,1087,N/A,128,4
8,N/A,N/A,N/A,1055,1063,N/A,131,1
9,N/A,N/A,N/A,1046,1055,N/A,137,1
42,N/A,N/A,N/A,1004,1046,N/A,142,6
11,N/A,N/A,N/A,988,999,N/A,6,1
7,N/A,N/A,N/A,981,988,N/A,12,1
43,N/A,N/A,N/A,938,981,N/A,17,6
37,N/A,N/A,N/A,901,938,N/A,22,5
32,N/A,N/A,N/A,869,901,N/A,27,4
13,N/A,N/A,N/A,856,869,N/A,31,2
44,N/A,N/A,N/A,812,856,N/A,35,6
30,N/A,N/A,N/A,782,812,N/A,39,4
28,N/A,N/A,N/A,754,782,N/A,45,4
31,N/A,N/A,N/A,723,754,N/A,51,4
10,N/A,N/A,N/A,713,723,N/A,55,2
41,N/A,N/A,N/A,672,713,N/A,59,6
30,N/A,N/A,N/A,642,672,N/A,63,4
16,N/A,N/A,N/A,626,642,N/A,68,3
14,N/A,N/A,N/A,612,626,N/A,74,3
17,N/A,N/A,N/A,595,612,N/A,79,2
41,N/A,N/A,N/A,554,595,N/A,83,6
6,N/A,N/A,N/A,548,554,N/A,89,0
28,N/A,N/A,N/A,520,548,N/A,93,4
23,N/A,N/A,N/A,497,520,N/A,98,3
9,N/A,N/A,N/A,488,497,N/A,102,1
22,N/A,N/A,N/A,466,488,N/A,105,4
26,N/A,N/A,N/A,440,466,N/A,111,4
23,N/A,N/A,N/A,417,440,N/A,117,4
10,N/A,N/A,N/A,407,417,N/A,120,1
33,N/A,N/A,N/A,374,407,N/A,124,5
14,N/A,N/A,N/A,360,374,N/A,128,3
18,N/A,N/A,N/A,342,360,N/A,134,3
15,N/A,N/A,N/A,327,342,N/A,140,3
18,N/A,N/A,N/A,309,327,N/A,146,3
17,N/A,N/A,N/A,374,391,N/A,6,3
15,N/A,N/A,N/A,359,374,N/A,11,2
34,N/A,N/A,N/A,325,359,N/A,14,5
35,N/A,N/A,N/A,290,325,N/A,20,5
14,N/A,N/A,N/A,276,290,N/A,23,2
14,N/A,N/A,N/A,262,276,N/A,29,2
13,N/A,N/A,N/A,249,262,N/A,35,2
44,N/A,N/A,N/A,205,249,N/A,39,6
6,N/A,N/A,N/A,199,205,N/A,45,0
34,N/A,N/A,N/A,165,199,N/A,50,5
32,N/A,N/A,N/A,133,165,N/A,55,4
14,N/A,N/A,N/A,119,133,N/A,60,3
16,N/A,N/A,N/A,103,119,N/A,65,2
38,N/A,N/A,N/A,65,103,N/A,68,5
36,N/A,N/A,N/A,29,65,N/A,74,5
34,N/A,N/A,N/A,-5,29,N/A,80,5
42,N/A,N/A,N/A,694,736,N/A,6,6
22,N/A,N/A,N/A,672,694,N/A,10,4
15,N/A,N/A,N/A,657,672,N/A,15,3
42,N/A,N/A,N/A,615,657,N/A,18,6
16,N/A,N/A,N/A,599,615,N/A,21,3
8,N/A,N/A,N/A,591,599,N/A,25,1
12,N/A,N/A,N/A,579,591,N/A,31,1
43,N/A,N/A,N/A,536,579,N/A,36,6
26,N/A,N/A,N/A,510,536,N/A,40,4
11,N/A,N/A,N/A,499,510,N/A,43,1
37,N/A,N/A,N/A,462,499,N/A,47,5
29,N/A,N/A,N/A,433,462,N/A,52,4
14,N/A,N/A,N/A,419,433,N/A,55,1
38,N/A,N/A,N/A,381,419,N/A,59,5
16,N/A,N/A,N/A,365,381,N/A,63,3
20,N/A,N/A,N/A,345,365,N/A,69,3
21,N/A,N/A,N/A,324,345,N/A,75,3
14,N/A,N/A,N/A,310,324,N/A,80,2
13,N/A,N/A,N/A,297,310,N/A,85,1
25,N/A,N/A,N/A,272,297,N/A,88,4
15,N/A,N/A,N/A,257,272,N/A,92,2
34,N/A,N/A,N/A,223,257,N/A,95,5
21,N/A,N/A,N/A,202,223,N/A,99,3
11,N/A,N/A,N/A,191,202,N/A,103,1
41,N/A,N/A,N/A,150,191,N/A,108,6
18,N/A,N/A,N/A,132,150,N/A,111,3
14,N/A,N/A,N/A,118,132,N/A,116,2
39,N/A,N/A,N/A,79,118,N/A,119,5
14,N/A,N/A,N/A,65,79,N/A,122,2
32,N/A,N/A,N/A,33,65,N/A,125,5
14,N/A,N/A,N/A,1684,1698,N/A,6,3
14,N/A,N/A,N/A,1670,1684,N/A,10,1
10,N/A,N/A,N/A,1660,1670,N/A,16,1
10,N/A,N/A,N/A,1650,1660,N/A,22,1
42,N/A,N/A,N/A,1608,1650,N/A,27,6
8,N/A,N/A,N/A,1600,1608,N/A,33,0
19,N/A,N/A,N/A,1581,1600,N/A,36,3
42,N/A,N/A,N/A,1539,1581,N/A,39,6
23,N/A,N/A,N/A,1516,1539,N/A,43,4
14,N/A,N/A,N/A,1502,1516,N/A,47,2
41,N/A,N/A,N/A,1461,1502,N/A,51,6
7,N/A,N/A,N/A,1454,1461,N/A,57,0
23,N/A,N/A,N/A,1431,1454,N/A,60,3
16,N/A,N/A,N/A,1415,1431,N/A,65,2
13,N/A,N/A,N/A,1402,1415,N/A,71,2
14,N/A,N/A,N/A,1388,1402,N/A,77,2
14,N/A,N/A,N/A,1374,1388,N/A,83,2
33,N/A,N/A,N/A,1341,1374,N/A,86,5
23,N/A,N/A,N/A,1318,1341,N/A,90,3
7,N/A,N/A,N/A,1311,1318,N/A,94,1
9,N/A,N/A,N/A,1302,1311,N/A,100,1
8,N/A,N/A,N/A,1294,1302,N/A,106,1
44,N/A,N/A,N/A,1250,1294,N/A,111,6
6,N/A,N/A,N/A,1244,1250,N/A,117,0
16,N/A,N/A,N/A,1228,1244,N/A,120,3
12,N/A,N/A,N/A,1216,1228,N/A,125,2
7,N/A,N/A,N/A,1209,1216,N/A,130,1
13,N/A,N/A,N/A,1196,1209,N/A,136,1
35,N/A,N/A,N/A,1161,1196,N/A,140,5
19,N/A,N/A,N/A,1142,1161,N/A,144,3
43,N/A,N/A,N/A,1015,1058,N/A,3,6
22,N/A,N/A,N/A,993,1015,N/A,6,3
14,N/A,N/A,N/A,979,993,N/A,10,1
42,N/A,N/A,N/A,937,979,N/A,15,6
7,N/A,N/A,N/A,930,937,N/A,21,0
32,N/A,N/A,N/A,898,930,N/A,26,5
18,N/A,N/A,N/A,880,898,N/A,30,3
12,N/A,N/A,N/A,868,880,N/A,35,2
42,N/A,N/A,N/A,826,868,N/A,39,6
38,N/A,N/A,N/A,788,826,N/A,44,5
16,N/A,N/A,N/A,772,788,N/A,47,2
43,N/A,N/A,N/A,729,772,N/A,51,6
32,N/A,N/A,N/A,697,729,N/A,56,5
23,N/A,N/A,N/A,674,697,N/A,61,4
14,N/A,N/A,N/A,660,674,N/A,64,1
35,N/A,N/A,N/A,625,660,N/A,68,5
23,N/A,N/A,N/A,602,625,N/A,72,3
44,N/A,N/A,N/A,558,602,N/A,75,6
35,N/A,N/A,N/A,523,558,N/A,80,5
39,N/A,N/A,N/A,484,523,N/A,86,5
31,N/A,N/A,N/A,453,484,N/A,91,4
22,N/A,N/A,N/A,431,453,N/A,97,4
12,N/A,N/A,N/A,419,431,N/A,101,2
11,N/A,N/A,N/A,408,419,N/A,106,1
24,N/A,N/A,N/A,384,408,N/A,109,4
22,N/A,N/A,N/A,362,384,N/A,115,4
10,N/A,N/A,N/A,352,362,N/A,118,1
10,N/A,N/A,N/A,342,352,N/A,124,1
41,N/A,N/A,N/A,301,342,N/A,129,6
17,N/A,N/A,N/A,284,301,N/A,132,3
7,N/A,N/A,N/A,1146,1153,N/A,3,1
37,N/A,N/A,N/A,1109,1146,N/A,7,5
23,N/A,N/A,N/A,1086,1109,N/A,11,3
14,N/A,N/A,N/A,1072,1086,N/A,17,3
21,N/A,N/A,N/A,1051,1072,N/A,23,3
22,N/A,N/A,N/A,1029,1051,N/A,29,3
15,N/A,N/A,N/A,1014,1029,N/A,35,3
41,N/A,N/A,N/A,973,1014,N/A,38,6
29,N/A,N/A,N/A,944,973,N/A,42,4
21,N/A,N/A,N/A,923,944,N/A,47,3
21,N/A,N/A,N/A,902,923,N/A,53,3
12,N/A,N/A,N/A,890,902,N/A,58,2
43,N/A,N/A,N/A,847,890,N/A,62,6
26,N/A,N/A,N/A,821,847,N/A,66,4
32,N/A,N/A,N/A,789,821,N/A,72,4
15,N/A,N/A,N/A,774,789,N/A,76,2
10,N/A,N/A,N/A,764,774,N/A,81,1
43,N/A,N/A,N/A,721,764,N/A,86,6
22,N/A,N/A,N/A,699,721,N/A,90,4
21,N/A,N/A,N/A,678,699,N/A,95,3
43,N/A,N/A,N/A,635,678,N/A,98,6
19,N/A,N/A,N/A,616,635,N/A,101,3
16,N/A,N/A,N/A,600,616,N/A,106,2
14,N/A,N/A,N/A,586,600,N/A,111,1
8,N/A,N/A,N/A,578,586,N/A,117,1
44,N/A,N/A,N/A,534,578,N/A,122,6
6,N/A,N/A,N/A,528,534,N/A,128,0
27,N/A,N/A,N/A,501,528,N/A,132,4
22,N/A,N/A,N/A,479,501,N/A,137,3
10,N/A,N/A,N/A,469,479,N/A,141,1
34,N/A,N/A,N/A,722,756,N/A,6,5
32,N/A,N/A,N/A,690,722,N/A,11,4
17,N/A,N/A,N/A,673,690,N/A,15,2
36,N/A,N/A,N/A,637,673,N/A,18,5
39,N/A,N/A,N/A,598,637,N/A,24,5
37,N/A,N/A,N/A,561,598,N/A,30,5
22,N/A,N/A,N/A,539,561,N/A,34,3
43,N/A,N/A,N/A,496,539,N/A,37,6
21,N/A,N/A,N/A,475,496,N/A,40,3
11,N/A,N/A,N/A,464,475,N/A,45,2
44,N/A,N/A,N/A,420,464,N/A,49,6
21,N/A,N/A,N/A,399,420,N/A,52,3
14,N/A,N/A,N/A,385,399,N/A,57,2
34,N/A,N/A,N/A,351,385,N/A,60,5
26,N/A,N/A,N/A,325,351,N/A,65,4
11,N/A,N/A,N/A,314,325,N/A,69,2
32,N/A,N/A,N/A,282,314,N/A,72,5
25,N/A,N/A,N/A,257,282,N/A,77,4
17,N/A,N/A,N/A,240,257,N/A,82,3
12,N/A,N/A,N/A,228,240,N/A,87,2
13,N/A,N/A,N/A,215,228,N/A,92,1
34,N/A,N/A,N/A,181,215,N/A,96,5
34,N/A,N/A,N/A,147,181,N/A,102,5
21,N/A,N/A,N/A,126,147,N/A,106,3
13,N/A,N/A,N/A,113,126,N/A,110,1
42,N/A,N/A,N/A,71,113,N/A,115,6
33,N/A,N/A,N/A,38,71,N/A,120,5
12,N/A,N/A,N/A,26,38,N/A,123,2
14,N/A,N/A,N/A,12,26,N/A,129,2
17,N/A,N/A,N/A,-5,12,N/A,135,2
44,N/A,N/A,N/A,466,510,N/A,3,6
22,N/A,N/A,N/A,444,466,N/A,6,3
21,N/A,N/A,N/A,423,444,N/A,12,3
41,N/A,N/A,N/A,382,423,N/A,15,6
34,N/A,N/A,N/A,348,382,N/A,20,5
11,N/A,N/A,N/A,337,348,N/A,23,2
32,N/A,N/A,N/A,305,337,N/A,26,5
15,N/A,N/A,N/A,290,305,N/A,29,2
17,N/A,N/A,N/A,273,290,N/A,35,2
44,N/A,N/A,N/A,229,273,N/A,39,6
23,N/A,N/A,N/A,206,229,N/A,43,4
12,N/A,N/A,N/A,194,206,N/A,46,1
43,N/A,N/A,N/A,151,194,N/A,51,6
32,N/A,N/A,N/A,119,151,N/A,56,5
13,N/A,N/A,N/A,106,119,N/A,59,2
10,N/A,N/A,N/A,96,106,N/A,64,1
32,N/A,N/A,N/A,64,96,N/A,68,5
34,N/A,N/A,N/A,30,64,N/A,74,5
16,N/A,N/A,N/A,14,30,N/A,78,3
9,N/A,N/A,N/A,5,14,N/A,82,1
44,N/A,N/A,N/A,-39,5,N/A,87,6
32,N/A,N/A,N/A,456,488,N/A,5,5
36,N/A,N/A,N/A,420,456,N/A,11,5
12,N/A,N/A,N/A,408,420,N/A,14,2
17,N/A,N/A,N/A,391,408,N/A,20,2
43,N/A,N/A,N/A,348,391,N/A,24,6
16,N/A,N/A,N/A,332,348,N/A,27,3
42,N/A,N/A,N/A,290,332,N/A,30,6
5,N/A,N/A,N/A,285,290,N/A,36,0
43,N/A,N/A,N/A,242,285,N/A,42,6
34,N/A,N/A,N/A,208,242,N/A,47,5
13,N/A,N/A,N/A,195,208,N/A,50,2
33,N/A,N/A,N/A,162,195,N/A,53,5
17,N/A,N/A,N/A,145,162,N/A,57,3
23,N/A,N/A,N/A,122,145,N/A,63,3
17,N/A,N/A,N/A,105,122,N/A,69,3
10,N/A,N/A,N/A,95,105,N/A,73,1
38,N/A,N/A,N/A,57,95,N/A,77,5
33,N/A,N/A,N/A,24,57,N/A,83,5
22,N/A,N/A,N/A,2,24,N/A,87,3
21,N/A,N/A,N/A,-19,2,N/A,93,3
41,N/A,N/A,N/A,682,723,N/A,3,6
19,N/A,N/A,N/A,663,682,N/A,6,3
41,N/A,N/A,N/A,622,663,N/A,9,6
39,N/A,N/A,N/A,583,622,N/A,14,5
25,N/A,N/A,N/A,558,583,N/A,19,4
14,N/A,N/A,N/A,544,558,N/A,22,1
29,N/A,N/A,N/A,515,544,N/A,25,4
17,N/A,N/A,N/A,498,515,N/A,30,3
11,N/A,N/A,N/A,487,498,N/A,35,2
42,N/A,N/A,N/A,445,487,N/A,39,6
6,N/A,N/A,N/A,439,445,N/A,45,0
14,N/A,N/A,N/A,425,439,N/A,48,3
14,N/A,N/A,N/A,411,425,N/A,52,1
36,N/A,N/A,N/A,375,411,N/A,56,5
14,N/A,N/A,N/A,361,375,N/A,60,3
16,N/A,N/A,N/A,345,361,N/A,66,3
15,N/A,N/A,N/A,330,345,N/A,71,2
13,N/A,N/A,N/A,317,330,N/A,76,1
13,N/A,N/A,N/A,304,317,N/A,82,1
44,N/A,N/A,N/A,260,304,N/A,87,6
32,N/A,N/A,N/A,228,260,N/A,91,4
23,N/A,N/A,N/A,205,228,N/A,97,4
9,N/A,N/A,N/A,196,205,N/A,100,1
43,N/A,N/A,N/A,153,196,N/A,105,6
38,N/A,N/A,N/A,115,153,N/A,110,5
35,N/A,N/A,N/A,80,115,N/A,116,5
35,N/A,N/A,N/A,45,80,N/A,122,5
34,N/A,N/A,N/A,11,45,N/A,128,5
11,N/A,N/A,N/A,0,11,N/A,131,2
38,N/A,N/A,N/A,510,548,N/A,6,5
22,N/A,N/A,N/A,488,510,N/A,10,3
12,N/A,N/A,N/A,476,488,N/A,14,1
43,N/A,N/A,N/A,433,476,N/A,19,6
14,N/A,N/A,N/A,419,433,N/A,22,3
18,N/A,N/A,N/A,401,419,N/A,28,3
41,N/A,N/A,N/A,360,401,N/A,31,6
26,N/A,N/A,N/A,334,360,N/A,35,4
8,N/A,N/A,N/A,326,334,N/A,38,1
22,N/A,N/A,N/A,304,326,N/A,41,4
17,N/A,N/A,N/A,287,304,N/A,45,2
15,N/A,N/A,N/A,272,287,N/A,51,2
12,N/A,N/A,N/A,260,272,N/A,56,1
44,N/A,N/A,N/A,216,260,N/A,61,6
15,N/A,N/A,N/A,201,216,N/A,64,3
42,N/A,N/A,N/A,159,201,N/A,67,6
22,N/A,N/A,N/A,137,159,N/A,71,4
16,N/A,N/A,N/A,121,137,N/A,75,2
7,N/A,N/A,N/A,114,121,N/A,80,1
9,N/A,N/A,N/A,105,114,N/A,86,1
27,N/A,N/A,N/A,78,105,N/A,89,4
30,N/A,N/A,N/A,48,78,N/A,95,4
14,N/A,N/A,N/A,34,48,N/A,98,1
24,N/A,N/A,N/A,10,34,N/A,101,4
21,N/A,N/A,N/A,-11,10,N/A,106,3
10,N/A,N/A,N/A,1984,1994,N/A,4,2
41,N/A,N/A,N/A,1943,1984,N/A,8,6
22,N/A,N/A,N/A,1921,1943,N/A,12,4
17,N/A,N/A,N/A,1904,1921,N/A,16,2
37,N/A,N/A,N/A,1867,1904,N/A,19,5
30,N/A,N/A,N/A,1837,1867,N/A,24,4
14,N/A,N/A,N/A,1823,1837,N/A,29,3
13,N/A,N/A,N/A,1810,1823,N/A,34,2
16,N/A,N/A,N/A,1794,1810,N/A,40,2
10,N/A,N/A,N/A,1784,1794,N/A,45,1
9,N/A,N/A,N/A,1775,1784,N/A,51,1
12,N/A,N/A,N/A,1763,1775,N/A,57,1
44,N/A,N/A,N/A,1719,1763,N/A,62,6
7,N/A,N/A,N/A,1712,1719,N/A,68,0
36,N/A,N/A,N/A,1676,1712,N/A,73,5
25,N/A,N/A,N/A,1651,1676,N/A,78,4
17,N/A,N/A,N/A,1634,1651,N/A,83,3
43,N/A,N/A,N/A,1591,1634,N/A,86,6
23,N/A,N/A,N/A,1568,1591,N/A,90,4
17,N/A,N/A,N/A,1551,1568,N/A,94,2
13,N/A,N/A,N/A,1538,1551,N/A,100,2
43,N/A,N/A,N/A,1495,1538,N/A,104,6
5,N/A,N/A,N/A,1490,1495,N/A,110,0
41,N/A,N/A,N/A,1449,1490,N/A,116,6
18,N/A,N/A,N/A,1431,1449,N/A,119,3
21,N/A,N/A,N/A,1410,1431,N/A,125,3
9,N/A,N/A,N/A,1401,1410,N/A,129,1
41,N/A,N/A,N/A,1360,1401,N/A,134,6
15,N/A,N/A,N/A,1345,1360,N/A,137,3
21,N/A,N/A,N/A,1324,1345,N/A,143,3
25,N/A,N/A,N/A,753,778,N/A,4,4
14,N/A,N/A,N/A,739,753,N/A,9,3
9,N/A,N/A,N/A,730,739,N/A,13,1
26,N/A,N/A,N/A,704,730,N/A,16,4
23,N/A,N/A,N/A,681,704,N/A,21,3
16,N/A,N/A,N/A,665,681,N/A,26,2
9,N/A,N/A,N/A,656,665,N/A,31,1
35,N/A,N/A,N/A,621,656,N/A,35,5
22,N/A,N/A,N/A,599,621,N/A,39,3
12,N/A,N/A,N/A,587,599,N/A,44,2
43,N/A,N/A,N/A,544,587,N/A,48,6
15,N/A,N/A,N/A,529,544,N/A,51,3
43,N/A,N/A,N/A,486,529,N/A,54,6
21,N/A,N/A,N/A,465,486,N/A,57,3
15,N/A,N/A,N/A,450,465,N/A,63,3
43,N/A,N/A,N/A,407,450,N/A,66,6
32,N/A,N/A,N/A,375,407,N/A,71,5
22,N/A,N/A,N/A,353,375,N/A,75,3
41,N/A,N/A,N/A,312,353,N/A,78,6
16,N/A,N/A,N/A,296,312,N/A,81,3
44,N/A,N/A,N/A,252,296,N/A,84,6
22,N/A,N/A,N/A,230,252,N/A,88,4
8,N/A,N/A,N/A,222,230,N/A,91,1
34,N/A,N/A,N/A,188,222,N/A,95,5
16,N/A,N/A,N/A,172,188,N/A,98,2
11,N/A,N/A,N/A,161,172,N/A,104,2
44,N/A,N/A,N/A,117,161,N/A,108,6
7,N/A,N/A,N/A,110,117,N/A,114,0
42,N/A,N/A,N/A,68,110,N/A,120,6
29,N/A,N/A,N/A,39,68,N/A,124,4
10,N/A,N/A,N/A,1573,1583,N/A,3,1
10,N/A,N/A,N/A,1563,1573,N/A,9,1
41,N/A,N/A,N/A,1522,1563,N/A,14,6
14,N/A,N/A,N/A,1508,1522,N/A,17,3
11,N/A,N/A,N/A,1497,1508,N/A,22,2
34,N/A,N/A,N/A,1463,1497,N/A,25,5
34,N/A,N/A,N/A,1429,1463,N/A,31,5
25,N/A,N/A,N/A,1404,1429,N/A,36,4
22,N/A,N/A,N/A,1382,1404,N/A,41,3
14,N/A,N/A,N/A,1368,1382,N/A,45,1
33,N/A,N/A,N/A,1335,1368,N/A,49,5
37,N/A,N/A,N/A,1298,1335,N/A,55,5
33,N/A,N/A,N/A,1265,1298,N/A,61,5
20,N/A,N/A,N/A,1245,1265,N/A,65,3
19,N/A,N/A,N/A,1226,1245,N/A,71,3
23,N/A,N/A,N/A,1203,1226,N/A,77,3
21,N/A,N/A,N/A,1182,1203,N/A,83,3
15,N/A,N/A,N/A,1167,1182,N/A,88,2
16,N/A,N/A,N/A,1151,1167,N/A,94,2
11,N/A,N/A,N/A,1140,1151,N/A,99,1
7,N/A,N/A,N/A,1133,1140,N/A,105,1
44,N/A,N/A,N/A,1089,1133,N/A,110,6
38,N/A,N/A,N/A,1051,1089,N/A,115,5
17,N/A,N/A,N/A,1034,1051,N/A,119,3
18,N/A,N/A,N/A,1016,1034,N/A,125,3
20,N/A,N/A,N/A,996,1016,N/A,131,3
43,N/A,N/A,N/A,953,996,N/A,134,6
28,N/A,N/A,N/A,925,953,N/A,138,4
12,N/A,N/A,N/A,913,925,N/A,141,1
43,N/A,N/A,N/A,870,913,N/A,146,6
22,N/A,N/A,N/A,862,884,N/A,5,4
7,N/A,N/A,N/A,855,862,N/A,8,1
32,N/A,N/A,N/A,823,855,N/A,12,5
19,N/A,N/A,N/A,804,823,N/A,16,3
19,N/A,N/A,N/A,785,804,N/A,22,3
42,N/A,N/A,N/A,743,785,N/A,25,6
9,N/A,N/A,N/A,734,743,N/A,31,0
44,N/A,N/A,N/A,690,734,N/A,37,6
34,N/A,N/A,N/A,656,690,N/A,42,5
10,N/A,N/A,N/A,646,656,N/A,45,2
44,N/A,N/A,N/A,602,646,N/A,49,6
37,N/A,N/A,N/A,565,602,N/A,54,5
13,N/A,N/A,N/A,552,565,N/A,57,2
33,N/A,N/A,N/A,519,552,N/A,60,5
21,N/A,N/A,N/A,498,519,N/A,64,3
22,N/A,N/A,N/A,476,498,N/A,70,3
23,N/A,N/A,N/A,453,476,N/A,76,3
43,N/A,N/A,N/A,410,453,N/A,79,6
34,N/A,N/A,N/A,376,410,N/A,84,5
12,N/A,N/A,N/A,364,376,N/A,87,2
13,N/A,N/A,N/A,351,364,N/A,92,1
43,N/A,N/A,N/A,308,351,N/A,97,6
27,N/A,N/A,N/A,281,308,N/A,101,4
14,N/A,N/A,N/A,267,281,N/A,104,1
12,N/A,N/A,N/A,255,267,N/A,110,1
42,N/A,N/A,N/A,213,255,N/A,115,6
26,N/A,N/A,N/A,187,213,N/A,119,4
31,N/A,N/A,N/A,156,187,N/A,125,4
12,N/A,N/A,N/A,144,156,N/A,128,1
36,N/A,N/A,N/A,108,144,N/A,132,5
30,N/A,N/A,N/A,1799,1829,N/A,3,4
27,N/A,N/A,N/A,1772,1799,N/A,9,4
8,N/A,N/A,N/A,1764,1772,N/A,12,1
22,N/A,N/A,N/A,1742,1764,N/A,15,4
22,N/A,N/A,N/A,1720,1742,N/A,20,3
11,N/A,N/A,N/A,1709,1720,N/A,25,2
41,N/A,N/A,N/A,1668,1709,N/A,29,6
25,N/A,N/A,N/A,1643,1668,N/A,33,4
16,N/A,N/A,N/A,1627,1643,N/A,38,3
13,N/A,N/A,N/A,1614,1627,N/A,42,1
30,N/A,N/A,N/A,1584,1614,N/A,45,4
9,N/A,N/A,N/A,1575,1584,N/A,48,1
7,N/A,N/A,N/A,1568,1575,N/A,54,1
42,N/A,N/A,N/A,1526,1568,N/A,59,6
26,N/A,N/A,N/A,1500,1526,N/A,63,4
9,N/A,N/A,N/A,1491,1500,N/A,66,1
43,N/A,N/A,N/A,1448,1491,N/A,71,6
22,N/A,N/A,N/A,1426,1448,N/A,75,4
16,N/A,N/A,N/A,1410,1426,N/A,79,2
10,N/A,N/A,N/A,1400,1410,N/A,85,2
35,N/A,N/A,N/A,1365,1400,N/A,88,5
26,N/A,N/A,N/A,1339,1365,N/A,93,4
21,N/A,N/A,N/A,1318,1339,N/A,98,3
20,N/A,N/A,N/A,1298,1318,N/A,104,3
22,N/A,N/A,N/A,1276,1298,N/A,110,3
10,N/A,N/A,N/A,1266,1276,N/A,114,1
38,N/A,N/A,N/A,1228,1266,N/A,118,5
13,N/A,N/A,N/A,1215,1228,N/A,121,2
14,N/A,N/A,N/A,1201,1215,N/A,126,1
12,N/A,N/A,N/A,1189,1201,N/A,132,1
32,N/A,N/A,N/A,728,760,N/A,3,4
16,N/A,N/A,N/A,712,728,N/A,7,2
15,N/A,N/A,N/A,697,712,N/A,13,2
13,N/A,N/A,N/A,684,697,N/A,18,1
42,N/A,N/A,N/A,642,684,N/A,23,6
25,N/A,N/A,N/A,617,642,N/A,27,4
15,N/A,N/A,N/A,602,617,N/A,32,3
43,N/A,N/A,N/A,559,602,N/A,35,6
32,N/A,N/A,N/A,527,559,N/A,39,4
7,N/A,N/A,N/A,520,527,N/A,42,1
13,N/A,N/A,N/A,507,520,N/A,48,1
12,N/A,N/A,N/A,495,507,N/A,54,1
37,N/A,N/A,N/A,458,495,N/A,58,5
38,N/A,N/A,N/A,420,458,N/A,64,5
36,N/A,N/A,N/A,384,420,N/A,70,5
15,N/A,N/A,N/A,369,384,N/A,73,2
42,N/A,N/A,N/A,327,369,N/A,77,6
39,N/A,N/A,N/A,288,327,N/A,82,5
21,N/A,N/A,N/A,267,288,N/A,86,3
43,N/A,N/A,N/A,224,267,N/A,89,6
9,N/A,N/A,N/A,215,224,N/A,95,0
36,N/A,N/A,N/A,179,215,N/A,100,5
29,N/A,N/A,N/A,150,179,N/A,105,4
16,N/A,N/A,N/A,134,150,N/A,109,2
13,N/A,N/A,N/A,121,134,N/A,115,2
14,N/A,N/A,N/A,107,121,N/A,121,2
7,N/A,N/A,N/A,100,107,N/A,126,1
28,N/A,N/A,N/A,72,100,N/A,129,4
11,N/A,N/A,N/A,61,72,N/A,132,1
43,N/A,N/A,N/A,18,61,N/A,137,6
35,N/A,N/A,N/A,1418,1453,N/A,6,5
36,N/A,N/A,N/A,1382,1418,N/A,12,5
36,N/A,N/A,N/A,1346,1382,N/A,18,5
27,N/A,N/A,N/A,1319,1346,N/A,23,4
14,N/A,N/A,N/A,1305,1319,N/A,26,1
41,N/A,N/A,N/A,1264,1305,N/A,31,6
8,N/A,N/A,N/A,1256,1264,N/A,37,0
43,N/A,N/A,N/A,1213,1256,N/A,43,6
23,N/A,N/A,N/A,1190,1213,N/A,47,4
19,N/A,N/A,N/A,1171,1190,N/A,52,3
14,N/A,N/A,N/A,1157,1171,N/A,57,2
17,N/A,N/A,N/A,1140,1157,N/A,63,2
44,N/A,N/A,N/A,1096,1140,N/A,67,6
32,N/A,N/A,N/A,1064,1096,N/A,71,4
30,N/A,N/A,N/A,1034,1064,N/A,77,4
24,N/A,N/A,N/A,1010,1034,N/A,83,4
9,N/A,N/A,N/A,1001,1010,N/A,86,1
44,N/A,N/A,N/A,957,1001,N/A,91,6
30,N/A,N/A,N/A,927,957,N/A,95,4
13,N/A,N/A,N/A,914,927,N/A,99,2
12,N/A,N/A,N/A,902,914,N/A,104,1
9,N/A,N/A,N/A,893,902,N/A,110,1
41,N/A,N/A,N/A,852,893,N/A,115,6
28,N/A,N/A,N/A,824,852,N/A,119,4
13,N/A,N/A,N/A,811,824,N/A,122,1
44,N/A,N/A,N/A,767,811,N/A,127,6
22,N/A,N/A,N/A,745,767,N/A,130,3
11,N/A,N/A,N/A,734,745,N/A,135,2
14,N/A,N/A,N/A,720,734,N/A,141,2
44,N/A,N/A,N/A,676,720,N/A,145,6
14,N/A,N/A,N/A,684,698,N/A,4,1
36,N/A,N/A,N/A,648,684,N/A,8,5
20,N/A,N/A,N/A,628,648,N/A,12,3
18,N/A,N/A,N/A,610,628,N/A,18,3
20,N/A,N/A,N/A,590,610,N/A,24,3
8,N/A,N/A,N/A,582,590,N/A,28,1
42,N/A,N/A,N/A,540,582,N/A,33,6
27,N/A,N/A,N/A,513,540,N/A,37,4
21,N/A,N/A,N/A,492,513,N/A,42,3
12,N/A,N/A,N/A,480,492,N/A,47,2
34,N/A,N/A,N/A,446,480,N/A,50,5
25,N/A,N/A,N/A,421,446,N/A,55,4
19,N/A,N/A,N/A,402,421,N/A,60,3
17,N/A,N/A,N/A,385,402,N/A,66,3
9,N/A,N/A,N/A,376,385,N/A,70,1
7,N/A,N/A,N/A,369,376,N/A,76,1
38,N/A,N/A,N/A,331,369,N/A,80,5
38,N/A,N/A,N/A,293,331,N/A,86,5
24,N/A,N/A,N/A,269,293,N/A,91,4
23,N/A,N/A,N/A,246,269,N/A,96,3
44,N/A,N/A,N/A,202,246,N/A,99,6
33,N/A,N/A,N/A,169,202,N/A,104,5
36,N/A,N/A,N/A,133,169,N/A,110,5
34,N/A,N/A,N/A,99,133,N/A,116,5
32,N/A,N/A,N/A,67,99,N/A,122,5
27,N/A,N/A,N/A,40,67,N/A,127,4
10,N/A,N/A,N/A,30,40,N/A,131,2
34,N/A,N/A,N/A,-4,30,N/A,134,5
23,N/A,N/A,N/A,844,867,N/A,5,4
14,N/A,N/A,N/A,830,844,N/A,9,2
11,N/A,N/A,N/A,819,830,N/A,14,1
7,N/A,N/A,N/A,812,819,N/A,20,1
28,N/A,N/A,N/A,784,812,N/A,23,4
29,N/A,N/A,N/A,755,784,N/A,29,4
17,N/A,N/A,N/A,738,755,N/A,33,2
41,N/A,N/A,N/A,697,738,N/A,37,6
14,N/A,N/A,N/A,683,697,N/A,40,3
17,N/A,N/A,N/A,666,683,N/A,46,3
14,N/A,N/A,N/A,652,666,N/A,52,3
16,N/A,N/A,N/A,636,652,N/A,58,3
17,N/A,N/A,N/A,619,636,N/A,63,2
42,N/A,N/A,N/A,577,619,N/A,67,6
36,N/A,N/A,N/A,541,577,N/A,72,5
15,N/A,N/A,N/A,526,541,N/A,75,2
13,N/A,N/A,N/A,513,526,N/A,81,2
15,N/A,N/A,N/A,498,513,N/A,87,2
34,N/A,N/A,N/A,464,498,N/A,90,5
33,N/A,N/A,N/A,431,464,N/A,96,5
16,N/A,N/A,N/A,415,431,N/A,99,2
36,N/A,N/A,N/A,379,415,N/A,102,5
19,N/A,N/A,N/A,360,379,N/A,106,3
9,N/A,N/A,N/A,351,360,N/A,110,1
36,N/A,N/A,N/A,315,351,N/A,114,5
32,N/A,N/A,N/A,283,315,N/A,120,5
20,N/A,N/A,N/A,263,283,N/A,124,3
44,N/A,N/A,N/A,219,263,N/A,127,6
9,N/A,N/A,N/A,210,219,N/A,133,0
29,N/A,N/A,N/A,181,210,N/A,137,4
43,N/A,N/A,N/A,585,628,N/A,3,6
23,N/A,N/A,N/A,562,585,N/A,6,3
11,N/A,N/A,N/A,551,562,N/A,11,2
38,N/A,N/A,N/A,513,551,N/A,14,5
32,N/A,N/A,N/A,481,513,N/A,20,5
22,N/A,N/A,N/A,459,481,N/A,24,3
44,N/A,N/A,N/A,415,459,N/A,27,6
16,N/A,N/A,N/A,399,415,N/A,30,3
14,N/A,N/A,N/A,385,399,N/A,36,3
17,N/A,N/A,N/A,368,385,N/A,41,2
39,N/A,N/A,N/A,329,368,N/A,44,5
16,N/A,N/A,N/A,313,329,N/A,48,3
19,N/A,N/A,N/A,294,313,N/A,54,3
16,N/A,N/A,N/A,278,294,N/A,59,2
41,N/A,N/A,N/A,237,278,N/A,63,6
33,N/A,N/A,N/A,204,237,N/A,68,5
22,N/A,N/A,N/A,182,204,N/A,73,4
15,N/A,N/A,N/A,167,182,N/A,78,3
13,N/A,N/A,N/A,154,167,N/A,83,2
39,N/A,N/A,N/A,115,154,N/A,86,5
32,N/A,N/A,N/A,83,115,N/A,92,5
16,N/A,N/A,N/A,67,83,N/A,95,2
34,N/A,N/A,N/A,33,67,N/A,98,5
16,N/A,N/A,N/A,17,33,N/A,102,3
14,N/A,N/A,N/A,3,17,N/A,108,3
12,N/A,N/A,N/A,-9,3,N/A,113,2
10,N/A,N/A,N/A,1190,1200,N/A,6,1
42,N/A,N/A,N/A,1148,1190,N/A,11,6
21,N/A,N/A,N/A,1127,1148,N/A,14,3
42,N/A,N/A,N/A,1085,1127,N/A,17,6
37,N/A,N/A,N/A,1048,1085,N/A,22,5
32,N/A,N/A,N/A,1016,1048,N/A,27,4
9,N/A,N/A,N/A,1007,1016,N/A,30,1
23,N/A,N/A,N/A,984,1007,N/A,33,4
19,N/A,N/A,N/A,965,984,N/A,38,3
10,N/A,N/A,N/A,955,965,N/A,43,2
7,N/A,N/A,N/A,948,955,N/A,48,1
31,N/A,N/A,N/A,917,948,N/A,51,4
23,N/A,N/A,N/A,894,917,N/A,56,3
44,N/A,N/A,N/A,850,894,N/A,59,6
39,N/A,N/A,N/A,811,850,N/A,64,5
30,N/A,N/A,N/A,781,811,N/A,69,4
15,N/A,N/A,N/A,766,781,N/A,73,2
36,N/A,N/A,N/A,730,766,N/A,76,5
35,N/A,N/A,N/A,695,730,N/A,82,5
17,N/A,N/A,N/A,678,695,N/A,85,2
36,N/A,N/A,N/A,642,678,N/A,88,5
20,N/A,N/A,N/A,622,642,N/A,92,3
15,N/A,N/A,N/A,607,622,N/A,98,3
16,N/A,N/A,N/A,591,607,N/A,104,3
14,N/A,N/A,N/A,577,591,N/A,109,2
13,N/A,N/A,N/A,564,577,N/A,115,2
13,N/A,N/A,N/A,551,564,N/A,120,1
34,N/A,N/A,N/A,517,551,N/A,124,5
25,N/A,N/A,N/A,492,517,N/A,129,4
8,N/A,N/A,N/A,484,492,N/A,132,1
16,N/A,N/A,N/A,368,384,N/A,3,3
44,N/A,N/A,N/A,324,368,N/A,6,6
39,N/A,N/A,N/A,285,324,N/A,11,5
14,N/A,N/A,N/A,271,285,N/A,15,3
12,N/A,N/A,N/A,259,271,N/A,19,1
44,N/A,N/A,N/A,215,259,N/A,24,6
17,N/A,N/A,N/A,198,215,N/A,27,3
11,N/A,N/A,N/A,187,198,N/A,31,1
32,N/A,N/A,N/A,155,187,N/A,35,5
14,N/A,N/A,N/A,141,155,N/A,39,3
23,N/A,N/A,N/A,118,141,N/A,45,3
41,N/A,N/A,N/A,77,118,N/A,48,6
17,N/A,N/A,N/A,60,77,N/A,51,3
16,N/A,N/A,N/A,44,60,N/A,57,3
44,N/A,N/A,N/A,0,44,N/A,60,6
9,N/A,N/A,N/A,1917,1926,N/A,5,1
39,N/A,N/A,N/A,1878,1917,N/A,9,5
15,N/A,N/A,N/A,1863,1878,N/A,13,3
8,N/A,N/A,N/A,1855,1863,N/A,17,1
41,N/A,N/A,N/A,1814,1855,N/A,22,6
22,N/A,N/A,N/A,1792,1814,N/A,25,3
13,N/A,N/A,N/A,1779,1792,N/A,29,1
12,N/A,N/A,N/A,1767,1779,N/A,35,1
11,N/A,N/A,N/A,1756,1767,N/A,41,1
44,N/A,N/A,N/A,1712,1756,N/A,46,6
21,N/A,N/A,N/A,1691,1712,N/A,49,3
44,N/A,N/A,N/A,1647,1691,N/A,52,6
6,N/A,N/A,N/A,1641,1647,N/A,58,0
24,N/A,N/A,N/A,1617,1641,N/A,62,4
31,N/A,N/A,N/A,1586,1617,N/A,68,4
21,N/A,N/A,N/A,1565,1586,N/A,73,3
12,N/A,N/A,N/A,1553,1565,N/A,77,1
25,N/A,N/A,N/A,1528,1553,N/A,80,4
31,N/A,N/A,N/A,1497,1528,N/A,86,4
11,N/A,N/A,N/A,1486,1497,N/A,89,1
43,N/A,N/A,N/A,1443,1486,N/A,94,6
20,N/A,N/A,N/A,1423,1443,N/A,97,3
10,N/A,N/A,N/A,1413,1423,N/A,102,2
11,N/A,N/A,N/A,1402,1413,N/A,107,1
33,N/A,N/A,N/A,1369,1402,N/A,111,5
22,N/A,N/A,N/A,1347,1369,N/A,115,3
42,N/A,N/A,N/A,1305,1347,N/A,118,6
25,N/A,N/A,N/A,1280,1305,N/A,122,4
11,N/A,N/A,N/A,1269,1280,N/A,125,1
43,N/A,N/A,N/A,1226,1269,N/A,130,6
22,N/A,N/A,N/A,1741,1763,N/A,3,3
12,N/A,N/A,N/A,1729,1741,N/A,8,2
13,N/A,N/A,N/A,1716,1729,N/A,13,1
36,N/A,N/A,N/A,1680,1716,N/A,17,5
20,N/A,N/A,N/A,1660,1680,N/A,21,3
7,N/A,N/A,N/A,1653,1660,N/A,25,1
44,N/A,N/A,N/A,1609,1653,N/A,30,6
5,N/A,N/A,N/A,1604,1609,N/A,36,0
16,N/A,N/A,N/A,1588,1604,N/A,39,3
19,N/A,N/A,N/A,1569,1588,N/A,45,3
10,N/A,N/A,N/A,1559,1569,N/A,49,1
43,N/A,N/A,N/A,1516,1559,N/A,54,6
27,N/A,N/A,N/A,1489,1516,N/A,58,4
14,N/A,N/A,N/A,1475,1489,N/A,61,1
33,N/A,N/A,N/A,1442,1475,N/A,65,5
31,N/A,N/A,N/A,1411,1442,N/A,70,4
13,N/A,N/A,N/A,1398,1411,N/A,73,1
14,N/A,N/A,N/A,1384,1398,N/A,79,1
32,N/A,N/A,N/A,1352,1384,N/A,83,5
14,N/A,N/A,N/A,1338,1352,N/A,87,3
16,N/A,N/A,N/A,1322,1338,N/A,93,3
7,N/A,N/A,N/A,1315,1322,N/A,97,1
42,N/A,N/A,N/A,1273,1315,N/A,102,6
38,N/A,N/A,N/A,1235,1273,N/A,107,5
23,N/A,N/A,N/A,1212,1235,N/A,112,4
11,N/A,N/A,N/A,1201,1212,N/A,115,1
34,N/A,N/A,N/A,1167,1201,N/A,119,5
39,N/A,N/A,N/A,1128,1167,N/A,125,5
27,N/A,N/A,N/A,1101,1128,N/A,130,4
21,N/A,N/A,N/A,1080,1101,N/A,135,3
9,N/A,N/A,N/A,917,926,N/A,3,1
36,N/A,N/A,N/A,881,917,N/A,7,5
22,N/A,N/A,N/A,859,881,N/A,12,4
12,N/A,N/A,N/A,847,859,N/A,15,1
36,N/A,N/A,N/A,811,847,N/A,19,5
35,N/A,N/A,N/A,776,811,N/A,25,5
19,N/A,N/A,N/A,757,776,N/A,29,3
18,N/A,N/A,N/A,739,757,N/A,35,3
14,N/A,N/A,N/A,725,739,N/A,40,2
13,N/A,N/A,N/A,712,725,N/A,45,1
42,N/A,N/A,N/A,670,712,N/A,50,6
6,N/A,N/A,N/A,664,670,N/A,56,0
29,N/A,N/A,N/A,635,664,N/A,60,4
27,N/A,N/A,N/A,608,635,N/A,66,4
26,N/A,N/A,N/A,582,608,N/A,72,4
14,N/A,N/A,N/A,568,582,N/A,77,3
12,N/A,N/A,N/A,556,568,N/A,82,2
32,N/A,N/A,N/A,524,556,N/A,85,5
28,N/A,N/A,N/A,496,524,N/A,90,4
8,N/A,N/A,N/A,488,496,N/A,93,1
41,N/A,N/A,N/A,447,488,N/A,98,6
30,N/A,N/A,N/A,417,447,N/A,102,4
17,N/A,N/A,N/A,400,417,N/A,107,3
14,N/A,N/A,N/A,386,400,N/A,111,1
38,N/A,N/A,N/A,348,386,N/A,115,5
16,N/A,N/A,N/A,332,348,N/A,119,3
43,N/A,N/A,N/A,289,332,N/A,122,6
39,N/A,N/A,N/A,250,289,N/A,127,5
32,N/A,N/A,N/A,218,250,N/A,133,5
14,N/A,N/A,N/A,204,218,N/A,136,2
38,N/A,N/A,N/A,661,699,N/A,3,5
11,N/A,N/A,N/A,650,661,N/A,6,2
13,N/A,N/A,N/A,637,650,N/A,11,1
9,N/A,N/A,N/A,628,637,N/A,17,1
35,N/A,N/A,N/A,593,628,N/A,21,5
12,N/A,N/A,N/A,581,593,N/A,24,2
16,N/A,N/A,N/A,565,581,N/A,30,2
10,N/A,N/A,N/A,555,565,N/A,35,1
38,N/A,N/A,N/A,517,555,N/A,39,5
30,N/A,N/A,N/A,487,517,N/A,44,4
18,N/A,N/A,N/A,469,487,N/A,49,3
43,N/A,N/A,N/A,426,469,N/A,52,6
19,N/A,N/A,N/A,407,426,N/A,55,3
11,N/A,N/A,N/A,396,407,N/A,60,2
42,N/A,N/A,N/A,354,396,N/A,64,6
38,N/A,N/A,N/A,316,354,N/A,69,5
37,N/A,N/A,N/A,279,316,N/A,75,5
33,N/A,N/A,N/A,246,279,N/A,81,5
10,N/A,N/A,N/A,236,246,N/A,84,2
34,N/A,N/A,N/A,202,236,N/A,87,5
26,N/A,N/A,N/A,176,202,N/A,92,4
10,N/A,N/A,N/A,166,176,N/A,96,2
41,N/A,N/A,N/A,125,166,N/A,100,6
20,N/A,N/A,N/A,105,125,N/A,103,3
17,N/A,N/A,N/A,88,105,N/A,108,2
37,N/A,N/A,N/A,51,88,N/A,111,5
27,N/A,N/A,N/A,24,51,N/A,116,4
10,N/A,N/A,N/A,14,24,N/A,120,2
44,N/A,N/A,N/A,-30,14,N/A,124,6
12,N/A,N/A,N/A,1042,1054,N/A,4,1
32,N/A,N/A,N/A,1010,1042,N/A,7,4
27,N/A,N/A,N/A,983,1010,N/A,13,4
10,N/A,N/A,N/A,973,983,N/A,16,1
41,N/A,N/A,N/A,932,973,N/A,21,6
8,N/A,N/A,N/A,924,932,N/A,27,0
32,N/A,N/A,N/A,892,924,N/A,32,5
11,N/A,N/A,N/A,881,892,N/A,35,2
42,N/A,N/A,N/A,839,881,N/A,39,6
23,N/A,N/A,N/A,816,839,N/A,43,4
16,N/A,N/A,N/A,800,816,N/A,47,2
34,N/A,N/A,N/A,766,800,N/A,50,5
17,N/A,N/A,N/A,749,766,N/A,54,3
17,N/A,N/A,N/A,732,749,N/A,60,3
11,N/A,N/A,N/A,721,732,N/A,65,2
8,N/A,N/A,N/A,713,721,N/A,70,1
34,N/A,N/A,N/A,679,713,N/A,74,5
16,N/A,N/A,N/A,663,679,N/A,78,3
41,N/A,N/A,N/A,622,663,N/A,81,6
6,N/A,N/A,N/A,616,622,N/A,87,0
42,N/A,N/A,N/A,574,616,N/A,93,6
26,N/A,N/A,N/A,548,574,N/A,97,4
14,N/A,N/A,N/A,534,548,N/A,101,2
9,N/A,N/A,N/A,525,534,N/A,106,1
33,N/A,N/A,N/A,492,525,N/A,110,5
38,N/A,N/A,N/A,454,492,N/A,116,5
17,N/A,N/A,N/A,437,454,N/A,119,2
12,N/A,N/A,N/A,425,437,N/A,125,2
37,N/A,N/A,N/A,388,425,N/A,128,5
21,N/A,N/A,N/A,367,388,N/A,132,3
26,N/A,N/A,N/A,751,777,N/A,5,4
15,N/A,N/A,N/A,736,751,N/A,9,2
37,N/A,N/A,N/A,699,736,N/A,12,5
10,N/A,N/A,N/A,689,699,N/A,15,2
13,N/A,N/A,N/A,676,689,N/A,20,1
42,N/A,N/A,N/A,634,676,N/A,25,6
5,N/A,N/A,N/A,629,634,N/A,31,0
37,N/A,N/A,N/A,592,629,N/A,36,5
23,N/A,N/A,N/A,569,592,N/A,40,3
13,N/A,N/A,N/A,556,569,N/A,44,1
24,N/A,N/A,N/A,532,556,N/A,47,4
23,N/A,N/A,N/A,509,532,N/A,52,3
42,N/A,N/A,N/A,467,509,N/A,55,6
25,N/A,N/A,N/A,442,467,N/A,59,4
16,N/A,N/A,N/A,426,442,N/A,63,2
39,N/A,N/A,N/A,387,426,N/A,66,5
21,N/A,N/A,N/A,366,387,N/A,70,3
10,N/A,N/A,N/A,356,366,N/A,74,1
12,N/A,N/A,N/A,344,356,N/A,80,1
32,N/A,N/A,N/A,312,344,N/A,84,5
27,N/A,N/A,N/A,285,312,N/A,89,4
21,N/A,N/A,N/A,264,285,N/A,94,3
21,N/A,N/A,N/A,243,264,N/A,100,3
18,N/A,N/A,N/A,225,243,N/A,106,3
42,N/A,N/A,N/A,183,225,N/A,109,6
15,N/A,N/A,N/A,168,183,N/A,112,3
10,N/A,N/A,N/A,158,168,N/A,117,2
35,N/A,N/A,N/A,123,158,N/A,120,5
18,N/A,N/A,N/A,105,123,N/A,124,3
13,N/A,N/A,N/A,92,105,N/A,128,1
36,N/A,N/A,N/A,1535,1571,N/A,4,5
25,N/A,N/A,N/A,1510,1535,N/A,9,4
18,N/A,N/A,N/A,1492,1510,N/A,14,3
16,N/A,N/A,N/A,1476,1492,N/A,20,3
14,N/A,N/A,N/A,1462,1476,N/A,24,1
27,N/A,N/A,N/A,1435,1462,N/A,27,4
9,N/A,N/A,N/A,1426,1435,N/A,30,1
39,N/A,N/A,N/A,1387,1426,N/A,34,5
26,N/A,N/A,N/A,1361,1387,N/A,39,4
7,N/A,N/A,N/A,1354,1361,N/A,42,1
44,N/A,N/A,N/A,1310,1354,N/A,47,6
18,N/A,N/A,N/A,1292,1310,N/A,50,3
44,N/A,N/A,N/A,1248,1292,N/A,53,6
19,N/A,N/A,N/A,1229,1248,N/A,56,3
43,N/A,N/A,N/A,1186,1229,N/A,59,6
32,N/A,N/A,N/A,1154,1186,N/A,64,5
36,N/A,N/A,N/A,1118,1154,N/A,70,5
25,N/A,N/A,N/A,1093,1118,N/A,75,4
16,N/A,N/A,N/A,1077,1093,N/A,79,2
8,N/A,N/A,N/A,1069,1077,N/A,84,1
41,N/A,N/A,N/A,1028,1069,N/A,89,6
9,N/A,N/A,N/A,1019,1028,N/A,95,0
42,N/A,N/A,N/A,977,1019,N/A,101,6
23,N/A,N/A,N/A,954,977,N/A,104,3
16,N/A,N/A,N/A,938,954,N/A,110,3
16,N/A,N/A,N/A,922,938,N/A,115,2
13,N/A,N/A,N/A,909,922,N/A,121,2
33,N/A,N/A,N/A,876,909,N/A,124,5
31,N/A,N/A,N/A,845,876,N/A,129,4
8,N/A,N/A,N/A,837,845,N/A,132,1
23,N/A,N/A,N/A,919,942,N/A,6,4
17,N/A,N/A,N/A,902,919,N/A,10,2
12,N/A,N/A,N/A,890,902,N/A,15,1
7,N/A,N/A,N/A,883,890,N/A,21,1
41,N/A,N/A,N/A,842,883,N/A,26,6
34,N/A,N/A,N/A,808,842,N/A,31,5
15,N/A,N/A,N/A,793,808,N/A,34,2
11,N/A,N/A,N/A,782,793,N/A,40,2
44,N/A,N/A,N/A,738,782,N/A,44,6
22,N/A,N/A,N/A,716,738,N/A,48,4
23,N/A,N/A,N/A,693,716,N/A,54,4
17,N/A,N/A,N/A,676,693,N/A,58,2
39,N/A,N/A,N/A,637,676,N/A,61,5
22,N/A,N/A,N/A,615,637,N/A,65,3
13,N/A,N/A,N/A,602,615,N/A,69,1
11,N/A,N/A,N/A,591,602,N/A,75,1
10,N/A,N/A,N/A,581,591,N/A,81,1
14,N/A,N/A,N/A,567,581,N/A,87,1
11,N/A,N/A,N/A,556,567,N/A,93,1
11,N/A,N/A,N/A,545,556,N/A,99,1
42,N/A,N/A,N/A,503,545,N/A,104,6
36,N/A,N/A,N/A,467,503,N/A,109,5
36,N/A,N/A,N/A,431,467,N/A,115,5
17,N/A,N/A,N/A,414,431,N/A,119,3
14,N/A,N/A,N/A,400,414,N/A,125,3
16,N/A,N/A,N/A,384,400,N/A,131,3
10,N/A,N/A,N/A,374,384,N/A,135,1
41,N/A,N/A,N/A,333,374,N/A,140,6
35,N/A,N/A,N/A,298,333,N/A,145,5
22,N/A,N/A,N/A,276,298,N/A,149,3
43,N/A,N/A,N/A,1010,1053,N/A,4,6
22,N/A,N/A,N/A,988,1010,N/A,8,4
10,N/A,N/A,N/A,978,988,N/A,12,2
8,N/A,N/A,N/A,970,978,N/A,17,1
8,N/A,N/A,N/A,962,970,N/A,23,1
39,N/A,N/A,N/A,923,962,N/A,27,5
37,N/A,N/A,N/A,886,923,N/A,33,5
37,N/A,N/A,N/A,849,886,N/A,39,5
16,N/A,N/A,N/A,833,849,N/A,42,2
16,N/A,N/A,N/A,817,833,N/A,48,2
13,N/A,N/A,N/A,804,817,N/A,54,2
34,N/A,N/A,N/A,770,804,N/A,57,5
11,N/A,N/A,N/A,759,770,N/A,60,2
15,N/A,N/A,N/A,744,759,N/A,66,2
36,N/A,N/A,N/A,708,744,N/A,69,5
30,N/A,N/A,N/A,678,708,N/A,74,4
16,N/A,N/A,N/A,662,678,N/A,78,2
39,N/A,N/A,N/A,623,662,N/A,81,5
11,N/A,N/A,N/A,612,623,N/A,84,2
17,N/A,N/A,N/A,595,612,N/A,90,2
43,N/A,N/A,N/A,552,595,N/A,94,6
21,N/A,N/A,N/A,531,552,N/A,97,3
23,N/A,N/A,N/A,508,531,N/A,103,3
10,N/A,N/A,N/A,498,508,N/A,107,1
9,N/A,N/A,N/A,489,498,N/A,113,1
32,N/A,N/A,N/A,457,489,N/A,116,4
13,N/A,N/A,N/A,444,457,N/A,120,2
34,N/A,N/A,N/A,410,444,N/A,123,5
23,N/A,N/A,N/A,387,410,N/A,127,3
13,N/A,N/A,N/A,374,387,N/A,132,2
34,N/A,N/A,N/A,1306,1340,N/A,5,5
21,N/A,N/A,N/A,1285,1306,N/A,9,3
13,N/A,N/A,N/A,1272,1285,N/A,14,2
39,N/A,N/A,N/A,1233,1272,N/A,17,5
38,N/A,N/A,N/A,1195,1233,N/A,23,5
19,N/A,N/A,N/A,1176,1195,N/A,27,3
43,N/A,N/A,N/A,1133,1176,N/A,30,6
26,N/A,N/A,N/A,1107,1133,N/A,34,4
13,N/A,N/A,N/A,1094,1107,N/A,37,1
11,N/A,N/A,N/A,1083,1094,N/A,43,1
12,N/A,N/A,N/A,1071,1083,N/A,49,1
23,N/A,N/A,N/A,1048,1071,N/A,52,4
21,N/A,N/A,N/A,1027,1048,N/A,57,3
10,N/A,N/A,N/A,1017,1027,N/A,61,1
41,N/A,N/A,N/A,976,1017,N/A,66,6
31,N/A,N/A,N/A,945,976,N/A,70,4
12,N/A,N/A,N/A,933,945,N/A,73,1
32,N/A,N/A,N/A,901,933,N/A,76,4
11,N/A,N/A,N/A,890,901,N/A,79,1
41,N/A,N/A,N/A,849,890,N/A,84,6
24,N/A,N/A,N/A,825,849,N/A,88,4
12,N/A,N/A,N/A,813,825,N/A,91,1
25,N/A,N/A,N/A,788,813,N/A,94,4
20,N/A,N/A,N/A,768,788,N/A,99,3
18,N/A,N/A,N/A,750,768,N/A,105,3
41,N/A,N/A,N/A,709,750,N/A,108,6
7,N/A,N/A,N/A,702,709,N/A,114,0
36,N/A,N/A,N/A,666,702,N/A,119,5
10,N/A,N/A,N/A,656,666,N/A,122,2
35,N/A,N/A,N/A,621,656,N/A,125,5
11,N/A,N/A,N/A,904,915,N/A,3,1
33,N/A,N/A,N/A,871,904,N/A,7,5
37,N/A,N/A,N/A,834,871,N/A,13,5
31,N/A,N/A,N/A,803,834,N/A,18,4
32,N/A,N/A,N/A,771,803,N/A,24,4
26,N/A,N/A,N/A,745,771,N/A,30,4
21,N/A,N/A,N/A,724,745,N/A,35,3
41,N/A,N/A,N/A,683,724,N/A,38,6
29,N/A,N/A,N/A,654,683,N/A,42,4
14,N/A,N/A,N/A,640,654,N/A,47,3
44,N/A,N/A,N/A,596,640,N/A,50,6
6,N/A,N/A,N/A,590,596,N/A,56,0
43,N/A,N/A,N/A,547,590,N/A,62,6
22,N/A,N/A,N/A,525,547,N/A,66,4
23,N/A,N/A,N/A,502,525,N/A,72,4
27,N/A,N/A,N/A,475,502,N/A,78,4
20,N/A,N/A,N/A,455,475,N/A,83,3
13,N/A,N/A,N/A,442,455,N/A,88,2
12,N/A,N/A,N/A,430,442,N/A,93,1
32,N/A,N/A,N/A,398,430,N/A,97,5
32,N/A,N/A,N/A,366,398,N/A,103,5
34,N/A,N/A,N/A,332,366,N/A,109,5
14,N/A,N/A,N/A,318,332,N/A,113,3
11,N/A,N/A,N/A,307,318,N/A,117,1
12,N/A,N/A,N/A,295,307,N/A,123,1
24,N/A,N/A,N/A,271,295,N/A,126,4
13,N/A,N/A,N/A,258,271,N/A,130,2
10,N/A,N/A,N/A,248,258,N/A,136,2
14,N/A,N/A,N/A,234,248,N/A,141,1
8,N/A,N/A,N/A,226,234,N/A,147,1
27,N/A,N/A,N/A,601,628,N/A,4,4
15,N/A,N/A,N/A,586,601,N/A,8,2
42,N/A,N/A,N/A,544,586,N/A,12,6
36,N/A,N/A,N/A,508,544,N/A,17,5
13,N/A,N/A,N/A,495,508,N/A,20,2
13,N/A,N/A,N/A,482,495,N/A,26,2
41,N/A,N/A,N/A,441,482,N/A,30,6
6,N/A,N/A,N/A,435,441,N/A,36,0
18,N/A,N/A,N/A,417,435,N/A,39,3
11,N/A,N/A,N/A,406,417,N/A,43,1
35,N/A,N/A,N/A,371,406,N/A,47,5
26,N/A,N/A,N/A,345,371,N/A,52,4
23,N/A,N/A,N/A,322,345,N/A,57,3
20,N/A,N/A,N/A,302,322,N/A,63,3
43,N/A,N/A,N/A,259,302,N/A,66,6
34,N/A,N/A,N/A,225,259,N/A,71,5
35,N/A,N/A,N/A,190,225,N/A,77,5
22,N/A,N/A,N/A,168,190,N/A,81,3
12,N/A,N/A,N/A,156,168,N/A,85,1
31,N/A,N/A,N/A,125,156,N/A,88,4
15,N/A,N/A,N/A,110,125,N/A,92,2
32,N/A,N/A,N/A,78,110,N/A,95,5
17,N/A,N/A,N/A,61,78,N/A,98,2
35,N/A,N/A,N/A,26,61,N/A,101,5
32,N/A,N/A,N/A,-6,26,N/A,107,5
41,N/A,N/A,N/A,1463,1504,N/A,5,6
32,N/A,N/A,N/A,1431,1463,N/A,9,4
7,N/A,N/A,N/A,1424,1431,N/A,12,1
35,N/A,N/A,N/A,1389,1424,N/A,16,5
16,N/A,N/A,N/A,1373,1389,N/A,20,3
15,N/A,N/A,N/A,1358,1373,N/A,26,3
43,N/A,N/A,N/A,1315,1358,N/A,29,6
16,N/A,N/A,N/A,1299,1315,N/A,32,3
12,N/A,N/A,N/A,1287,1299,N/A,37,2
43,N/A,N/A,N/A,1244,1287,N/A,41,6
26,N/A,N/A,N/A,1218,1244,N/A,45,4
25,N/A,N/A,N/A,1193,1218,N/A,51,4
7,N/A,N/A,N/A,1186,1193,N/A,54,1
14,N/A,N/A,N/A,1172,1186,N/A,60,1
41,N/A,N/A,N/A,1131,1172,N/A,65,6
27,N/A,N/A,N/A,1104,1131,N/A,69,4
11,N/A,N/A,N/A,1093,1104,N/A,73,2
37,N/A,N/A,N/A,1056,1093,N/A,76,5
16,N/A,N/A,N/A,1040,1056,N/A,80,3
19,N/A,N/A,N/A,1021,1040,N/A,86,3
17,N/A,N/A,N/A,1004,1021,N/A,91,2
14,N/A,N/A,N/A,990,1004,N/A,96,1
31,N/A,N/A,N/A,959,990,N/A,99,4
13,N/A,N/A,N/A,946,959,N/A,102,1
35,N/A,N/A,N/A,911,946,N/A,106,5
17,N/A,N/A,N/A,894,911,N/A,109,2
42,N/A,N/A,N/A,852,894,N/A,113,6
35,N/A,N/A,N/A,817,852,N/A,118,5
16,N/A,N/A,N/A,801,817,N/A,122,3
11,N/A,N/A,N/A,790,801,N/A,127,2
19,N/A,N/A,N/A,1468,1487,N/A,4,3
11,N/A,N/A,N/A,1457,1468,N/A,9,2
8,N/A,N/A,N/A,1449,1457,N/A,14,1
43,N/A,N/A,N/A,1406,1449,N/A,19,6
5,N/A,N/A,N/A,1401,1406,N/A,25,0
23,N/A,N/A,N/A,1378,1401,N/A,28,3
41,N/A,N/A,N/A,1337,1378,N/A,31,6
9,N/A,N/A,N/A,1328,1337,N/A,37,0
32,N/A,N/A,N/A,1296,1328,N/A,42,5
15,N/A,N/A,N/A,1281,1296,N/A,46,3
18,N/A,N/A,N/A,1263,1281,N/A,52,3
12,N/A,N/A,N/A,1251,1263,N/A,56,1
35,N/A,N/A,N/A,1216,1251,N/A,60,5
15,N/A,N/A,N/A,1201,1216,N/A,63,2
10,N/A,N/A,N/A,1191,1201,N/A,69,2
37,N/A,N/A,N/A,1154,1191,N/A,72,5
31,N/A,N/A,N/A,1123,1154,N/A,77,4
31,N/A,N/A,N/A,1092,1123,N/A,83,4
13,N/A,N/A,N/A,1079,1092,N/A,86,1
9,N/A,N/A,N/A,1070,1079,N/A,92,1
33,N/A,N/A,N/A,1037,1070,N/A,96,5
22,N/A,N/A,N/A,1015,1037,N/A,101,4
16,N/A,N/A,N/A,999,1015,N/A,105,2
12,N/A,N/A,N/A,987,999,N/A,110,1
34,N/A,N/A,N/A,953,987,N/A,114,5
16,N/A,N/A,N/A,937,953,N/A,117,2
38,N/A,N/A,N/A,899,937,N/A,120,5
27,N/A,N/A,N/A,872,899,N/A,125,4
13,N/A,N/A,N/A,859,872,N/A,128,1
26,N/A,N/A,N/A,833,859,N/A,131,4
44,N/A,N/A,N/A,1175,1219,N/A,4,6
27,N/A,N/A,N/A,1148,1175,N/A,8,4
13,N/A,N/A,N/A,1135,1148,N/A,11,1
13,N/A,N/A,N/A,1122,1135,N/A,17,1
13,N/A,N/A,N/A,1109,1122,N/A,23,1
34,N/A,N/A,N/A,1075,1109,N/A,27,5
29,N/A,N/A,N/A,1046,1075,N/A,32,4
9,N/A,N/A,N/A,1037,1046,N/A,35,1
8,N/A,N/A,N/A,1029,1037,N/A,41,1
8,N/A,N/A,N/A,1021,1029,N/A,47,1
37,N/A,N/A,N/A,984,1021,N/A,51,5
11,N/A,N/A,N/A,973,984,N/A,54,2
43,N/A,N/A,N/A,930,973,N/A,58,6
6,N/A,N/A,N/A,924,930,N/A,64,0
27,N/A,N/A,N/A,897,924,N/A,68,4
23,N/A,N/A,N/A,874,897,N/A,73,3
10,N/A,N/A,N/A,864,874,N/A,77,1
42,N/A,N/A,N/A,822,864,N/A,82,6
6,N/A,N/A,N/A,816,822,N/A,88,0
41,N/A,N/A,N/A,775,816,N/A,94,6
15,N/A,N/A,N/A,760,775,N/A,97,3
13,N/A,N/A,N/A,747,760,N/A,101,1
37,N/A,N/A,N/A,710,747,N/A,105,5
19,N/A,N/A,N/A,691,710,N/A,109,3
13,N/A,N/A,N/A,678,691,N/A,113,1
44,N/A,N/A,N/A,634,678,N/A,118,6
5,N/A,N/A,N/A,629,634,N/A,124,0
42,N/A,N/A,N/A,587,629,N/A,130,6
15,N/A,N/A,N/A,572,587,N/A,133,3
18,N/A,N/A,N/A,554,572,N/A,139,3
18,N/A,N/A,N/A,446,464,N/A,6,3
43,N/A,N/A,N/A,403,446,N/A,9,6
38,N/A,N/A,N/A,365,403,N/A,14,5
19,N/A,N/A,N/A,346,365,N/A,18,3
42,N/A,N/A,N/A,304,346,N/A,21,6
30,N/A,N/A,N/A,274,304,N/A,25,4
11,N/A,N/A,N/A,263,274,N/A,29,2
14,N/A,N/A,N/A,249,263,N/A,34,1
32,N/A,N/A,N/A,217,249,N/A,38,5
38,N/A,N/A,N/A,179,217,N/A,44,5
22,N/A,N/A,N/A,157,179,N/A,48,3
13,N/A,N/A,N/A,144,157,N/A,53,2
39,N/A,N/A,N/A,105,144,N/A,56,5
14,N/A,N/A,N/A,91,105,N/A,59,2
43,N/A,N/A,N/A,48,91,N/A,63,6
18,N/A,N/A,N/A,30,48,N/A,66,3
12,N/A,N/A,N/A,18,30,N/A,70,1
36,N/A,N/A,N/A,-18,18,N/A,74,5
23,N/A,N/A,N/A,1810,1833,N/A,6,4
14,N/A,N/A,N/A,1796,1810,N/A,9,1
43,N/A,N/A,N/A,1753,1796,N/A,14,6
14,N/A,N/A,N/A,1739,1753,N/A,17,3
8,N/A,N/A,N/A,1731,1739,N/A,21,1
23,N/A,N/A,N/A,1708,1731,N/A,24,4
14,N/A,N/A,N/A,1694,1708,N/A,29,3
15,N/A,N/A,N/A,1679,1694,N/A,35,3
43,N/A,N/A,N/A,1636,1679,N/A,38,6
16,N/A,N/A,N/A,1620,1636,N/A,41,3
12,N/A,N/A,N/A,1608,1620,N/A,45,1
44,N/A,N/A,N/A,1564,1608,N/A,50,6
6,N/A,N/A,N/A,1558,1564,N/A,56,0
41,N/A,N/A,N/A,1517,1558,N/A,62,6
25,N/A,N/A,N/A,1492,1517,N/A,66,4
23,N/A,N/A,N/A,1469,1492,N/A,72,4
13,N/A,N/A,N/A,1456,1469,N/A,75,1
38,N/A,N/A,N/A,1418,1456,N/A,79,5
13,N/A,N/A,N/A,1405,1418,N/A,82,2
44,N/A,N/A,N/A,1361,1405,N/A,86,6
20,N/A,N/A,N/A,1341,1361,N/A,89,3
7,N/A,N/A,N/A,1334,1341,N/A,93,1
36,N/A,N/A,N/A,1298,1334,N/A,97,5
32,N/A,N/A,N/A,1266,1298,N/A,102,4
11,N/A,N/A,N/A,1255,1266,N/A,105,1
39,N/A,N/A,N/A,1216,1255,N/A,109,5
33,N/A,N/A,N/A,1183,1216,N/A,115,5
15,N/A,N/A,N/A,1168,1183,N/A,119,3
19,N/A,N/A,N/A,1149,1168,N/A,125,3
10,N/A,N/A,N/A,1139,1149,N/A,129,1
7,N/A,N/A,N/A,1337,1344,N/A,4,1
34,N/A,N/A,N/A,1303,1337,N/A,8,5
11,N/A,N/A,N/A,1292,1303,N/A,11,2
34,N/A,N/A,N/A,1258,1292,N/A,14,5
24,N/A,N/A,N/A,1234,1258,N/A,19,4
10,N/A,N/A,N/A,1224,1234,N/A,22,1
11,N/A,N/A,N/A,1213,1224,N/A,28,1
25,N/A,N/A,N/A,1188,1213,N/A,31,4
13,N/A,N/A,N/A,1175,1188,N/A,34,1
38,N/A,N/A,N/A,1137,1175,N/A,38,5
35,N/A,N/A,N/A,1102,1137,N/A,44,5
32,N/A,N/A,N/A,1070,1102,N/A,50,5
19,N/A,N/A,N/A,1051,1070,N/A,54,3
16,N/A,N/A,N/A,1035,1051,N/A,59,2
42,N/A,N/A,N/A,993,1035,N/A,63,6
16,N/A,N/A,N/A,977,993,N/A,66,3
41,N/A,N/A,N/A,936,977,N/A,69,6
9,N/A,N/A,N/A,927,936,N/A,75,0
44,N/A,N/A,N/A,883,927,N/A,81,6
35,N/A,N/A,N/A,848,883,N/A,86,5
39,N/A,N/A,N/A,809,848,N/A,92,5
25,N/A,N/A,N/A,784,809,N/A,97,4
28,N/A,N/A,N/A,756,784,N/A,103,4
32,N/A,N/A,N/A,724,756,N/A,109,4
14,N/A,N/A,N/A,710,724,N/A,114,3
42,N/A,N/A,N/A,668,710,N/A,117,6
29,N/A,N/A,N/A,639,668,N/A,121,4
11,N/A,N/A,N/A,628,639,N/A,124,1
35,N/A,N/A,N/A,593,628,N/A,128,5
20,N/A,N/A,N/A,573,593,N/A,132,3
41,N/A,N/A,N/A,649,690,N/A,6,6
23,N/A,N/A,N/A,626,649,N/A,10,4
12,N/A,N/A,N/A,614,626,N/A,14,2
36,N/A,N/A,N/A,578,614,N/A,17,5
32,N/A,N/A,N/A,546,578,N/A,23,5
33,N/A,N/A,N/A,513,546,N/A,29,5
27,N/A,N/A,N/A,486,513,N/A,34,4
10,N/A,N/A,N/A,476,486,N/A,37,1
37,N/A,N/A,N/A,439,476,N/A,41,5
15,N/A,N/A,N/A,424,439,N/A,45,3
44,N/A,N/A,N/A,380,424,N/A,48,6
37,N/A,N/A,N/A,343,380,N/A,53,5
28,N/A,N/A,N/A,315,343,N/A,58,4
8,N/A,N/A,N/A,307,315,N/A,61,1
43,N/A,N/A,N/A,264,307,N/A,66,6
19,N/A,N/A,N/A,245,264,N/A,69,3
20,N/A,N/A,N/A,225,245,N/A,75,3
22,N/A,N/A,N/A,203,225,N/A,81,3
10,N/A,N/A,N/A,193,203,N/A,86,2
37,N/A,N/A,N/A,156,193,N/A,89,5
14,N/A,N/A,N/A,142,156,N/A,92,2
12,N/A,N/A,N/A,130,142,N/A,98,2
43,N/A,N/A,N/A,87,130,N/A,102,6
35,N/A,N/A,N/A,52,87,N/A,107,5
23,N/A,N/A,N/A,29,52,N/A,112,4
9,N/A,N/A,N/A,20,29,N/A,115,1
32,N/A,N/A,N/A,-12,20,N/A,119,5
43,N/A,N/A,N/A,785,828,N/A,6,6
31,N/A,N/A,N/A,754,785,N/A,10,4
13,N/A,N/A,N/A,741,754,N/A,14,2
35,N/A,N/A,N/A,706,741,N/A,17,5
13,N/A,N/A,N/A,693,706,N/A,20,2
11,N/A,N/A,N/A,682,693,N/A,25,1
41,N/A,N/A,N/A,641,682,N/A,30,6
15,N/A,N/A,N/A,626,641,N/A,33,3
43,N/A,N/A,N/A,583,626,N/A,36,6
38,N/A,N/A,N/A,545,583,N/A,41,5
33,N/A,N/A,N/A,512,545,N/A,47,5
17,N/A,N/A,N/A,495,512,N/A,50,2
14,N/A,N/A,N/A,481,495,N/A,56,2
8,N/A,N/A,N/A,473,481,N/A,61,1
42,N/A,N/A,N/A,431,473,N/A,66,6
36,N/A,N/A,N/A,395,431,N/A,71,5
29,N/A,N/A,N/A,366,395,N/A,76,4
14,N/A,N/A,N/A,352,366,N/A,80,2
10,N/A,N/A,N/A,342,352,N/A,86,2
12,N/A,N/A,N/A,330,342,N/A,92,2
10,N/A,N/A,N/A,320,330,N/A,97,1
23,N/A,N/A,N/A,297,320,N/A,100,4
14,N/A,N/A,N/A,283,297,N/A,103,1
34,N/A,N/A,N/A,249,283,N/A,107,5
28,N/A,N/A,N/A,221,249,N/A,112,4
9,N/A,N/A,N/A,212,221,N/A,115,1
11,N/A,N/A,N/A,201,212,N/A,121,1
11,N/A,N/A,N/A,190,201,N/A,127,1
13,N/A,N/A,N/A,177,190,N/A,133,1
29,N/A,N/A,N/A,148,177,N/A,136,4
42,N/A,N/A,N/A,1202,1244,N/A,3,6
6,N/A,N/A,N/A,1196,1202,N/A,9,0
35,N/A,N/A,N/A,1161,1196,N/A,14,5
32,N/A,N/A,N/A,1129,1161,N/A,20,5
35,N/A,N/A,N/A,1094,1129,N/A,26,5
17,N/A,N/A,N/A,1077,1094,N/A,29,2
43,N/A,N/A,N/A,1034,1077,N/A,33,6
22,N/A,N/A,N/A,1012,1034,N/A,36,3
19,N/A,N/A,N/A,993,1012,N/A,42,3
23,N/A,N/A,N/A,970,993,N/A,48,3
12,N/A,N/A,N/A,958,970,N/A,53,2
11,N/A,N/A,N/A,947,958,N/A,58,1
13,N/A,N/A,N/A,934,947,N/A,64,1
11,N/A,N/A,N/A,923,934,N/A,70,1
42,N/A,N/A,N/A,881,923,N/A,75,6
17,N/A,N/A,N/A,864,881,N/A,78,3
41,N/A,N/A,N/A,823,864,N/A,81,6
28,N/A,N/A,N/A,795,823,N/A,85,4
30,N/A,N/A,N/A,765,795,N/A,91,4
15,N/A,N/A,N/A,750,765,N/A,95,2
13,N/A,N/A,N/A,737,750,N/A,101,2
41,N/A,N/A,N/A,696,737,N/A,105,6
33,N/A,N/A,N/A,663,696,N/A,110,5
15,N/A,N/A,N/A,648,663,N/A,113,2
13,N/A,N/A,N/A,635,648,N/A,118,1
39,N/A,N/A,N/A,596,635,N/A,122,5
24,N/A,N/A,N/A,572,596,N/A,127,4
22,N/A,N/A,N/A,550,572,N/A,133,4
23,N/A,N/A,N/A,527,550,N/A,139,4
22,N/A,N/A,N/A,505,527,N/A,144,3
22,N/A,N/A,N/A,1094,1116,N/A,3,3
44,N/A,N/A,N/A,1050,1094,N/A,6,6
23,N/A,N/A,N/A,1027,1050,N/A,10,4
9,N/A,N/A,N/A,1018,1027,N/A,13,1
42,N/A,N/A,N/A,976,1018,N/A,18,6
6,N/A,N/A,N/A,970,976,N/A,24,0
41,N/A,N/A,N/A,929,970,N/A,30,6
5,N/A,N/A,N/A,924,929,N/A,36,0
15,N/A,N/A,N/A,909,924,N/A,39,3
14,N/A,N/A,N/A,895,909,N/A,44,2
7,N/A,N/A,N/A,888,895,N/A,49,1
11,N/A,N/A,N/A,877,888,N/A,55,1
26,N/A,N/A,N/A,851,877,N/A,58,4
14,N/A,N/A,N/A,837,851,N/A,63,3
17,N/A,N/A,N/A,820,837,N/A,69,3
42,N/A,N/A,N/A,778,820,N/A,72,6
7,N/A,N/A,N/A,771,778,N/A,78,0
14,N/A,N/A,N/A,757,771,N/A,81,3
43,N/A,N/A,N/A,714,757,N/A,84,6
32,N/A,N/A,N/A,682,714,N/A,89,5
32,N/A,N/A,N/A,650,682,N/A,94,4
12,N/A,N/A,N/A,638,650,N/A,98,2
10,N/A,N/A,N/A,628,638,N/A,104,2
41,N/A,N/A,N/A,587,628,N/A,108,6
38,N/A,N/A,N/A,549,587,N/A,113,5
27,N/A,N/A,N/A,522,549,N/A,118,4
12,N/A,N/A,N/A,510,522,N/A,122,2
12,N/A,N/A,N/A,498,510,N/A,127,1
31,N/A,N/A,N/A,467,498,N/A,130,4
17,N/A,N/A,N/A,450,467,N/A,134,2
39,N/A,N/A,N/A,493,532,N/A,3,5
13,N/A,N/A,N/A,480,493,N/A,6,2
39,N/A,N/A,N/A,441,480,N/A,9,5
32,N/A,N/A,N/A,409,441,N/A,15,5
16,N/A,N/A,N/A,393,409,N/A,18,2
43,N/A,N/A,N/A,350,393,N/A,22,6
32,N/A,N/A,N/A,318,350,N/A,27,5
35,N/A,N/A,N/A,283,318,N/A,33,5
32,N/A,N/A,N/A,251,283,N/A,39,5
37,N/A,N/A,N/A,214,251,N/A,45,5
17,N/A,N/A,N/A,197,214,N/A,48,2
9,N/A,N/A,N/A,188,197,N/A,53,1
35,N/A,N/A,N/A,153,188,N/A,57,5
17,N/A,N/A,N/A,136,153,N/A,61,3
14,N/A,N/A,N/A,122,136,N/A,66,2
12,N/A,N/A,N/A,110,122,N/A,71,1
9,N/A,N/A,N/A,101,110,N/A,77,1
35,N/A,N/A,N/A,66,101,N/A,81,5
36,N/A,N/A,N/A,30,66,N/A,87,5
23,N/A,N/A,N/A,7,30,N/A,91,3
17,N/A,N/A,N/A,-10,7,N/A,96,2
10,N/A,N/A,N/A,514,524,N/A,3,1
10,N/A,N/A,N/A,504,514,N/A,9,1
42,N/A,N/A,N/A,462,504,N/A,14,6
33,N/A,N/A,N/A,429,462,N/A,19,5
38,N/A,N/A,N/A,391,429,N/A,25,5
26,N/A,N/A,N/A,365,391,N/A,30,4
29,N/A,N/A,N/A,336,365,N/A,36,4
19,N/A,N/A,N/A,317,336,N/A,41,3
14,N/A,N/A,N/A,303,317,N/A,45,1
26,N/A,N/A,N/A,277,303,N/A,48,4
10,N/A,N/A,N/A,267,277,N/A,51,1
32,N/A,N/A,N/A,235,267,N/A,55,5
30,N/A,N/A,N/A,205,235,N/A,60,4
15,N/A,N/A,N/A,190,205,N/A,64,2
38,N/A,N/A,N/A,152,190,N/A,67,5
17,N/A,N/A,N/A,135,152,N/A,70,2
44,N/A,N/A,N/A,91,135,N/A,74,6
19,N/A,N/A,N/A,72,91,N/A,77,3
10,N/A,N/A,N/A,62,72,N/A,81,1
7,N/A,N/A,N/A,55,62,N/A,87,1
32,N/A,N/A,N/A,23,55,N/A,90,4
17,N/A,N/A,N/A,6,23,N/A,95,3
19,N/A,N/A,N/A,-13,6,N/A,101,3
18,N/A,N/A,N/A,479,497,N/A,6,3
12,N/A,N/A,N/A,467,479,N/A,10,1
34,N/A,N/A,N/A,433,467,N/A,14,5
17,N/A,N/A,N/A,416,433,N/A,18,3
23,N/A,N/A,N/A,393,416,N/A,24,3
23,N/A,N/A,N/A,370,393,N/A,30,3
7,N/A,N/A,N/A,363,370,N/A,34,1
11,N/A,N/A,N/A,352,363,N/A,40,1
43,N/A,N/A,N/A,309,352,N/A,45,6
35,N/A,N/A,N/A,274,309,N/A,50,5
29,N/A,N/A,N/A,245,274,N/A,55,4
22,N/A,N/A,N/A,223,245,N/A,61,4
19,N/A,N/A,N/A,204,223,N/A,66,3
43,N/A,N/A,N/A,161,204,N/A,69,6
6,N/A,N/A,N/A,155,161,N/A,75,0
38,N/A,N/A,N/A,117,155,N/A,80,5
25,N/A,N/A,N/A,92,117,N/A,85,4
32,N/A,N/A,N/A,60,92,N/A,91,4
26,N/A,N/A,N/A,34,60,N/A,97,4
14,N/A,N/A,N/A,20,34,N/A,102,3
22,N/A,N/A,N/A,-2,20,N/A,108,3
9,N/A,N/A,N/A,825,834,N/A,3,1
33,N/A,N/A,N/A,792,825,N/A,7,5
32,N/A,N/A,N/A,760,792,N/A,13,5
28,N/A,N/A,N/A,732,760,N/A,18,4
14,N/A,N/A,N/A,718,732,N/A,22,2
44,N/A,N/A,N/A,674,718,N/A,26,6
22,N/A,N/A,N/A,652,674,N/A,30,4
14,N/A,N/A,N/A,638,652,N/A,34,2
11,N/A,N/A,N/A,627,638,N/A,39,1
44,N/A,N/A,N/A,583,627,N/A,44,6
8,N/A,N/A,N/A,575,583,N/A,50,0
42,N/A,N/A,N/A,533,575,N/A,56,6
35,N/A,N/A,N/A,498,533,N/A,61,5
29,N/A,N/A,N/A,469,498,N/A,66,4
27,N/A,N/A,N/A,442,469,N/A,72,4
16,N/A,N/A,N/A,426,442,N/A,76,2
14,N/A,N/A,N/A,412,426,N/A,81,1
22,N/A,N/A,N/A,390,412,N/A,84,4
8,N/A,N/A,N/A,382,390,N/A,87,1
9,N/A,N/A,N/A,373,382,N/A,93,1
10,N/A,N/A,N/A,363,373,N/A,99,1
42,N/A,N/A,N/A,321,363,N/A,104,6
39,N/A,N/A,N/A,282,321,N/A,109,5
14,N/A,N/A,N/A,268,282,N/A,112,2
8,N/A,N/A,N/A,260,268,N/A,117,1
39,N/A,N/A,N/A,221,260,N/A,121,5
23,N/A,N/A,N/A,198,221,N/A,125,3
20,N/A,N/A,N/A,178,198,N/A,131,3
42,N/A,N/A,N/A,136,178,N/A,134,6
5,N/A,N/A,N/A,131,136,N/A,140,0
17,N/A,N/A,N/A,1327,1344,N/A,3,2
14,N/A,N/A,N/A,1313,1327,N/A,9,2
35,N/A,N/A,N/A,1278,1313,N/A,12,5
14,N/A,N/A,N/A,1264,1278,N/A,15,2
12,N/A,N/A,N/A,1252,1264,N/A,20,1
43,N/A,N/A,N/A,1209,1252,N/A,25,6
8,N/A,N/A,N/A,1201,1209,N/A,31,0
41,N/A,N/A,N/A,1160,1201,N/A,37,6
16,N/A,N/A,N/A,1144,1160,N/A,40,3
41,N/A,N/A,N/A,1103,1144,N/A,43,6
31,N/A,N/A,N/A,1072,1103,N/A,47,4
14,N/A,N/A,N/A,1058,1072,N/A,52,3
13,N/A,N/A,N/A,1045,1058,N/A,56,1
24,N/A,N/A,N/A,1021,1045,N/A,59,4
10,N/A,N/A,N/A,1011,1021,N/A,63,2
13,N/A,N/A,N/A,998,1011,N/A,69,2
7,N/A,N/A,N/A,991,998,N/A,74,1
11,N/A,N/A,N/A,980,991,N/A,80,1
44,N/A,N/A,N/A,936,980,N/A,85,6
7,N/A,N/A,N/A,929,936,N/A,91,0
19,N/A,N/A,N/A,910,929,N/A,94,3
13,N/A,N/A,N/A,897,910,N/A,99,2
14,N/A,N/A,N/A,883,897,N/A,105,2
13,N/A,N/A,N/A,870,883,N/A,110,1
41,N/A,N/A,N/A,829,870,N/A,115,6
29,N/A,N/A,N/A,800,829,N/A,119,4
10,N/A,N/A,N/A,790,800,N/A,122,1
44,N/A,N/A,N/A,746,790,N/A,127,6
35,N/A,N/A,N/A,711,746,N/A,132,5
18,N/A,N/A,N/A,693,711,N/A,136,3
29,N/A,N/A,N/A,1372,1401,N/A,6,4
16,N/A,N/A,N/A,1356,1372,N/A,11,3
12,N/A,N/A,N/A,1344,1356,N/A,15,1
24,N/A,N/A,N/A,1320,1344,N/A,18,4
15,N/A,N/A,N/A,1305,1320,N/A,22,2
9,N/A,N/A,N/A,1296,1305,N/A,27,1
32,N/A,N/A,N/A,1264,1296,N/A,31,5
17,N/A,N/A,N/A,1247,1264,N/A,34,2
37,N/A,N/A,N/A,1210,1247,N/A,37,5
25,N/A,N/A,N/A,1185,1210,N/A,42,4
10,N/A,N/A,N/A,1175,1185,N/A,46,2
9,N/A,N/A,N/A,1166,1175,N/A,51,1
25,N/A,N/A,N/A,1141,1166,N/A,54,4
19,N/A,N/A,N/A,1122,1141,N/A,59,3
44,N/A,N/A,N/A,1078,1122,N/A,62,6
14,N/A,N/A,N/A,1064,1078,N/A,65,3
41,N/A,N/A,N/A,1023,1064,N/A,68,6
23,N/A,N/A,N/A,1000,1023,N/A,72,4
26,N/A,N/A,N/A,974,1000,N/A,78,4
9,N/A,N/A,N/A,965,974,N/A,81,1
24,N/A,N/A,N/A,941,965,N/A,84,4
14,N/A,N/A,N/A,927,941,N/A,88,2
39,N/A,N/A,N/A,888,927,N/A,91,5
21,N/A,N/A,N/A,867,888,N/A,95,3
23,N/A,N/A,N/A,844,867,N/A,101,3
12,N/A,N/A,N/A,832,844,N/A,105,1
43,N/A,N/A,N/A,789,832,N/A,110,6
7,N/A,N/A,N/A,782,789,N/A,116,0
22,N/A,N/A,N/A,760,782,N/A,119,3
14,N/A,N/A,N/A,746,760,N/A,125,3
44,N/A,N/A,N/A,860,904,N/A,6,6
35,N/A,N/A,N/A,825,860,N/A,11,5
39,N/A,N/A,N/A,786,825,N/A,17,5
10,N/A,N/A,N/A,776,786,N/A,20,2
39,N/A,N/A,N/A,737,776,N/A,23,5
36,N/A,N/A,N/A,701,737,N/A,29,5
11,N/A,N/A,N/A,690,701,N/A,32,2
15,N/A,N/A,N/A,675,690,N/A,38,2
34,N/A,N/A,N/A,641,675,N/A,41,5
14,N/A,N/A,N/A,627,641,N/A,44,2
14,N/A,N/A,N/A,613,627,N/A,49,1
44,N/A,N/A,N/A,569,613,N/A,54,6
15,N/A,N/A,N/A,554,569,N/A,57,3
17,N/A,N/A,N/A,537,554,N/A,63,3
14,N/A,N/A,N/A,523,537,N/A,69,3
13,N/A,N/A,N/A,510,523,N/A,74,2
13,N/A,N/A,N/A,497,510,N/A,80,2
9,N/A,N/A,N/A,488,497,N/A,85,1
10,N/A,N/A,N/A,478,488,N/A,91,1
37,N/A,N/A,N/A,441,478,N/A,95,5
18,N/A,N/A,N/A,423,441,N/A,99,3
16,N/A,N/A,N/A,407,423,N/A,104,2
13,N/A,N/A,N/A,394,407,N/A,109,1
32,N/A,N/A,N/A,362,394,N/A,113,5
38,N/A,N/A,N/A,324,362,N/A,119,5
33,N/A,N/A,N/A,291,324,N/A,125,5
25,N/A,N/A,N/A,266,291,N/A,130,4
26,N/A,N/A,N/A,240,266,N/A,136,4
25,N/A,N/A,N/A,215,240,N/A,142,4
22,N/A,N/A,N/A,193,215,N/A,147,3
8,N/A,N/A,N/A,1532,1540,N/A,4,1
12,N/A,N/A,N/A,1520,1532,N/A,10,1
10,N/A,N/A,N/A,1510,1520,N/A,16,1
12,N/A,N/A,N/A,1498,1510,N/A,22,1
11,N/A,N/A,N/A,1487,1498,N/A,28,1
9,N/A,N/A,N/A,1478,1487,N/A,34,1
34,N/A,N/A,N/A,1444,1478,N/A,38,5
27,N/A,N/A,N/A,1417,1444,N/A,43,4
7,N/A,N/A,N/A,1410,1417,N/A,46,1
8,N/A,N/A,N/A,1402,1410,N/A,52,1
24,N/A,N/A,N/A,1378,1402,N/A,55,4
23,N/A,N/A,N/A,1355,1378,N/A,60,3
18,N/A,N/A,N/A,1337,1355,N/A,66,3
12,N/A,N/A,N/A,1325,1337,N/A,71,2
37,N/A,N/A,N/A,1288,1325,N/A,74,5
38,N/A,N/A,N/A,1250,1288,N/A,80,5
17,N/A,N/A,N/A,1233,1250,N/A,84,3
43,N/A,N/A,N/A,1190,1233,N/A,87,6
38,N/A,N/A,N/A,1152,1190,N/A,92,5
26,N/A,N/A,N/A,1126,1152,N/A,97,4
23,N/A,N/A,N/A,1103,1126,N/A,103,4
23,N/A,N/A,N/A,1080,1103,N/A,108,3
43,N/A,N/A,N/A,1037,1080,N/A,111,6
7,N/A,N/A,N/A,1030,1037,N/A,117,0
23,N/A,N/A,N/A,1007,1030,N/A,121,4
7,N/A,N/A,N/A,1000,1007,N/A,124,1
42,N/A,N/A,N/A,958,1000,N/A,129,6
34,N/A,N/A,N/A,924,958,N/A,134,5
39,N/A,N/A,N/A,885,924,N/A,140,5
35,N/A,N/A,N/A,850,885,N/A,146,5
29,N/A,N/A,N/A,1413,1442,N/A,4,4
11,N/A,N/A,N/A,1402,1413,N/A,8,2
34,N/A,N/A,N/A,1368,1402,N/A,11,5
32,N/A,N/A,N/A,1336,1368,N/A,17,5
37,N/A,N/A,N/A,1299,1336,N/A,23,5
24,N/A,N/A,N/A,1275,1299,N/A,28,4
30,N/A,N/A,N/A,1245,1275,N/A,34,4
26,N/A,N/A,N/A,1219,1245,N/A,40,4
23,N/A,N/A,N/A,1196,1219,N/A,46,4
10,N/A,N/A,N/A,1186,1196,N/A,49,1
31,N/A,N/A,N/A,1155,1186,N/A,52,4
11,N/A,N/A,N/A,1144,1155,N/A,56,2
17,N/A,N/A,N/A,1127,1144,N/A,62,2
16,N/A,N/A,N/A,1111,1127,N/A,68,2
33,N/A,N/A,N/A,1078,1111,N/A,71,5
34,N/A,N/A,N/A,1044,1078,N/A,77,5
12,N/A,N/A,N/A,1032,1044,N/A,80,2
10,N/A,N/A,N/A,1022,1032,N/A,85,1
23,N/A,N/A,N/A,999,1022,N/A,88,4
12,N/A,N/A,N/A,987,999,N/A,92,2
41,N/A,N/A,N/A,946,987,N/A,96,6
19,N/A,N/A,N/A,927,946,N/A,99,3
10,N/A,N/A,N/A,917,927,N/A,103,1
8,N/A,N/A,N/A,909,917,N/A,109,1
37,N/A,N/A,N/A,872,909,N/A,113,5
17,N/A,N/A,N/A,855,872,N/A,117,3
15,N/A,N/A,N/A,840,855,N/A,123,3
42,N/A,N/A,N/A,798,840,N/A,126,6
28,N/A,N/A,N/A,770,798,N/A,130,4
16,N/A,N/A,N/A,754,770,N/A,135,3
15,N/A,N/A,N/A,722,737,N/A,4,3
20,N/A,N/A,N/A,702,722,N/A,10,3
22,N/A,N/A,N/A,680,702,N/A,16,3
19,N/A,N/A,N/A,661,680,N/A,22,3
42,N/A,N/A,N/A,619,661,N/A,25,6
28,N/A,N/A,N/A,591,619,N/A,29,4
10,N/A,N/A,N/A,581,591,N/A,33,2
36,N/A,N/A,N/A,545,581,N/A,36,5
15,N/A,N/A,N/A,530,545,N/A,39,2
41,N/A,N/A,N/A,489,530,N/A,43,6
16,N/A,N/A,N/A,473,489,N/A,46,3
14,N/A,N/A,N/A,459,473,N/A,50,1
26,N/A,N/A,N/A,433,459,N/A,53,4
23,N/A,N/A,N/A,410,433,N/A,59,4
14,N/A,N/A,N/A,396,410,N/A,62,1
36,N/A,N/A,N/A,360,396,N/A,66,5
34,N/A,N/A,N/A,326,360,N/A,72,5
23,N/A,N/A,N/A,303,326,N/A,77,4
13,N/A,N/A,N/A,290,303,N/A,80,1
8,N/A,N/A,N/A,282,290,N/A,86,1
42,N/A,N/A,N/A,240,282,N/A,91,6
6,N/A,N/A,N/A,234,240,N/A,97,0
23,N/A,N/A,N/A,211,234,N/A,101,4
12,N/A,N/A,N/A,199,211,N/A,104,1
23,N/A,N/A,N/A,176,199,N/A,107,4
13,N/A,N/A,N/A,163,176,N/A,111,2
43,N/A,N/A,N/A,120,163,N/A,115,6
27,N/A,N/A,N/A,93,120,N/A,119,4
32,N/A,N/A,N/A,61,93,N/A,125,4
11,N/A,N/A,N/A,50,61,N/A,129,2
39,N/A,N/A,N/A,1940,1979,N/A,5,5
16,N/A,N/A,N/A,1924,1940,N/A,8,2
41,N/A,N/A,N/A,1883,1924,N/A,12,6
17,N/A,N/A,N/A,1866,1883,N/A,15,3
10,N/A,N/A,N/A,1856,1866,N/A,19,1
44,N/A,N/A,N/A,1812,1856,N/A,24,6
31,N/A,N/A,N/A,1781,1812,N/A,28,4
12,N/A,N/A,N/A,1769,1781,N/A,32,2
8,N/A,N/A,N/A,1761,1769,N/A,37,1
32,N/A,N/A,N/A,1729,1761,N/A,41,5
34,N/A,N/A,N/A,1695,1729,N/A,47,5
23,N/A,N/A,N/A,1672,1695,N/A,52,4
14,N/A,N/A,N/A,1658,1672,N/A,56,2
35,N/A,N/A,N/A,1623,1658,N/A,59,5
23,N/A,N/A,N/A,1600,1623,N/A,63,3
16,N/A,N/A,N/A,1584,1600,N/A,69,3
15,N/A,N/A,N/A,1569,1584,N/A,75,3
17,N/A,N/A,N/A,1552,1569,N/A,81,3
44,N/A,N/A,N/A,1508,1552,N/A,84,6
28,N/A,N/A,N/A,1480,1508,N/A,88,4
15,N/A,N/A,N/A,1465,1480,N/A,93,3
15,N/A,N/A,N/A,1450,1465,N/A,99,3
19,N/A,N/A,N/A,1431,1450,N/A,105,3
12,N/A,N/A,N/A,1419,1431,N/A,110,2
10,N/A,N/A,N/A,1409,1419,N/A,116,2
39,N/A,N/A,N/A,1370,1409,N/A,119,5
29,N/A,N/A,N/A,1341,1370,N/A,124,4
14,N/A,N/A,N/A,1327,1341,N/A,128,2
11,N/A,N/A,N/A,1316,1327,N/A,134,2
13,N/A,N/A,N/A,1303,1316,N/A,140,2
43,N/A,N/A,N/A,1360,1403,N/A,5,6
35,N/A,N/A,N/A,1325,1360,N/A,10,5
29,N/A,N/A,N/A,1296,1325,N/A,15,4
23,N/A,N/A,N/A,1273,1296,N/A,21,4
7,N/A,N/A,N/A,1266,1273,N/A,24,1
24,N/A,N/A,N/A,1242,1266,N/A,27,4
26,N/A,N/A,N/A,1216,1242,N/A,33,4
7,N/A,N/A,N/A,1209,1216,N/A,36,1
42,N/A,N/A,N/A,1167,1209,N/A,41,6
24,N/A,N/A,N/A,1143,1167,N/A,45,4
8,N/A,N/A,N/A,1135,1143,N/A,48,1
41,N/A,N/A,N/A,1094,1135,N/A,53,6
9,N/A,N/A,N/A,1085,1094,N/A,59,0
33,N/A,N/A,N/A,1052,1085,N/A,64,5
15,N/A,N/A,N/A,1037,1052,N/A,68,3
11,N/A,N/A,N/A,1026,1037,N/A,73,2
11,N/A,N/A,N/A,1015,1026,N/A,79,2
41,N/A,N/A,N/A,974,1015,N/A,83,6
31,N/A,N/A,N/A,943,974,N/A,87,4
17,N/A,N/A,N/A,926,943,N/A,91,2
16,N/A,N/A,N/A,910,926,N/A,97,2
17,N/A,N/A,N/A,893,910,N/A,103,2
10,N/A,N/A,N/A,883,893,N/A,109,2
44,N/A,N/A,N/A,839,883,N/A,113,6
36,N/A,N/A,N/A,803,839,N/A,118,5
14,N/A,N/A,N/A,789,803,N/A,122,3
22,N/A,N/A,N/A,767,789,N/A,128,3
13,N/A,N/A,N/A,754,767,N/A,133,2
37,N/A,N/A,N/A,717,754,N/A,136,5
16,N/A,N/A,N/A,701,717,N/A,140,3
42,N/A,N/A,N/A,1952,1994,N/A,5,6
6,N/A,N/A,N/A,1946,1952,N/A,11,0
25,N/A,N/A,N/A,1921,1946,N/A,15,4
11,N/A,N/A,N/A,1910,1921,N/A,18,1
14,N/A,N/A,N/A,1896,1910,N/A,24,1
38,N/A,N/A,N/A,1858,1896,N/A,28,5
37,N/A,N/A,N/A,1821,1858,N/A,34,5
37,N/A,N/A,N/A,1784,1821,N/A,40,5
30,N/A,N/A,N/A,1754,1784,N/A,45,4
10,N/A,N/A,N/A,1744,1754,N/A,49,2
38,N/A,N/A,N/A,1706,1744,N/A,52,5
35,N/A,N/A,N/A,1671,1706,N/A,58,5
25,N/A,N/A,N/A,1646,1671,N/A,63,4
23,N/A,N/A,N/A,1623,1646,N/A,68,3
11,N/A,N/A,N/A,1612,1623,N/A,72,1
44,N/A,N/A,N/A,1568,1612,N/A,77,6
34,N/A,N/A,N/A,1534,1568,N/A,82,5
34,N/A,N/A,N/A,1500,1534,N/A,88,5
20,N/A,N/A,N/A,1480,1500,N/A,92,3
15,N/A,N/A,N/A,1465,1480,N/A,97,2
8,N/A,N/A,N/A,1457,1465,N/A,102,1
26,N/A,N/A,N/A,1431,1457,N/A,105,4
29,N/A,N/A,N/A,1402,1431,N/A,111,4
23,N/A,N/A,N/A,1379,1402,N/A,117,4
17,N/A,N/A,N/A,1362,1379,N/A,121,2
42,N/A,N/A,N/A,1320,1362,N/A,125,6
7,N/A,N/A,N/A,1313,1320,N/A,131,0
42,N/A,N/A,N/A,1271,1313,N/A,137,6
5,N/A,N/A,N/A,1266,1271,N/A,143,0
25,N/A,N/A,N/A,1241,1266,N/A,147,4
15,N/A,N/A,N/A,1473,1488,N/A,3,3
23,N/A,N/A,N/A,1450,1473,N/A,9,3
14,N/A,N/A,N/A,1436,1450,N/A,13,1
27,N/A,N/A,N/A,1409,1436,N/A,16,4
12,N/A,N/A,N/A,1397,1409,N/A,19,1
30,N/A,N/A,N/A,1367,1397,N/A,22,4
10,N/A,N/A,N/A,1357,1367,N/A,25,1
39,N/A,N/A,N/A,1318,1357,N/A,29,5
12,N/A,N/A,N/A,1306,1318,N/A,32,2
14,N/A,N/A,N/A,1292,1306,N/A,37,1
44,N/A,N/A,N/A,1248,1292,N/A,42,6
23,N/A,N/A,N/A,1225,1248,N/A,45,3
44,N/A,N/A,N/A,1181,1225,N/A,48,6
20,N/A,N/A,N/A,1161,1181,N/A,51,3
17,N/A,N/A,N/A,1144,1161,N/A,56,2
36,N/A,N/A,N/A,1108,1144,N/A,59,5
14,N/A,N/A,N/A,1094,1108,N/A,62,2
17,N/A,N/A,N/A,1077,1094,N/A,68,2
17,N/A,N/A,N/A,1060,1077,N/A,74,2
9,N/A,N/A,N/A,1051,1060,N/A,79,1
42,N/A,N/A,N/A,1009,1051,N/A,84,6
5,N/A,N/A,N/A,1004,1009,N/A,90,0
35,N/A,N/A,N/A,969,1004,N/A,95,5
34,N/A,N/A,N/A,935,969,N/A,101,5
30,N/A,N/A,N/A,905,935,N/A,106,4
20,N/A,N/A,N/A,885,905,N/A,111,3
11,N/A,N/A,N/A,874,885,N/A,115,1
10,N/A,N/A,N/A,864,874,N/A,121,1
43,N/A,N/A,N/A,821,864,N/A,126,6
38,N/A,N/A,N/A,783,821,N/A,131,5
10,N/A,N/A,N/A,1266,1276,N/A,6,2
42,N/A,N/A,N/A,1224,1266,N/A,10,6
8,N/A,N/A,N/A,1216,1224,N/A,16,0
41,N/A,N/A,N/A,1175,1216,N/A,22,6
39,N/A,N/A,N/A,1136,1175,N/A,27,5
31,N/A,N/A,N/A,1105,1136,N/A,32,4
15,N/A,N/A,N/A,1090,1105,N/A,37,3
13,N/A,N/A,N/A,1077,1090,N/A,42,2
12,N/A,N/A,N/A,1065,1077,N/A,47,1
30,N/A,N/A,N/A,1035,1065,N/A,50,4
26,N/A,N/A,N/A,1009,1035,N/A,56,4
12,N/A,N/A,N/A,997,1009,N/A,60,2
9,N/A,N/A,N/A,988,997,N/A,65,1
34,N/A,N/A,N/A,954,988,N/A,69,5
37,N/A,N/A,N/A,917,954,N/A,75,5
24,N/A,N/A,N/A,893,917,N/A,80,4
12,N/A,N/A,N/A,881,893,N/A,84,2
8,N/A,N/A,N/A,873,881,N/A,89,1
32,N/A,N/A,N/A,841,873,N/A,93,5
16,N/A,N/A,N/A,825,841,N/A,97,3
13,N/A,N/A,N/A,812,825,N/A,102,2
43,N/A,N/A,N/A,769,812,N/A,106,6
33,N/A,N/A,N/A,736,769,N/A,111,5
15,N/A,N/A,N/A,721,736,N/A,114,2
14,N/A,N/A,N/A,707,721,N/A,120,2
36,N/A,N/A,N/A,671,707,N/A,123,5
26,N/A,N/A,N/A,645,671,N/A,128,4
8,N/A,N/A,N/A,637,645,N/A,131,1
30,N/A,N/A,N/A,607,637,N/A,134,4
30,N/A,N/A,N/A,577,607,N/A,140,4
16,N/A,N/A,N/A,533,549,N/A,3,3
15,N/A,N/A,N/A,518,533,N/A,9,3
44,N/A,N/A,N/A,474,518,N/A,12,6
20,N/A,N/A,N/A,454,474,N/A,15,3
15,N/A,N/A,N/A,439,454,N/A,21,3
16,N/A,N/A,N/A,423,439,N/A,27,3
44,N/A,N/A,N/A,379,423,N/A,30,6
14,N/A,N/A,N/A,365,379,N/A,33,3
12,N/A,N/A,N/A,353,365,N/A,38,2
14,N/A,N/A,N/A,339,353,N/A,43,1
13,N/A,N/A,N/A,326,339,N/A,49,1
12,N/A,N/A,N/A,314,326,N/A,55,1
26,N/A,N/A,N/A,288,314,N/A,58,4
16,N/A,N/A,N/A,272,288,N/A,63,3
11,N/A,N/A,N/A,261,272,N/A,68,2
43,N/A,N/A,N/A,218,261,N/A,72,6
9,N/A,N/A,N/A,209,218,N/A,78,0
30,N/A,N/A,N/A,179,209,N/A,82,4
16,N/A,N/A,N/A,163,179,N/A,87,3
42,N/A,N/A,N/A,121,163,N/A,90,6
9,N/A,N/A,N/A,112,121,N/A,96,0
28,N/A,N/A,N/A,84,112,N/A,100,4
14,N/A,N/A,N/A,70,84,N/A,104,2
10,N/A,N/A,N/A,60,70,N/A,109,1
43,N/A,N/A,N/A,17,60,N/A,114,6
32,N/A,N/A,N/A,-15,17,N/A,119,5
43,N/A,N/A,N/A,1584,1627,N/A,4,6
25,N/A,N/A,N/A,1559,1584,N/A,8,4
18,N/A,N/A,N/A,1541,1559,N/A,13,3
11,N/A,N/A,N/A,1530,1541,N/A,18,2
12,N/A,N/A,N/A,1518,1530,N/A,23,1
13,N/A,N/A,N/A,1505,1518,N/A,29,1
23,N/A,N/A,N/A,1482,1505,N/A,32,4
31,N/A,N/A,N/A,1451,1482,N/A,38,4
12,N/A,N/A,N/A,1439,1451,N/A,42,2
14,N/A,N/A,N/A,1425,1439,N/A,47,1
22,N/A,N/A,N/A,1403,1425,N/A,50,4
9,N/A,N/A,N/A,1394,1403,N/A,53,1
32,N/A,N/A,N/A,1362,1394,N/A,57,5
14,N/A,N/A,N/A,1348,1362,N/A,60,2
32,N/A,N/A,N/A,1316,1348,N/A,63,5
35,N/A,N/A,N/A,1281,1316,N/A,69,5
31,N/A,N/A,N/A,1250,1281,N/A,74,4
15,N/A,N/A,N/A,1235,1250,N/A,78,2
41,N/A,N/A,N/A,1194,1235,N/A,82,6
23,N/A,N/A,N/A,1171,1194,N/A,85,3
13,N/A,N/A,N/A,1158,1171,N/A,89,1
25,N/A,N/A,N/A,1133,1158,N/A,92,4
17,N/A,N/A,N/A,1116,1133,N/A,96,2
35,N/A,N/A,N/A,1081,1116,N/A,99,5
25,N/A,N/A,N/A,1056,1081,N/A,104,4
23,N/A,N/A,N/A,1033,1056,N/A,110,4
23,N/A,N/A,N/A,1010,1033,N/A,115,3
41,N/A,N/A,N/A,969,1010,N/A,118,6
36,N/A,N/A,N/A,933,969,N/A,123,5
22,N/A,N/A,N/A,911,933,N/A,128,4
42,N/A,N/A,N/A,746,788,N/A,5,6
5,N/A,N/A,N/A,741,746,N/A,11,0
30,N/A,N/A,N/A,711,741,N/A,15,4
28,N/A,N/A,N/A,683,711,N/A,21,4
14,N/A,N/A,N/A,669,683,N/A,26,3
22,N/A,N/A,N/A,647,669,N/A,32,3
12,N/A,N/A,N/A,635,647,N/A,37,2
44,N/A,N/A,N/A,591,635,N/A,41,6
18,N/A,N/A,N/A,573,591,N/A,44,3
11,N/A,N/A,N/A,562,573,N/A,49,2
34,N/A,N/A,N/A,528,562,N/A,52,5
24,N/A,N/A,N/A,504,528,N/A,57,4
17,N/A,N/A,N/A,487,504,N/A,61,2
7,N/A,N/A,N/A,480,487,N/A,66,1
39,N/A,N/A,N/A,441,480,N/A,70,5
29,N/A,N/A,N/A,412,441,N/A,75,4
10,N/A,N/A,N/A,402,412,N/A,79,2
10,N/A,N/A,N/A,392,402,N/A,85,2
36,N/A,N/A,N/A,356,392,N/A,88,5
31,N/A,N/A,N/A,325,356,N/A,93,4
17,N/A,N/A,N/A,308,325,N/A,98,3
22,N/A,N/A,N/A,286,308,N/A,104,3
41,N/A,N/A,N/A,245,286,N/A,107,6
31,N/A,N/A,N/A,214,245,N/A,111,4
23,N/A,N/A,N/A,191,214,N/A,116,3
13,N/A,N/A,N/A,178,191,N/A,121,2
7,N/A,N/A,N/A,171,178,N/A,126,1
31,N/A,N/A,N/A,140,171,N/A,129,4
28,N/A,N/A,N/A,112,140,N/A,135,4
10,N/A,N/A,N/A,102,112,N/A,139,2
18,N/A,N/A,N/A,1360,1378,N/A,3,3
42,N/A,N/A,N/A,1318,1360,N/A,6,6
9,N/A,N/A,N/A,1309,1318,N/A,12,0
42,N/A,N/A,N/A,1267,1309,N/A,18,6
23,N/A,N/A,N/A,1244,1267,N/A,21,3
41,N/A,N/A,N/A,1203,1244,N/A,24,6
22,N/A,N/A,N/A,1181,1203,N/A,28,4
8,N/A,N/A,N/A,1173,1181,N/A,31,1
35,N/A,N/A,N/A,1138,1173,N/A,35,5
23,N/A,N/A,N/A,1115,1138,N/A,39,3
15,N/A,N/A,N/A,1100,1115,N/A,44,2
42,N/A,N/A,N/A,1058,1100,N/A,48,6
6,N/A,N/A,N/A,1052,1058,N/A,54,0
34,N/A,N/A,N/A,1018,1052,N/A,59,5
24,N/A,N/A,N/A,994,1018,N/A,64,4
11,N/A,N/A,N/A,983,994,N/A,67,1
8,N/A,N/A,N/A,975,983,N/A,73,1
38,N/A,N/A,N/A,937,975,N/A,77,5
17,N/A,N/A,N/A,920,937,N/A,80,2
15,N/A,N/A,N/A,905,920,N/A,86,2
10,N/A,N/A,N/A,895,905,N/A,92,2
9,N/A,N/A,N/A,886,895,N/A,97,1
39,N/A,N/A,N/A,847,886,N/A,101,5
16,N/A,N/A,N/A,831,847,N/A,104,2
17,N/A,N/A,N/A,814,831,N/A,110,2
7,N/A,N/A,N/A,807,814,N/A,115,1
32,N/A,N/A,N/A,775,807,N/A,118,4
32,N/A,N/A,N/A,743,775,N/A,124,4
11,N/A,N/A,N/A,732,743,N/A,128,2
11,N/A,N/A,N/A,721,732,N/A,133,1
41,N/A,N/A,N/A,1157,1198,N/A,6,6
39,N/A,N/A,N/A,1118,1157,N/A,11,5
39,N/A,N/A,N/A,1079,1118,N/A,17,5
13,N/A,N/A,N/A,1066,1079,N/A,20,2
36,N/A,N/A,N/A,1030,1066,N/A,23,5
38,N/A,N/A,N/A,992,1030,N/A,29,5
13,N/A,N/A,N/A,979,992,N/A,32,2
39,N/A,N/A,N/A,940,979,N/A,35,5
17,N/A,N/A,N/A,923,940,N/A,38,2
10,N/A,N/A,N/A,913,923,N/A,43,1
22,N/A,N/A,N/A,891,913,N/A,46,4
14,N/A,N/A,N/A,877,891,N/A,49,1
38,N/A,N/A,N/A,839,877,N/A,53,5
25,N/A,N/A,N/A,814,839,N/A,58,4
29,N/A,N/A,N/A,785,814,N/A,64,4
14,N/A,N/A,N/A,771,785,N/A,69,3
12,N/A,N/A,N/A,759,771,N/A,73,1
29,N/A,N/A,N/A,730,759,N/A,76,4
20,N/A,N/A,N/A,710,730,N/A,81,3
14,N/A,N/A,N/A,696,710,N/A,86,2
16,N/A,N/A,N/A,680,696,N/A,92,2
36,N/A,N/A,N/A,644,680,N/A,95,5
12,N/A,N/A,N/A,632,644,N/A,98,2
37,N/A,N/A,N/A,595,632,N/A,101,5
29,N/A,N/A,N/A,566,595,N/A,106,4
11,N/A,N/A,N/A,555,566,N/A,110,2
37,N/A,N/A,N/A,518,555,N/A,113,5
10,N/A,N/A,N/A,508,518,N/A,116,2
9,N/A,N/A,N/A,499,508,N/A,121,1
7,N/A,N/A,N/A,492,499,N/A,127,1
43,N/A,N/A,N/A,1196,1239,N/A,4,6
36,N/A,N/A,N/A,1160,1196,N/A,9,5
14,N/A,N/A,N/A,1146,1160,N/A,12,2
15,N/A,N/A,N/A,1131,1146,N/A,18,2
33,N/A,N/A,N/A,1098,1131,N/A,21,5
12,N/A,N/A,N/A,1086,1098,N/A,24,2
42,N/A,N/A,N/A,1044,1086,N/A,28,6
15,N/A,N/A,N/A,1029,1044,N/A,31,3
19,N/A,N/A,N/A,1010,1029,N/A,37,3
43,N/A,N/A,N/A,967,1010,N/A,40,6
30,N/A,N/A,N/A,937,967,N/A,44,4
23,N/A,N/A,N/A,914,937,N/A,50,4
25,N/A,N/A,N/A,889,914,N/A,56,4
26,N/A,N/A,N/A,863,889,N/A,62,4
31,N/A,N/A,N/A,832,863,N/A,68,4
12,N/A,N/A,N/A,820,832,N/A,71,1
44,N/A,N/A,N/A,776,820,N/A,76,6
34,N/A,N/A,N/A,742,776,N/A,81,5
33,N/A,N/A,N/A,709,742,N/A,87,5
22,N/A,N/A,N/A,687,709,N/A,91,3
21,N/A,N/A,N/A,666,687,N/A,97,3
7,N/A,N/A,N/A,659,666,N/A,101,1
29,N/A,N/A,N/A,630,659,N/A,104,4
16,N/A,N/A,N/A,614,630,N/A,108,2
14,N/A,N/A,N/A,600,614,N/A,114,2
16,N/A,N/A,N/A,584,600,N/A,120,2
16,N/A,N/A,N/A,568,584,N/A,126,2
43,N/A,N/A,N/A,525,568,N/A,130,6
29,N/A,N/A,N/A,496,525,N/A,134,4
9,N/A,N/A,N/A,487,496,N/A,137,1
42,N/A,N/A,N/A,600,642,N/A,5,6
7,N/A,N/A,N/A,593,600,N/A,11,0
44,N/A,N/A,N/A,549,593,N/A,17,6
7,N/A,N/A,N/A,542,549,N/A,23,0
19,N/A,N/A,N/A,523,542,N/A,26,3
43,N/A,N/A,N/A,480,523,N/A,29,6
16,N/A,N/A,N/A,464,480,N/A,32,3
23,N/A,N/A,N/A,441,464,N/A,38,3
44,N/A,N/A,N/A,397,441,N/A,41,6
16,N/A,N/A,N/A,381,397,N/A,44,3
10,N/A,N/A,N/A,371,381,N/A,48,1
22,N/A,N/A,N/A,349,371,N/A,51,4
13,N/A,N/A,N/A,336,349,N/A,54,1
8,N/A,N/A,N/A,328,336,N/A,60,1
37,N/A,N/A,N/A,291,328,N/A,64,5
11,N/A,N/A,N/A,280,291,N/A,67,2
37,N/A,N/A,N/A,243,280,N/A,70,5
32,N/A,N/A,N/A,211,243,N/A,76,5
32,N/A,N/A,N/A,179,211,N/A,82,5
15,N/A,N/A,N/A,164,179,N/A,85,2
11,N/A,N/A,N/A,153,164,N/A,90,1
29,N/A,N/A,N/A,124,153,N/A,93,4
22,N/A,N/A,N/A,102,124,N/A,98,3
44,N/A,N/A,N/A,58,102,N/A,101,6
7,N/A,N/A,N/A,51,58,N/A,107,0
42,N/A,N/A,N/A,9,51,N/A,113,6
30,N/A,N/A,N/A,-21,9,N/A,117,4
29,N/A,N/A,N/A,774,803,N/A,3,4
16,N/A,N/A,N/A,758,774,N/A,7,2
13,N/A,N/A,N/A,745,758,N/A,12,1
14,N/A,N/A,N/A,731,745,N/A,18,1
26,N/A,N/A,N/A,705,731,N/A,21,4
15,N/A,N/A,N/A,690,705,N/A,25,2
42,N/A,N/A,N/A,648,690,N/A,29,6
32,N/A,N/A,N/A,616,648,N/A,33,4
16,N/A,N/A,N/A,600,616,N/A,38,3
18,N/A,N/A,N/A,582,600,N/A,44,3
10,N/A,N/A,N/A,572,582,N/A,49,2
16,N/A,N/A,N/A,556,572,N/A,55,2
11,N/A,N/A,N/A,545,556,N/A,60,1
9,N/A,N/A,N/A,536,545,N/A,66,1
24,N/A,N/A,N/A,512,536,N/A,69,4
29,N/A,N/A,N/A,483,512,N/A,75,4
12,N/A,N/A,N/A,471,483,N/A,79,2
14,N/A,N/A,N/A,457,471,N/A,84,1
12,N/A,N/A,N/A,445,457,N/A,90,1
32,N/A,N/A,N/A,413,445,N/A,94,5
32,N/A,N/A,N/A,381,413,N/A,100,5
37,N/A,N/A,N/A,344,381,N/A,106,5
21,N/A,N/A,N/A,323,344,N/A,110,3
13,N/A,N/A,N/A,310,323,N/A,115,2
12,N/A,N/A,N/A,298,310,N/A,120,1
26,N/A,N/A,N/A,272,298,N/A,123,4
14,N/A,N/A,N/A,258,272,N/A,128,3
20,N/A,N/A,N/A,238,258,N/A,134,3
43,N/A,N/A,N/A,195,238,N/A,137,6
15,N/A,N/A,N/A,180,195,N/A,140,3
11,N/A,N/A,N/A,868,879,N/A,3,1
38,N/A,N/A,N/A,830,868,N/A,7,5
17,N/A,N/A,N/A,813,830,N/A,10,2
13,N/A,N/A,N/A,800,813,N/A,16,2
10,N/A,N/A,N/A,790,800,N/A,21,1
43,N/A,N/A,N/A,747,790,N/A,26,6
29,N/A,N/A,N/A,718,747,N/A,30,4
11,N/A,N/A,N/A,707,718,N/A,34,2
41,N/A,N/A,N/A,666,707,N/A,38,6
5,N/A,N/A,N/A,661,666,N/A,44,0
41,N/A,N/A,N/A,620,661,N/A,50,6
25,N/A,N/A,N/A,595,620,N/A,54,4
10,N/A,N/A,N/A,585,595,N/A,57,1
41,N/A,N/A,N/A,544,585,N/A,62,6
39,N/A,N/A,N/A,505,544,N/A,67,5
31,N/A,N/A,N/A,474,505,N/A,72,4
8,N/A,N/A,N/A,466,474,N/A,75,1
44,N/A,N/A,N/A,422,466,N/A,80,6
32,N/A,N/A,N/A,390,422,N/A,84,4
20,N/A,N/A,N/A,370,390,N/A,89,3
42,N/A,N/A,N/A,328,370,N/A,92,6
26,N/A,N/A,N/A,302,328,N/A,96,4
32,N/A,N/A,N/A,270,302,N/A,102,4
8,N/A,N/A,N/A,262,270,N/A,105,1
33,N/A,N/A,N/A,229,262,N/A,109,5
27,N/A,N/A,N/A,202,229,N/A,114,4
22,N/A,N/A,N/A,180,202,N/A,119,3
13,N/A,N/A,N/A,167,180,N/A,124,2
43,N/A,N/A,N/A,124,167,N/A,128,6
20,N/A,N/A,N/A,104,124,N/A,131,3
14,N/A,N/A,N/A,390,404,N/A,6,3
14,N/A,N/A,N/A,376,390,N/A,12,3
11,N/A,N/A,N/A,365,376,N/A,16,1
14,N/A,N/A,N/A,351,365,N/A,22,1
24,N/A,N/A,N/A,327,351,N/A,25,4
31,N/A,N/A,N/A,296,327,N/A,31,4
15,N/A,N/A,N/A,281,296,N/A,36,3
16,N/A,N/A,N/A,265,281,N/A,42,3
12,N/A,N/A,N/A,253,265,N/A,46,1
34,N/A,N/A,N/A,219,253,N/A,50,5
26,N/A,N/A,N/A,193,219,N/A,55,4
15,N/A,N/A,N/A,178,193,N/A,59,2
12,N/A,N/A,N/A,166,178,N/A,65,2
38,N/A,N/A,N/A,128,166,N/A,68,5
18,N/A,N/A,N/A,110,128,N/A,72,3
15,N/A,N/A,N/A,95,110,N/A,78,3
17,N/A,N/A,N/A,78,95,N/A,83,2
11,N/A,N/A,N/A,67,78,N/A,88,1
37,N/A,N/A,N/A,30,67,N/A,92,5
17,N/A,N/A,N/A,13,30,N/A,95,2
39,N/A,N/A,N/A,-26,13,N/A,98,5
12,N/A,N/A,N/A,1525,1537,N/A,5,2
35,N/A,N/A,N/A,1490,1525,N/A,8,5
28,N/A,N/A,N/A,1462,1490,N/A,13,4
9,N/A,N/A,N/A,1453,1462,N/A,16,1
36,N/A,N/A,N/A,1417,1453,N/A,20,5
38,N/A,N/A,N/A,1379,1417,N/A,26,5
35,N/A,N/A,N/A,1344,1379,N/A,32,5
14,N/A,N/A,N/A,1330,1344,N/A,36,3
16,N/A,N/A,N/A,1314,1330,N/A,41,2
42,N/A,N/A,N/A,1272,1314,N/A,45,6
6,N/A,N/A,N/A,1266,1272,N/A,51,0
42,N/A,N/A,N/A,1224,1266,N/A,57,6
28,N/A,N/A,N/A,1196,1224,N/A,61,4
30,N/A,N/A,N/A,1166,1196,N/A,67,4
25,N/A,N/A,N/A,1141,1166,N/A,73,4
22,N/A,N/A,N/A,1119,1141,N/A,78,3
16,N/A,N/A,N/A,1103,1119,N/A,83,2
11,N/A,N/A,N/A,1092,1103,N/A,89,2
8,N/A,N/A,N/A,1084,1092,N/A,94,1
34,N/A,N/A,N/A,1050,1084,N/A,98,5
26,N/A,N/A,N/A,1024,1050,N/A,103,4
22,N/A,N/A,N/A,1002,1024,N/A,109,4
28,N/A,N/A,N/A,974,1002,N/A,115,4
32,N/A,N/A,N/A,942,974,N/A,121,4
7,N/A,N/A,N/A,935,942,N/A,124,1
28,N/A,N/A,N/A,907,935,N/A,127,4
14,N/A,N/A,N/A,893,907,N/A,132,3
16,N/A,N/A,N/A,877,893,N/A,138,3
19,N/A,N/A,N/A,858,877,N/A,144,3
14,N/A,N/A,N/A,844,858,N/A,149,2
20,N/A,N/A,N/A,1746,1766,N/A,4,3
14,N/A,N/A,N/A,1732,1746,N/A,10,3
10,N/A,N/A,N/A,1722,1732,N/A,14,1
32,N/A,N/A,N/A,1690,1722,N/A,17,4
14,N/A,N/A,N/A,1676,1690,N/A,21,2
35,N/A,N/A,N/A,1641,1676,N/A,24,5
31,N/A,N/A,N/A,1610,1641,N/A,29,4
17,N/A,N/A,N/A,1593,1610,N/A,33,2
11,N/A,N/A,N/A,1582,1593,N/A,39,2
44,N/A,N/A,N/A,1538,1582,N/A,43,6
6,N/A,N/A,N/A,1532,1538,N/A,49,0
44,N/A,N/A,N/A,1488,1532,N/A,55,6
33,N/A,N/A,N/A,1455,1488,N/A,60,5
14,N/A,N/A,N/A,1441,1455,N/A,63,2
36,N/A,N/A,N/A,1405,1441,N/A,66,5
29,N/A,N/A,N/A,1376,1405,N/A,71,4
13,N/A,N/A,N/A,1363,1376,N/A,74,1
37,N/A,N/A,N/A,1326,1363,N/A,78,5
14,N/A,N/A,N/A,1312,1326,N/A,82,3
44,N/A,N/A,N/A,1268,1312,N/A,85,6
20,N/A,N/A,N/A,1248,1268,N/A,88,3
15,N/A,N/A,N/A,1233,1248,N/A,93,2
7,N/A,N/A,N/A,1226,1233,N/A,98,1
31,N/A,N/A,N/A,1195,1226,N/A,101,4
29,N/A,N/A,N/A,1166,1195,N/A,107,4
20,N/A,N/A,N/A,1146,1166,N/A,112,3
22,N/A,N/A,N/A,1124,1146,N/A,118,3
12,N/A,N/A,N/A,1112,1124,N/A,123,2
43,N/A,N/A,N/A,1069,1112,N/A,127,6
25,N/A,N/A,N/A,1044,1069,N/A,131,4
42,N/A,N/A,N/A,982,1024,N/A,5,6
22,N/A,N/A,N/A,960,982,N/A,9,4
27,N/A,N/A,N/A,933,960,N/A,15,4
14,N/A,N/A,N/A,919,933,N/A,18,1
24,N/A,N/A,N/A,895,919,N/A,21,4
25,N/A,N/A,N/A,870,895,N/A,27,4
19,N/A,N/A,N/A,851,870,N/A,32,3
15,N/A,N/A,N/A,836,851,N/A,37,2
12,N/A,N/A,N/A,824,836,N/A,43,2
32,N/A,N/A,N/A,792,824,N/A,46,5
13,N/A,N/A,N/A,779,792,N/A,49,2
39,N/A,N/A,N/A,740,779,N/A,52,5
18,N/A,N/A,N/A,722,740,N/A,56,3
44,N/A,N/A,N/A,678,722,N/A,59,6
18,N/A,N/A,N/A,660,678,N/A,62,3
19,N/A,N/A,N/A,641,660,N/A,68,3
7,N/A,N/A,N/A,634,641,N/A,72,1
38,N/A,N/A,N/A,596,634,N/A,76,5
33,N/A,N/A,N/A,563,596,N/A,82,5
18,N/A,N/A,N/A,545,563,N/A,86,3
41,N/A,N/A,N/A,504,545,N/A,89,6
15,N/A,N/A,N/A,489,504,N/A,92,3
13,N/A,N/A,N/A,476,489,N/A,97,2
15,N/A,N/A,N/A,461,476,N/A,103,2
42,N/A,N/A,N/A,419,461,N/A,107,6
32,N/A,N/A,N/A,387,419,N/A,111,4
27,N/A,N/A,N/A,360,387,N/A,117,4
29,N/A,N/A,N/A,331,360,N/A,123,4
30,N/A,N/A,N/A,301,331,N/A,129,4
10,N/A,N/A,N/A,291,301,N/A,132,1
22,N/A,N/A,N/A,1746,1768,N/A,6,4
14,N/A,N/A,N/A,1732,1746,N/A,9,1
9,N/A,N/A,N/A,1723,1732,N/A,15,1
44,N/A,N/A,N/A,1679,1723,N/A,20,6
19,N/A,N/A,N/A,1660,1679,N/A,23,3
21,N/A,N/A,N/A,1639,1660,N/A,29,3
14,N/A,N/A,N/A,1625,1639,N/A,35,3
13,N/A,N/A,N/A,1612,1625,N/A,40,2
41,N/A,N/A,N/A,1571,1612,N/A,44,6
21,N/A,N/A,N/A,1550,1571,N/A,47,3
10,N/A,N/A,N/A,1540,1550,N/A,52,2
43,N/A,N/A,N/A,1497,1540,N/A,56,6
24,N/A,N/A,N/A,1473,1497,N/A,60,4
18,N/A,N/A,N/A,1455,1473,N/A,65,3
43,N/A,N/A,N/A,1412,1455,N/A,68,6
9,N/A,N/A,N/A,1403,1412,N/A,74,0
39,N/A,N/A,N/A,1364,1403,N/A,79,5
27,N/A,N/A,N/A,1337,1364,N/A,84,4
14,N/A,N/A,N/A,1323,1337,N/A,89,3
42,N/A,N/A,N/A,1281,1323,N/A,92,6
39,N/A,N/A,N/A,1242,1281,N/A,97,5
26,N/A,N/A,N/A,1216,1242,N/A,102,4
12,N/A,N/A,N/A,1204,1216,N/A,105,1
44,N/A,N/A,N/A,1160,1204,N/A,110,6
8,N/A,N/A,N/A,1152,1160,N/A,116,0
34,N/A,N/A,N/A,1118,1152,N/A,121,5
19,N/A,N/A,N/A,1099,1118,N/A,125,3
23,N/A,N/A,N/A,1076,1099,N/A,131,3
44,N/A,N/A,N/A,1032,1076,N/A,134,6
21,N/A,N/A,N/A,1011,1032,N/A,137,3
17,N/A,N/A,N/A,1935,1952,N/A,4,2
12,N/A,N/A,N/A,1923,1935,N/A,9,1
32,N/A,N/A,N/A,1891,1923,N/A,12,4
11,N/A,N/A,N/A,1880,1891,N/A,15,1
24,N/A,N/A,N/A,1856,1880,N/A,18,4
19,N/A,N/A,N/A,1837,1856,N/A,23,3
16,N/A,N/A,N/A,1821,1837,N/A,29,3
43,N/A,N/A,N/A,1778,1821,N/A,32,6
24,N/A,N/A,N/A,1754,1778,N/A,36,4
23,N/A,N/A,N/A,1731,1754,N/A,42,4
17,N/A,N/A,N/A,1714,1731,N/A,47,3
15,N/A,N/A,N/A,1699,1714,N/A,52,2
43,N/A,N/A,N/A,1656,1699,N/A,56,6
8,N/A,N/A,N/A,1648,1656,N/A,62,0
43,N/A,N/A,N/A,1605,1648,N/A,68,6
19,N/A,N/A,N/A,1586,1605,N/A,71,3
43,N/A,N/A,N/A,1543,1586,N/A,74,6
8,N/A,N/A,N/A,1535,1543,N/A,80,0
44,N/A,N/A,N/A,1491,1535,N/A,86,6
25,N/A,N/A,N/A,1466,1491,N/A,90,4
15,N/A,N/A,N/A,1451,1466,N/A,95,3
12,N/A,N/A,N/A,1439,1451,N/A,99,1
27,N/A,N/A,N/A,1412,1439,N/A,102,4
12,N/A,N/A,N/A,1400,1412,N/A,106,2
36,N/A,N/A,N/A,1364,1400,N/A,109,5
33,N/A,N/A,N/A,1331,1364,N/A,115,5
38,N/A,N/A,N/A,1293,1331,N/A,121,5
24,N/A,N/A,N/A,1269,1293,N/A,126,4
13,N/A,N/A,N/A,1256,1269,N/A,130,2
9,N/A,N/A,N/A,1247,1256,N/A,135,1
23,N/A,N/A,N/A,1000,1023,N/A,3,4
31,N/A,N/A,N/A,969,1000,N/A,9,4
19,N/A,N/A,N/A,950,969,N/A,14,3
44,N/A,N/A,N/A,906,950,N/A,17,6
21,N/A,N/A,N/A,885,906,N/A,20,3
18,N/A,N/A,N/A,867,885,N/A,26,3
43,N/A,N/A,N/A,824,867,N/A,29,6
22,N/A,N/A,N/A,802,824,N/A,32,3
17,N/A,N/A,N/A,785,802,N/A,37,2
12,N/A,N/A,N/A,773,785,N/A,42,1
41,N/A,N/A,N/A,732,773,N/A,47,6
31,N/A,N/A,N/A,701,732,N/A,51,4
10,N/A,N/A,N/A,691,701,N/A,54,1
7,N/A,N/A,N/A,684,691,N/A,60,1
31,N/A,N/A,N/A,653,684,N/A,63,4
15,N/A,N/A,N/A,638,653,N/A,67,2
13,N/A,N/A,N/A,625,638,N/A,73,2
42,N/A,N/A,N/A,583,625,N/A,77,6
22,N/A,N/A,N/A,561,583,N/A,81,4
20,N/A,N/A,N/A,541,561,N/A,86,3
43,N/A,N/A,N/A,498,541,N/A,89,6
35,N/A,N/A,N/A,463,498,N/A,94,5
21,N/A,N/A,N/A,442,463,N/A,98,3
15,N/A,N/A,N/A,427,442,N/A,103,2
35,N/A,N/A,N/A,392,427,N/A,106,5
14,N/A,N/A,N/A,378,392,N/A,109,2
41,N/A,N/A,N/A,337,378,N/A,113,6
34,N/A,N/A,N/A,303,337,N/A,118,5
37,N/A,N/A,N/A,266,303,N/A,124,5
12,N/A,N/A,N/A,254,266,N/A,127,2
14,N/A,N/A,N/A,1913,1927,N/A,6,1
12,N/A,N/A,N/A,1901,1913,N/A,12,1
7,N/A,N/A,N/A,1894,1901,N/A,18,1
39,N/A,N/A,N/A,1855,1894,N/A,22,5
38,N/A,N/A,N/A,1817,1855,N/A,28,5
20,N/A,N/A,N/A,1797,1817,N/A,32,3
42,N/A,N/A,N/A,1755,1797,N/A,35,6
21,N/A,N/A,N/A,1734,1755,N/A,38,3
17,N/A,N/A,N/A,1717,1734,N/A,43,2
44,N/A,N/A,N/A,1673,1717,N/A,47,6
28,N/A,N/A,N/A,1645,1673,N/A,51,4
20,N/A,N/A,N/A,1625,1645,N/A,56,3
44,N/A,N/A,N/A,1581,1625,N/A,59,6
15,N/A,N/A,N/A,1566,1581,N/A,62,3
44,N/A,N/A,N/A,1522,1566,N/A,65,6
16,N/A,N/A,N/A,1506,1522,N/A,68,3
20,N/A,N/A,N/A,1486,1506,N/A,74,3
7,N/A,N/A,N/A,1479,1486,N/A,78,1
27,N/A,N/A,N/A,1452,1479,N/A,81,4
12,N/A,N/A,N/A,1440,1452,N/A,85,2
39,N/A,N/A,N/A,1401,1440,N/A,88,5
27,N/A,N/A,N/A,1374,1401,N/A,93,4
28,N/A,N/A,N/A,1346,1374,N/A,99,4
15,N/A,N/A,N/A,1331,1346,N/A,103,2
34,N/A,N/A,N/A,1297,1331,N/A,106,5
36,N/A,N/A,N/A,1261,1297,N/A,112,5
16,N/A,N/A,N/A,1245,1261,N/A,115,2
10,N/A,N/A,N/A,1235,1245,N/A,120,1
11,N/A,N/A,N/A,1224,1235,N/A,126,1
32,N/A,N/A,N/A,1192,1224,N/A,130,5
35,N/A,N/A,N/A,1426,1461,N/A,5,5
13,N/A,N/A,N/A,1413,1426,N/A,8,2
36,N/A,N/A,N/A,1377,1413,N/A,11,5
33,N/A,N/A,N/A,1344,1377,N/A,17,5
32,N/A,N/A,N/A,1312,1344,N/A,22,4
11,N/A,N/A,N/A,1301,1312,N/A,25,1
7,N/A,N/A,N/A,1294,1301,N/A,31,1
33,N/A,N/A,N/A,1261,1294,N/A,35,5
34,N/A,N/A,N/A,1227,1261,N/A,41,5
14,N/A,N/A,N/A,1213,1227,N/A,45,3
12,N/A,N/A,N/A,1201,1213,N/A,49,1
37,N/A,N/A,N/A,1164,1201,N/A,53,5
15,N/A,N/A,N/A,1149,1164,N/A,56,2
16,N/A,N/A,N/A,1133,1149,N/A,62,2
34,N/A,N/A,N/A,1099,1133,N/A,65,5
11,N/A,N/A,N/A,1088,1099,N/A,68,2
8,N/A,N/A,N/A,1080,1088,N/A,73,1
24,N/A,N/A,N/A,1056,1080,N/A,76,4
20,N/A,N/A,N/A,1036,1056,N/A,81,3
10,N/A,N/A,N/A,1026,1036,N/A,86,2
38,N/A,N/A,N/A,988,1026,N/A,89,5
26,N/A,N/A,N/A,962,988,N/A,94,4
19,N/A,N/A,N/A,943,962,N/A,99,3
12,N/A,N/A,N/A,931,943,N/A,103,1
8,N/A,N/A,N/A,923,931,N/A,109,1
13,N/A,N/A,N/A,910,923,N/A,115,1
41,N/A,N/A,N/A,869,910,N/A,120,6
8,N/A,N/A,N/A,861,869,N/A,126,0
35,N/A,N/A,N/A,826,861,N/A,131,5
16,N/A,N/A,N/A,810,826,N/A,135,3
36,N/A,N/A,N/A,1703,1739,N/A,4,5
10,N/A,N/A,N/A,1693,1703,N/A,7,2
44,N/A,N/A,N/A,1649,1693,N/A,11,6
30,N/A,N/A,N/A,1619,1649,N/A,15,4
7,N/A,N/A,N/A,1612,1619,N/A,18,1
31,N/A,N/A,N/A,1581,1612,N/A,21,4
21,N/A,N/A,N/A,1560,1581,N/A,26,3
7,N/A,N/A,N/A,1553,1560,N/A,30,1
26,N/A,N/A,N/A,1527,1553,N/A,33,4
11,N/A,N/A,N/A,1516,1527,N/A,36,1
33,N/A,N/A,N/A,1483,1516,N/A,40,5
17,N/A,N/A,N/A,1466,1483,N/A,44,3
11,N/A,N/A,N/A,1455,1466,N/A,49,2
33,N/A,N/A,N/A,1422,1455,N/A,52,5
16,N/A,N/A,N/A,1406,1422,N/A,56,3
14,N/A,N/A,N/A,1392,1406,N/A,62,3
44,N/A,N/A,N/A,1348,1392,N/A,65,6
28,N/A,N/A,N/A,1320,1348,N/A,69,4
12,N/A,N/A,N/A,1308,1320,N/A,72,1
25,N/A,N/A,N/A,1283,1308,N/A,75,4
9,N/A,N/A,N/A,1274,1283,N/A,78,1
33,N/A,N/A,N/A,1241,1274,N/A,82,5
34,N/A,N/A,N/A,1207,1241,N/A,88,5
37,N/A,N/A,N/A,1170,1207,N/A,94,5
16,N/A,N/A,N/A,1154,1170,N/A,98,3
42,N/A,N/A,N/A,1112,1154,N/A,101,6
24,N/A,N/A,N/A,1088,1112,N/A,105,4
15,N/A,N/A,N/A,1073,1088,N/A,109,2
38,N/A,N/A,N/A,1035,1073,N/A,112,5
25,N/A,N/A,N/A,1010,1035,N/A,117,4
15,N/A,N/A,N/A,1922,1937,N/A,3,2
36,N/A,N/A,N/A,1886,1922,N/A,6,5
39,N/A,N/A,N/A,1847,1886,N/A,12,5
32,N/A,N/A,N/A,1815,1847,N/A,18,5
33,N/A,N/A,N/A,1782,1815,N/A,24,5
28,N/A,N/A,N/A,1754,1782,N/A,29,4
11,N/A,N/A,N/A,1743,1754,N/A,32,1
41,N/A,N/A,N/A,1702,1743,N/A,37,6
8,N/A,N/A,N/A,1694,1702,N/A,43,0
25,N/A,N/A,N/A,1669,1694,N/A,47,4
31,N/A,N/A,N/A,1638,1669,N/A,53,4
26,N/A,N/A,N/A,1612,1638,N/A,59,4
7,N/A,N/A,N/A,1605,1612,N/A,62,1
14,N/A,N/A,N/A,1591,1605,N/A,68,1
12,N/A,N/A,N/A,1579,1591,N/A,74,1
36,N/A,N/A,N/A,1543,1579,N/A,78,5
28,N/A,N/A,N/A,1515,1543,N/A,83,4
30,N/A,N/A,N/A,1485,1515,N/A,89,4
13,N/A,N/A,N/A,1472,1485,N/A,92,1
30,N/A,N/A,N/A,1442,1472,N/A,95,4
27,N/A,N/A,N/A,1415,1442,N/A,101,4
31,N/A,N/A,N/A,1384,1415,N/A,107,4
22,N/A,N/A,N/A,1362,1384,N/A,113,4
11,N/A,N/A,N/A,1351,1362,N/A,117,2
39,N/A,N/A,N/A,1312,1351,N/A,120,5
22,N/A,N/A,N/A,1290,1312,N/A,125,4
13,N/A,N/A,N/A,1277,1290,N/A,129,2
10,N/A,N/A,N/A,1267,1277,N/A,135,2
10,N/A,N/A,N/A,1257,1267,N/A,141,2
12,N/A,N/A,N/A,1245,1257,N/A,146,1
18,N/A,N/A,N/A,1388,1406,N/A,3,3
9,N/A,N/A,N/A,1379,1388,N/A,7,1
12,N/A,N/A,N/A,1367,1379,N/A,13,1
10,N/A,N/A,N/A,1357,1367,N/A,19,1
30,N/A,N/A,N/A,1327,1357,N/A,22,4
13,N/A,N/A,N/A,1314,1327,N/A,26,2
13,N/A,N/A,N/A,1301,1314,N/A,32,2
8,N/A,N/A,N/A,1293,1301,N/A,37,1
41,N/A,N/A,N/A,1252,1293,N/A,42,6
27,N/A,N/A,N/A,1225,1252,N/A,46,4
21,N/A,N/A,N/A,1204,1225,N/A,51,3
42,N/A,N/A,N/A,1162,1204,N/A,54,6
32,N/A,N/A,N/A,1130,1162,N/A,59,5
16,N/A,N/A,N/A,1114,1130,N/A,62,2
11,N/A,N/A,N/A,1103,1114,N/A,67,1
33,N/A,N/A,N/A,1070,1103,N/A,71,5
16,N/A,N/A,N/A,1054,1070,N/A,75,3
20,N/A,N/A,N/A,1034,1054,N/A,81,3
42,N/A,N/A,N/A,992,1034,N/A,84,6
39,N/A,N/A,N/A,953,992,N/A,89,5
17,N/A,N/A,N/A,936,953,N/A,93,3
14,N/A,N/A,N/A,922,936,N/A,98,2
37,N/A,N/A,N/A,885,922,N/A,101,5
34,N/A,N/A,N/A,851,885,N/A,107,5
17,N/A,N/A,N/A,834,851,N/A,111,3
12,N/A,N/A,N/A,822,834,N/A,115,1
22,N/A,N/A,N/A,800,822,N/A,118,4
13,N/A,N/A,N/A,787,800,N/A,121,1
31,N/A,N/A,N/A,756,787,N/A,124,4
10,N/A,N/A,N/A,746,756,N/A,128,2
44,N/A,N/A,N/A,1695,1739,N/A,3,6
23,N/A,N/A,N/A,1672,1695,N/A,6,3
14,N/A,N/A,N/A,1658,1672,N/A,11,2
14,N/A,N/A,N/A,1644,1658,N/A,17,2
11,N/A,N/A,N/A,1633,1644,N/A,23,2
38,N/A,N/A,N/A,1595,1633,N/A,26,5
16,N/A,N/A,N/A,1579,1595,N/A,29,2
39,N/A,N/A,N/A,1540,1579,N/A,32,5
15,N/A,N/A,N/A,1525,1540,N/A,35,2
44,N/A,N/A,N/A,1481,1525,N/A,39,6
34,N/A,N/A,N/A,1447,1481,N/A,44,5
32,N/A,N/A,N/A,1415,1447,N/A,49,4
25,N/A,N/A,N/A,1390,1415,N/A,55,4
15,N/A,N/A,N/A,1375,1390,N/A,59,2
12,N/A,N/A,N/A,1363,1375,N/A,64,1
32,N/A,N/A,N/A,1331,1363,N/A,68,5
17,N/A,N/A,N/A,1314,1331,N/A,72,3
7,N/A,N/A,N/A,1307,1314,N/A,76,1
13,N/A,N/A,N/A,1294,1307,N/A,82,1
14,N/A,N/A,N/A,1280,1294,N/A,88,1
10,N/A,N/A,N/A,1270,1280,N/A,94,1
41,N/A,N/A,N/A,1229,1270,N/A,99,6
17,N/A,N/A,N/A,1212,1229,N/A,102,3
9,N/A,N/A,N/A,1203,1212,N/A,106,1
32,N/A,N/A,N/A,1171,1203,N/A,110,5
15,N/A,N/A,N/A,1156,1171,N/A,114,3
7,N/A,N/A,N/A,1149,1156,N/A,118,1
28,N/A,N/A,N/A,1121,1149,N/A,121,4
15,N/A,N/A,N/A,1106,1121,N/A,125,2
44,N/A,N/A,N/A,1062,1106,N/A,129,6
42,N/A,N/A,N/A,1691,1733,N/A,3,6
37,N/A,N/A,N/A,1654,1691,N/A,8,5
16,N/A,N/A,N/A,1638,1654,N/A,12,3
42,N/A,N/A,N/A,1596,1638,N/A,15,6
26,N/A,N/A,N/A,1570,1596,N/A,19,4
8,N/A,N/A,N/A,1562,1570,N/A,22,1
39,N/A,N/A,N/A,1523,1562,N/A,26,5
27,N/A,N/A,N/A,1496,1523,N/A,31,4
17,N/A,N/A,N/A,1479,1496,N/A,35,2
10,N/A,N/A,N/A,1469,1479,N/A,41,2
7,N/A,N/A,N/A,1462,1469,N/A,46,1
34,N/A,N/A,N/A,1428,1462,N/A,50,5
23,N/A,N/A,N/A,1405,1428,N/A,54,3
20,N/A,N/A,N/A,1385,1405,N/A,60,3
10,N/A,N/A,N/A,1375,1385,N/A,64,1
30,N/A,N/A,N/A,1345,1375,N/A,67,4
11,N/A,N/A,N/A,1334,1345,N/A,71,2
44,N/A,N/A,N/A,1290,1334,N/A,75,6
16,N/A,N/A,N/A,1274,1290,N/A,78,3
16,N/A,N/A,N/A,1258,1274,N/A,84,3
18,N/A,N/A,N/A,1240,1258,N/A,90,3
9,N/A,N/A,N/A,1231,1240,N/A,94,1
14,N/A,N/A,N/A,1217,1231,N/A,100,1
32,N/A,N/A,N/A,1185,1217,N/A,104,5
39,N/A,N/A,N/A,1146,1185,N/A,110,5
28,N/A,N/A,N/A,1118,1146,N/A,115,4
11,N/A,N/A,N/A,1107,1118,N/A,119,2
12,N/A,N/A,N/A,1095,1107,N/A,124,1
35,N/A,N/A,N/A,1060,1095,N/A,128,5
16,N/A,N/A,N/A,1044,1060,N/A,132,3
28,N/A,N/A,N/A,1389,1417,N/A,4,4
17,N/A,N/A,N/A,1372,1389,N/A,8,2
42,N/A,N/A,N/A,1330,1372,N/A,12,6
7,N/A,N/A,N/A,1323,1330,N/A,18,0
38,N/A,N/A,N/A,1285,1323,N/A,23,5
14,N/A,N/A,N/A,1271,1285,N/A,26,2
39,N/A,N/A,N/A,1232,1271,N/A,29,5
17,N/A,N/A,N/A,1215,1232,N/A,33,3
41,N/A,N/A,N/A,1174,1215,N/A,36,6
38,N/A,N/A,N/A,1136,1174,N/A,41,5
22,N/A,N/A,N/A,1114,1136,N/A,46,4
19,N/A,N/A,N/A,1095,1114,N/A,51,3
18,N/A,N/A,N/A,1077,1095,N/A,57,3
21,N/A,N/A,N/A,1056,1077,N/A,63,3
14,N/A,N/A,N/A,1042,1056,N/A,69,3
41,N/A,N/A,N/A,1001,1042,N/A,72,6
37,N/A,N/A,N/A,964,1001,N/A,77,5
31,N/A,N/A,N/A,933,964,N/A,82,4
22,N/A,N/A,N/A,911,933,N/A,88,4
15,N/A,N/A,N/A,896,911,N/A,93,3
15,N/A,N/A,N/A,881,896,N/A,98,2
12,N/A,N/A,N/A,869,881,N/A,103,1
44,N/A,N/A,N/A,825,869,N/A,108,6
18,N/A,N/A,N/A,807,825,N/A,111,3
17,N/A,N/A,N/A,790,807,N/A,116,2
36,N/A,N/A,N/A,754,790,N/A,119,5
17,N/A,N/A,N/A,737,754,N/A,122,2
10,N/A,N/A,N/A,727,737,N/A,127,1
41,N/A,N/A,N/A,686,727,N/A,132,6
36,N/A,N/A,N/A,650,686,N/A,137,5
34,N/A,N/A,N/A,1461,1495,N/A,5,5
28,N/A,N/A,N/A,1433,1461,N/A,10,4
30,N/A,N/A,N/A,1403,1433,N/A,16,4
16,N/A,N/A,N/A,1387,1403,N/A,21,3
17,N/A,N/A,N/A,1370,1387,N/A,26,2
38,N/A,N/A,N/A,1332,1370,N/A,29,5
29,N/A,N/A,N/A,1303,1332,N/A,34,4
10,N/A,N/A,N/A,1293,1303,N/A,37,1
24,N/A,N/A,N/A,1269,1293,N/A,40,4
23,N/A,N/A,N/A,1246,1269,N/A,46,4
10,N/A,N/A,N/A,1236,1246,N/A,49,1
7,N/A,N/A,N/A,1229,1236,N/A,55,1
14,N/A,N/A,N/A,1215,1229,N/A,61,1
43,N/A,N/A,N/A,1172,1215,N/A,66,6
38,N/A,N/A,N/A,1134,1172,N/A,71,5
23,N/A,N/A,N/A,1111,1134,N/A,75,3
44,N/A,N/A,N/A,1067,1111,N/A,78,6
23,N/A,N/A,N/A,1044,1067,N/A,82,4
8,N/A,N/A,N/A,1036,1044,N/A,85,1
28,N/A,N/A,N/A,1008,1036,N/A,88,4
23,N/A,N/A,N/A,985,1008,N/A,93,3
15,N/A,N/A,N/A,970,985,N/A,98,2
10,N/A,N/A,N/A,960,970,N/A,104,2
34,N/A,N/A,N/A,926,960,N/A,107,5
25,N/A,N/A,N/A,901,926,N/A,112,4
29,N/A,N/A,N/A,872,901,N/A,118,4
13,N/A,N/A,N/A,859,872,N/A,122,2
42,N/A,N/A,N/A,817,859,N/A,126,6
6,N/A,N/A,N/A,811,817,N/A,132,0
23,N/A,N/A,N/A,788,811,N/A,135,3
11,N/A,N/A,N/A,1613,1624,N/A,6,2
12,N/A,N/A,N/A,1601,1613,N/A,12,2
36,N/A,N/A,N/A,1565,1601,N/A,15,5
12,N/A,N/A,N/A,1553,1565,N/A,18,2
11,N/A,N/A,N/A,1542,1553,N/A,23,1
9,N/A,N/A,N/A,1533,1542,N/A,29,1
32,N/A,N/A,N/A,1501,1533,N/A,32,4
25,N/A,N/A,N/A,1476,1501,N/A,38,4
22,N/A,N/A,N/A,1454,1476,N/A,43,3
21,N/A,N/A,N/A,1433,1454,N/A,49,3
43,N/A,N/A,N/A,1390,1433,N/A,52,6
9,N/A,N/A,N/A,1381,1390,N/A,58,0
14,N/A,N/A,N/A,1367,1381,N/A,61,3
12,N/A,N/A,N/A,1355,1367,N/A,66,2
12,N/A,N/A,N/A,1343,1355,N/A,72,2
10,N/A,N/A,N/A,1333,1343,N/A,77,1
41,N/A,N/A,N/A,1292,1333,N/A,82,6
30,N/A,N/A,N/A,1262,1292,N/A,86,4
17,N/A,N/A,N/A,1245,1262,N/A,91,3
17,N/A,N/A,N/A,1228,1245,N/A,96,2
33,N/A,N/A,N/A,1195,1228,N/A,99,5
17,N/A,N/A,N/A,1178,1195,N/A,102,2
36,N/A,N/A,N/A,1142,1178,N/A,105,5
20,N/A,N/A,N/A,1122,1142,N/A,109,3
17,N/A,N/A,N/A,1105,1122,N/A,114,2
15,N/A,N/A,N/A,1090,1105,N/A,120,2
42,N/A,N/A,N/A,1048,1090,N/A,124,6
29,N/A,N/A,N/A,1019,1048,N/A,128,4
20,N/A,N/A,N/A,999,1019,N/A,133,3
13,N/A,N/A,N/A,986,999,N/A,137,1
42,N/A,N/A,N/A,546,588,N/A,6,6
38,N/A,N/A,N/A,508,546,N/A,11,5
31,N/A,N/A,N/A,477,508,N/A,16,4
25,N/A,N/A,N/A,452,477,N/A,22,4
16,N/A,N/A,N/A,436,452,N/A,27,3
44,N/A,N/A,N/A,392,436,N/A,30,6
20,N/A,N/A,N/A,372,392,N/A,33,3
18,N/A,N/A,N/A,354,372,N/A,39,3
43,N/A,N/A,N/A,311,354,N/A,42,6
21,N/A,N/A,N/A,290,311,N/A,45,3
43,N/A,N/A,N/A,247,290,N/A,48,6
35,N/A,N/A,N/A,212,247,N/A,53,5
22,N/A,N/A,N/A,190,212,N/A,57,3
42,N/A,N/A,N/A,148,190,N/A,60,6
23,N/A,N/A,N/A,125,148,N/A,63,3
43,N/A,N/A,N/A,82,125,N/A,66,6
31,N/A,N/A,N/A,51,82,N/A,70,4
11,N/A,N/A,N/A,40,51,N/A,74,2
9,N/A,N/A,N/A,31,40,N/A,79,1
34,N/A,N/A,N/A,-3,31,N/A,83,5
35,N/A,N/A,N/A,999,1034,N/A,6,5
19,N/A,N/A,N/A,980,999,N/A,10,3
44,N/A,N/A,N/A,936,980,N/A,13,6
38,N/A,N/A,N/A,898,936,N/A,18,5
31,N/A,N/A,N/A,867,898,N/A,23,4
13,N/A,N/A,N/A,854,867,N/A,27,2
13,N/A,N/A,N/A,841,854,N/A,33,2
9,N/A,N/A,N/A,832,841,N/A,38,1
11,N/A,N/A,N/A,821,832,N/A,44,1
14,N/A,N/A,N/A,807,821,N/A,50,1
43,N/A,N/A,N/A,764,807,N/A,55,6
32,N/A,N/A,N/A,732,764,N/A,59,4
13,N/A,N/A,N/A,719,732,N/A,62,1
13,N/A,N/A,N/A,706,719,N/A,68,1
10,N/A,N/A,N/A,696,706,N/A,74,1
36,N/A,N/A,N/A,660,696,N/A,78,5
34,N/A,N/A,N/A,626,660,N/A,84,5
37,N/A,N/A,N/A,589,626,N/A,90,5
19,N/A,N/A,N/A,570,589,N/A,94,3
10,N/A,N/A,N/A,560,570,N/A,99,2
12,N/A,N/A,N/A,548,560,N/A,105,2
33,N/A,N/A,N/A,515,548,N/A,108,5
10,N/A,N/A,N/A,505,515,N/A,111,2
43,N/A,N/A,N/A,462,505,N/A,115,6
32,N/A,N/A,N/A,430,462,N/A,119,4
23,N/A,N/A,N/A,407,430,N/A,124,3
17,N/A,N/A,N/A,390,407,N/A,130,3
41,N/A,N/A,N/A,349,390,N/A,133,6
31,N/A,N/A,N/A,318,349,N/A,137,4
24,N/A,N/A,N/A,294,318,N/A,143,4
41,N/A,N/A,N/A,1702,1743,N/A,3,6
39,N/A,N/A,N/A,1663,1702,N/A,8,5
26,N/A,N/A,N/A,1637,1663,N/A,13,4
10,N/A,N/A,N/A,1627,1637,N/A,16,1
32,N/A,N/A,N/A,1595,1627,N/A,19,4
11,N/A,N/A,N/A,1584,1595,N/A,22,1
33,N/A,N/A,N/A,1551,1584,N/A,26,5
35,N/A,N/A,N/A,1516,1551,N/A,32,5
33,N/A,N/A,N/A,1483,1516,N/A,38,5
36,N/A,N/A,N/A,1447,1483,N/A,44,5
23,N/A,N/A,N/A,1424,1447,N/A,49,4
27,N/A,N/A,N/A,1397,1424,N/A,55,4
24,N/A,N/A,N/A,1373,1397,N/A,61,4
15,N/A,N/A,N/A,1358,1373,N/A,66,3
8,N/A,N/A,N/A,1350,1358,N/A,70,1
43,N/A,N/A,N/A,1307,1350,N/A,75,6
17,N/A,N/A,N/A,1290,1307,N/A,78,3
16,N/A,N/A,N/A,1274,1290,N/A,83,2
44,N/A,N/A,N/A,1230,1274,N/A,87,6
38,N/A,N/A,N/A,1192,1230,N/A,92,5
23,N/A,N/A,N/A,1169,1192,N/A,96,3
19,N/A,N/A,N/A,1150,1169,N/A,102,3
23,N/A,N/A,N/A,1127,1150,N/A,108,3
44,N/A,N/A,N/A,1083,1127,N/A,111,6
22,N/A,N/A,N/A,1061,1083,N/A,115,4
18,N/A,N/A,N/A,1043,1061,N/A,120,3
9,N/A,N/A,N/A,1034,1043,N/A,124,1
34,N/A,N/A,N/A,1000,1034,N/A,128,5
28,N/A,N/A,N/A,972,1000,N/A,133,4
23,N/A,N/A,N/A,949,972,N/A,139,4
22,N/A,N/A,N/A,919,941,N/A,3,3
8,N/A,N/A,N/A,911,919,N/A,7,1
32,N/A,N/A,N/A,879,911,N/A,11,5
11,N/A,N/A,N/A,868,879,N/A,14,2
41,N/A,N/A,N/A,827,868,N/A,18,6
22,N/A,N/A,N/A,805,827,N/A,21,3
20,N/A,N/A,N/A,785,805,N/A,27,3
16,N/A,N/A,N/A,769,785,N/A,33,3
43,N/A,N/A,N/A,726,769,N/A,36,6
22,N/A,N/A,N/A,704,726,N/A,40,4
18,N/A,N/A,N/A,686,704,N/A,45,3
10,N/A,N/A,N/A,676,686,N/A,49,1
9,N/A,N/A,N/A,667,676,N/A,55,1
10,N/A,N/A,N/A,657,667,N/A,61,1
43,N/A,N/A,N/A,614,657,N/A,66,6
34,N/A,N/A,N/A,580,614,N/A,71,5
12,N/A,N/A,N/A,568,580,N/A,74,2
7,N/A,N/A,N/A,561,568,N/A,79,1
11,N/A,N/A,N/A,550,561,N/A,85,1
10,N/A,N/A,N/A,540,550,N/A,91,1
23,N/A,N/A,N/A,517,540,N/A,94,4
23,N/A,N/A,N/A,494,517,N/A,99,3
15,N/A,N/A,N/A,479,494,N/A,105,3
42,N/A,N/A,N/A,437,479,N/A,108,6
21,N/A,N/A,N/A,416,437,N/A,111,3
22,N/A,N/A,N/A,394,416,N/A,117,3
12,N/A,N/A,N/A,382,394,N/A,122,2
14,N/A,N/A,N/A,368,382,N/A,127,1
37,N/A,N/A,N/A,331,368,N/A,131,5
33,N/A,N/A,N/A,298,331,N/A,137,5
12,N/A,N/A,N/A,1151,1163,N/A,3,1
9,N/A,N/A,N/A,1142,1151,N/A,9,1
41,N/A,N/A,N/A,1101,1142,N/A,14,6
27,N/A,N/A,N/A,1074,1101,N/A,18,4
11,N/A,N/A,N/A,1063,1074,N/A,22,2
16,N/A,N/A,N/A,1047,1063,N/A,28,2
42,N/A,N/A,N/A,1005,1047,N/A,32,6
15,N/A,N/A,N/A,990,1005,N/A,35,3
14,N/A,N/A,N/A,976,990,N/A,39,1
38,N/A,N/A,N/A,938,976,N/A,43,5
10,N/A,N/A,N/A,928,938,N/A,46,2
12,N/A,N/A,N/A,916,928,N/A,52,2
33,N/A,N/A,N/A,883,916,N/A,55,5
32,N/A,N/A,N/A,851,883,N/A,61,5
17,N/A,N/A,N/A,834,851,N/A,64,2
17,N/A,N/A,N/A,817,834,N/A,70,2
7,N/A,N/A,N/A,810,817,N/A,75,1
41,N/A,N/A,N/A,769,810,N/A,80,6
32,N/A,N/A,N/A,737,769,N/A,84,4
24,N/A,N/A,N/A,713,737,N/A,90,4
16,N/A,N/A,N/A,697,713,N/A,94,2
15,N/A,N/A,N/A,682,697,N/A,100,2
34,N/A,N/A,N/A,648,682,N/A,103,5
36,N/A,N/A,N/A,612,648,N/A,109,5
13,N/A,N/A,N/A,599,612,N/A,112,2
41,N/A,N/A,N/A,558,599,N/A,116,6
19,N/A,N/A,N/A,539,558,N/A,119,3
43,N/A,N/A,N/A,496,539,N/A,122,6
23,N/A,N/A,N/A,473,496,N/A,125,3
19,N/A,N/A,N/A,454,473,N/A,131,3
7,N/A,N/A,N/A,449,456,N/A,6,1
42,N/A,N/A,N/A,407,449,N/A,11,6
38,N/A,N/A,N/A,369,407,N/A,16,5
28,N/A,N/A,N/A,341,369,N/A,21,4
26,N/A,N/A,N/A,315,341,N/A,27,4
24,N/A,N/A,N/A,291,315,N/A,33,4
11,N/A,N/A,N/A,280,291,N/A,37,2
10,N/A,N/A,N/A,270,280,N/A,43,2
39,N/A,N/A,N/A,231,270,N/A,46,5
15,N/A,N/A,N/A,216,231,N/A,50,3
41,N/A,N/A,N/A,175,216,N/A,53,6
6,N/A,N/A,N/A,169,175,N/A,59,0
39,N/A,N/A,N/A,130,169,N/A,64,5
25,N/A,N/A,N/A,105,130,N/A,69,4
22,N/A,N/A,N/A,83,105,N/A,74,3
17,N/A,N/A,N/A,66,83,N/A,79,2
39,N/A,N/A,N/A,27,66,N/A,82,5
25,N/A,N/A,N/A,2,27,N/A,87,4
7,N/A,N/A,N/A,-5,2,N/A,90,1
12,N/A,N/A,N/A,1622,1634,N/A,5,1
28,N/A,N/A,N/A,1594,1622,N/A,8,4
22,N/A,N/A,N/A,1572,1594,N/A,14,4
13,N/A,N/A,N/A,1559,1572,N/A,18,2
12,N/A,N/A,N/A,1547,1559,N/A,23,1
44,N/A,N/A,N/A,1503,1547,N/A,28,6
27,N/A,N/A,N/A,1476,1503,N/A,32,4
9,N/A,N/A,N/A,1467,1476,N/A,35,1
11,N/A,N/A,N/A,1456,1467,N/A,41,1
43,N/A,N/A,N/A,1413,1456,N/A,46,6
20,N/A,N/A,N/A,1393,1413,N/A,49,3
14,N/A,N/A,N/A,1379,1393,N/A,53,1
36,N/A,N/A,N/A,1343,1379,N/A,57,5
14,N/A,N/A,N/A,1329,1343,N/A,61,3
12,N/A,N/A,N/A,1317,1329,N/A,65,1
39,N/A,N/A,N/A,1278,1317,N/A,69,5
17,N/A,N/A,N/A,1261,1278,N/A,73,3
44,N/A,N/A,N/A,1217,1261,N/A,76,6
8,N/A,N/A,N/A,1209,1217,N/A,82,0
19,N/A,N/A,N/A,1190,1209,N/A,85,3
12,N/A,N/A,N/A,1178,1190,N/A,89,1
12,N/A,N/A,N/A,1166,1178,N/A,95,1
38,N/A,N/A,N/A,1128,1166,N/A,99,5
34,N/A,N/A,N/A,1094,1128,N/A,105,5
11,N/A,N/A,N/A,1083,1094,N/A,108,2
37,N/A,N/A,N/A,1046,1083,N/A,111,5
17,N/A,N/A,N/A,1029,1046,N/A,115,3
15,N/A,N/A,N/A,1014,1029,N/A,120,2
11,N/A,N/A,N/A,1003,1014,N/A,125,1
32,N/A,N/A,N/A,971,1003,N/A,129,5
35,N/A,N/A,N/A,547,582,N/A,4,5
36,N/A,N/A,N/A,511,547,N/A,10,5
17,N/A,N/A,N/A,494,511,N/A,13,2
34,N/A,N/A,N/A,460,494,N/A,16,5
37,N/A,N/A,N/A,423,460,N/A,22,5
25,N/A,N/A,N/A,398,423,N/A,27,4
12,N/A,N/A,N/A,386,398,N/A,31,2
43,N/A,N/A,N/A,343,386,N/A,35,6
38,N/A,N/A,N/A,305,343,N/A,40,5
22,N/A,N/A,N/A,283,305,N/A,44,3
17,N/A,N/A,N/A,266,283,N/A,49,2
9,N/A,N/A,N/A,257,266,N/A,54,1
37,N/A,N/A,N/A,220,257,N/A,58,5
14,N/A,N/A,N/A,206,220,N/A,62,3
10,N/A,N/A,N/A,196,206,N/A,67,2
17,N/A,N/A,N/A,179,196,N/A,73,2
10,N/A,N/A,N/A,169,179,N/A,78,1
41,N/A,N/A,N/A,128,169,N/A,83,6
31,N/A,N/A,N/A,97,128,N/A,87,4
13,N/A,N/A,N/A,84,97,N/A,90,1
11,N/A,N/A,N/A,73,84,N/A,96,1
34,N/A,N/A,N/A,39,73,N/A,100,5
39,N/A,N/A,N/A,0,39,N/A,106,5
39,N/A,N/A,N/A,518,557,N/A,3,5
23,N/A,N/A,N/A,495,518,N/A,8,4
15,N/A,N/A,N/A,480,495,N/A,12,2
14,N/A,N/A,N/A,466,480,N/A,18,2
14,N/A,N/A,N/A,452,466,N/A,24,2
10,N/A,N/A,N/A,442,452,N/A,29,1
37,N/A,N/A,N/A,405,442,N/A,33,5
33,N/A,N/A,N/A,372,405,N/A,39,5
27,N/A,N/A,N/A,345,372,N/A,44,4
24,N/A,N/A,N/A,321,345,N/A,50,4
7,N/A,N/A,N/A,314,321,N/A,53,1
43,N/A,N/A,N/A,271,314,N/A,58,6
31,N/A,N/A,N/A,240,271,N/A,62,4
30,N/A,N/A,N/A,210,240,N/A,68,4
31,N/A,N/A,N/A,179,210,N/A,74,4
27,N/A,N/A,N/A,152,179,N/A,80,4
17,N/A,N/A,N/A,135,152,N/A,85,3
11,N/A,N/A,N/A,124,135,N/A,90,2
11,N/A,N/A,N/A,113,124,N/A,95,1
35,N/A,N/A,N/A,78,113,N/A,99,5
21,N/A,N/A,N/A,57,78,N/A,103,3
14,N/A,N/A,N/A,43,57,N/A,108,2
38,N/A,N/A,N/A,5,43,N/A,111,5
17,N/A,N/A,N/A,-12,5,N/A,114,2
15,N/A,N/A,N/A,632,647,N/A,5,2
7,N/A,N/A,N/A,625,632,N/A,10,1
30,N/A,N/A,N/A,595,625,N/A,13,4
18,N/A,N/A,N/A,577,595,N/A,18,3
14,N/A,N/A,N/A,563,577,N/A,22,1
31,N/A,N/A,N/A,532,563,N/A,25,4
10,N/A,N/A,N/A,522,532,N/A,28,1
32,N/A,N/A,N/A,490,522,N/A,31,4
16,N/A,N/A,N/A,474,490,N/A,35,2
33,N/A,N/A,N/A,441,474,N/A,38,5
19,N/A,N/A,N/A,422,441,N/A,42,3
42,N/A,N/A,N/A,380,422,N/A,45,6
20,N/A,N/A,N/A,360,380,N/A,48,3
10,N/A,N/A,N/A,350,360,N/A,52,1
43,N/A,N/A,N/A,307,350,N/A,57,6
17,N/A,N/A,N/A,290,307,N/A,60,3
43,N/A,N/A,N/A,247,290,N/A,63,6
31,N/A,N/A,N/A,216,247,N/A,67,4
20,N/A,N/A,N/A,196,216,N/A,72,3
12,N/A,N/A,N/A,184,196,N/A,77,2
39,N/A,N/A,N/A,145,184,N/A,80,5
23,N/A,N/A,N/A,122,145,N/A,85,4
14,N/A,N/A,N/A,108,122,N/A,90,3
41,N/A,N/A,N/A,67,108,N/A,93,6
29,N/A,N/A,N/A,38,67,N/A,97,4
22,N/A,N/A,N/A,16,38,N/A,103,4
13,N/A,N/A,N/A,3,16,N/A,106,1
25,N/A,N/A,N/A,-22,3,N/A,109,4
33,N/A,N/A,N/A,1663,1696,N/A,5,5
28,N/A,N/A,N/A,1635,1663,N/A,10,4
26,N/A,N/A,N/A,1609,1635,N/A,16,4
16,N/A,N/A,N/A,1593,1609,N/A,20,2
38,N/A,N/A,N/A,1555,1593,N/A,23,5
30,N/A,N/A,N/A,1525,1555,N/A,28,4
26,N/A,N/A,N/A,1499,1525,N/A,34,4
29,N/A,N/A,N/A,1470,1499,N/A,40,4
23,N/A,N/A,N/A,1447,1470,N/A,46,4
10,N/A,N/A,N/A,1437,1447,N/A,49,1
39,N/A,N/A,N/A,1398,1437,N/A,53,5
33,N/A,N/A,N/A,1365,1398,N/A,59,5
34,N/A,N/A,N/A,1331,1365,N/A,65,5
11,N/A,N/A,N/A,1320,1331,N/A,68,2
43,N/A,N/A,N/A,1277,1320,N/A,72,6
9,N/A,N/A,N/A,1268,1277,N/A,78,0
28,N/A,N/A,N/A,1240,1268,N/A,82,4
22,N/A,N/A,N/A,1218,1240,N/A,87,3
10,N/A,N/A,N/A,1208,1218,N/A,92,2
10,N/A,N/A,N/A,1198,1208,N/A,98,2
9,N/A,N/A,N/A,1189,1198,N/A,103,1
14,N/A,N/A,N/A,1175,1189,N/A,109,1
26,N/A,N/A,N/A,1149,1175,N/A,112,4
23,N/A,N/A,N/A,1126,1149,N/A,118,4
14,N/A,N/A,N/A,1112,1126,N/A,121,1
42,N/A,N/A,N/A,1070,1112,N/A,126,6
8,N/A,N/A,N/A,1062,1070,N/A,132,0
39,N/A,N/A,N/A,1023,1062,N/A,137,5
34,N/A,N/A,N/A,989,1023,N/A,143,5
32,N/A,N/A,N/A,957,989,N/A,148,4
41,N/A,N/A,N/A,1421,1462,N/A,3,6
15,N/A,N/A,N/A,1406,1421,N/A,6,3
17,N/A,N/A,N/A,1389,1406,N/A,11,2
37,N/A,N/A,N/A,1352,1389,N/A,14,5
31,N/A,N/A,N/A,1321,1352,N/A,19,4
7,N/A,N/A,N/A,1314,1321,N/A,22,1
30,N/A,N/A,N/A,1284,1314,N/A,25,4
22,N/A,N/A,N/A,1262,1284,N/A,30,3
12,N/A,N/A,N/A,1250,1262,N/A,35,2
12,N/A,N/A,N/A,1238,1250,N/A,40,1
35,N/A,N/A,N/A,1203,1238,N/A,44,5
13,N/A,N/A,N/A,1190,1203,N/A,47,2
16,N/A,N/A,N/A,1174,1190,N/A,53,2
43,N/A,N/A,N/A,1131,1174,N/A,57,6
34,N/A,N/A,N/A,1097,1131,N/A,62,5
32,N/A,N/A,N/A,1065,1097,N/A,68,5
33,N/A,N/A,N/A,1032,1065,N/A,74,5
26,N/A,N/A,N/A,1006,1032,N/A,79,4
12,N/A,N/A,N/A,994,1006,N/A,83,2
42,N/A,N/A,N/A,952,994,N/A,87,6
16,N/A,N/A,N/A,936,952,N/A,90,3
44,N/A,N/A,N/A,892,936,N/A,93,6
8,N/A,N/A,N/A,884,892,N/A,99,0
37,N/A,N/A,N/A,847,884,N/A,104,5
11,N/A,N/A,N/A,836,847,N/A,107,2
32,N/A,N/A,N/A,804,836,N/A,110,5
16,N/A,N/A,N/A,788,804,N/A,114,3
21,N/A,N/A,N/A,767,788,N/A,120,3
43,N/A,N/A,N/A,724,767,N/A,123,6
7,N/A,N/A,N/A,717,724,N/A,129,0
21,N/A,N/A,N/A,910,931,N/A,6,3
44,N/A,N/A,N/A,866,910,N/A,9,6
8,N/A,N/A,N/A,858,866,N/A,15,0
44,N/A,N/A,N/A,814,858,N/A,21,6
29,N/A,N/A,N/A,785,814,N/A,25,4
14,N/A,N/A,N/A,771,785,N/A,29,2
9,N/A,N/A,N/A,762,771,N/A,34,1
42,N/A,N/A,N/A,720,762,N/A,39,6
9,N/A,N/A,N/A,711,720,N/A,45,0
20,N/A,N/A,N/A,691,711,N/A,48,3
12,N/A,N/A,N/A,679,691,N/A,53,2
10,N/A,N/A,N/A,669,679,N/A,58,1
8,N/A,N/A,N/A,661,669,N/A,64,1
42,N/A,N/A,N/A,619,661,N/A,69,6
22,N/A,N/A,N/A,597,619,N/A,72,3
44,N/A,N/A,N/A,553,597,N/A,75,6
22,N/A,N/A,N/A,531,553,N/A,78,3
42,N/A,N/A,N/A,489,531,N/A,81,6
22,N/A,N/A,N/A,467,489,N/A,84,3
42,N/A,N/A,N/A,425,467,N/A,87,6
21,N/A,N/A,N/A,404,425,N/A,90,3
14,N/A,N/A,N/A,390,404,N/A,94,1
35,N/A,N/A,N/A,355,390,N/A,98,5
14,N/A,N/A,N/A,341,355,N/A,101,2
14,N/A,N/A,N/A,327,341,N/A,106,1
32,N/A,N/A,N/A,295,327,N/A,110,5
10,N/A,N/A,N/A,285,295,N/A,113,2
10,N/A,N/A,N/A,275,285,N/A,119,2
10,N/A,N/A,N/A,265,275,N/A,124,1
43,N/A,N/A,N/A,222,265,N/A,129,6
28,N/A,N/A,N/A,1913,1941,N/A,3,4
17,N/A,N/A,N/A,1896,1913,N/A,8,3
12,N/A,N/A,N/A,1884,1896,N/A,13,2
11,N/A,N/A,N/A,1873,1884,N/A,18,1
8,N/A,N/A,N/A,1865,1873,N/A,24,1
24,N/A,N/A,N/A,1841,1865,N/A,27,4
28,N/A,N/A,N/A,1813,1841,N/A,33,4
11,N/A,N/A,N/A,1802,1813,N/A,37,2
39,N/A,N/A,N/A,1763,1802,N/A,40,5
16,N/A,N/A,N/A,1747,1763,N/A,43,2
44,N/A,N/A,N/A,1703,1747,N/A,47,6
14,N/A,N/A,N/A,1689,1703,N/A,50,3
43,N/A,N/A,N/A,1646,1689,N/A,53,6
6,N/A,N/A,N/A,1640,1646,N/A,59,0
36,N/A,N/A,N/A,1604,1640,N/A,64,5
31,N/A,N/A,N/A,1573,1604,N/A,69,4
21,N/A,N/A,N/A,1552,1573,N/A,74,3
19,N/A,N/A,N/A,1533,1552,N/A,80,3
8,N/A,N/A,N/A,1525,1533,N/A,84,1
14,N/A,N/A,N/A,1511,1525,N/A,90,1
32,N/A,N/A,N/A,1479,1511,N/A,94,5
37,N/A,N/A,N/A,1442,1479,N/A,100,5
25,N/A,N/A,N/A,1417,1442,N/A,105,4
17,N/A,N/A,N/A,1400,1417,N/A,110,3
11,N/A,N/A,N/A,1389,1400,N/A,114,1
41,N/A,N/A,N/A,1348,1389,N/A,119,6
23,N/A,N/A,N/A,1325,1348,N/A,122,3
15,N/A,N/A,N/A,1310,1325,N/A,128,3
10,N/A,N/A,N/A,1300,1310,N/A,133,2
11,N/A,N/A,N/A,1289,1300,N/A,138,1
44,N/A,N/A,N/A,1297,1341,N/A,3,6
5,N/A,N/A,N/A,1292,1297,N/A,9,0
18,N/A,N/A,N/A,1274,1292,N/A,12,3
13,N/A,N/A,N/A,1261,1274,N/A,16,1
31,N/A,N/A,N/A,1230,1261,N/A,19,4
24,N/A,N/A,N/A,1206,1230,N/A,25,4
23,N/A,N/A,N/A,1183,1206,N/A,31,4
14,N/A,N/A,N/A,1169,1183,N/A,36,3
43,N/A,N/A,N/A,1126,1169,N/A,39,6
32,N/A,N/A,N/A,1094,1126,N/A,44,5
22,N/A,N/A,N/A,1072,1094,N/A,48,3
13,N/A,N/A,N/A,1059,1072,N/A,52,1
12,N/A,N/A,N/A,1047,1059,N/A,58,1
9,N/A,N/A,N/A,1038,1047,N/A,64,1
44,N/A,N/A,N/A,994,1038,N/A,69,6
27,N/A,N/A,N/A,967,994,N/A,73,4
7,N/A,N/A,N/A,960,967,N/A,76,1
31,N/A,N/A,N/A,929,960,N/A,79,4
9,N/A,N/A,N/A,920,929,N/A,82,1
37,N/A,N/A,N/A,883,920,N/A,86,5
18,N/A,N/A,N/A,865,883,N/A,90,3
12,N/A,N/A,N/A,853,865,N/A,94,1
34,N/A,N/A,N/A,819,853,N/A,98,5
32,N/A,N/A,N/A,787,819,N/A,104,5
20,N/A,N/A,N/A,767,787,N/A,108,3
11,N/A,N/A,N/A,756,767,N/A,112,1
37,N/A,N/A,N/A,719,756,N/A,116,5
34,N/A,N/A,N/A,685,719,N/A,122,5
15,N/A,N/A,N/A,670,685,N/A,126,3
7,N/A,N/A,N/A,663,670,N/A,130,1
22,N/A,N/A,N/A,1205,1227,N/A,5,3
42,N/A,N/A,N/A,1163,1205,N/A,8,6
38,N/A,N/A,N/A,1125,1163,N/A,13,5
38,N/A,N/A,N/A,1087,1125,N/A,19,5
26,N/A,N/A,N/A,1061,1087,N/A,24,4
15,N/A,N/A,N/A,1046,1061,N/A,28,2
13,N/A,N/A,N/A,1033,1046,N/A,33,1
9,N/A,N/A,N/A,1024,1033,N/A,39,1
43,N/A,N/A,N/A,981,1024,N/A,44,6
38,N/A,N/A,N/A,943,981,N/A,49,5
15,N/A,N/A,N/A,928,943,N/A,52,2
16,N/A,N/A,N/A,912,928,N/A,58,2
14,N/A,N/A,N/A,898,912,N/A,63,1
42,N/A,N/A,N/A,856,898,N/A,68,6
23,N/A,N/A,N/A,833,856,N/A,71,3
15,N/A,N/A,N/A,818,833,N/A,76,2
43,N/A,N/A,N/A,775,818,N/A,80,6
33,N/A,N/A,N/A,742,775,N/A,85,5
14,N/A,N/A,N/A,728,742,N/A,88,2
34,N/A,N/A,N/A,694,728,N/A,91,5
33,N/A,N/A,N/A,661,694,N/A,97,5
33,N/A,N/A,N/A,628,661,N/A,103,5
27,N/A,N/A,N/A,601,628,N/A,108,4
16,N/A,N/A,N/A,585,601,N/A,112,2
11,N/A,N/A,N/A,574,585,N/A,118,2
34,N/A,N/A,N/A,540,574,N/A,121,5
10,N/A,N/A,N/A,530,540,N/A,124,2
14,N/A,N/A,N/A,516,530,N/A,129,1
11,N/A,N/A,N/A,505,516,N/A,135,1
44,N/A,N/A,N/A,461,505,N/A,140,6
16,N/A,N/A,N/A,1288,1304,N/A,6,3
11,N/A,N/A,N/A,1277,1288,N/A,10,1
44,N/A,N/A,N/A,1233,1277,N/A,15,6
22,N/A,N/A,N/A,1211,1233,N/A,19,4
9,N/A,N/A,N/A,1202,1211,N/A,22,1
33,N/A,N/A,N/A,1169,1202,N/A,26,5
15,N/A,N/A,N/A,1154,1169,N/A,29,2
43,N/A,N/A,N/A,1111,1154,N/A,33,6
32,N/A,N/A,N/A,1079,1111,N/A,38,5
13,N/A,N/A,N/A,1066,1079,N/A,41,2
10,N/A,N/A,N/A,1056,1066,N/A,46,1
35,N/A,N/A,N/A,1021,1056,N/A,50,5
16,N/A,N/A,N/A,1005,1021,N/A,53,2
8,N/A,N/A,N/A,997,1005,N/A,58,1
28,N/A,N/A,N/A,969,997,N/A,61,4
17,N/A,N/A,N/A,952,969,N/A,66,3
13,N/A,N/A,N/A,939,952,N/A,71,2
38,N/A,N/A,N/A,901,939,N/A,74,5
14,N/A,N/A,N/A,887,901,N/A,78,3
10,N/A,N/A,N/A,877,887,N/A,83,2
42,N/A,N/A,N/A,835,877,N/A,87,6
39,N/A,N/A,N/A,796,835,N/A,92,5
18,N/A,N/A,N/A,778,796,N/A,96,3
12,N/A,N/A,N/A,766,778,N/A,100,1
42,N/A,N/A,N/A,724,766,N/A,105,6
9,N/A,N/A,N/A,715,724,N/A,111,0
18,N/A,N/A,N/A,697,715,N/A,114,3
12,N/A,N/A,N/A,685,697,N/A,119,2
15,N/A,N/A,N/A,670,685,N/A,125,2
44,N/A,N/A,N/A,626,670,N/A,129,6
36,N/A,N/A,N/A,1933,1969,N/A,5,5
17,N/A,N/A,N/A,1916,1933,N/A,9,3
8,N/A,N/A,N/A,1908,1916,N/A,13,1
13,N/A,N/A,N/A,1895,1908,N/A,19,1
8,N/A,N/A,N/A,1887,1895,N/A,25,1
42,N/A,N/A,N/A,1845,1887,N/A,30,6
27,N/A,N/A,N/A,1818,1845,N/A,34,4
28,N/A,N/A,N/A,1790,1818,N/A,40,4
7,N/A,N/A,N/A,1783,1790,N/A,43,1
42,N/A,N/A,N/A,1741,1783,N/A,48,6
31,N/A,N/A,N/A,1710,1741,N/A,52,4
17,N/A,N/A,N/A,1693,1710,N/A,56,2
42,N/A,N/A,N/A,1651,1693,N/A,60,6
32,N/A,N/A,N/A,1619,1651,N/A,64,4
13,N/A,N/A,N/A,1606,1619,N/A,68,2
12,N/A,N/A,N/A,1594,1606,N/A,74,2
35,N/A,N/A,N/A,1559,1594,N/A,77,5
32,N/A,N/A,N/A,1527,1559,N/A,83,5
11,N/A,N/A,N/A,1516,1527,N/A,86,2
35,N/A,N/A,N/A,1481,1516,N/A,89,5
16,N/A,N/A,N/A,1465,1481,N/A,92,2
42,N/A,N/A,N/A,1423,1465,N/A,96,6
32,N/A,N/A,N/A,1391,1423,N/A,101,5
15,N/A,N/A,N/A,1376,1391,N/A,105,3
14,N/A,N/A,N/A,1362,1376,N/A,110,2
39,N/A,N/A,N/A,1323,1362,N/A,113,5
24,N/A,N/A,N/A,1299,1323,N/A,118,4
11,N/A,N/A,N/A,1288,1299,N/A,121,1
27,N/A,N/A,N/A,1261,1288,N/A,124,4
13,N/A,N/A,N/A,1248,1261,N/A,128,2
22,N/A,N/A,N/A,379,401,N/A,4,3
14,N/A,N/A,N/A,365,379,N/A,9,2
10,N/A,N/A,N/A,355,365,N/A,14,1
26,N/A,N/A,N/A,329,355,N/A,17,4
12,N/A,N/A,N/A,317,329,N/A,21,2
10,N/A,N/A,N/A,307,317,N/A,26,1
39,N/A,N/A,N/A,268,307,N/A,30,5
11,N/A,N/A,N/A,257,268,N/A,33,2
43,N/A,N/A,N/A,214,257,N/A,37,6
5,N/A,N/A,N/A,209,214,N/A,43,0
22,N/A,N/A,N/A,187,209,N/A,47,4
14,N/A,N/A,N/A,173,187,N/A,52,3
13,N/A,N/A,N/A,160,173,N/A,56,1
42,N/A,N/A,N/A,118,160,N/A,61,6
32,N/A,N/A,N/A,86,118,N/A,66,5
17,N/A,N/A,N/A,69,86,N/A,70,3
15,N/A,N/A,N/A,54,69,N/A,75,2
14,N/A,N/A,N/A,40,54,N/A,80,1
25,N/A,N/A,N/A,15,40,N/A,83,4
16,N/A,N/A,N/A,-1,15,N/A,88,3
42,N/A,N/A,N/A,662,704,N/A,6,6
35,N/A,N/A,N/A,627,662,N/A,11,5
29,N/A,N/A,N/A,598,627,N/A,16,4
7,N/A,N/A,N/A,591,598,N/A,19,1
39,N/A,N/A,N/A,552,591,N/A,23,5
35,N/A,N/A,N/A,517,552,N/A,29,5
12,N/A,N/A,N/A,505,517,N/A,32,2
16,N/A,N/A,N/A,489,505,N/A,38,2
8,N/A,N/A,N/A,481,489,N/A,43,1
33,N/A,N/A,N/A,448,481,N/A,47,5
32,N/A,N/A,N/A,416,448,N/A,53,5
28,N/A,N/A,N/A,388,416,N/A,58,4
19,N/A,N/A,N/A,369,388,N/A,63,3
17,N/A,N/A,N/A,352,369,N/A,69,3
19,N/A,N/A,N/A,333,352,N/A,75,3
43,N/A,N/A,N/A,290,333,N/A,78,6
25,N/A,N/A,N/A,265,290,N/A,82,4
7,N/A,N/A,N/A,258,265,N/A,85,1
39,N/A,N/A,N/A,219,258,N/A,89,5
39,N/A,N/A,N/A,180,219,N/A,95,5
33,N/A,N/A,N/A,147,180,N/A,101,5
16,N/A,N/A,N/A,131,147,N/A,104,2
8,N/A,N/A,N/A,123,131,N/A,109,1
38,N/A,N/A,N/A,85,123,N/A,113,5
39,N/A,N/A,N/A,46,85,N/A,119,5
38,N/A,N/A,N/A,8,46,N/A,125,5
23,N/A,N/A,N/A,-15,8,N/A,130,4
9,N/A,N/A,N/A,1056,1065,N/A,5,1
41,N/A,N/A,N/A,1015,1056,N/A,10,6
9,N/A,N/A,N/A,1006,1015,N/A,16,0
43,N/A,N/A,N/A,963,1006,N/A,22,6
5,N/A,N/A,N/A,958,963,N/A,28,0
43,N/A,N/A,N/A,915,958,N/A,34,6
23,N/A,N/A,N/A,892,915,N/A,38,4
13,N/A,N/A,N/A,879,892,N/A,42,2
15,N/A,N/A,N/A,864,879,N/A,48,2
13,N/A,N/A,N/A,851,864,N/A,53,1
9,N/A,N/A,N/A,842,851,N/A,59,1
29,N/A,N/A,N/A,813,842,N/A,62,4
32,N/A,N/A,N/A,781,813,N/A,68,4
12,N/A,N/A,N/A,769,781,N/A,71,1
36,N/A,N/A,N/A,733,769,N/A,75,5
18,N/A,N/A,N/A,715,733,N/A,79,3
12,N/A,N/A,N/A,703,715,N/A,84,2
11,N/A,N/A,N/A,692,703,N/A,90,2
41,N/A,N/A,N/A,651,692,N/A,94,6
7,N/A,N/A,N/A,644,651,N/A,100,0
37,N/A,N/A,N/A,607,644,N/A,105,5
23,N/A,N/A,N/A,584,607,N/A,109,3
23,N/A,N/A,N/A,561,584,N/A,115,3
12,N/A,N/A,N/A,549,561,N/A,119,1
41,N/A,N/A,N/A,508,549,N/A,124,6
39,N/A,N/A,N/A,469,508,N/A,129,5
34,N/A,N/A,N/A,435,469,N/A,135,5
30,N/A,N/A,N/A,405,435,N/A,140,4
26,N/A,N/A,N/A,379,405,N/A,146,4
31,N/A,N/A,N/A,348,379,N/A,152,4
11,N/A,N/A,N/A,1333,1344,N/A,3,2
44,N/A,N/A,N/A,1289,1333,N/A,7,6
35,N/A,N/A,N/A,1254,1289,N/A,12,5
17,N/A,N/A,N/A,1237,1254,N/A,15,2
17,N/A,N/A,N/A,1220,1237,N/A,21,2
42,N/A,N/A,N/A,1178,1220,N/A,25,6
23,N/A,N/A,N/A,1155,1178,N/A,29,4
9,N/A,N/A,N/A,1146,1155,N/A,32,1
13,N/A,N/A,N/A,1133,1146,N/A,38,1
43,N/A,N/A,N/A,1090,1133,N/A,43,6
5,N/A,N/A,N/A,1085,1090,N/A,49,0
27,N/A,N/A,N/A,1058,1085,N/A,53,4
10,N/A,N/A,N/A,1048,1058,N/A,56,1
43,N/A,N/A,N/A,1005,1048,N/A,61,6
33,N/A,N/A,N/A,972,1005,N/A,66,5
34,N/A,N/A,N/A,938,972,N/A,72,5
27,N/A,N/A,N/A,911,938,N/A,77,4
10,N/A,N/A,N/A,901,911,N/A,81,2
11,N/A,N/A,N/A,890,901,N/A,86,1
44,N/A,N/A,N/A,846,890,N/A,91,6
9,N/A,N/A,N/A,837,846,N/A,97,0
39,N/A,N/A,N/A,798,837,N/A,102,5
37,N/A,N/A,N/A,761,798,N/A,108,5
13,N/A,N/A,N/A,748,761,N/A,111,2
14,N/A,N/A,N/A,734,748,N/A,117,2
34,N/A,N/A,N/A,700,734,N/A,120,5
16,N/A,N/A,N/A,684,700,N/A,124,3
12,N/A,N/A,N/A,672,684,N/A,128,1
30,N/A,N/A,N/A,642,672,N/A,131,4
32,N/A,N/A,N/A,610,642,N/A,137,4
39,N/A,N/A,N/A,554,593,N/A,5,5
11,N/A,N/A,N/A,543,554,N/A,8,2
37,N/A,N/A,N/A,506,543,N/A,11,5
36,N/A,N/A,N/A,470,506,N/A,17,5
15,N/A,N/A,N/A,455,470,N/A,20,2
16,N/A,N/A,N/A,439,455,N/A,26,2
17,N/A,N/A,N/A,422,439,N/A,32,2
8,N/A,N/A,N/A,414,422,N/A,37,1
41,N/A,N/A,N/A,373,414,N/A,42,6
5,N/A,N/A,N/A,368,373,N/A,48,0
26,N/A,N/A,N/A,342,368,N/A,52,4
10,N/A,N/A,N/A,332,342,N/A,56,2
17,N/A,N/A,N/A,315,332,N/A,62,2
17,N/A,N/A,N/A,298,315,N/A,68,2
12,N/A,N/A,N/A,286,298,N/A,73,1
14,N/A,N/A,N/A,272,286,N/A,79,1
42,N/A,N/A,N/A,230,272,N/A,84,6
6,N/A,N/A,N/A,224,230,N/A,90,0
35,N/A,N/A,N/A,189,224,N/A,95,5
25,N/A,N/A,N/A,164,189,N/A,100,4
15,N/A,N/A,N/A,149,164,N/A,104,2
43,N/A,N/A,N/A,106,149,N/A,108,6
25,N/A,N/A,N/A,81,106,N/A,112,4
18,N/A,N/A,N/A,63,81,N/A,117,3
9,N/A,N/A,N/A,54,63,N/A,121,1
42,N/A,N/A,N/A,12,54,N/A,126,6
7,N/A,N/A,N/A,5,12,N/A,132,0
36,N/A,N/A,N/A,-31,5,N/A,137,5
32,N/A,N/A,N/A,1543,1575,N/A,4,5
22,N/A,N/A,N/A,1521,1543,N/A,8,3
14,N/A,N/A,N/A,1507,1521,N/A,13,2
42,N/A,N/A,N/A,1465,1507,N/A,17,6
20,N/A,N/A,N/A,1445,1465,N/A,20,3
18,N/A,N/A,N/A,1427,1445,N/A,26,3
13,N/A,N/A,N/A,1414,1427,N/A,30,1
39,N/A,N/A,N/A,1375,1414,N/A,34,5
14,N/A,N/A,N/A,1361,1375,N/A,37,2
38,N/A,N/A,N/A,1323,1361,N/A,40,5
39,N/A,N/A,N/A,1284,1323,N/A,46,5
16,N/A,N/A,N/A,1268,1284,N/A,49,2
11,N/A,N/A,N/A,1257,1268,N/A,55,2
41,N/A,N/A,N/A,1216,1257,N/A,59,6
15,N/A,N/A,N/A,1201,1216,N/A,62,3
9,N/A,N/A,N/A,1192,1201,N/A,66,1
42,N/A,N/A,N/A,1150,1192,N/A,71,6
32,N/A,N/A,N/A,1118,1150,N/A,75,4
25,N/A,N/A,N/A,1093,1118,N/A,81,4
32,N/A,N/A,N/A,1061,1093,N/A,87,4
25,N/A,N/A,N/A,1036,1061,N/A,93,4
26,N/A,N/A,N/A,1010,1036,N/A,99,4
10,N/A,N/A,N/A,1000,1010,N/A,103,2
8,N/A,N/A,N/A,992,1000,N/A,108,1
36,N/A,N/A,N/A,956,992,N/A,112,5
11,N/A,N/A,N/A,945,956,N/A,115,2
43,N/A,N/A,N/A,902,945,N/A,119,6
6,N/A,N/A,N/A,896,902,N/A,125,0
30,N/A,N/A,N/A,866,896,N/A,129,4
7,N/A,N/A,N/A,859,866,N/A,132,1
42,N/A,N/A,N/A,1888,1930,N/A,3,6
25,N/A,N/A,N/A,1863,1888,N/A,7,4
16,N/A,N/A,N/A,1847,1863,N/A,11,2
10,N/A,N/A,N/A,1837,1847,N/A,17,2
41,N/A,N/A,N/A,1796,1837,N/A,21,6
34,N/A,N/A,N/A,1762,1796,N/A,26,5
25,N/A,N/A,N/A,1737,1762,N/A,31,4
14,N/A,N/A,N/A,1723,1737,N/A,34,1
41,N/A,N/A,N/A,1682,1723,N/A,39,6
18,N/A,N/A,N/A,1664,1682,N/A,42,3
11,N/A,N/A,N/A,1653,1664,N/A,46,1
36,N/A,N/A,N/A,1617,1653,N/A,50,5
38,N/A,N/A,N/A,1579,1617,N/A,56,5
17,N/A,N/A,N/A,1562,1579,N/A,59,2
34,N/A,N/A,N/A,1528,1562,N/A,62,5
37,N/A,N/A,N/A,1491,1528,N/A,68,5
16,N/A,N/A,N/A,1475,1491,N/A,72,3
12,N/A,N/A,N/A,1463,1475,N/A,77,2
37,N/A,N/A,N/A,1426,1463,N/A,80,5
11,N/A,N/A,N/A,1415,1426,N/A,83,2
12,N/A,N/A,N/A,1403,1415,N/A,88,1
36,N/A,N/A,N/A,1367,1403,N/A,92,5
32,N/A,N/A,N/A,1335,1367,N/A,98,5
25,N/A,N/A,N/A,1310,1335,N/A,103,4
24,N/A,N/A,N/A,1286,1310,N/A,109,4
18,N/A,N/A,N/A,1268,1286,N/A,114,3
15,N/A,N/A,N/A,1253,1268,N/A,119,2
8,N/A,N/A,N/A,1245,1253,N/A,124,1
36,N/A,N/A,N/A,1209,1245,N/A,128,5
10,N/A,N/A,N/A,1199,1209,N/A,131,2
9,N/A,N/A,N/A,1523,1532,N/A,4,1
12,N/A,N/A,N/A,1511,1523,N/A,10,1
30,N/A,N/A,N/A,1481,1511,N/A,13,4
25,N/A,N/A,N/A,1456,1481,N/A,19,4
23,N/A,N/A,N/A,1433,1456,N/A,25,4
12,N/A,N/A,N/A,1421,1433,N/A,28,1
8,N/A,N/A,N/A,1413,1421,N/A,34,1
14,N/A,N/A,N/A,1399,1413,N/A,40,1
34,N/A,N/A,N/A,1365,1399,N/A,44,5
23,N/A,N/A,N/A,1342,1365,N/A,49,4
26,N/A,N/A,N/A,1316,1342,N/A,55,4
16,N/A,N/A,N/A,1300,1316,N/A,60,3
17,N/A,N/A,N/A,1283,1300,N/A,66,3
10,N/A,N/A,N/A,1273,1283,N/A,70,1
8,N/A,N/A,N/A,1265,1273,N/A,76,1
41,N/A,N/A,N/A,1224,1265,N/A,81,6
38,N/A,N/A,N/A,1186,1224,N/A,86,5
34,N/A,N/A,N/A,1152,1186,N/A,92,5
15,N/A,N/A,N/A,1137,1152,N/A,95,2
44,N/A,N/A,N/A,1093,1137,N/A,99,6
15,N/A,N/A,N/A,1078,1093,N/A,102,3
20,N/A,N/A,N/A,1058,1078,N/A,108,3
15,N/A,N/A,N/A,1043,1058,N/A,113,2
35,N/A,N/A,N/A,1008,1043,N/A,116,5
32,N/A,N/A,N/A,976,1008,N/A,121,4
25,N/A,N/A,N/A,951,976,N/A,127,4
22,N/A,N/A,N/A,929,951,N/A,133,4
16,N/A,N/A,N/A,913,929,N/A,137,2
43,N/A,N/A,N/A,870,913,N/A,141,6
9,N/A,N/A,N/A,861,870,N/A,147,0
17,N/A,N/A,N/A,918,935,N/A,3,2
43,N/A,N/A,N/A,875,918,N/A,7,6
16,N/A,N/A,N/A,859,875,N/A,10,3
18,N/A,N/A,N/A,841,859,N/A,16,3
14,N/A,N/A,N/A,827,841,N/A,20,1
14,N/A,N/A,N/A,813,827,N/A,26,1
41,N/A,N/A,N/A,772,813,N/A,31,6
9,N/A,N/A,N/A,763,772,N/A,37,0
42,N/A,N/A,N/A,721,763,N/A,43,6
39,N/A,N/A,N/A,682,721,N/A,48,5
32,N/A,N/A,N/A,650,682,N/A,53,4
8,N/A,N/A,N/A,642,650,N/A,56,1
41,N/A,N/A,N/A,601,642,N/A,61,6
6,N/A,N/A,N/A,595,601,N/A,67,0
23,N/A,N/A,N/A,572,595,N/A,71,4
13,N/A,N/A,N/A,559,572,N/A,74,1
9,N/A,N/A,N/A,550,559,N/A,80,1
41,N/A,N/A,N/A,509,550,N/A,85,6
28,N/A,N/A,N/A,481,509,N/A,89,4
11,N/A,N/A,N/A,470,481,N/A,92,1
8,N/A,N/A,N/A,462,470,N/A,98,1
26,N/A,N/A,N/A,436,462,N/A,101,4
9,N/A,N/A,N/A,427,436,N/A,104,1
7,N/A,N/A,N/A,420,427,N/A,110,1
36,N/A,N/A,N/A,384,420,N/A,114,5
23,N/A,N/A,N/A,361,384,N/A,119,4
23,N/A,N/A,N/A,338,361,N/A,124,3
15,N/A,N/A,N/A,323,338,N/A,130,3
17,N/A,N/A,N/A,306,323,N/A,135,2
13,N/A,N/A,N/A,293,306,N/A,140,1
37,N/A,N/A,N/A,935,972,N/A,6,5
26,N/A,N/A,N/A,909,935,N/A,11,4
17,N/A,N/A,N/A,892,909,N/A,16,3
8,N/A,N/A,N/A,884,892,N/A,20,1
44,N/A,N/A,N/A,840,884,N/A,25,6
22,N/A,N/A,N/A,818,840,N/A,28,3
8,N/A,N/A,N/A,810,818,N/A,32,1
44,N/A,N/A,N/A,766,810,N/A,37,6
23,N/A,N/A,N/A,743,766,N/A,41,4
14,N/A,N/A,N/A,729,743,N/A,44,1
35,N/A,N/A,N/A,694,729,N/A,48,5
34,N/A,N/A,N/A,660,694,N/A,54,5
36,N/A,N/A,N/A,624,660,N/A,60,5
26,N/A,N/A,N/A,598,624,N/A,65,4
22,N/A,N/A,N/A,576,598,N/A,71,4
27,N/A,N/A,N/A,549,576,N/A,77,4
14,N/A,N/A,N/A,535,549,N/A,82,3
44,N/A,N/A,N/A,491,535,N/A,85,6
19,N/A,N/A,N/A,472,491,N/A,88,3
21,N/A,N/A,N/A,451,472,N/A,94,3
10,N/A,N/A,N/A,441,451,N/A,99,2
12,N/A,N/A,N/A,429,441,N/A,105,2
12,N/A,N/A,N/A,417,429,N/A,110,1
22,N/A,N/A,N/A,395,417,N/A,113,4
32,N/A,N/A,N/A,363,395,N/A,119,4
10,N/A,N/A,N/A,353,363,N/A,122,1
9,N/A,N/A,N/A,344,353,N/A,128,1
42,N/A,N/A,N/A,302,344,N/A,133,6
6,N/A,N/A,N/A,296,302,N/A,139,0
43,N/A,N/A,N/A,253,296,N/A,145,6
36,N/A,N/A,N/A,1201,1237,N/A,5,5
35,N/A,N/A,N/A,1166,1201,N/A,11,5
14,N/A,N/A,N/A,1152,1166,N/A,15,3
22,N/A,N/A,N/A,1130,1152,N/A,21,3
11,N/A,N/A,N/A,1119,1130,N/A,25,1
30,N/A,N/A,N/A,1089,1119,N/A,28,4
29,N/A,N/A,N/A,1060,1089,N/A,34,4
14,N/A,N/A,N/A,1046,1060,N/A,38,2
38,N/A,N/A,N/A,1008,1046,N/A,41,5
33,N/A,N/A,N/A,975,1008,N/A,47,5
32,N/A,N/A,N/A,943,975,N/A,53,5
14,N/A,N/A,N/A,929,943,N/A,56,2
14,N/A,N/A,N/A,915,929,N/A,62,2
38,N/A,N/A,N/A,877,915,N/A,65,5
10,N/A,N/A,N/A,867,877,N/A,68,2
39,N/A,N/A,N/A,828,867,N/A,71,5
12,N/A,N/A,N/A,816,828,N/A,74,2
41,N/A,N/A,N/A,775,816,N/A,78,6
28,N/A,N/A,N/A,747,775,N/A,82,4
31,N/A,N/A,N/A,716,747,N/A,88,4
23,N/A,N/A,N/A,693,716,N/A,93,3
44,N/A,N/A,N/A,649,693,N/A,96,6
34,N/A,N/A,N/A,615,649,N/A,101,5
28,N/A,N/A,N/A,587,615,N/A,106,4
11,N/A,N/A,N/A,576,587,N/A,110,2
15,N/A,N/A,N/A,561,576,N/A,116,2
35,N/A,N/A,N/A,526,561,N/A,119,5
32,N/A,N/A,N/A,494,526,N/A,124,4
27,N/A,N/A,N/A,467,494,N/A,130,4
10,N/A,N/A,N/A,457,467,N/A,133,1
13,N/A,N/A,N/A,1165,1178,N/A,5,1
8,N/A,N/A,N/A,1157,1165,N/A,11,1
13,N/A,N/A,N/A,1144,1157,N/A,17,1
34,N/A,N/A,N/A,1110,1144,N/A,21,5
14,N/A,N/A,N/A,1096,1110,N/A,24,2
39,N/A,N/A,N/A,1057,1096,N/A,27,5
27,N/A,N/A,N/A,1030,1057,N/A,32,4
22,N/A,N/A,N/A,1008,1030,N/A,38,4
10,N/A,N/A,N/A,998,1008,N/A,42,2
34,N/A,N/A,N/A,964,998,N/A,45,5
16,N/A,N/A,N/A,948,964,N/A,49,3
9,N/A,N/A,N/A,939,948,N/A,53,1
7,N/A,N/A,N/A,932,939,N/A,59,1
41,N/A,N/A,N/A,891,932,N/A,64,6
38,N/A,N/A,N/A,853,891,N/A,69,5
14,N/A,N/A,N/A,839,853,N/A,73,3
9,N/A,N/A,N/A,830,839,N/A,77,1
38,N/A,N/A,N/A,792,830,N/A,81,5
22,N/A,N/A,N/A,770,792,N/A,85,3
10,N/A,N/A,N/A,760,770,N/A,89,1
14,N/A,N/A,N/A,746,760,N/A,95,1
27,N/A,N/A,N/A,719,746,N/A,98,4
18,N/A,N/A,N/A,701,719,N/A,103,3
13,N/A,N/A,N/A,688,701,N/A,108,2
37,N/A,N/A,N/A,651,688,N/A,111,5
12,N/A,N/A,N/A,639,651,N/A,114,2
12,N/A,N/A,N/A,627,639,N/A,119,1
28,N/A,N/A,N/A,599,627,N/A,122,4
23,N/A,N/A,N/A,576,599,N/A,127,3
17,N/A,N/A,N/A,559,576,N/A,132,2
24,N/A,N/A,N/A,1141,1165,N/A,3,4
13,N/A,N/A,N/A,1128,1141,N/A,6,1
23,N/A,N/A,N/A,1105,1128,N/A,9,4
15,N/A,N/A,N/A,1090,1105,N/A,13,2
43,N/A,N/A,N/A,1047,1090,N/A,17,6
22,N/A,N/A,N/A,1025,1047,N/A,21,4
29,N/A,N/A,N/A,996,1025,N/A,27,4
32,N/A,N/A,N/A,964,996,N/A,33,4
15,N/A,N/A,N/A,949,964,N/A,37,2
43,N/A,N/A,N/A,906,949,N/A,41,6
27,N/A,N/A,N/A,879,906,N/A,45,4
10,N/A,N/A,N/A,869,879,N/A,49,2
13,N/A,N/A,N/A,856,869,N/A,54,1
32,N/A,N/A,N/A,824,856,N/A,57,4
31,N/A,N/A,N/A,793,824,N/A,63,4
12,N/A,N/A,N/A,781,793,N/A,66,1
7,N/A,N/A,N/A,774,781,N/A,72,1
43,N/A,N/A,N/A,731,774,N/A,77,6
25,N/A,N/A,N/A,706,731,N/A,81,4
10,N/A,N/A,N/A,696,706,N/A,84,1
14,N/A,N/A,N/A,682,696,N/A,90,1
41,N/A,N/A,N/A,641,682,N/A,95,6
9,N/A,N/A,N/A,632,641,N/A,101,0
17,N/A,N/A,N/A,615,632,N/A,104,3
14,N/A,N/A,N/A,601,615,N/A,109,2
37,N/A,N/A,N/A,564,601,N/A,112,5
18,N/A,N/A,N/A,546,564,N/A,116,3
9,N/A,N/A,N/A,537,546,N/A,120,1
42,N/A,N/A,N/A,495,537,N/A,125,6
15,N/A,N/A,N/A,480,495,N/A,128,3
11,N/A,N/A,N/A,651,662,N/A,5,2
44,N/A,N/A,N/A,607,651,N/A,9,6
26,N/A,N/A,N/A,581,607,N/A,13,4
22,N/A,N/A,N/A,559,581,N/A,18,3
14,N/A,N/A,N/A,545,559,N/A,24,3
18,N/A,N/A,N/A,527,545,N/A,30,3
7,N/A,N/A,N/A,520,527,N/A,34,1
12,N/A,N/A,N/A,508,520,N/A,40,1
12,N/A,N/A,N/A,496,508,N/A,46,1
44,N/A,N/A,N/A,452,496,N/A,51,6
6,N/A,N/A,N/A,446,452,N/A,57,0
20,N/A,N/A,N/A,426,446,N/A,60,3
41,N/A,N/A,N/A,385,426,N/A,63,6
16,N/A,N/A,N/A,369,385,N/A,66,3
8,N/A,N/A,N/A,361,369,N/A,70,1
31,N/A,N/A,N/A,330,361,N/A,73,4
20,N/A,N/A,N/A,310,330,N/A,78,3
43,N/A,N/A,N/A,267,310,N/A,81,6
17,N/A,N/A,N/A,250,267,N/A,84,3
43,N/A,N/A,N/A,207,250,N/A,87,6
37,N/A,N/A,N/A,170,207,N/A,92,5
16,N/A,N/A,N/A,154,170,N/A,95,2
32,N/A,N/A,N/A,122,154,N/A,98,5
11,N/A,N/A,N/A,111,122,N/A,101,2
36,N/A,N/A,N/A,75,111,N/A,104,5
31,N/A,N/A,N/A,44,75,N/A,109,4
7,N/A,N/A,N/A,37,44,N/A,112,1
33,N/A,N/A,N/A,4,37,N/A,116,5
30,N/A,N/A,N/A,-26,4,N/A,121,4
14,N/A,N/A,N/A,1278,1292,N/A,5,2
13,N/A,N/A,N/A,1265,1278,N/A,10,1
44,N/A,N/A,N/A,1221,1265,N/A,15,6
23,N/A,N/A,N/A,1198,1221,N/A,19,4
12,N/A,N/A,N/A,1186,1198,N/A,23,2
38,N/A,N/A,N/A,1148,1186,N/A,26,5
18,N/A,N/A,N/A,1130,1148,N/A,30,3
14,N/A,N/A,N/A,1116,1130,N/A,34,1
32,N/A,N/A,N/A,1084,1116,N/A,38,5
16,N/A,N/A,N/A,1068,1084,N/A,41,2
38,N/A,N/A,N/A,1030,1068,N/A,44,5
14,N/A,N/A,N/A,1016,1030,N/A,47,2
32,N/A,N/A,N/A,984,1016,N/A,50,5
29,N/A,N/A,N/A,955,984,N/A,55,4
26,N/A,N/A,N/A,929,955,N/A,61,4
19,N/A,N/A,N/A,910,929,N/A,66,3
8,N/A,N/A,N/A,902,910,N/A,70,1
10,N/A,N/A,N/A,892,902,N/A,76,1
41,N/A,N/A,N/A,851,892,N/A,81,6
17,N/A,N/A,N/A,834,851,N/A,84,3
17,N/A,N/A,N/A,817,834,N/A,90,3
42,N/A,N/A,N/A,775,817,N/A,93,6
36,N/A,N/A,N/A,739,775,N/A,98,5
15,N/A,N/A,N/A,724,739,N/A,101,2
11,N/A,N/A,N/A,713,724,N/A,107,2
13,N/A,N/A,N/A,700,713,N/A,112,1
7,N/A,N/A,N/A,693,700,N/A,118,1
27,N/A,N/A,N/A,666,693,N/A,121,4
27,N/A,N/A,N/A,639,666,N/A,127,4
12,N/A,N/A,N/A,627,639,N/A,130,1
20,N/A,N/A,N/A,1141,1161,N/A,4,3
21,N/A,N/A,N/A,1120,1141,N/A,10,3
14,N/A,N/A,N/A,1106,1120,N/A,16,3
23,N/A,N/A,N/A,1083,1106,N/A,22,3
12,N/A,N/A,N/A,1071,1083,N/A,26,1
29,N/A,N/A,N/A,1042,1071,N/A,29,4
12,N/A,N/A,N/A,1030,1042,N/A,32,1
26,N/A,N/A,N/A,1004,1030,N/A,35,4
9,N/A,N/A,N/A,995,1004,N/A,38,1
31,N/A,N/A,N/A,964,995,N/A,41,4
13,N/A,N/A,N/A,951,964,N/A,45,2
17,N/A,N/A,N/A,934,951,N/A,51,2
44,N/A,N/A,N/A,890,934,N/A,55,6
27,N/A,N/A,N/A,863,890,N/A,59,4
31,N/A,N/A,N/A,832,863,N/A,65,4
21,N/A,N/A,N/A,811,832,N/A,70,3
13,N/A,N/A,N/A,798,811,N/A,75,2
39,N/A,N/A,N/A,759,798,N/A,78,5
25,N/A,N/A,N/A,734,759,N/A,83,4
15,N/A,N/A,N/A,719,734,N/A,87,2
14,N/A,N/A,N/A,705,719,N/A,93,2
44,N/A,N/A,N/A,661,705,N/A,97,6
23,N/A,N/A,N/A,638,661,N/A,101,4
16,N/A,N/A,N/A,622,638,N/A,106,3
43,N/A,N/A,N/A,579,622,N/A,109,6
20,N/A,N/A,N/A,559,579,N/A,112,3
15,N/A,N/A,N/A,544,559,N/A,118,3
14,N/A,N/A,N/A,530,544,N/A,122,1
43,N/A,N/A,N/A,487,530,N/A,127,6
8,N/A,N/A,N/A,479,487,N/A,133,0
22,N/A,N/A,N/A,603,625,N/A,5,4
23,N/A,N/A,N/A,580,603,N/A,11,4
11,N/A,N/A,N/A,569,580,N/A,14,1
23,N/A,N/A,N/A,546,569,N/A,17,4
13,N/A,N/A,N/A,533,546,N/A,20,1
33,N/A,N/A,N/A,500,533,N/A,24,5
11,N/A,N/A,N/A,489,500,N/A,27,2
7,N/A,N/A,N/A,482,489,N/A,32,1
30,N/A,N/A,N/A,452,482,N/A,35,4
13,N/A,N/A,N/A,439,452,N/A,39,2
36,N/A,N/A,N/A,403,439,N/A,42,5
11,N/A,N/A,N/A,392,403,N/A,45,2
11,N/A,N/A,N/A,381,392,N/A,51,2
12,N/A,N/A,N/A,369,381,N/A,56,1
24,N/A,N/A,N/A,345,369,N/A,59,4
12,N/A,N/A,N/A,333,345,N/A,62,1
32,N/A,N/A,N/A,301,333,N/A,65,4
15,N/A,N/A,N/A,286,301,N/A,69,2
41,N/A,N/A,N/A,245,286,N/A,73,6
32,N/A,N/A,N/A,213,245,N/A,78,5
26,N/A,N/A,N/A,187,213,N/A,83,4
15,N/A,N/A,N/A,172,187,N/A,87,2
42,N/A,N/A,N/A,130,172,N/A,91,6
39,N/A,N/A,N/A,91,130,N/A,96,5
39,N/A,N/A,N/A,52,91,N/A,102,5
25,N/A,N/A,N/A,27,52,N/A,107,4
28,N/A,N/A,N/A,-1,27,N/A,113,4
36,N/A,N/A,N/A,1644,1680,N/A,5,5
17,N/A,N/A,N/A,1627,1644,N/A,8,2
12,N/A,N/A,N/A,1615,1627,N/A,14,2
17,N/A,N/A,N/A,1598,1615,N/A,20,2
32,N/A,N/A,N/A,1566,1598,N/A,23,5
27,N/A,N/A,N/A,1539,1566,N/A,28,4
11,N/A,N/A,N/A,1528,1539,N/A,32,2
12,N/A,N/A,N/A,1516,1528,N/A,37,1
33,N/A,N/A,N/A,1483,1516,N/A,41,5
38,N/A,N/A,N/A,1445,1483,N/A,47,5
37,N/A,N/A,N/A,1408,1445,N/A,53,5
21,N/A,N/A,N/A,1387,1408,N/A,57,3
10,N/A,N/A,N/A,1377,1387,N/A,61,1
44,N/A,N/A,N/A,1333,1377,N/A,66,6
27,N/A,N/A,N/A,1306,1333,N/A,70,4
18,N/A,N/A,N/A,1288,1306,N/A,75,3
22,N/A,N/A,N/A,1266,1288,N/A,81,3
17,N/A,N/A,N/A,1249,1266,N/A,86,2
38,N/A,N/A,N/A,1211,1249,N/A,89,5
36,N/A,N/A,N/A,1175,1211,N/A,95,5
32,N/A,N/A,N/A,1143,1175,N/A,101,5
17,N/A,N/A,N/A,1126,1143,N/A,104,2
33,N/A,N/A,N/A,1093,1126,N/A,107,5
11,N/A,N/A,N/A,1082,1093,N/A,110,2
36,N/A,N/A,N/A,1046,1082,N/A,113,5
36,N/A,N/A,N/A,1010,1046,N/A,119,5
27,N/A,N/A,N/A,983,1010,N/A,124,4
22,N/A,N/A,N/A,961,983,N/A,129,3
17,N/A,N/A,N/A,944,961,N/A,134,2
15,N/A,N/A,N/A,929,944,N/A,140,2
37,N/A,N/A,N/A,923,960,N/A,6,5
32,N/A,N/A,N/A,891,923,N/A,11,4
14,N/A,N/A,N/A,877,891,N/A,15,2
41,N/A,N/A,N/A,836,877,N/A,19,6
30,N/A,N/A,N/A,806,836,N/A,23,4
18,N/A,N/A,N/A,788,806,N/A,28,3
20,N/A,N/A,N/A,768,788,N/A,34,3
11,N/A,N/A,N/A,757,768,N/A,39,2
8,N/A,N/A,N/A,749,757,N/A,44,1
31,N/A,N/A,N/A,718,749,N/A,47,4
15,N/A,N/A,N/A,703,718,N/A,52,3
42,N/A,N/A,N/A,661,703,N/A,55,6
17,N/A,N/A,N/A,644,661,N/A,58,3
42,N/A,N/A,N/A,602,644,N/A,61,6
8,N/A,N/A,N/A,594,602,N/A,67,0
41,N/A,N/A,N/A,553,594,N/A,73,6
19,N/A,N/A,N/A,534,553,N/A,76,3
17,N/A,N/A,N/A,517,534,N/A,82,3
20,N/A,N/A,N/A,497,517,N/A,88,3
20,N/A,N/A,N/A,477,497,N/A,94,3
13,N/A,N/A,N/A,464,477,N/A,98,1
41,N/A,N/A,N/A,423,464,N/A,103,6
23,N/A,N/A,N/A,400,423,N/A,107,4
10,N/A,N/A,N/A,390,400,N/A,110,1
33,N/A,N/A,N/A,357,390,N/A,114,5
22,N/A,N/A,N/A,335,357,N/A,118,3
17,N/A,N/A,N/A,318,335,N/A,123,2
44,N/A,N/A,N/A,274,318,N/A,127,6
17,N/A,N/A,N/A,257,274,N/A,130,3
10,N/A,N/A,N/A,247,257,N/A,134,1
8,N/A,N/A,N/A,1796,1804,N/A,4,1
7,N/A,N/A,N/A,1789,1796,N/A,10,1
43,N/A,N/A,N/A,1746,1789,N/A,15,6
23,N/A,N/A,N/A,1723,1746,N/A,19,4
12,N/A,N/A,N/A,1711,1723,N/A,22,1
41,N/A,N/A,N/A,1670,1711,N/A,27,6
6,N/A,N/A,N/A,1664,1670,N/A,33,0
15,N/A,N/A,N/A,1649,1664,N/A,36,3
11,N/A,N/A,N/A,1638,1649,N/A,41,2
35,N/A,N/A,N/A,1603,1638,N/A,44,5
30,N/A,N/A,N/A,1573,1603,N/A,49,4
10,N/A,N/A,N/A,1563,1573,N/A,52,1
27,N/A,N/A,N/A,1536,1563,N/A,55,4
30,N/A,N/A,N/A,1506,1536,N/A,61,4
31,N/A,N/A,N/A,1475,1506,N/A,67,4
8,N/A,N/A,N/A,1467,1475,N/A,70,1
31,N/A,N/A,N/A,1436,1467,N/A,73,4
32,N/A,N/A,N/A,1404,1436,N/A,79,4
15,N/A,N/A,N/A,1389,1404,N/A,84,3
12,N/A,N/A,N/A,1377,1389,N/A,89,2
9,N/A,N/A,N/A,1368,1377,N/A,94,1
37,N/A,N/A,N/A,1331,1368,N/A,98,5
34,N/A,N/A,N/A,1297,1331,N/A,104,5
35,N/A,N/A,N/A,1262,1297,N/A,110,5
24,N/A,N/A,N/A,1238,1262,N/A,115,4
15,N/A,N/A,N/A,1223,1238,N/A,119,2
41,N/A,N/A,N/A,1182,1223,N/A,123,6
23,N/A,N/A,N/A,1159,1182,N/A,127,4
22,N/A,N/A,N/A,1137,1159,N/A,132,3
9,N/A,N/A,N/A,1128,1137,N/A,136,1
42,N/A,N/A,N/A,455,497,N/A,4,6
27,N/A,N/A,N/A,428,455,N/A,8,4
15,N/A,N/A,N/A,413,428,N/A,12,2
11,N/A,N/A,N/A,402,413,N/A,18,2
42,N/A,N/A,N/A,360,402,N/A,22,6
14,N/A,N/A,N/A,346,360,N/A,25,3
23,N/A,N/A,N/A,323,346,N/A,31,3
42,N/A,N/A,N/A,281,323,N/A,34,6
19,N/A,N/A,N/A,262,281,N/A,37,3
20,N/A,N/A,N/A,242,262,N/A,43,3
41,N/A,N/A,N/A,201,242,N/A,46,6
19,N/A,N/A,N/A,182,201,N/A,49,3
16,N/A,N/A,N/A,166,182,N/A,54,2
17,N/A,N/A,N/A,149,166,N/A,60,2
13,N/A,N/A,N/A,136,149,N/A,65,1
30,N/A,N/A,N/A,106,136,N/A,68,4
23,N/A,N/A,N/A,83,106,N/A,74,4
9,N/A,N/A,N/A,74,83,N/A,77,1
30,N/A,N/A,N/A,44,74,N/A,80,4
14,N/A,N/A,N/A,30,44,N/A,84,2
15,N/A,N/A,N/A,15,30,N/A,90,2
12,N/A,N/A,N/A,3,15,N/A,96,2
12,N/A,N/A,N/A,-9,3,N/A,102,2
16,N/A,N/A,N/A,358,374,N/A,3,2
12,N/A,N/A,N/A,346,358,N/A,9,2
35,N/A,N/A,N/A,311,346,N/A,12,5
35,N/A,N/A,N/A,276,311,N/A,18,5
32,N/A,N/A,N/A,244,276,N/A,24,5
17,N/A,N/A,N/A,227,244,N/A,28,3
41,N/A,N/A,N/A,186,227,N/A,31,6
21,N/A,N/A,N/A,165,186,N/A,34,3
15,N/A,N/A,N/A,150,165,N/A,40,3
12,N/A,N/A,N/A,138,150,N/A,45,2
7,N/A,N/A,N/A,131,138,N/A,50,1
22,N/A,N/A,N/A,109,131,N/A,53,4
23,N/A,N/A,N/A,86,109,N/A,58,3
20,N/A,N/A,N/A,66,86,N/A,64,3
18,N/A,N/A,N/A,48,66,N/A,70,3
44,N/A,N/A,N/A,4,48,N/A,73,6
25,N/A,N/A,N/A,-21,4,N/A,77,4
13,N/A,N/A,N/A,1782,1795,N/A,6,2
15,N/A,N/A,N/A,1767,1782,N/A,12,2
44,N/A,N/A,N/A,1723,1767,N/A,16,6
21,N/A,N/A,N/A,1702,1723,N/A,19,3
17,N/A,N/A,N/A,1685,1702,N/A,25,3
42,N/A,N/A,N/A,1643,1685,N/A,28,6
6,N/A,N/A,N/A,1637,1643,N/A,34,0
43,N/A,N/A,N/A,1594,1637,N/A,40,6
14,N/A,N/A,N/A,1580,1594,N/A,43,3
13,N/A,N/A,N/A,1567,1580,N/A,47,1
41,N/A,N/A,N/A,1526,1567,N/A,52,6
34,N/A,N/A,N/A,1492,1526,N/A,57,5
22,N/A,N/A,N/A,1470,1492,N/A,61,3
41,N/A,N/A,N/A,1429,1470,N/A,64,6
8,N/A,N/A,N/A,1421,1429,N/A,70,0
33,N/A,N/A,N/A,1388,1421,N/A,75,5
13,N/A,N/A,N/A,1375,1388,N/A,78,2
12,N/A,N/A,N/A,1363,1375,N/A,84,2
15,N/A,N/A,N/A,1348,1363,N/A,90,2
33,N/A,N/A,N/A,1315,1348,N/A,93,5
12,N/A,N/A,N/A,1303,1315,N/A,96,2
9,N/A,N/A,N/A,1294,1303,N/A,101,1
36,N/A,N/A,N/A,1258,1294,N/A,105,5
12,N/A,N/A,N/A,1246,1258,N/A,108,2
43,N/A,N/A,N/A,1203,1246,N/A,112,6
29,N/A,N/A,N/A,1174,1203,N/A,116,4
21,N/A,N/A,N/A,1153,1174,N/A,121,3
23,N/A,N/A,N/A,1130,1153,N/A,127,3
15,N/A,N/A,N/A,1115,1130,N/A,133,3
42,N/A,N/A,N/A,1073,1115,N/A,136,6
35,N/A,N/A,N/A,694,729,N/A,3,5
18,N/A,N/A,N/A,676,694,N/A,7,3
11,N/A,N/A,N/A,665,676,N/A,11,1
41,N/A,N/A,N/A,624,665,N/A,16,6
22,N/A,N/A,N/A,602,624,N/A,19,3
43,N/A,N/A,N/A,559,602,N/A,22,6
39,N/A,N/A,N/A,520,559,N/A,27,5
27,N/A,N/A,N/A,493,520,N/A,32,4
18,N/A,N/A,N/A,475,493,N/A,37,3
23,N/A,N/A,N/A,452,475,N/A,43,3
9,N/A,N/A,N/A,443,452,N/A,47,1
22,N/A,N/A,N/A,421,443,N/A,50,4
16,N/A,N/A,N/A,405,421,N/A,54,2
10,N/A,N/A,N/A,395,405,N/A,59,1
41,N/A,N/A,N/A,354,395,N/A,64,6
36,N/A,N/A,N/A,318,354,N/A,69,5
14,N/A,N/A,N/A,304,318,N/A,72,2
39,N/A,N/A,N/A,265,304,N/A,75,5
10,N/A,N/A,N/A,255,265,N/A,78,2
12,N/A,N/A,N/A,243,255,N/A,83,1
11,N/A,N/A,N/A,232,243,N/A,89,1
13,N/A,N/A,N/A,219,232,N/A,95,1
43,N/A,N/A,N/A,176,219,N/A,100,6
15,N/A,N/A,N/A,161,176,N/A,103,3
17,N/A,N/A,N/A,144,161,N/A,109,3
7,N/A,N/A,N/A,137,144,N/A,113,1
9,N/A,N/A,N/A,128,137,N/A,119,1
28,N/A,N/A,N/A,100,128,N/A,122,4
15,N/A,N/A,N/A,85,100,N/A,127,3
15,N/A,N/A,N/A,70,85,N/A,132,2
37,N/A,N/A,N/A,1477,1514,N/A,5,5
28,N/A,N/A,N/A,1449,1477,N/A,10,4
25,N/A,N/A,N/A,1424,1449,N/A,16,4
11,N/A,N/A,N/A,1413,1424,N/A,20,2
8,N/A,N/A,N/A,1405,1413,N/A,25,1
38,N/A,N/A,N/A,1367,1405,N/A,29,5
11,N/A,N/A,N/A,1356,1367,N/A,32,2
17,N/A,N/A,N/A,1339,1356,N/A,38,2
12,N/A,N/A,N/A,1327,1339,N/A,43,1
10,N/A,N/A,N/A,1317,1327,N/A,49,1
39,N/A,N/A,N/A,1278,1317,N/A,53,5
14,N/A,N/A,N/A,1264,1278,N/A,56,2
38,N/A,N/A,N/A,1226,1264,N/A,59,5
17,N/A,N/A,N/A,1209,1226,N/A,63,3
41,N/A,N/A,N/A,1168,1209,N/A,66,6
24,N/A,N/A,N/A,1144,1168,N/A,70,4
29,N/A,N/A,N/A,1115,1144,N/A,76,4
22,N/A,N/A,N/A,1093,1115,N/A,81,3
42,N/A,N/A,N/A,1051,1093,N/A,84,6
9,N/A,N/A,N/A,1042,1051,N/A,90,0
24,N/A,N/A,N/A,1018,1042,N/A,94,4
25,N/A,N/A,N/A,993,1018,N/A,100,4
19,N/A,N/A,N/A,974,993,N/A,105,3
41,N/A,N/A,N/A,933,974,N/A,108,6
31,N/A,N/A,N/A,902,933,N/A,112,4
18,N/A,N/A,N/A,884,902,N/A,117,3
12,N/A,N/A,N/A,872,884,N/A,122,2
38,N/A,N/A,N/A,834,872,N/A,125,5
34,N/A,N/A,N/A,800,834,N/A,131,5
15,N/A,N/A,N/A,785,800,N/A,134,2
19,N/A,N/A,N/A,357,376,N/A,6,3
10,N/A,N/A,N/A,347,357,N/A,11,2
39,N/A,N/A,N/A,308,347,N/A,14,5
38,N/A,N/A,N/A,270,308,N/A,20,5
36,N/A,N/A,N/A,234,270,N/A,26,5
39,N/A,N/A,N/A,195,234,N/A,32,5
32,N/A,N/A,N/A,163,195,N/A,38,5
15,N/A,N/A,N/A,148,163,N/A,42,3
18,N/A,N/A,N/A,130,148,N/A,48,3
16,N/A,N/A,N/A,114,130,N/A,54,3
15,N/A,N/A,N/A,99,114,N/A,60,3
19,N/A,N/A,N/A,80,99,N/A,66,3
14,N/A,N/A,N/A,66,80,N/A,71,2
37,N/A,N/A,N/A,29,66,N/A,74,5
30,N/A,N/A,N/A,-1,29,N/A,79,4
20,N/A,N/A,N/A,1667,1687,N/A,4,3
43,N/A,N/A,N/A,1624,1667,N/A,7,6
5,N/A,N/A,N/A,1619,1624,N/A,13,0
27,N/A,N/A,N/A,1592,1619,N/A,17,4
12,N/A,N/A,N/A,1580,1592,N/A,21,2
17,N/A,N/A,N/A,1563,1580,N/A,27,2
17,N/A,N/A,N/A,1546,1563,N/A,33,2
43,N/A,N/A,N/A,1503,1546,N/A,37,6
36,N/A,N/A,N/A,1467,1503,N/A,42,5
30,N/A,N/A,N/A,1437,1467,N/A,47,4
27,N/A,N/A,N/A,1410,1437,N/A,53,4
14,N/A,N/A,N/A,1396,1410,N/A,56,1
26,N/A,N/A,N/A,1370,1396,N/A,59,4
32,N/A,N/A,N/A,1338,1370,N/A,65,4
17,N/A,N/A,N/A,1321,1338,N/A,70,3
16,N/A,N/A,N/A,1305,1321,N/A,76,3
8,N/A,N/A,N/A,1297,1305,N/A,80,1
8,N/A,N/A,N/A,1289,1297,N/A,86,1
43,N/A,N/A,N/A,1246,1289,N/A,91,6
5,N/A,N/A,N/A,1241,1246,N/A,97,0
21,N/A,N/A,N/A,1220,1241,N/A,100,3
19,N/A,N/A,N/A,1201,1220,N/A,106,3
41,N/A,N/A,N/A,1160,1201,N/A,109,6
34,N/A,N/A,N/A,1126,1160,N/A,114,5
16,N/A,N/A,N/A,1110,1126,N/A,117,2
16,N/A,N/A,N/A,1094,1110,N/A,123,2
39,N/A,N/A,N/A,1055,1094,N/A,126,5
25,N/A,N/A,N/A,1030,1055,N/A,131,4
16,N/A,N/A,N/A,1014,1030,N/A,136,3
10,N/A,N/A,N/A,1004,1014,N/A,140,1
16,N/A,N/A,N/A,1874,1890,N/A,6,3
10,N/A,N/A,N/A,1864,1874,N/A,11,2
17,N/A,N/A,N/A,1847,1864,N/A,17,2
44,N/A,N/A,N/A,1803,1847,N/A,21,6
18,N/A,N/A,N/A,1785,1803,N/A,24,3
13,N/A,N/A,N/A,1772,1785,N/A,28,1
27,N/A,N/A,N/A,1745,1772,N/A,31,4
16,N/A,N/A,N/A,1729,1745,N/A,35,2
37,N/A,N/A,N/A,1692,1729,N/A,38,5
34,N/A,N/A,N/A,1658,1692,N/A,44,5
16,N/A,N/A,N/A,1642,1658,N/A,48,3
42,N/A,N/A,N/A,1600,1642,N/A,51,6
32,N/A,N/A,N/A,1568,1600,N/A,55,4
15,N/A,N/A,N/A,1553,1568,N/A,59,2
34,N/A,N/A,N/A,1519,1553,N/A,62,5
38,N/A,N/A,N/A,1481,1519,N/A,68,5
15,N/A,N/A,N/A,1466,1481,N/A,71,2
35,N/A,N/A,N/A,1431,1466,N/A,74,5
17,N/A,N/A,N/A,1414,1431,N/A,77,2
41,N/A,N/A,N/A,1373,1414,N/A,81,6
23,N/A,N/A,N/A,1350,1373,N/A,84,3
13,N/A,N/A,N/A,1337,1350,N/A,88,1
11,N/A,N/A,N/A,1326,1337,N/A,94,1
41,N/A,N/A,N/A,1285,1326,N/A,99,6
32,N/A,N/A,N/A,1253,1285,N/A,103,4
14,N/A,N/A,N/A,1239,1253,N/A,107,2
15,N/A,N/A,N/A,1224,1239,N/A,113,2
11,N/A,N/A,N/A,1213,1224,N/A,119,2
44,N/A,N/A,N/A,1169,1213,N/A,123,6
20,N/A,N/A,N/A,1149,1169,N/A,126,3
30,N/A,N/A,N/A,1583,1613,N/A,3,4
7,N/A,N/A,N/A,1576,1583,N/A,6,1
32,N/A,N/A,N/A,1544,1576,N/A,9,4
19,N/A,N/A,N/A,1525,1544,N/A,14,3
9,N/A,N/A,N/A,1516,1525,N/A,18,1
39,N/A,N/A,N/A,1477,1516,N/A,22,5
35,N/A,N/A,N/A,1442,1477,N/A,28,5
37,N/A,N/A,N/A,1405,1442,N/A,34,5
35,N/A,N/A,N/A,1370,1405,N/A,40,5
34,N/A,N/A,N/A,1336,1370,N/A,46,5
27,N/A,N/A,N/A,1309,1336,N/A,51,4
23,N/A,N/A,N/A,1286,1309,N/A,56,3
42,N/A,N/A,N/A,1244,1286,N/A,59,6
27,N/A,N/A,N/A,1217,1244,N/A,63,4
17,N/A,N/A,N/A,1200,1217,N/A,67,2
42,N/A,N/A,N/A,1158,1200,N/A,71,6
23,N/A,N/A,N/A,1135,1158,N/A,74,3
10,N/A,N/A,N/A,1125,1135,N/A,78,1
34,N/A,N/A,N/A,1091,1125,N/A,82,5
21,N/A,N/A,N/A,1070,1091,N/A,86,3
15,N/A,N/A,N/A,1055,1070,N/A,92,3
44,N/A,N/A,N/A,1011,1055,N/A,95,6
5,N/A,N/A,N/A,1006,1011,N/A,101,0
43,N/A,N/A,N/A,963,1006,N/A,107,6
20,N/A,N/A,N/A,943,963,N/A,110,3
14,N/A,N/A,N/A,929,943,N/A,115,2
17,N/A,N/A,N/A,912,929,N/A,121,2
44,N/A,N/A,N/A,868,912,N/A,125,6
23,N/A,N/A,N/A,845,868,N/A,129,4
22,N/A,N/A,N/A,823,845,N/A,134,3
35,N/A,N/A,N/A,1651,1686,N/A,6,5
16,N/A,N/A,N/A,1635,1651,N/A,10,3
10,N/A,N/A,N/A,1625,1635,N/A,15,2
12,N/A,N/A,N/A,1613,1625,N/A,21,2
13,N/A,N/A,N/A,1600,1613,N/A,26,1
34,N/A,N/A,N/A,1566,1600,N/A,30,5
14,N/A,N/A,N/A,1552,1566,N/A,33,2
33,N/A,N/A,N/A,1519,1552,N/A,36,5
30,N/A,N/A,N/A,1489,1519,N/A,41,4
14,N/A,N/A,N/A,1475,1489,N/A,45,2
14,N/A,N/A,N/A,1461,1475,N/A,50,1
43,N/A,N/A,N/A,1418,1461,N/A,55,6
29,N/A,N/A,N/A,1389,1418,N/A,59,4
8,N/A,N/A,N/A,1381,1389,N/A,62,1
23,N/A,N/A,N/A,1358,1381,N/A,65,4
9,N/A,N/A,N/A,1349,1358,N/A,68,1
13,N/A,N/A,N/A,1336,1349,N/A,74,1
43,N/A,N/A,N/A,1293,1336,N/A,79,6
24,N/A,N/A,N/A,1269,1293,N/A,83,4
13,N/A,N/A,N/A,1256,1269,N/A,87,2
36,N/A,N/A,N/A,1220,1256,N/A,90,5
36,N/A,N/A,N/A,1184,1220,N/A,96,5
17,N/A,N/A,N/A,1167,1184,N/A,99,2
8,N/A,N/A,N/A,1159,1167,N/A,104,1
44,N/A,N/A,N/A,1115,1159,N/A,109,6
22,N/A,N/A,N/A,1093,1115,N/A,113,4
9,N/A,N/A,N/A,1084,1093,N/A,116,1
28,N/A,N/A,N/A,1056,1084,N/A,119,4
19,N/A,N/A,N/A,1037,1056,N/A,124,3
15,N/A,N/A,N/A,1022,1037,N/A,130,3
20,N/A,N/A,N/A,567,587,N/A,3,3
17,N/A,N/A,N/A,550,567,N/A,8,2
13,N/A,N/A,N/A,537,550,N/A,13,1
43,N/A,N/A,N/A,494,537,N/A,18,6
26,N/A,N/A,N/A,468,494,N/A,22,4
19,N/A,N/A,N/A,449,468,N/A,27,3
11,N/A,N/A,N/A,438,449,N/A,31,1
41,N/A,N/A,N/A,397,438,N/A,36,6
35,N/A,N/A,N/A,362,397,N/A,41,5
39,N/A,N/A,N/A,323,362,N/A,47,5
23,N/A,N/A,N/A,300,323,N/A,52,4
10,N/A,N/A,N/A,290,300,N/A,55,1
41,N/A,N/A,N/A,249,290,N/A,60,6
36,N/A,N/A,N/A,213,249,N/A,65,5
15,N/A,N/A,N/A,198,213,N/A,69,3
19,N/A,N/A,N/A,179,198,N/A,75,3
41,N/A,N/A,N/A,138,179,N/A,78,6
7,N/A,N/A,N/A,131,138,N/A,84,0
37,N/A,N/A,N/A,94,131,N/A,89,5
31,N/A,N/A,N/A,63,94,N/A,94,4
11,N/A,N/A,N/A,52,63,N/A,97,1
41,N/A,N/A,N/A,11,52,N/A,102,6
15,N/A,N/A,N/A,-4,11,N/A,105,3
13,N/A,N/A,N/A,1607,1620,N/A,6,2
32,N/A,N/A,N/A,1575,1607,N/A,9,5
29,N/A,N/A,N/A,1546,1575,N/A,14,4
10,N/A,N/A,N/A,1536,1546,N/A,17,1
41,N/A,N/A,N/A,1495,1536,N/A,22,6
21,N/A,N/A,N/A,1474,1495,N/A,25,3
13,N/A,N/A,N/A,1461,1474,N/A,30,2
44,N/A,N/A,N/A,1417,1461,N/A,34,6
17,N/A,N/A,N/A,1400,1417,N/A,37,3
43,N/A,N/A,N/A,1357,1400,N/A,40,6
8,N/A,N/A,N/A,1349,1357,N/A,46,0
41,N/A,N/A,N/A,1308,1349,N/A,52,6
8,N/A,N/A,N/A,1300,1308,N/A,58,0
21,N/A,N/A,N/A,1279,1300,N/A,61,3
17,N/A,N/A,N/A,1262,1279,N/A,66,2
33,N/A,N/A,N/A,1229,1262,N/A,69,5
38,N/A,N/A,N/A,1191,1229,N/A,75,5
19,N/A,N/A,N/A,1172,1191,N/A,79,3
44,N/A,N/A,N/A,1128,1172,N/A,82,6
5,N/A,N/A,N/A,1123,1128,N/A,88,0
31,N/A,N/A,N/A,1092,1123,N/A,92,4
13,N/A,N/A,N/A,1079,1092,N/A,96,2
12,N/A,N/A,N/A,1067,1079,N/A,101,1
11,N/A,N/A,N/A,1056,1067,N/A,107,1
44,N/A,N/A,N/A,1012,1056,N/A,112,6
5,N/A,N/A,N/A,1007,1012,N/A,118,0
44,N/A,N/A,N/A,963,1007,N/A,124,6
9,N/A,N/A,N/A,954,963,N/A,130,0
42,N/A,N/A,N/A,912,954,N/A,136,6
22,N/A,N/A,N/A,890,912,N/A,139,3
13,N/A,N/A,N/A,1682,1695,N/A,3,1
14,N/A,N/A,N/A,1668,1682,N/A,9,1
30,N/A,N/A,N/A,1638,1668,N/A,12,4
14,N/A,N/A,N/A,1624,1638,N/A,15,1
43,N/A,N/A,N/A,1581,1624,N/A,20,6
7,N/A,N/A,N/A,1574,1581,N/A,26,0
23,N/A,N/A,N/A,1551,1574,N/A,30,4
21,N/A,N/A,N/A,1530,1551,N/A,35,3
16,N/A,N/A,N/A,1514,1530,N/A,41,3
42,N/A,N/A,N/A,1472,1514,N/A,44,6
8,N/A,N/A,N/A,1464,1472,N/A,50,0
39,N/A,N/A,N/A,1425,1464,N/A,55,5
22,N/A,N/A,N/A,1403,1425,N/A,59,3
41,N/A,N/A,N/A,1362,1403,N/A,62,6
18,N/A,N/A,N/A,1344,1362,N/A,65,3
14,N/A,N/A,N/A,1330,1344,N/A,70,2
42,N/A,N/A,N/A,1288,1330,N/A,74,6
20,N/A,N/A,N/A,1268,1288,N/A,77,3
8,N/A,N/A,N/A,1260,1268,N/A,81,1
28,N/A,N/A,N/A,1232,1260,N/A,84,4
28,N/A,N/A,N/A,1204,1232,N/A,90,4
11,N/A,N/A,N/A,1193,1204,N/A,93,1
22,N/A,N/A,N/A,1171,1193,N/A,96,4
14,N/A,N/A,N/A,1157,1171,N/A,99,1
41,N/A,N/A,N/A,1116,1157,N/A,104,6
35,N/A,N/A,N/A,1081,1116,N/A,109,5
16,N/A,N/A,N/A,1065,1081,N/A,113,3
17,N/A,N/A,N/A,1048,1065,N/A,118,2
9,N/A,N/A,N/A,1039,1048,N/A,123,1
29,N/A,N/A,N/A,1010,1039,N/A,126,4
21,N/A,N/A,N/A,1168,1189,N/A,6,3
12,N/A,N/A,N/A,1156,1168,N/A,10,1
38,N/A,N/A,N/A,1118,1156,N/A,14,5
25,N/A,N/A,N/A,1093,1118,N/A,19,4
32,N/A,N/A,N/A,1061,1093,N/A,25,4
32,N/A,N/A,N/A,1029,1061,N/A,31,4
21,N/A,N/A,N/A,1008,1029,N/A,36,3
12,N/A,N/A,N/A,996,1008,N/A,41,2
15,N/A,N/A,N/A,981,996,N/A,47,2
38,N/A,N/A,N/A,943,981,N/A,50,5
39,N/A,N/A,N/A,904,943,N/A,56,5
17,N/A,N/A,N/A,887,904,N/A,60,3
14,N/A,N/A,N/A,873,887,N/A,64,1
28,N/A,N/A,N/A,845,873,N/A,67,4
31,N/A,N/A,N/A,814,845,N/A,73,4
12,N/A,N/A,N/A,802,814,N/A,76,1
30,N/A,N/A,N/A,772,802,N/A,79,4
32,N/A,N/A,N/A,740,772,N/A,85,4
15,N/A,N/A,N/A,725,740,N/A,90,3
12,N/A,N/A,N/A,713,725,N/A,94,1
12,N/A,N/A,N/A,701,713,N/A,100,1
36,N/A,N/A,N/A,665,701,N/A,104,5
38,N/A,N/A,N/A,627,665,N/A,110,5
22,N/A,N/A,N/A,605,627,N/A,115,4
19,N/A,N/A,N/A,586,605,N/A,120,3
43,N/A,N/A,N/A,543,586,N/A,123,6
32,N/A,N/A,N/A,511,543,N/A,127,4
18,N/A,N/A,N/A,493,511,N/A,132,3
20,N/A,N/A,N/A,473,493,N/A,138,3
17,N/A,N/A,N/A,456,473,N/A,143,2
44,N/A,N/A,N/A,1474,1518,N/A,6,6
27,N/A,N/A,N/A,1447,1474,N/A,10,4
24,N/A,N/A,N/A,1423,1447,N/A,16,4
8,N/A,N/A,N/A,1415,1423,N/A,19,1
43,N/A,N/A,N/A,1372,1415,N/A,24,6
34,N/A,N/A,N/A,1338,1372,N/A,29,5
23,N/A,N/A,N/A,1315,1338,N/A,34,4
27,N/A,N/A,N/A,1288,1315,N/A,40,4
15,N/A,N/A,N/A,1273,1288,N/A,45,3
17,N/A,N/A,N/A,1256,1273,N/A,51,3
11,N/A,N/A,N/A,1245,1256,N/A,56,2
35,N/A,N/A,N/A,1210,1245,N/A,59,5
22,N/A,N/A,N/A,1188,1210,N/A,64,4
23,N/A,N/A,N/A,1165,1188,N/A,70,4
11,N/A,N/A,N/A,1154,1165,N/A,74,2
11,N/A,N/A,N/A,1143,1154,N/A,80,2
14,N/A,N/A,N/A,1129,1143,N/A,85,1
34,N/A,N/A,N/A,1095,1129,N/A,89,5
12,N/A,N/A,N/A,1083,1095,N/A,92,2
10,N/A,N/A,N/A,1073,1083,N/A,98,2
11,N/A,N/A,N/A,1062,1073,N/A,104,2
13,N/A,N/A,N/A,1049,1062,N/A,109,1
39,N/A,N/A,N/A,1010,1049,N/A,113,5
24,N/A,N/A,N/A,986,1010,N/A,118,4
13,N/A,N/A,N/A,973,986,N/A,122,2
11,N/A,N/A,N/A,962,973,N/A,128,2
39,N/A,N/A,N/A,923,962,N/A,131,5
29,N/A,N/A,N/A,894,923,N/A,136,4
8,N/A,N/A,N/A,886,894,N/A,139,1
8,N/A,N/A,N/A,878,886,N/A,145,1
11,N/A,N/A,N/A,1778,1789,N/A,3,1
44,N/A,N/A,N/A,1734,1778,N/A,8,6
6,N/A,N/A,N/A,1728,1734,N/A,14,0
24,N/A,N/A,N/A,1704,1728,N/A,18,4
21,N/A,N/A,N/A,1683,1704,N/A,23,3
42,N/A,N/A,N/A,1641,1683,N/A,26,6
8,N/A,N/A,N/A,1633,1641,N/A,32,0
22,N/A,N/A,N/A,1611,1633,N/A,35,3
42,N/A,N/A,N/A,1569,1611,N/A,38,6
16,N/A,N/A,N/A,1553,1569,N/A,41,3
13,N/A,N/A,N/A,1540,1553,N/A,46,2
12,N/A,N/A,N/A,1528,1540,N/A,51,1
42,N/A,N/A,N/A,1486,1528,N/A,56,6
19,N/A,N/A,N/A,1467,1486,N/A,59,3
11,N/A,N/A,N/A,1456,1467,N/A,63,1
23,N/A,N/A,N/A,1433,1456,N/A,66,4
20,N/A,N/A,N/A,1413,1433,N/A,71,3
14,N/A,N/A,N/A,1399,1413,N/A,75,1
43,N/A,N/A,N/A,1356,1399,N/A,80,6
5,N/A,N/A,N/A,1351,1356,N/A,86,0
25,N/A,N/A,N/A,1326,1351,N/A,90,4
25,N/A,N/A,N/A,1301,1326,N/A,96,4
30,N/A,N/A,N/A,1271,1301,N/A,102,4
17,N/A,N/A,N/A,1254,1271,N/A,106,2
14,N/A,N/A,N/A,1240,1254,N/A,112,2
41,N/A,N/A,N/A,1199,1240,N/A,116,6
14,N/A,N/A,N/A,1185,1199,N/A,119,3
18,N/A,N/A,N/A,1167,1185,N/A,125,3
14,N/A,N/A,N/A,1153,1167,N/A,129,1
31,N/A,N/A,N/A,1122,1153,N/A,132,4
14,N/A,N/A,N/A,1363,1377,N/A,4,1
44,N/A,N/A,N/A,1319,1363,N/A,9,6
18,N/A,N/A,N/A,1301,1319,N/A,12,3
11,N/A,N/A,N/A,1290,1301,N/A,17,2
10,N/A,N/A,N/A,1280,1290,N/A,22,1
11,N/A,N/A,N/A,1269,1280,N/A,28,1
24,N/A,N/A,N/A,1245,1269,N/A,31,4
8,N/A,N/A,N/A,1237,1245,N/A,34,1
28,N/A,N/A,N/A,1209,1237,N/A,37,4
14,N/A,N/A,N/A,1195,1209,N/A,40,1
39,N/A,N/A,N/A,1156,1195,N/A,44,5
12,N/A,N/A,N/A,1144,1156,N/A,47,2
11,N/A,N/A,N/A,1133,1144,N/A,52,1
42,N/A,N/A,N/A,1091,1133,N/A,57,6
9,N/A,N/A,N/A,1082,1091,N/A,63,0
42,N/A,N/A,N/A,1040,1082,N/A,69,6
5,N/A,N/A,N/A,1035,1040,N/A,75,0
35,N/A,N/A,N/A,1000,1035,N/A,80,5
17,N/A,N/A,N/A,983,1000,N/A,83,2
13,N/A,N/A,N/A,970,983,N/A,89,2
41,N/A,N/A,N/A,929,970,N/A,93,6
17,N/A,N/A,N/A,912,929,N/A,96,3
41,N/A,N/A,N/A,871,912,N/A,99,6
39,N/A,N/A,N/A,832,871,N/A,104,5
14,N/A,N/A,N/A,818,832,N/A,108,3
21,N/A,N/A,N/A,797,818,N/A,114,3
10,N/A,N/A,N/A,787,797,N/A,118,1
14,N/A,N/A,N/A,773,787,N/A,124,1
37,N/A,N/A,N/A,736,773,N/A,128,5
14,N/A,N/A,N/A,722,736,N/A,132,3
10,N/A,N/A,N/A,763,773,N/A,5,1
26,N/A,N/A,N/A,737,763,N/A,8,4
15,N/A,N/A,N/A,722,737,N/A,12,2
39,N/A,N/A,N/A,683,722,N/A,15,5
34,N/A,N/A,N/A,649,683,N/A,21,5
27,N/A,N/A,N/A,622,649,N/A,26,4
22,N/A,N/A,N/A,600,622,N/A,32,4
10,N/A,N/A,N/A,590,600,N/A,36,2
11,N/A,N/A,N/A,579,590,N/A,42,2
14,N/A,N/A,N/A,565,579,N/A,48,2
14,N/A,N/A,N/A,551,565,N/A,53,1
9,N/A,N/A,N/A,542,551,N/A,59,1
12,N/A,N/A,N/A,530,542,N/A,65,1
42,N/A,N/A,N/A,488,530,N/A,70,6
38,N/A,N/A,N/A,450,488,N/A,75,5
29,N/A,N/A,N/A,421,450,N/A,80,4
12,N/A,N/A,N/A,409,421,N/A,84,2
14,N/A,N/A,N/A,395,409,N/A,90,2
13,N/A,N/A,N/A,382,395,N/A,96,2
44,N/A,N/A,N/A,338,382,N/A,100,6
32,N/A,N/A,N/A,306,338,N/A,105,5
39,N/A,N/A,N/A,267,306,N/A,111,5
15,N/A,N/A,N/A,252,267,N/A,115,3
41,N/A,N/A,N/A,211,252,N/A,118,6
35,N/A,N/A,N/A,176,211,N/A,123,5
17,N/A,N/A,N/A,159,176,N/A,126,2
14,N/A,N/A,N/A,145,159,N/A,132,2
39,N/A,N/A,N/A,106,145,N/A,135,5
28,N/A,N/A,N/A,78,106,N/A,140,4
31,N/A,N/A,N/A,47,78,N/A,146,4
43,N/A,N/A,N/A,1817,1860,N/A,4,6
16,N/A,N/A,N/A,1801,1817,N/A,7,3
16,N/A,N/A,N/A,1785,1801,N/A,12,2
34,N/A,N/A,N/A,1751,1785,N/A,15,5
15,N/A,N/A,N/A,1736,1751,N/A,19,3
11,N/A,N/A,N/A,1725,1736,N/A,24,2
15,N/A,N/A,N/A,1710,1725,N/A,30,2
15,N/A,N/A,N/A,1695,1710,N/A,36,2
41,N/A,N/A,N/A,1654,1695,N/A,40,6
9,N/A,N/A,N/A,1645,1654,N/A,46,0
44,N/A,N/A,N/A,1601,1645,N/A,52,6
38,N/A,N/A,N/A,1563,1601,N/A,57,5
33,N/A,N/A,N/A,1530,1563,N/A,63,5
11,N/A,N/A,N/A,1519,1530,N/A,66,2
16,N/A,N/A,N/A,1503,1519,N/A,72,2
8,N/A,N/A,N/A,1495,1503,N/A,77,1
36,N/A,N/A,N/A,1459,1495,N/A,81,5
17,N/A,N/A,N/A,1442,1459,N/A,85,3
21,N/A,N/A,N/A,1421,1442,N/A,91,3
11,N/A,N/A,N/A,1410,1421,N/A,95,1
39,N/A,N/A,N/A,1371,1410,N/A,99,5
24,N/A,N/A,N/A,1347,1371,N/A,104,4
22,N/A,N/A,N/A,1325,1347,N/A,109,3
43,N/A,N/A,N/A,1282,1325,N/A,112,6
23,N/A,N/A,N/A,1259,1282,N/A,115,3
42,N/A,N/A,N/A,1217,1259,N/A,118,6
34,N/A,N/A,N/A,1183,1217,N/A,123,5
17,N/A,N/A,N/A,1166,1183,N/A,126,2
42,N/A,N/A,N/A,1124,1166,N/A,130,6
6,N/A,N/A,N/A,1118,1124,N/A,136,0
13,N/A,N/A,N/A,1509,1522,N/A,6,1
7,N/A,N/A,N/A,1502,1509,N/A,12,1
12,N/A,N/A,N/A,1490,1502,N/A,18,1
38,N/A,N/A,N/A,1452,1490,N/A,22,5
12,N/A,N/A,N/A,1440,1452,N/A,25,2
44,N/A,N/A,N/A,1396,1440,N/A,29,6
37,N/A,N/A,N/A,1359,1396,N/A,34,5
19,N/A,N/A,N/A,1340,1359,N/A,38,3
42,N/A,N/A,N/A,1298,1340,N/A,41,6
28,N/A,N/A,N/A,1270,1298,N/A,45,4
9,N/A,N/A,N/A,1261,1270,N/A,48,1
10,N/A,N/A,N/A,1251,1261,N/A,54,1
10,N/A,N/A,N/A,1241,1251,N/A,60,1
35,N/A,N/A,N/A,1206,1241,N/A,64,5
22,N/A,N/A,N/A,1184,1206,N/A,68,3
18,N/A,N/A,N/A,1166,1184,N/A,74,3
10,N/A,N/A,N/A,1156,1166,N/A,78,1
34,N/A,N/A,N/A,1122,1156,N/A,82,5
16,N/A,N/A,N/A,1106,1122,N/A,86,3
16,N/A,N/A,N/A,1090,1106,N/A,91,2
34,N/A,N/A,N/A,1056,1090,N/A,94,5
15,N/A,N/A,N/A,1041,1056,N/A,98,3
21,N/A,N/A,N/A,1020,1041,N/A,104,3
18,N/A,N/A,N/A,1002,1020,N/A,110,3
8,N/A,N/A,N/A,994,1002,N/A,114,1
39,N/A,N/A,N/A,955,994,N/A,118,5
14,N/A,N/A,N/A,941,955,N/A,121,2
41,N/A,N/A,N/A,900,941,N/A,125,6
34,N/A,N/A,N/A,866,900,N/A,130,5
29,N/A,N/A,N/A,837,866,N/A,135,4
7,N/A,N/A,N/A,1669,1676,N/A,3,1
43,N/A,N/A,N/A,1626,1669,N/A,8,6
16,N/A,N/A,N/A,1610,1626,N/A,11,3
17,N/A,N/A,N/A,1593,1610,N/A,17,3
14,N/A,N/A,N/A,1579,1593,N/A,23,3
10,N/A,N/A,N/A,1569,1579,N/A,27,1
32,N/A,N/A,N/A,1537,1569,N/A,30,4
32,N/A,N/A,N/A,1505,1537,N/A,36,4
14,N/A,N/A,N/A,1491,1505,N/A,41,3
10,N/A,N/A,N/A,1481,1491,N/A,46,2
14,N/A,N/A,N/A,1467,1481,N/A,52,2
10,N/A,N/A,N/A,1457,1467,N/A,57,1
39,N/A,N/A,N/A,1418,1457,N/A,61,5
14,N/A,N/A,N/A,1404,1418,N/A,65,3
22,N/A,N/A,N/A,1382,1404,N/A,71,3
8,N/A,N/A,N/A,1374,1382,N/A,75,1
30,N/A,N/A,N/A,1344,1374,N/A,78,4
11,N/A,N/A,N/A,1333,1344,N/A,81,1
22,N/A,N/A,N/A,1311,1333,N/A,84,4
10,N/A,N/A,N/A,1301,1311,N/A,88,2
41,N/A,N/A,N/A,1260,1301,N/A,92,6
14,N/A,N/A,N/A,1246,1260,N/A,95,3
14,N/A,N/A,N/A,1232,1246,N/A,100,2
43,N/A,N/A,N/A,1189,1232,N/A,104,6
6,N/A,N/A,N/A,1183,1189,N/A,110,0
25,N/A,N/A,N/A,1158,1183,N/A,114,4
27,N/A,N/A,N/A,1131,1158,N/A,120,4
12,N/A,N/A,N/A,1119,1131,N/A,123,1
33,N/A,N/A,N/A,1086,1119,N/A,127,5
16,N/A,N/A,N/A,1070,1086,N/A,131,3
18,N/A,N/A,N/A,371,389,N/A,3,3
43,N/A,N/A,N/A,328,371,N/A,6,6
9,N/A,N/A,N/A,319,328,N/A,12,0
18,N/A,N/A,N/A,301,319,N/A,15,3
13,N/A,N/A,N/A,288,301,N/A,20,2
42,N/A,N/A,N/A,246,288,N/A,24,6
32,N/A,N/A,N/A,214,246,N/A,28,4
10,N/A,N/A,N/A,204,214,N/A,31,1
41,N/A,N/A,N/A,163,204,N/A,36,6
26,N/A,N/A,N/A,137,163,N/A,40,4
14,N/A,N/A,N/A,123,137,N/A,45,3
41,N/A,N/A,N/A,82,123,N/A,48,6
32,N/A,N/A,N/A,50,82,N/A,53,5
11,N/A,N/A,N/A,39,50,N/A,56,2
10,N/A,N/A,N/A,29,39,N/A,62,2
41,N/A,N/A,N/A,-12,29,N/A,66,6
14,N/A,N/A,N/A,1872,1886,N/A,3,3
15,N/A,N/A,N/A,1857,1872,N/A,8,2
42,N/A,N/A,N/A,1815,1857,N/A,12,6
30,N/A,N/A,N/A,1785,1815,N/A,16,4
22,N/A,N/A,N/A,1763,1785,N/A,21,3
17,N/A,N/A,N/A,1746,1763,N/A,26,2
14,N/A,N/A,N/A,1732,1746,N/A,31,1
27,N/A,N/A,N/A,1705,1732,N/A,34,4
13,N/A,N/A,N/A,1692,1705,N/A,37,1
23,N/A,N/A,N/A,1669,1692,N/A,40,4
31,N/A,N/A,N/A,1638,1669,N/A,46,4
23,N/A,N/A,N/A,1615,1638,N/A,52,4
13,N/A,N/A,N/A,1602,1615,N/A,56,2
12,N/A,N/A,N/A,1590,1602,N/A,61,1
43,N/A,N/A,N/A,1547,1590,N/A,66,6
39,N/A,N/A,N/A,1508,1547,N/A,71,5
39,N/A,N/A,N/A,1469,1508,N/A,77,5
12,N/A,N/A,N/A,1457,1469,N/A,80,2
15,N/A,N/A,N/A,1442,1457,N/A,86,2
35,N/A,N/A,N/A,1407,1442,N/A,89,5
23,N/A,N/A,N/A,1384,1407,N/A,93,3
16,N/A,N/A,N/A,1368,1384,N/A,99,3
22,N/A,N/A,N/A,1346,1368,N/A,105,3
12,N/A,N/A,N/A,1334,1346,N/A,109,1
42,N/A,N/A,N/A,1292,1334,N/A,114,6
9,N/A,N/A,N/A,1283,1292,N/A,120,0
16,N/A,N/A,N/A,1267,1283,N/A,123,3
42,N/A,N/A,N/A,1225,1267,N/A,126,6
31,N/A,N/A,N/A,1194,1225,N/A,130,4
22,N/A,N/A,N/A,1172,1194,N/A,136,4
16,N/A,N/A,N/A,1769,1785,N/A,6,3
19,N/A,N/A,N/A,1750,1769,N/A,12,3
43,N/A,N/A,N/A,1707,1750,N/A,15,6
23,N/A,N/A,N/A,1684,1707,N/A,18,3
16,N/A,N/A,N/A,1668,1684,N/A,23,2
41,N/A,N/A,N/A,1627,1668,N/A,27,6
8,N/A,N/A,N/A,1619,1627,N/A,33,0
31,N/A,N/A,N/A,1588,1619,N/A,37,4
31,N/A,N/A,N/A,1557,1588,N/A,43,4
16,N/A,N/A,N/A,1541,1557,N/A,47,2
14,N/A,N/A,N/A,1527,1541,N/A,52,1
22,N/A,N/A,N/A,1505,1527,N/A,55,4
26,N/A,N/A,N/A,1479,1505,N/A,61,4
12,N/A,N/A,N/A,1467,1479,N/A,64,1
41,N/A,N/A,N/A,1426,1467,N/A,69,6
8,N/A,N/A,N/A,1418,1426,N/A,75,0
21,N/A,N/A,N/A,1397,1418,N/A,78,3
41,N/A,N/A,N/A,1356,1397,N/A,81,6
19,N/A,N/A,N/A,1337,1356,N/A,84,3
14,N/A,N/A,N/A,1323,1337,N/A,90,3
42,N/A,N/A,N/A,1281,1323,N/A,93,6
25,N/A,N/A,N/A,1256,1281,N/A,97,4
12,N/A,N/A,N/A,1244,1256,N/A,100,1
22,N/A,N/A,N/A,1222,1244,N/A,103,4
15,N/A,N/A,N/A,1207,1222,N/A,108,3
22,N/A,N/A,N/A,1185,1207,N/A,114,3
12,N/A,N/A,N/A,1173,1185,N/A,118,1
36,N/A,N/A,N/A,1137,1173,N/A,122,5
11,N/A,N/A,N/A,1126,1137,N/A,125,2
37,N/A,N/A,N/A,1089,1126,N/A,128,5
42,N/A,N/A,N/A,1556,1598,N/A,3,6
31,N/A,N/A,N/A,1525,1556,N/A,7,4
14,N/A,N/A,N/A,1511,1525,N/A,10,1
33,N/A,N/A,N/A,1478,1511,N/A,14,5
37,N/A,N/A,N/A,1441,1478,N/A,20,5
13,N/A,N/A,N/A,1428,1441,N/A,23,2
38,N/A,N/A,N/A,1390,1428,N/A,26,5
27,N/A,N/A,N/A,1363,1390,N/A,31,4
8,N/A,N/A,N/A,1355,1363,N/A,34,1
31,N/A,N/A,N/A,1324,1355,N/A,37,4
14,N/A,N/A,N/A,1310,1324,N/A,40,1
12,N/A,N/A,N/A,1298,1310,N/A,46,1
14,N/A,N/A,N/A,1284,1298,N/A,52,1
39,N/A,N/A,N/A,1245,1284,N/A,56,5
26,N/A,N/A,N/A,1219,1245,N/A,61,4
11,N/A,N/A,N/A,1208,1219,N/A,64,1
30,N/A,N/A,N/A,1178,1208,N/A,67,4
16,N/A,N/A,N/A,1162,1178,N/A,71,2
10,N/A,N/A,N/A,1152,1162,N/A,77,2
41,N/A,N/A,N/A,1111,1152,N/A,81,6
7,N/A,N/A,N/A,1104,1111,N/A,87,0
22,N/A,N/A,N/A,1082,1104,N/A,91,4
30,N/A,N/A,N/A,1052,1082,N/A,97,4
29,N/A,N/A,N/A,1023,1052,N/A,103,4
31,N/A,N/A,N/A,992,1023,N/A,109,4
23,N/A,N/A,N/A,969,992,N/A,115,4
23,N/A,N/A,N/A,946,969,N/A,120,3
14,N/A,N/A,N/A,932,946,N/A,125,2
35,N/A,N/A,N/A,897,932,N/A,128,5
31,N/A,N/A,N/A,866,897,N/A,133,4
22,N/A,N/A,N/A,700,722,N/A,5,3
41,N/A,N/A,N/A,659,700,N/A,8,6
7,N/A,N/A,N/A,652,659,N/A,14,0
23,N/A,N/A,N/A,629,652,N/A,18,4
15,N/A,N/A,N/A,614,629,N/A,23,3
21,N/A,N/A,N/A,593,614,N/A,29,3
17,N/A,N/A,N/A,576,593,N/A,35,3
14,N/A,N/A,N/A,562,576,N/A,40,2
43,N/A,N/A,N/A,519,562,N/A,44,6
23,N/A,N/A,N/A,496,519,N/A,47,3
23,N/A,N/A,N/A,473,496,N/A,53,3
14,N/A,N/A,N/A,459,473,N/A,58,2
11,N/A,N/A,N/A,448,459,N/A,64,2
42,N/A,N/A,N/A,406,448,N/A,68,6
20,N/A,N/A,N/A,386,406,N/A,71,3
18,N/A,N/A,N/A,368,386,N/A,77,3
11,N/A,N/A,N/A,357,368,N/A,81,1
22,N/A,N/A,N/A,335,357,N/A,84,4
11,N/A,N/A,N/A,324,335,N/A,88,2
12,N/A,N/A,N/A,312,324,N/A,93,1
36,N/A,N/A,N/A,276,312,N/A,97,5
33,N/A,N/A,N/A,243,276,N/A,103,5
22,N/A,N/A,N/A,221,243,N/A,108,4
26,N/A,N/A,N/A,195,221,N/A,114,4
18,N/A,N/A,N/A,177,195,N/A,119,3
43,N/A,N/A,N/A,134,177,N/A,122,6
7,N/A,N/A,N/A,127,134,N/A,128,0
35,N/A,N/A,N/A,92,127,N/A,133,5
14,N/A,N/A,N/A,78,92,N/A,136,2
41,N/A,N/A,N/A,37,78,N/A,140,6
18,N/A,N/A,N/A,1951,1969,N/A,3,3
16,N/A,N/A,N/A,1935,1951,N/A,9,3
12,N/A,N/A,N/A,1923,1935,N/A,14,2
35,N/A,N/A,N/A,1888,1923,N/A,17,5
13,N/A,N/A,N/A,1875,1888,N/A,20,2
12,N/A,N/A,N/A,1863,1875,N/A,25,1
10,N/A,N/A,N/A,1853,1863,N/A,31,1
34,N/A,N/A,N/A,1819,1853,N/A,35,5
17,N/A,N/A,N/A,1802,1819,N/A,38,2
43,N/A,N/A,N/A,1759,1802,N/A,42,6
19,N/A,N/A,N/A,1740,1759,N/A,45,3
13,N/A,N/A,N/A,1727,1740,N/A,50,2
43,N/A,N/A,N/A,1684,1727,N/A,54,6
9,N/A,N/A,N/A,1675,1684,N/A,60,0
39,N/A,N/A,N/A,1636,1675,N/A,65,5
15,N/A,N/A,N/A,1621,1636,N/A,68,2
34,N/A,N/A,N/A,1587,1621,N/A,71,5
37,N/A,N/A,N/A,1550,1587,N/A,77,5
14,N/A,N/A,N/A,1536,1550,N/A,80,2
42,N/A,N/A,N/A,1494,1536,N/A,84,6
32,N/A,N/A,N/A,1462,1494,N/A,88,4
16,N/A,N/A,N/A,1446,1462,N/A,92,2
16,N/A,N/A,N/A,1430,1446,N/A,98,2
13,N/A,N/A,N/A,1417,1430,N/A,103,1
44,N/A,N/A,N/A,1373,1417,N/A,108,6
22,N/A,N/A,N/A,1351,1373,N/A,111,3
18,N/A,N/A,N/A,1333,1351,N/A,117,3
10,N/A,N/A,N/A,1323,1333,N/A,121,1
7,N/A,N/A,N/A,1316,1323,N/A,127,1
12,N/A,N/A,N/A,1304,1316,N/A,133,1
14,N/A,N/A,N/A,460,474,N/A,3,2
9,N/A,N/A,N/A,451,460,N/A,8,1
9,N/A,N/A,N/A,442,451,N/A,14,1
32,N/A,N/A,N/A,410,442,N/A,17,4
11,N/A,N/A,N/A,399,410,N/A,20,1
23,N/A,N/A,N/A,376,399,N/A,23,4
14,N/A,N/A,N/A,362,376,N/A,28,3
8,N/A,N/A,N/A,354,362,N/A,32,1
12,N/A,N/A,N/A,342,354,N/A,38,1
36,N/A,N/A,N/A,306,342,N/A,42,5
30,N/A,N/A,N/A,276,306,N/A,47,4
27,N/A,N/A,N/A,249,276,N/A,53,4
30,N/A,N/A,N/A,219,249,N/A,59,4
11,N/A,N/A,N/A,208,219,N/A,63,2
11,N/A,N/A,N/A,197,208,N/A,69,2
36,N/A,N/A,N/A,161,197,N/A,72,5
12,N/A,N/A,N/A,149,161,N/A,75,2
11,N/A,N/A,N/A,138,149,N/A,81,2
10,N/A,N/A,N/A,128,138,N/A,87,2
8,N/A,N/A,N/A,120,128,N/A,92,1
9,N/A,N/A,N/A,111,120,N/A,98,1
14,N/A,N/A,N/A,97,111,N/A,104,1
14,N/A,N/A,N/A,83,97,N/A,110,1
34,N/A,N/A,N/A,49,83,N/A,114,5
17,N/A,N/A,N/A,32,49,N/A,117,2
11,N/A,N/A,N/A,21,32,N/A,122,1
33,N/A,N/A,N/A,-12,21,N/A,126,5
16,N/A,N/A,N/A,483,499,N/A,6,2
14,N/A,N/A,N/A,469,483,N/A,11,1
10,N/A,N/A,N/A,459,469,N/A,17,1
7,N/A,N/A,N/A,452,459,N/A,23,1
9,N/A,N/A,N/A,443,452,N/A,29,1
41,N/A,N/A,N/A,402,443,N/A,34,6
35,N/A,N/A,N/A,367,402,N/A,39,5
17,N/A,N/A,N/A,350,367,N/A,42,2
37,N/A,N/A,N/A,313,350,N/A,45,5
29,N/A,N/A,N/A,284,313,N/A,50,4
32,N/A,N/A,N/A,252,284,N/A,56,4
20,N/A,N/A,N/A,232,252,N/A,61,3
42,N/A,N/A,N/A,190,232,N/A,64,6
29,N/A,N/A,N/A,161,190,N/A,68,4
16,N/A,N/A,N/A,145,161,N/A,72,2
15,N/A,N/A,N/A,130,145,N/A,78,2
44,N/A,N/A,N/A,86,130,N/A,82,6
26,N/A,N/A,N/A,60,86,N/A,86,4
16,N/A,N/A,N/A,44,60,N/A,91,3
43,N/A,N/A,N/A,1,44,N/A,94,6
23,N/A,N/A,N/A,-22,1,N/A,97,3
37,N/A,N/A,N/A,1174,1211,N/A,4,5
26,N/A,N/A,N/A,1148,1174,N/A,9,4
31,N/A,N/A,N/A,1117,1148,N/A,15,4
17,N/A,N/A,N/A,1100,1117,N/A,20,3
11,N/A,N/A,N/A,1089,1100,N/A,25,2
11,N/A,N/A,N/A,1078,1089,N/A,31,2
12,N/A,N/A,N/A,1066,1078,N/A,37,2
43,N/A,N/A,N/A,1023,1066,N/A,41,6
29,N/A,N/A,N/A,994,1023,N/A,45,4
21,N/A,N/A,N/A,973,994,N/A,50,3
12,N/A,N/A,N/A,961,973,N/A,54,1
25,N/A,N/A,N/A,936,961,N/A,57,4
9,N/A,N/A,N/A,927,936,N/A,60,1
27,N/A,N/A,N/A,900,927,N/A,63,4
25,N/A,N/A,N/A,875,900,N/A,69,4
13,N/A,N/A,N/A,862,875,N/A,73,2
17,N/A,N/A,N/A,845,862,N/A,79,2
37,N/A,N/A,N/A,808,845,N/A,82,5
23,N/A,N/A,N/A,785,808,N/A,87,4
12,N/A,N/A,N/A,773,785,N/A,90,1
25,N/A,N/A,N/A,748,773,N/A,93,4
15,N/A,N/A,N/A,733,748,N/A,97,2
44,N/A,N/A,N/A,689,733,N/A,101,6
34,N/A,N/A,N/A,655,689,N/A,106,5
33,N/A,N/A,N/A,622,655,N/A,112,5
37,N/A,N/A,N/A,585,622,N/A,118,5
27,N/A,N/A,N/A,558,585,N/A,123,4
19,N/A,N/A,N/A,539,558,N/A,128,3
44,N/A,N/A,N/A,495,539,N/A,131,6
22,N/A,N/A,N/A,473,495,N/A,134,3
15,N/A,N/A,N/A,1413,1428,N/A,5,3
19,N/A,N/A,N/A,1394,1413,N/A,11,3
41,N/A,N/A,N/A,1353,1394,N/A,14,6
9,N/A,N/A,N/A,1344,1353,N/A,20,0
39,N/A,N/A,N/A,1305,1344,N/A,25,5
32,N/A,N/A,N/A,1273,1305,N/A,30,4
18,N/A,N/A,N/A,1255,1273,N/A,35,3
13,N/A,N/A,N/A,1242,1255,N/A,39,1
43,N/A,N/A,N/A,1199,1242,N/A,44,6
39,N/A,N/A,N/A,1160,1199,N/A,49,5
17,N/A,N/A,N/A,1143,1160,N/A,52,2
41,N/A,N/A,N/A,1102,1143,N/A,56,6
9,N/A,N/A,N/A,1093,1102,N/A,62,0
26,N/A,N/A,N/A,1067,1093,N/A,66,4
12,N/A,N/A,N/A,1055,1067,N/A,70,2
14,N/A,N/A,N/A,1041,1055,N/A,75,1
41,N/A,N/A,N/A,1000,1041,N/A,80,6
38,N/A,N/A,N/A,962,1000,N/A,85,5
39,N/A,N/A,N/A,923,962,N/A,91,5
16,N/A,N/A,N/A,907,923,N/A,94,2
35,N/A,N/A,N/A,872,907,N/A,97,5
38,N/A,N/A,N/A,834,872,N/A,103,5
23,N/A,N/A,N/A,811,834,N/A,107,3
13,N/A,N/A,N/A,798,811,N/A,112,2
13,N/A,N/A,N/A,785,798,N/A,118,2
43,N/A,N/A,N/A,742,785,N/A,122,6
22,N/A,N/A,N/A,720,742,N/A,126,4
14,N/A,N/A,N/A,706,720,N/A,130,2
42,N/A,N/A,N/A,664,706,N/A,134,6
22,N/A,N/A,N/A,642,664,N/A,137,3
23,N/A,N/A,N/A,384,407,N/A,6,3
10,N/A,N/A,N/A,374,384,N/A,11,2
12,N/A,N/A,N/A,362,374,N/A,16,1
42,N/A,N/A,N/A,320,362,N/A,21,6
23,N/A,N/A,N/A,297,320,N/A,25,4
26,N/A,N/A,N/A,271,297,N/A,31,4
13,N/A,N/A,N/A,258,271,N/A,35,2
12,N/A,N/A,N/A,246,258,N/A,41,2
38,N/A,N/A,N/A,208,246,N/A,44,5
13,N/A,N/A,N/A,195,208,N/A,47,2
10,N/A,N/A,N/A,185,195,N/A,52,1
30,N/A,N/A,N/A,155,185,N/A,55,4
9,N/A,N/A,N/A,146,155,N/A,58,1
38,N/A,N/A,N/A,108,146,N/A,62,5
19,N/A,N/A,N/A,89,108,N/A,66,3
10,N/A,N/A,N/A,79,89,N/A,71,2
39,N/A,N/A,N/A,40,79,N/A,74,5
15,N/A,N/A,N/A,25,40,N/A,78,3
21,N/A,N/A,N/A,4,25,N/A,84,3
10,N/A,N/A,N/A,-6,4,N/A,89,2
23,N/A,N/A,N/A,1150,1173,N/A,3,4
7,N/A,N/A,N/A,1143,1150,N/A,6,1
11,N/A,N/A,N/A,1132,1143,N/A,12,1
12,N/A,N/A,N/A,1120,1132,N/A,18,1
34,N/A,N/A,N/A,1086,1120,N/A,22,5
37,N/A,N/A,N/A,1049,1086,N/A,28,5
22,N/A,N/A,N/A,1027,1049,N/A,33,4
9,N/A,N/A,N/A,1018,1027,N/A,36,1
30,N/A,N/A,N/A,988,1018,N/A,39,4
19,N/A,N/A,N/A,969,988,N/A,44,3
14,N/A,N/A,N/A,955,969,N/A,50,3
18,N/A,N/A,N/A,937,955,N/A,56,3
41,N/A,N/A,N/A,896,937,N/A,59,6
39,N/A,N/A,N/A,857,896,N/A,64,5
25,N/A,N/A,N/A,832,857,N/A,69,4
10,N/A,N/A,N/A,822,832,N/A,73,2
15,N/A,N/A,N/A,807,822,N/A,79,2
11,N/A,N/A,N/A,796,807,N/A,85,2
37,N/A,N/A,N/A,759,796,N/A,88,5
10,N/A,N/A,N/A,749,759,N/A,91,2
35,N/A,N/A,N/A,714,749,N/A,94,5
19,N/A,N/A,N/A,695,714,N/A,98,3
15,N/A,N/A,N/A,680,695,N/A,104,3
19,N/A,N/A,N/A,661,680,N/A,110,3
23,N/A,N/A,N/A,638,661,N/A,116,3
42,N/A,N/A,N/A,596,638,N/A,119,6
36,N/A,N/A,N/A,560,596,N/A,124,5
19,N/A,N/A,N/A,541,560,N/A,128,3
41,N/A,N/A,N/A,500,541,N/A,131,6
17,N/A,N/A,N/A,483,500,N/A,134,3
7,N/A,N/A,N/A,437,444,N/A,4,1
14,N/A,N/A,N/A,423,437,N/A,10,1
12,N/A,N/A,N/A,411,423,N/A,16,1
41,N/A,N/A,N/A,370,411,N/A,21,6
14,N/A,N/A,N/A,356,370,N/A,24,3
14,N/A,N/A,N/A,342,356,N/A,29,2
35,N/A,N/A,N/A,307,342,N/A,32,5
13,N/A,N/A,N/A,294,307,N/A,35,2
11,N/A,N/A,N/A,283,294,N/A,41,2
42,N/A,N/A,N/A,241,283,N/A,45,6
33,N/A,N/A,N/A,208,241,N/A,50,5
15,N/A,N/A,N/A,193,208,N/A,54,3
11,N/A,N/A,N/A,182,193,N/A,58,1
29,N/A,N/A,N/A,153,182,N/A,61,4
22,N/A,N/A,N/A,131,153,N/A,66,3
8,N/A,N/A,N/A,123,131,N/A,70,1
28,N/A,N/A,N/A,95,123,N/A,73,4
29,N/A,N/A,N/A,66,95,N/A,79,4
17,N/A,N/A,N/A,49,66,N/A,83,2
9,N/A,N/A,N/A,40,49,N/A,88,1
26,N/A,N/A,N/A,14,40,N/A,91,4
12,N/A,N/A,N/A,2,14,N/A,95,2
9,N/A,N/A,N/A,-7,2,N/A,100,1
10,N/A,N/A,N/A,918,928,N/A,5,2
16,N/A,N/A,N/A,902,918,N/A,11,2
10,N/A,N/A,N/A,892,902,N/A,16,1
41,N/A,N/A,N/A,851,892,N/A,21,6
20,N/A,N/A,N/A,831,851,N/A,24,3
41,N/A,N/A,N/A,790,831,N/A,27,6
15,N/A,N/A,N/A,775,790,N/A,30,3
14,N/A,N/A,N/A,761,775,N/A,36,3
43,N/A,N/A,N/A,718,761,N/A,39,6
14,N/A,N/A,N/A,704,718,N/A,42,3
13,N/A,N/A,N/A,691,704,N/A,47,2
44,N/A,N/A,N/A,647,691,N/A,51,6
6,N/A,N/A,N/A,641,647,N/A,57,0
32,N/A,N/A,N/A,609,641,N/A,61,4
22,N/A,N/A,N/A,587,609,N/A,67,4
23,N/A,N/A,N/A,564,587,N/A,72,3
41,N/A,N/A,N/A,523,564,N/A,75,6
17,N/A,N/A,N/A,506,523,N/A,78,3
23,N/A,N/A,N/A,483,506,N/A,84,3
14,N/A,N/A,N/A,469,483,N/A,89,2
33,N/A,N/A,N/A,436,469,N/A,92,5
17,N/A,N/A,N/A,419,436,N/A,96,3
20,N/A,N/A,N/A,399,419,N/A,102,3
44,N/A,N/A,N/A,355,399,N/A,105,6
5,N/A,N/A,N/A,350,355,N/A,111,0
25,N/A,N/A,N/A,325,350,N/A,115,4
8,N/A,N/A,N/A,317,325,N/A,118,1
35,N/A,N/A,N/A,282,317,N/A,122,5
12,N/A,N/A,N/A,270,282,N/A,125,2
34,N/A,N/A,N/A,236,270,N/A,128,5
8,N/A,N/A,N/A,1455,1463,N/A,4,1
42,N/A,N/A,N/A,1413,1455,N/A,9,6
8,N/A,N/A,N/A,1405,1413,N/A,15,0
33,N/A,N/A,N/A,1372,1405,N/A,20,5
36,N/A,N/A,N/A,1336,1372,N/A,26,5
33,N/A,N/A,N/A,1303,1336,N/A,32,5
32,N/A,N/A,N/A,1271,1303,N/A,37,4
17,N/A,N/A,N/A,1254,1271,N/A,42,3
13,N/A,N/A,N/A,1241,1254,N/A,47,2
38,N/A,N/A,N/A,1203,1241,N/A,50,5
32,N/A,N/A,N/A,1171,1203,N/A,55,4
9,N/A,N/A,N/A,1162,1171,N/A,58,1
43,N/A,N/A,N/A,1119,1162,N/A,63,6
25,N/A,N/A,N/A,1094,1119,N/A,67,4
28,N/A,N/A,N/A,1066,1094,N/A,73,4
31,N/A,N/A,N/A,1035,1066,N/A,79,4
14,N/A,N/A,N/A,1021,1035,N/A,83,2
42,N/A,N/A,N/A,979,1021,N/A,87,6
37,N/A,N/A,N/A,942,979,N/A,92,5
12,N/A,N/A,N/A,930,942,N/A,95,2
42,N/A,N/A,N/A,888,930,N/A,99,6
9,N/A,N/A,N/A,879,888,N/A,105,0
14,N/A,N/A,N/A,865,879,N/A,108,3
15,N/A,N/A,N/A,850,865,N/A,113,2
14,N/A,N/A,N/A,836,850,N/A,119,2
11,N/A,N/A,N/A,825,836,N/A,124,1
26,N/A,N/A,N/A,799,825,N/A,127,4
13,N/A,N/A,N/A,786,799,N/A,130,1
38,N/A,N/A,N/A,748,786,N/A,134,5
32,N/A,N/A,N/A,716,748,N/A,139,4
42,N/A,N/A,N/A,1590,1632,N/A,4,6
5,N/A,N/A,N/A,1585,1590,N/A,10,0
41,N/A,N/A,N/A,1544,1585,N/A,16,6
28,N/A,N/A,N/A,1516,1544,N/A,20,4
24,N/A,N/A,N/A,1492,1516,N/A,26,4
20,N/A,N/A,N/A,1472,1492,N/A,31,3
11,N/A,N/A,N/A,1461,1472,N/A,36,2
8,N/A,N/A,N/A,1453,1461,N/A,41,1
12,N/A,N/A,N/A,1441,1453,N/A,47,1
30,N/A,N/A,N/A,1411,1441,N/A,50,4
21,N/A,N/A,N/A,1390,1411,N/A,55,3
44,N/A,N/A,N/A,1346,1390,N/A,58,6
32,N/A,N/A,N/A,1314,1346,N/A,63,5
14,N/A,N/A,N/A,1300,1314,N/A,66,2
15,N/A,N/A,N/A,1285,1300,N/A,72,2
44,N/A,N/A,N/A,1241,1285,N/A,76,6
8,N/A,N/A,N/A,1233,1241,N/A,82,0
30,N/A,N/A,N/A,1203,1233,N/A,86,4
14,N/A,N/A,N/A,1189,1203,N/A,90,2
32,N/A,N/A,N/A,1157,1189,N/A,93,5
16,N/A,N/A,N/A,1141,1157,N/A,96,2
7,N/A,N/A,N/A,1134,1141,N/A,101,1
41,N/A,N/A,N/A,1093,1134,N/A,106,6
9,N/A,N/A,N/A,1084,1093,N/A,112,0
29,N/A,N/A,N/A,1055,1084,N/A,116,4
25,N/A,N/A,N/A,1030,1055,N/A,122,4
23,N/A,N/A,N/A,1007,1030,N/A,127,3
44,N/A,N/A,N/A,963,1007,N/A,130,6
9,N/A,N/A,N/A,954,963,N/A,136,0
23,N/A,N/A,N/A,931,954,N/A,140,4
41,N/A,N/A,N/A,705,746,N/A,4,6
28,N/A,N/A,N/A,677,705,N/A,8,4
15,N/A,N/A,N/A,662,677,N/A,12,2
35,N/A,N/A,N/A,627,662,N/A,15,5
23,N/A,N/A,N/A,604,627,N/A,20,4
10,N/A,N/A,N/A,594,604,N/A,23,1
43,N/A,N/A,N/A,551,594,N/A,28,6
18,N/A,N/A,N/A,533,551,N/A,31,3
12,N/A,N/A,N/A,521,533,N/A,36,2
44,N/A,N/A,N/A,477,521,N/A,40,6
31,N/A,N/A,N/A,446,477,N/A,44,4
22,N/A,N/A,N/A,424,446,N/A,49,3
12,N/A,N/A,N/A,412,424,N/A,53,1
30,N/A,N/A,N/A,382,412,N/A,56,4
12,N/A,N/A,N/A,370,382,N/A,60,2
17,N/A,N/A,N/A,353,370,N/A,66,2
38,N/A,N/A,N/A,315,353,N/A,69,5
12,N/A,N/A,N/A,303,315,N/A,72,2
14,N/A,N/A,N/A,289,303,N/A,77,1
10,N/A,N/A,N/A,279,289,N/A,83,1
31,N/A,N/A,N/A,248,279,N/A,86,4
29,N/A,N/A,N/A,219,248,N/A,92,4
10,N/A,N/A,N/A,209,219,N/A,96,2
43,N/A,N/A,N/A,166,209,N/A,100,6
32,N/A,N/A,N/A,134,166,N/A,105,5
23,N/A,N/A,N/A,111,134,N/A,109,3
41,N/A,N/A,N/A,70,111,N/A,112,6
25,N/A,N/A,N/A,45,70,N/A,116,4
17,N/A,N/A,N/A,28,45,N/A,121,3
16,N/A,N/A,N/A,12,28,N/A,126,2
13,N/A,N/A,N/A,661,674,N/A,4,1
37,N/A,N/A,N/A,624,661,N/A,8,5
13,N/A,N/A,N/A,611,624,N/A,11,2
33,N/A,N/A,N/A,578,611,N/A,14,5
10,N/A,N/A,N/A,568,578,N/A,17,2
42,N/A,N/A,N/A,526,568,N/A,21,6
31,N/A,N/A,N/A,495,526,N/A,25,4
13,N/A,N/A,N/A,482,495,N/A,28,1
25,N/A,N/A,N/A,457,482,N/A,31,4
17,N/A,N/A,N/A,440,457,N/A,35,2
12,N/A,N/A,N/A,428,440,N/A,41,2
13,N/A,N/A,N/A,415,428,N/A,46,1
8,N/A,N/A,N/A,407,415,N/A,52,1
35,N/A,N/A,N/A,372,407,N/A,56,5
10,N/A,N/A,N/A,362,372,N/A,59,2
44,N/A,N/A,N/A,318,362,N/A,63,6
26,N/A,N/A,N/A,292,318,N/A,67,4
8,N/A,N/A,N/A,284,292,N/A,70,1
8,N/A,N/A,N/A,276,284,N/A,76,1
14,N/A,N/A,N/A,262,276,N/A,82,1
43,N/A,N/A,N/A,219,262,N/A,87,6
38,N/A,N/A,N/A,181,219,N/A,92,5
35,N/A,N/A,N/A,146,181,N/A,98,5
14,N/A,N/A,N/A,132,146,N/A,102,3
20,N/A,N/A,N/A,112,132,N/A,108,3
14,N/A,N/A,N/A,98,112,N/A,113,2
43,N/A,N/A,N/A,55,98,N/A,117,6
15,N/A,N/A,N/A,40,55,N/A,120,3
42,N/A,N/A,N/A,-2,40,N/A,123,6
11,N/A,N/A,N/A,1381,1392,N/A,5,1
29,N/A,N/A,N/A,1352,1381,N/A,8,4
9,N/A,N/A,N/A,1343,1352,N/A,11,1
11,N/A,N/A,N/A,1332,1343,N/A,17,1
33,N/A,N/A,N/A,1299,1332,N/A,21,5
15,N/A,N/A,N/A,1284,1299,N/A,24,2
41,N/A,N/A,N/A,1243,1284,N/A,28,6
30,N/A,N/A,N/A,1213,1243,N/A,32,4
32,N/A,N/A,N/A,1181,1213,N/A,38,4
13,N/A,N/A,N/A,1168,1181,N/A,42,2
16,N/A,N/A,N/A,1152,1168,N/A,48,2
44,N/A,N/A,N/A,1108,1152,N/A,52,6
21,N/A,N/A,N/A,1087,1108,N/A,55,3
18,N/A,N/A,N/A,1069,1087,N/A,61,3
17,N/A,N/A,N/A,1052,1069,N/A,66,2
33,N/A,N/A,N/A,1019,1052,N/A,69,5
29,N/A,N/A,N/A,990,1019,N/A,74,4
14,N/A,N/A,N/A,976,990,N/A,79,3
13,N/A,N/A,N/A,963,976,N/A,83,1
44,N/A,N/A,N/A,919,963,N/A,88,6
38,N/A,N/A,N/A,881,919,N/A,93,5
21,N/A,N/A,N/A,860,881,N/A,97,3
42,N/A,N/A,N/A,818,860,N/A,100,6
30,N/A,N/A,N/A,788,818,N/A,104,4
10,N/A,N/A,N/A,778,788,N/A,108,2
10,N/A,N/A,N/A,768,778,N/A,114,2
14,N/A,N/A,N/A,754,768,N/A,120,2
44,N/A,N/A,N/A,710,754,N/A,124,6
6,N/A,N/A,N/A,704,710,N/A,130,0
32,N/A,N/A,N/A,672,704,N/A,135,5
19,N/A,N/A,N/A,283,302,N/A,6,3
17,N/A,N/A,N/A,266,283,N/A,12,3
21,N/A,N/A,N/A,245,266,N/A,18,3
12,N/A,N/A,N/A,233,245,N/A,23,2
10,N/A,N/A,N/A,223,233,N/A,28,1
13,N/A,N/A,N/A,210,223,N/A,34,1
33,N/A,N/A,N/A,177,210,N/A,38,5
28,N/A,N/A,N/A,149,177,N/A,43,4
14,N/A,N/A,N/A,135,149,N/A,48,3
18,N/A,N/A,N/A,117,135,N/A,54,3
13,N/A,N/A,N/A,104,117,N/A,58,1
43,N/A,N/A,N/A,61,104,N/A,63,6
32,N/A,N/A,N/A,29,61,N/A,68,5
15,N/A,N/A,N/A,14,29,N/A,71,2
38,N/A,N/A,N/A,-24,14,N/A,74,5
44,N/A,N/A,N/A,1877,1921,N/A,4,6
19,N/A,N/A,N/A,1858,1877,N/A,7,3
44,N/A,N/A,N/A,1814,1858,N/A,10,6
6,N/A,N/A,N/A,1808,1814,N/A,16,0
39,N/A,N/A,N/A,1769,1808,N/A,21,5
35,N/A,N/A,N/A,1734,1769,N/A,27,5
26,N/A,N/A,N/A,1708,1734,N/A,32,4
29,N/A,N/A,N/A,1679,1708,N/A,38,4
13,N/A,N/A,N/A,1666,1679,N/A,42,2
8,N/A,N/A,N/A,1658,1666,N/A,47,1
42,N/A,N/A,N/A,1616,1658,N/A,52,6
38,N/A,N/A,N/A,1578,1616,N/A,57,5
14,N/A,N/A,N/A,1564,1578,N/A,60,2
13,N/A,N/A,N/A,1551,1564,N/A,65,1
14,N/A,N/A,N/A,1537,1551,N/A,71,1
44,N/A,N/A,N/A,1493,1537,N/A,76,6
8,N/A,N/A,N/A,1485,1493,N/A,82,0
31,N/A,N/A,N/A,1454,1485,N/A,86,4
21,N/A,N/A,N/A,1433,1454,N/A,91,3
9,N/A,N/A,N/A,1424,1433,N/A,95,1
38,N/A,N/A,N/A,1386,1424,N/A,99,5
21,N/A,N/A,N/A,1365,1386,N/A,103,3
15,N/A,N/A,N/A,1350,1365,N/A,109,3
9,N/A,N/A,N/A,1341,1350,N/A,113,1
13,N/A,N/A,N/A,1328,1341,N/A,119,1
37,N/A,N/A,N/A,1291,1328,N/A,123,5
11,N/A,N/A,N/A,1280,1291,N/A,126,2
11,N/A,N/A,N/A,1269,1280,N/A,132,2
15,N/A,N/A,N/A,1254,1269,N/A,138,2
33,N/A,N/A,N/A,1221,1254,N/A,141,5
14,N/A,N/A,N/A,1066,1080,N/A,5,1
32,N/A,N/A,N/A,1034,1066,N/A,8,4
12,N/A,N/A,N/A,1022,1034,N/A,12,2
11,N/A,N/A,N/A,1011,1022,N/A,17,1
44,N/A,N/A,N/A,967,1011,N/A,22,6
15,N/A,N/A,N/A,952,967,N/A,25,3
16,N/A,N/A,N/A,936,952,N/A,31,3
15,N/A,N/A,N/A,921,936,N/A,37,3
13,N/A,N/A,N/A,908,921,N/A,41,1
23,N/A,N/A,N/A,885,908,N/A,44,4
16,N/A,N/A,N/A,869,885,N/A,49,3
44,N/A,N/A,N/A,825,869,N/A,52,6
29,N/A,N/A,N/A,796,825,N/A,56,4
10,N/A,N/A,N/A,786,796,N/A,60,2
34,N/A,N/A,N/A,752,786,N/A,63,5
10,N/A,N/A,N/A,742,752,N/A,66,2
33,N/A,N/A,N/A,709,742,N/A,69,5
15,N/A,N/A,N/A,694,709,N/A,73,3
15,N/A,N/A,N/A,679,694,N/A,78,2
12,N/A,N/A,N/A,667,679,N/A,83,1
22,N/A,N/A,N/A,645,667,N/A,86,4
16,N/A,N/A,N/A,629,645,N/A,91,3
43,N/A,N/A,N/A,586,629,N/A,94,6
38,N/A,N/A,N/A,548,586,N/A,99,5
38,N/A,N/A,N/A,510,548,N/A,105,5
33,N/A,N/A,N/A,477,510,N/A,111,5
20,N/A,N/A,N/A,457,477,N/A,115,3
42,N/A,N/A,N/A,415,457,N/A,118,6
23,N/A,N/A,N/A,392,415,N/A,121,3
23,N/A,N/A,N/A,369,392,N/A,127,3
34,N/A,N/A,N/A,908,942,N/A,3,5
15,N/A,N/A,N/A,893,908,N/A,6,2
33,N/A,N/A,N/A,860,893,N/A,9,5
39,N/A,N/A,N/A,821,860,N/A,15,5
14,N/A,N/A,N/A,807,821,N/A,18,2
14,N/A,N/A,N/A,793,807,N/A,23,1
23,N/A,N/A,N/A,770,793,N/A,26,4
26,N/A,N/A,N/A,744,770,N/A,32,4
13,N/A,N/A,N/A,731,744,N/A,36,2
33,N/A,N/A,N/A,698,731,N/A,39,5
29,N/A,N/A,N/A,669,698,N/A,44,4
22,N/A,N/A,N/A,647,669,N/A,50,4
14,N/A,N/A,N/A,633,647,N/A,53,1
33,N/A,N/A,N/A,600,633,N/A,57,5
34,N/A,N/A,N/A,566,600,N/A,63,5
39,N/A,N/A,N/A,527,566,N/A,69,5
36,N/A,N/A,N/A,491,527,N/A,75,5
11,N/A,N/A,N/A,480,491,N/A,78,2
33,N/A,N/A,N/A,447,480,N/A,81,5
17,N/A,N/A,N/A,430,447,N/A,85,3
8,N/A,N/A,N/A,422,430,N/A,89,1
37,N/A,N/A,N/A,385,422,N/A,93,5
22,N/A,N/A,N/A,363,385,N/A,98,4
10,N/A,N/A,N/A,353,363,N/A,102,2
12,N/A,N/A,N/A,341,353,N/A,107,1
44,N/A,N/A,N/A,297,341,N/A,112,6
37,N/A,N/A,N/A,260,297,N/A,117,5
24,N/A,N/A,N/A,236,260,N/A,122,4
31,N/A,N/A,N/A,205,236,N/A,128,4
17,N/A,N/A,N/A,188,205,N/A,133,3
13,N/A,N/A,N/A,1032,1045,N/A,5,2
43,N/A,N/A,N/A,989,1032,N/A,9,6
23,N/A,N/A,N/A,966,989,N/A,12,3
9,N/A,N/A,N/A,957,966,N/A,16,1
32,N/A,N/A,N/A,925,957,N/A,19,4
14,N/A,N/A,N/A,911,925,N/A,23,2
42,N/A,N/A,N/A,869,911,N/A,27,6
26,N/A,N/A,N/A,843,869,N/A,31,4
14,N/A,N/A,N/A,829,843,N/A,34,1
41,N/A,N/A,N/A,788,829,N/A,39,6
7,N/A,N/A,N/A,781,788,N/A,45,0
29,N/A,N/A,N/A,752,781,N/A,49,4
16,N/A,N/A,N/A,736,752,N/A,54,3
10,N/A,N/A,N/A,726,736,N/A,58,1
24,N/A,N/A,N/A,702,726,N/A,61,4
13,N/A,N/A,N/A,689,702,N/A,65,2
14,N/A,N/A,N/A,675,689,N/A,71,2
8,N/A,N/A,N/A,667,675,N/A,76,1
42,N/A,N/A,N/A,625,667,N/A,81,6
35,N/A,N/A,N/A,590,625,N/A,86,5
34,N/A,N/A,N/A,556,590,N/A,92,5
28,N/A,N/A,N/A,528,556,N/A,97,4
16,N/A,N/A,N/A,512,528,N/A,101,2
44,N/A,N/A,N/A,468,512,N/A,105,6
36,N/A,N/A,N/A,432,468,N/A,110,5
38,N/A,N/A,N/A,394,432,N/A,116,5
36,N/A,N/A,N/A,358,394,N/A,122,5
22,N/A,N/A,N/A,336,358,N/A,127,4
10,N/A,N/A,N/A,326,336,N/A,130,1
34,N/A,N/A,N/A,292,326,N/A,134,5
32,N/A,N/A,N/A,539,571,N/A,3,4
9,N/A,N/A,N/A,530,539,N/A,6,1
35,N/A,N/A,N/A,495,530,N/A,10,5
32,N/A,N/A,N/A,463,495,N/A,16,5
25,N/A,N/A,N/A,438,463,N/A,21,4
23,N/A,N/A,N/A,415,438,N/A,26,3
7,N/A,N/A,N/A,408,415,N/A,30,1
11,N/A,N/A,N/A,397,408,N/A,36,1
28,N/A,N/A,N/A,369,397,N/A,39,4
13,N/A,N/A,N/A,356,369,N/A,42,1
26,N/A,N/A,N/A,330,356,N/A,45,4
11,N/A,N/A,N/A,319,330,N/A,49,2
12,N/A,N/A,N/A,307,319,N/A,55,2
32,N/A,N/A,N/A,275,307,N/A,58,5
39,N/A,N/A,N/A,236,275,N/A,64,5
32,N/A,N/A,N/A,204,236,N/A,70,5
13,N/A,N/A,N/A,191,204,N/A,73,2
8,N/A,N/A,N/A,183,191,N/A,78,1
7,N/A,N/A,N/A,176,183,N/A,84,1
44,N/A,N/A,N/A,132,176,N/A,89,6
22,N/A,N/A,N/A,110,132,N/A,93,4
12,N/A,N/A,N/A,98,110,N/A,96,1
12,N/A,N/A,N/A,86,98,N/A,102,1
44,N/A,N/A,N/A,42,86,N/A,107,6
32,N/A,N/A,N/A,10,42,N/A,112,5
36,N/A,N/A,N/A,-26,10,N/A,118,5
13,N/A,N/A,N/A,1821,1834,N/A,3,2
43,N/A,N/A,N/A,1778,1821,N/A,7,6
39,N/A,N/A,N/A,1739,1778,N/A,12,5
23,N/A,N/A,N/A,1716,1739,N/A,16,3
14,N/A,N/A,N/A,1702,1716,N/A,22,3
14,N/A,N/A,N/A,1688,1702,N/A,28,3
11,N/A,N/A,N/A,1677,1688,N/A,33,2
32,N/A,N/A,N/A,1645,1677,N/A,36,5
17,N/A,N/A,N/A,1628,1645,N/A,39,2
11,N/A,N/A,N/A,1617,1628,N/A,45,2
34,N/A,N/A,N/A,1583,1617,N/A,48,5
19,N/A,N/A,N/A,1564,1583,N/A,52,3
17,N/A,N/A,N/A,1547,1564,N/A,58,3
42,N/A,N/A,N/A,1505,1547,N/A,61,6
7,N/A,N/A,N/A,1498,1505,N/A,67,0
27,N/A,N/A,N/A,1471,1498,N/A,71,4
7,N/A,N/A,N/A,1464,1471,N/A,74,1
37,N/A,N/A,N/A,1427,1464,N/A,78,5
36,N/A,N/A,N/A,1391,1427,N/A,84,5
10,N/A,N/A,N/A,1381,1391,N/A,87,2
43,N/A,N/A,N/A,1338,1381,N/A,91,6
7,N/A,N/A,N/A,1331,1338,N/A,97,0
32,N/A,N/A,N/A,1299,1331,N/A,102,5
18,N/A,N/A,N/A,1281,1299,N/A,106,3
20,N/A,N/A,N/A,1261,1281,N/A,112,3
23,N/A,N/A,N/A,1238,1261,N/A,118,3
10,N/A,N/A,N/A,1228,1238,N/A,122,1
22,N/A,N/A,N/A,1206,1228,N/A,125,4
19,N/A,N/A,N/A,1187,1206,N/A,130,3
13,N/A,N/A,N/A,1174,1187,N/A,135,2
25,N/A,N/A,N/A,1024,1049,N/A,3,4
14,N/A,N/A,N/A,1010,1024,N/A,7,2
37,N/A,N/A,N/A,973,1010,N/A,10,5
14,N/A,N/A,N/A,959,973,N/A,13,2
44,N/A,N/A,N/A,915,959,N/A,17,6
5,N/A,N/A,N/A,910,915,N/A,23,0
30,N/A,N/A,N/A,880,910,N/A,27,4
7,N/A,N/A,N/A,873,880,N/A,30,1
35,N/A,N/A,N/A,838,873,N/A,34,5
15,N/A,N/A,N/A,823,838,N/A,37,2
8,N/A,N/A,N/A,815,823,N/A,42,1
39,N/A,N/A,N/A,776,815,N/A,46,5
34,N/A,N/A,N/A,742,776,N/A,52,5
25,N/A,N/A,N/A,717,742,N/A,57,4
12,N/A,N/A,N/A,705,717,N/A,61,2
34,N/A,N/A,N/A,671,705,N/A,64,5
33,N/A,N/A,N/A,638,671,N/A,70,5
29,N/A,N/A,N/A,609,638,N/A,75,4
14,N/A,N/A,N/A,595,609,N/A,80,3
23,N/A,N/A,N/A,572,595,N/A,86,3
12,N/A,N/A,N/A,560,572,N/A,91,2
37,N/A,N/A,N/A,523,560,N/A,94,5
33,N/A,N/A,N/A,490,523,N/A,100,5
35,N/A,N/A,N/A,455,490,N/A,106,5
27,N/A,N/A,N/A,428,455,N/A,111,4
19,N/A,N/A,N/A,409,428,N/A,116,3
21,N/A,N/A,N/A,388,409,N/A,122,3
13,N/A,N/A,N/A,375,388,N/A,126,1
36,N/A,N/A,N/A,339,375,N/A,130,5
20,N/A,N/A,N/A,319,339,N/A,134,3
26,N/A,N/A,N/A,966,992,N/A,4,4
17,N/A,N/A,N/A,949,966,N/A,8,2
17,N/A,N/A,N/A,932,949,N/A,14,2
12,N/A,N/A,N/A,920,932,N/A,19,1
8,N/A,N/A,N/A,912,920,N/A,25,1
32,N/A,N/A,N/A,880,912,N/A,29,5
37,N/A,N/A,N/A,843,880,N/A,35,5
15,N/A,N/A,N/A,828,843,N/A,39,3
7,N/A,N/A,N/A,821,828,N/A,43,1
42,N/A,N/A,N/A,779,821,N/A,48,6
26,N/A,N/A,N/A,753,779,N/A,52,4
16,N/A,N/A,N/A,737,753,N/A,57,3
14,N/A,N/A,N/A,723,737,N/A,63,3
7,N/A,N/A,N/A,716,723,N/A,67,1
42,N/A,N/A,N/A,674,716,N/A,72,6
7,N/A,N/A,N/A,667,674,N/A,78,0
38,N/A,N/A,N/A,629,667,N/A,83,5
16,N/A,N/A,N/A,613,629,N/A,87,3
16,N/A,N/A,N/A,597,613,N/A,93,3
12,N/A,N/A,N/A,585,597,N/A,98,2
37,N/A,N/A,N/A,548,585,N/A,101,5
28,N/A,N/A,N/A,520,548,N/A,106,4
10,N/A,N/A,N/A,510,520,N/A,109,1
44,N/A,N/A,N/A,466,510,N/A,114,6
18,N/A,N/A,N/A,448,466,N/A,117,3
14,N/A,N/A,N/A,434,448,N/A,121,1
44,N/A,N/A,N/A,390,434,N/A,126,6
16,N/A,N/A,N/A,374,390,N/A,129,3
42,N/A,N/A,N/A,332,374,N/A,132,6
37,N/A,N/A,N/A,295,332,N/A,137,5
37,N/A,N/A,N/A,393,430,N/A,5,5
16,N/A,N/A,N/A,377,393,N/A,9,3
41,N/A,N/A,N/A,336,377,N/A,12,6
27,N/A,N/A,N/A,309,336,N/A,16,4
12,N/A,N/A,N/A,297,309,N/A,19,1
8,N/A,N/A,N/A,289,297,N/A,25,1
28,N/A,N/A,N/A,261,289,N/A,28,4
17,N/A,N/A,N/A,244,261,N/A,33,3
14,N/A,N/A,N/A,230,244,N/A,39,3
43,N/A,N/A,N/A,187,230,N/A,42,6
32,N/A,N/A,N/A,155,187,N/A,47,5
13,N/A,N/A,N/A,142,155,N/A,50,2
10,N/A,N/A,N/A,132,142,N/A,56,2
13,N/A,N/A,N/A,119,132,N/A,61,1
44,N/A,N/A,N/A,75,119,N/A,66,6
7,N/A,N/A,N/A,68,75,N/A,72,0
44,N/A,N/A,N/A,24,68,N/A,78,6
34,N/A,N/A,N/A,-10,24,N/A,83,5
35,N/A,N/A,N/A,507,542,N/A,5,5
22,N/A,N/A,N/A,485,507,N/A,10,4
12,N/A,N/A,N/A,473,485,N/A,13,1
38,N/A,N/A,N/A,435,473,N/A,17,5
17,N/A,N/A,N/A,418,435,N/A,20,2
37,N/A,N/A,N/A,381,418,N/A,23,5
36,N/A,N/A,N/A,345,381,N/A,29,5
35,N/A,N/A,N/A,310,345,N/A,35,5
12,N/A,N/A,N/A,298,310,N/A,38,2
36,N/A,N/A,N/A,262,298,N/A,41,5
34,N/A,N/A,N/A,228,262,N/A,47,5
16,N/A,N/A,N/A,212,228,N/A,50,2
35,N/A,N/A,N/A,177,212,N/A,53,5
14,N/A,N/A,N/A,163,177,N/A,56,2
13,N/A,N/A,N/A,150,163,N/A,61,1
33,N/A,N/A,N/A,117,150,N/A,65,5
11,N/A,N/A,N/A,106,117,N/A,68,2
44,N/A,N/A,N/A,62,106,N/A,72,6
22,N/A,N/A,N/A,40,62,N/A,75,3
13,N/A,N/A,N/A,27,40,N/A,79,1
14,N/A,N/A,N/A,13,27,N/A,85,1
41,N/A,N/A,N/A,-28,13,N/A,90,6
14,N/A,N/A,N/A,772,786,N/A,5,3
14,N/A,N/A,N/A,758,772,N/A,11,3
21,N/A,N/A,N/A,737,758,N/A,17,3
43,N/A,N/A,N/A,694,737,N/A,20,6
7,N/A,N/A,N/A,687,694,N/A,26,0
25,N/A,N/A,N/A,662,687,N/A,30,4
20,N/A,N/A,N/A,642,662,N/A,35,3
41,N/A,N/A,N/A,601,642,N/A,38,6
9,N/A,N/A,N/A,592,601,N/A,44,0
31,N/A,N/A,N/A,561,592,N/A,48,4
29,N/A,N/A,N/A,532,561,N/A,54,4
29,N/A,N/A,N/A,503,532,N/A,60,4
7,N/A,N/A,N/A,496,503,N/A,63,1
41,N/A,N/A,N/A,455,496,N/A,68,6
6,N/A,N/A,N/A,449,455,N/A,74,0
33,N/A,N/A,N/A,416,449,N/A,79,5
32,N/A,N/A,N/A,384,416,N/A,84,4
32,N/A,N/A,N/A,352,384,N/A,90,4
25,N/A,N/A,N/A,327,352,N/A,96,4
25,N/A,N/A,N/A,302,327,N/A,102,4
17,N/A,N/A,N/A,285,302,N/A,107,3
43,N/A,N/A,N/A,242,285,N/A,110,6
22,N/A,N/A,N/A,220,242,N/A,114,4
20,N/A,N/A,N/A,200,220,N/A,119,3
14,N/A,N/A,N/A,186,200,N/A,124,2
12,N/A,N/A,N/A,174,186,N/A,129,1
12,N/A,N/A,N/A,162,174,N/A,135,1
11,N/A,N/A,N/A,151,162,N/A,141,1
7,N/A,N/A,N/A,144,151,N/A,147,1
9,N/A,N/A,N/A,135,144,N/A,153,1
44,N/A,N/A,N/A,478,522,N/A,4,6
27,N/A,N/A,N/A,451,478,N/A,8,4
13,N/A,N/A,N/A,438,451,N/A,11,1
39,N/A,N/A,N/A,399,438,N/A,15,5
17,N/A,N/A,N/A,382,399,N/A,18,2
9,N/A,N/A,N/A,373,382,N/A,23,1
37,N/A,N/A,N/A,336,373,N/A,27,5
19,N/A,N/A,N/A,317,336,N/A,31,3
11,N/A,N/A,N/A,306,317,N/A,35,1
43,N/A,N/A,N/A,263,306,N/A,40,6
6,N/A,N/A,N/A,257,263,N/A,46,0
42,N/A,N/A,N/A,215,257,N/A,52,6
31,N/A,N/A,N/A,184,215,N/A,56,4
15,N/A,N/A,N/A,169,184,N/A,60,2
13,N/A,N/A,N/A,156,169,N/A,65,1
41,N/A,N/A,N/A,115,156,N/A,70,6
15,N/A,N/A,N/A,100,115,N/A,73,3
43,N/A,N/A,N/A,57,100,N/A,76,6
26,N/A,N/A,N/A,31,57,N/A,80,4
21,N/A,N/A,N/A,10,31,N/A,85,3
12,N/A,N/A,N/A,-2,10,N/A,90,2
43,N/A,N/A,N/A,1691,1734,N/A,3,6
17,N/A,N/A,N/A,1674,1691,N/A,6,3
41,N/A,N/A,N/A,1633,1674,N/A,9,6
9,N/A,N/A,N/A,1624,1633,N/A,15,0
32,N/A,N/A,N/A,1592,1624,N/A,19,4
14,N/A,N/A,N/A,1578,1592,N/A,22,1
29,N/A,N/A,N/A,1549,1578,N/A,25,4
10,N/A,N/A,N/A,1539,1549,N/A,29,2
10,N/A,N/A,N/A,1529,1539,N/A,35,2
34,N/A,N/A,N/A,1495,1529,N/A,38,5
17,N/A,N/A,N/A,1478,1495,N/A,41,2
11,N/A,N/A,N/A,1467,1478,N/A,47,2
41,N/A,N/A,N/A,1426,1467,N/A,51,6
5,N/A,N/A,N/A,1421,1426,N/A,57,0
33,N/A,N/A,N/A,1388,1421,N/A,62,5
34,N/A,N/A,N/A,1354,1388,N/A,68,5
36,N/A,N/A,N/A,1318,1354,N/A,74,5
32,N/A,N/A,N/A,1286,1318,N/A,79,4
20,N/A,N/A,N/A,1266,1286,N/A,84,3
44,N/A,N/A,N/A,1222,1266,N/A,87,6
23,N/A,N/A,N/A,1199,1222,N/A,90,3
41,N/A,N/A,N/A,1158,1199,N/A,93,6
37,N/A,N/A,N/A,1121,1158,N/A,98,5
12,N/A,N/A,N/A,1109,1121,N/A,101,2
33,N/A,N/A,N/A,1076,1109,N/A,104,5
17,N/A,N/A,N/A,1059,1076,N/A,108,3
14,N/A,N/A,N/A,1045,1059,N/A,114,3
15,N/A,N/A,N/A,1030,1045,N/A,119,2
12,N/A,N/A,N/A,1018,1030,N/A,124,1
10,N/A,N/A,N/A,1008,1018,N/A,130,1
42,N/A,N/A,N/A,1224,1266,N/A,6,6
22,N/A,N/A,N/A,1202,1224,N/A,10,4
20,N/A,N/A,N/A,1182,1202,N/A,15,3
42,N/A,N/A,N/A,1140,1182,N/A,18,6
29,N/A,N/A,N/A,1111,1140,N/A,22,4
13,N/A,N/A,N/A,1098,1111,N/A,25,1
39,N/A,N/A,N/A,1059,1098,N/A,29,5
15,N/A,N/A,N/A,1044,1059,N/A,33,3
17,N/A,N/A,N/A,1027,1044,N/A,39,3
22,N/A,N/A,N/A,1005,1027,N/A,45,3
8,N/A,N/A,N/A,997,1005,N/A,49,1
44,N/A,N/A,N/A,953,997,N/A,54,6
38,N/A,N/A,N/A,915,953,N/A,59,5
22,N/A,N/A,N/A,893,915,N/A,64,4
14,N/A,N/A,N/A,879,893,N/A,67,1
26,N/A,N/A,N/A,853,879,N/A,70,4
15,N/A,N/A,N/A,838,853,N/A,75,3
7,N/A,N/A,N/A,831,838,N/A,79,1
39,N/A,N/A,N/A,792,831,N/A,83,5
30,N/A,N/A,N/A,762,792,N/A,88,4
18,N/A,N/A,N/A,744,762,N/A,93,3
12,N/A,N/A,N/A,732,744,N/A,97,1
44,N/A,N/A,N/A,688,732,N/A,102,6
23,N/A,N/A,N/A,665,688,N/A,106,4
14,N/A,N/A,N/A,651,665,N/A,110,2
34,N/A,N/A,N/A,617,651,N/A,113,5
13,N/A,N/A,N/A,604,617,N/A,116,2
44,N/A,N/A,N/A,560,604,N/A,120,6
24,N/A,N/A,N/A,536,560,N/A,124,4
22,N/A,N/A,N/A,514,536,N/A,130,4
11,N/A,N/A,N/A,1243,1254,N/A,5,1
44,N/A,N/A,N/A,1199,1243,N/A,10,6
17,N/A,N/A,N/A,1182,1199,N/A,13,3
22,N/A,N/A,N/A,1160,1182,N/A,19,3
22,N/A,N/A,N/A,1138,1160,N/A,25,3
8,N/A,N/A,N/A,1130,1138,N/A,29,1
38,N/A,N/A,N/A,1092,1130,N/A,33,5
13,N/A,N/A,N/A,1079,1092,N/A,36,2
37,N/A,N/A,N/A,1042,1079,N/A,39,5
25,N/A,N/A,N/A,1017,1042,N/A,44,4
22,N/A,N/A,N/A,995,1017,N/A,50,4
30,N/A,N/A,N/A,965,995,N/A,56,4
18,N/A,N/A,N/A,947,965,N/A,61,3
41,N/A,N/A,N/A,906,947,N/A,64,6
29,N/A,N/A,N/A,877,906,N/A,68,4
8,N/A,N/A,N/A,869,877,N/A,71,1
33,N/A,N/A,N/A,836,869,N/A,75,5
32,N/A,N/A,N/A,804,836,N/A,81,5
20,N/A,N/A,N/A,784,804,N/A,85,3
15,N/A,N/A,N/A,769,784,N/A,91,3
11,N/A,N/A,N/A,758,769,N/A,96,2
42,N/A,N/A,N/A,716,758,N/A,100,6
7,N/A,N/A,N/A,709,716,N/A,106,0
43,N/A,N/A,N/A,666,709,N/A,112,6
34,N/A,N/A,N/A,632,666,N/A,117,5
37,N/A,N/A,N/A,595,632,N/A,123,5
16,N/A,N/A,N/A,579,595,N/A,126,2
39,N/A,N/A,N/A,540,579,N/A,129,5
19,N/A,N/A,N/A,521,540,N/A,133,3
12,N/A,N/A,N/A,509,521,N/A,137,1
18,N/A,N/A,N/A,999,1017,N/A,4,3
14,N/A,N/A,N/A,985,999,N/A,10,3
13,N/A,N/A,N/A,972,985,N/A,15,2
38,N/A,N/A,N/A,934,972,N/A,18,5
16,N/A,N/A,N/A,918,934,N/A,21,2
16,N/A,N/A,N/A,902,918,N/A,27,2
12,N/A,N/A,N/A,890,902,N/A,33,2
41,N/A,N/A,N/A,849,890,N/A,37,6
38,N/A,N/A,N/A,811,849,N/A,42,5
17,N/A,N/A,N/A,794,811,N/A,46,3
43,N/A,N/A,N/A,751,794,N/A,49,6
24,N/A,N/A,N/A,727,751,N/A,53,4
23,N/A,N/A,N/A,704,727,N/A,59,4
10,N/A,N/A,N/A,694,704,N/A,62,1
36,N/A,N/A,N/A,658,694,N/A,66,5
12,N/A,N/A,N/A,646,658,N/A,69,2
43,N/A,N/A,N/A,603,646,N/A,73,6
33,N/A,N/A,N/A,570,603,N/A,78,5
38,N/A,N/A,N/A,532,570,N/A,84,5
18,N/A,N/A,N/A,514,532,N/A,88,3
17,N/A,N/A,N/A,497,514,N/A,93,2
42,N/A,N/A,N/A,455,497,N/A,97,6
5,N/A,N/A,N/A,450,455,N/A,103,0
42,N/A,N/A,N/A,408,450,N/A,109,6
14,N/A,N/A,N/A,394,408,N/A,112,3
44,N/A,N/A,N/A,350,394,N/A,115,6
24,N/A,N/A,N/A,326,350,N/A,119,4
32,N/A,N/A,N/A,294,326,N/A,125,4
21,N/A,N/A,N/A,273,294,N/A,130,3
43,N/A,N/A,N/A,230,273,N/A,133,6
41,N/A,N/A,N/A,861,902,N/A,6,6
6,N/A,N/A,N/A,855,861,N/A,12,0
44,N/A,N/A,N/A,811,855,N/A,18,6
17,N/A,N/A,N/A,794,811,N/A,21,3
12,N/A,N/A,N/A,782,794,N/A,26,2
33,N/A,N/A,N/A,749,782,N/A,29,5
35,N/A,N/A,N/A,714,749,N/A,35,5
29,N/A,N/A,N/A,685,714,N/A,40,4
22,N/A,N/A,N/A,663,685,N/A,45,3
8,N/A,N/A,N/A,655,663,N/A,49,1
43,N/A,N/A,N/A,612,655,N/A,54,6
25,N/A,N/A,N/A,587,612,N/A,58,4
11,N/A,N/A,N/A,576,587,N/A,62,2
13,N/A,N/A,N/A,563,576,N/A,68,2
32,N/A,N/A,N/A,531,563,N/A,71,5
14,N/A,N/A,N/A,517,531,N/A,74,2
12,N/A,N/A,N/A,505,517,N/A,80,2
14,N/A,N/A,N/A,491,505,N/A,85,1
10,N/A,N/A,N/A,481,491,N/A,91,1
23,N/A,N/A,N/A,458,481,N/A,94,4
17,N/A,N/A,N/A,441,458,N/A,98,2
34,N/A,N/A,N/A,407,441,N/A,101,5
19,N/A,N/A,N/A,388,407,N/A,105,3
14,N/A,N/A,N/A,374,388,N/A,111,3
7,N/A,N/A,N/A,367,374,N/A,115,1
29,N/A,N/A,N/A,338,367,N/A,118,4
11,N/A,N/A,N/A,327,338,N/A,121,1
29,N/A,N/A,N/A,298,327,N/A,124,4
22,N/A,N/A,N/A,276,298,N/A,130,4
14,N/A,N/A,N/A,262,276,N/A,135,3
28,N/A,N/A,N/A,1651,1679,N/A,3,4
14,N/A,N/A,N/A,1637,1651,N/A,6,1
11,N/A,N/A,N/A,1626,1637,N/A,12,1
44,N/A,N/A,N/A,1582,1626,N/A,17,6
9,N/A,N/A,N/A,1573,1582,N/A,23,0
30,N/A,N/A,N/A,1543,1573,N/A,27,4
26,N/A,N/A,N/A,1517,1543,N/A,33,4
11,N/A,N/A,N/A,1506,1517,N/A,37,2
42,N/A,N/A,N/A,1464,1506,N/A,41,6
7,N/A,N/A,N/A,1457,1464,N/A,47,0
32,N/A,N/A,N/A,1425,1457,N/A,52,5
30,N/A,N/A,N/A,1395,1425,N/A,57,4
16,N/A,N/A,N/A,1379,1395,N/A,61,2
41,N/A,N/A,N/A,1338,1379,N/A,65,6
26,N/A,N/A,N/A,1312,1338,N/A,69,4
10,N/A,N/A,N/A,1302,1312,N/A,72,1
7,N/A,N/A,N/A,1295,1302,N/A,78,1
35,N/A,N/A,N/A,1260,1295,N/A,82,5
29,N/A,N/A,N/A,1231,1260,N/A,87,4
23,N/A,N/A,N/A,1208,1231,N/A,92,3
12,N/A,N/A,N/A,1196,1208,N/A,97,2
12,N/A,N/A,N/A,1184,1196,N/A,103,2
35,N/A,N/A,N/A,1149,1184,N/A,106,5
14,N/A,N/A,N/A,1135,1149,N/A,109,2
44,N/A,N/A,N/A,1091,1135,N/A,113,6
31,N/A,N/A,N/A,1060,1091,N/A,117,4
29,N/A,N/A,N/A,1031,1060,N/A,123,4
16,N/A,N/A,N/A,1015,1031,N/A,127,2
12,N/A,N/A,N/A,1003,1015,N/A,132,1
31,N/A,N/A,N/A,972,1003,N/A,135,4
8,N/A,N/A,N/A,1898,1906,N/A,5,1
28,N/A,N/A,N/A,1870,1898,N/A,8,4
13,N/A,N/A,N/A,1857,1870,N/A,12,2
17,N/A,N/A,N/A,1840,1857,N/A,18,2
42,N/A,N/A,N/A,1798,1840,N/A,22,6
21,N/A,N/A,N/A,1777,1798,N/A,25,3
22,N/A,N/A,N/A,1755,1777,N/A,31,3
7,N/A,N/A,N/A,1748,1755,N/A,35,1
41,N/A,N/A,N/A,1707,1748,N/A,40,6
39,N/A,N/A,N/A,1668,1707,N/A,45,5
22,N/A,N/A,N/A,1646,1668,N/A,49,3
41,N/A,N/A,N/A,1605,1646,N/A,52,6
25,N/A,N/A,N/A,1580,1605,N/A,56,4
14,N/A,N/A,N/A,1566,1580,N/A,59,1
41,N/A,N/A,N/A,1525,1566,N/A,64,6
32,N/A,N/A,N/A,1493,1525,N/A,69,5
13,N/A,N/A,N/A,1480,1493,N/A,72,2
13,N/A,N/A,N/A,1467,1480,N/A,77,1
14,N/A,N/A,N/A,1453,1467,N/A,83,1
11,N/A,N/A,N/A,1442,1453,N/A,89,1
34,N/A,N/A,N/A,1408,1442,N/A,93,5
15,N/A,N/A,N/A,1393,1408,N/A,96,2
15,N/A,N/A,N/A,1378,1393,N/A,102,2
17,N/A,N/A,N/A,1361,1378,N/A,108,2
11,N/A,N/A,N/A,1350,1361,N/A,114,2
10,N/A,N/A,N/A,1340,1350,N/A,119,1
41,N/A,N/A,N/A,1299,1340,N/A,124,6
33,N/A,N/A,N/A,1266,1299,N/A,129,5
16,N/A,N/A,N/A,1250,1266,N/A,133,3
17,N/A,N/A,N/A,1233,1250,N/A,138,2
41,N/A,N/A,N/A,776,817,N/A,3,6
31,N/A,N/A,N/A,745,776,N/A,7,4
11,N/A,N/A,N/A,734,745,N/A,10,1
27,N/A,N/A,N/A,707,734,N/A,13,4
11,N/A,N/A,N/A,696,707,N/A,16,1
37,N/A,N/A,N/A,659,696,N/A,20,5
14,N/A,N/A,N/A,645,659,N/A,23,2
41,N/A,N/A,N/A,604,645,N/A,27,6
7,N/A,N/A,N/A,597,604,N/A,33,0
26,N/A,N/A,N/A,571,597,N/A,37,4
13,N/A,N/A,N/A,558,571,N/A,40,1
26,N/A,N/A,N/A,532,558,N/A,43,4
23,N/A,N/A,N/A,509,532,N/A,49,4
22,N/A,N/A,N/A,487,509,N/A,55,4
21,N/A,N/A,N/A,466,487,N/A,60,3
21,N/A,N/A,N/A,445,466,N/A,66,3
15,N/A,N/A,N/A,430,445,N/A,71,2
41,N/A,N/A,N/A,389,430,N/A,75,6
27,N/A,N/A,N/A,362,389,N/A,79,4
11,N/A,N/A,N/A,351,362,N/A,83,2
35,N/A,N/A,N/A,316,351,N/A,86,5
16,N/A,N/A,N/A,300,316,N/A,90,3
15,N/A,N/A,N/A,285,300,N/A,96,3
14,N/A,N/A,N/A,271,285,N/A,101,2
43,N/A,N/A,N/A,228,271,N/A,105,6
7,N/A,N/A,N/A,221,228,N/A,111,0
25,N/A,N/A,N/A,196,221,N/A,115,4
19,N/A,N/A,N/A,177,196,N/A,120,3
41,N/A,N/A,N/A,136,177,N/A,123,6
30,N/A,N/A,N/A,106,136,N/A,127,4
24,N/A,N/A,N/A,1370,1394,N/A,3,4
22,N/A,N/A,N/A,1348,1370,N/A,9,4
19,N/A,N/A,N/A,1329,1348,N/A,14,3
16,N/A,N/A,N/A,1313,1329,N/A,20,3
13,N/A,N/A,N/A,1300,1313,N/A,25,2
36,N/A,N/A,N/A,1264,1300,N/A,28,5
22,N/A,N/A,N/A,1242,1264,N/A,33,4
30,N/A,N/A,N/A,1212,1242,N/A,39,4
7,N/A,N/A,N/A,1205,1212,N/A,42,1
14,N/A,N/A,N/A,1191,1205,N/A,48,1
12,N/A,N/A,N/A,1179,1191,N/A,54,1
8,N/A,N/A,N/A,1171,1179,N/A,60,1
39,N/A,N/A,N/A,1132,1171,N/A,64,5
36,N/A,N/A,N/A,1096,1132,N/A,70,5
25,N/A,N/A,N/A,1071,1096,N/A,75,4
27,N/A,N/A,N/A,1044,1071,N/A,81,4
22,N/A,N/A,N/A,1022,1044,N/A,87,4
9,N/A,N/A,N/A,1013,1022,N/A,90,1
36,N/A,N/A,N/A,977,1013,N/A,94,5
32,N/A,N/A,N/A,945,977,N/A,99,4
15,N/A,N/A,N/A,930,945,N/A,104,3
20,N/A,N/A,N/A,910,930,N/A,110,3
18,N/A,N/A,N/A,892,910,N/A,116,3
20,N/A,N/A,N/A,872,892,N/A,122,3
16,N/A,N/A,N/A,856,872,N/A,128,3
17,N/A,N/A,N/A,839,856,N/A,134,3
16,N/A,N/A,N/A,823,839,N/A,139,2
16,N/A,N/A,N/A,807,823,N/A,145,2
10,N/A,N/A,N/A,797,807,N/A,150,1
41,N/A,N/A,N/A,756,797,N/A,155,6
23,N/A,N/A,N/A,1513,1536,N/A,3,3
16,N/A,N/A,N/A,1497,1513,N/A,9,3
23,N/A,N/A,N/A,1474,1497,N/A,15,3
14,N/A,N/A,N/A,1460,1474,N/A,19,1
32,N/A,N/A,N/A,1428,1460,N/A,22,4
13,N/A,N/A,N/A,1415,1428,N/A,25,1
35,N/A,N/A,N/A,1380,1415,N/A,29,5
32,N/A,N/A,N/A,1348,1380,N/A,34,4
16,N/A,N/A,N/A,1332,1348,N/A,38,2
10,N/A,N/A,N/A,1322,1332,N/A,43,1
38,N/A,N/A,N/A,1284,1322,N/A,47,5
26,N/A,N/A,N/A,1258,1284,N/A,52,4
13,N/A,N/A,N/A,1245,1258,N/A,55,1
44,N/A,N/A,N/A,1201,1245,N/A,60,6
17,N/A,N/A,N/A,1184,1201,N/A,63,3
20,N/A,N/A,N/A,1164,1184,N/A,69,3
41,N/A,N/A,N/A,1123,1164,N/A,72,6
15,N/A,N/A,N/A,1108,1123,N/A,75,3
44,N/A,N/A,N/A,1064,1108,N/A,78,6
22,N/A,N/A,N/A,1042,1064,N/A,82,4
13,N/A,N/A,N/A,1029,1042,N/A,85,1
42,N/A,N/A,N/A,987,1029,N/A,90,6
7,N/A,N/A,N/A,980,987,N/A,96,0
15,N/A,N/A,N/A,965,980,N/A,99,3
42,N/A,N/A,N/A,923,965,N/A,102,6
32,N/A,N/A,N/A,891,923,N/A,107,5
15,N/A,N/A,N/A,876,891,N/A,110,2
42,N/A,N/A,N/A,834,876,N/A,114,6
14,N/A,N/A,N/A,820,834,N/A,117,3
17,N/A,N/A,N/A,803,820,N/A,122,2
34,N/A,N/A,N/A,541,575,N/A,4,5
16,N/A,N/A,N/A,525,541,N/A,7,2
43,N/A,N/A,N/A,482,525,N/A,11,6
19,N/A,N/A,N/A,463,482,N/A,14,3
41,N/A,N/A,N/A,422,463,N/A,17,6
9,N/A,N/A,N/A,413,422,N/A,23,0
42,N/A,N/A,N/A,371,413,N/A,29,6
22,N/A,N/A,N/A,349,371,N/A,32,3
17,N/A,N/A,N/A,332,349,N/A,38,3
21,N/A,N/A,N/A,311,332,N/A,44,3
42,N/A,N/A,N/A,269,311,N/A,47,6
35,N/A,N/A,N/A,234,269,N/A,52,5
32,N/A,N/A,N/A,202,234,N/A,57,4
13,N/A,N/A,N/A,189,202,N/A,61,2
35,N/A,N/A,N/A,154,189,N/A,64,5
37,N/A,N/A,N/A,117,154,N/A,70,5
37,N/A,N/A,N/A,80,117,N/A,76,5
35,N/A,N/A,N/A,45,80,N/A,82,5
13,N/A,N/A,N/A,32,45,N/A,85,2
43,N/A,N/A,N/A,-11,32,N/A,89,6
33,N/A,N/A,N/A,335,368,N/A,6,5
23,N/A,N/A,N/A,312,335,N/A,10,3
22,N/A,N/A,N/A,290,312,N/A,16,3
14,N/A,N/A,N/A,276,290,N/A,21,2
8,N/A,N/A,N/A,268,276,N/A,26,1
44,N/A,N/A,N/A,224,268,N/A,31,6
39,N/A,N/A,N/A,185,224,N/A,36,5
10,N/A,N/A,N/A,175,185,N/A,39,2
16,N/A,N/A,N/A,159,175,N/A,45,2
13,N/A,N/A,N/A,146,159,N/A,51,2
14,N/A,N/A,N/A,132,146,N/A,56,1
10,N/A,N/A,N/A,122,132,N/A,62,1
24,N/A,N/A,N/A,98,122,N/A,65,4
8,N/A,N/A,N/A,90,98,N/A,68,1
35,N/A,N/A,N/A,55,90,N/A,72,5
14,N/A,N/A,N/A,41,55,N/A,75,2
9,N/A,N/A,N/A,32,41,N/A,80,1
44,N/A,N/A,N/A,-12,32,N/A,85,6
13,N/A,N/A,N/A,374,387,N/A,4,1
14,N/A,N/A,N/A,360,374,N/A,10,1
32,N/A,N/A,N/A,328,360,N/A,14,5
15,N/A,N/A,N/A,313,328,N/A,17,2
11,N/A,N/A,N/A,302,313,N/A,22,1
32,N/A,N/A,N/A,270,302,N/A,26,5
12,N/A,N/A,N/A,258,270,N/A,29,2
38,N/A,N/A,N/A,220,258,N/A,32,5
14,N/A,N/A,N/A,206,220,N/A,35,2
14,N/A,N/A,N/A,192,206,N/A,40,1
24,N/A,N/A,N/A,168,192,N/A,43,4
12,N/A,N/A,N/A,156,168,N/A,47,2
9,N/A,N/A,N/A,147,156,N/A,52,1
42,N/A,N/A,N/A,105,147,N/A,57,6
9,N/A,N/A,N/A,96,105,N/A,63,0
42,N/A,N/A,N/A,54,96,N/A,69,6
20,N/A,N/A,N/A,34,54,N/A,72,3
19,N/A,N/A,N/A,15,34,N/A,78,3
43,N/A,N/A,N/A,-28,15,N/A,81,6
29,N/A,N/A,N/A,1227,1256,N/A,5,4
13,N/A,N/A,N/A,1214,1227,N/A,8,1
44,N/A,N/A,N/A,1170,1214,N/A,13,6
24,N/A,N/A,N/A,1146,1170,N/A,17,4
28,N/A,N/A,N/A,1118,1146,N/A,23,4
24,N/A,N/A,N/A,1094,1118,N/A,29,4
17,N/A,N/A,N/A,1077,1094,N/A,33,2
14,N/A,N/A,N/A,1063,1077,N/A,38,1
36,N/A,N/A,N/A,1027,1063,N/A,42,5
16,N/A,N/A,N/A,1011,1027,N/A,45,2
10,N/A,N/A,N/A,1001,1011,N/A,50,1
43,N/A,N/A,N/A,958,1001,N/A,55,6
23,N/A,N/A,N/A,935,958,N/A,59,4
13,N/A,N/A,N/A,922,935,N/A,62,1
43,N/A,N/A,N/A,879,922,N/A,67,6
20,N/A,N/A,N/A,859,879,N/A,70,3
13,N/A,N/A,N/A,846,859,N/A,74,1
35,N/A,N/A,N/A,811,846,N/A,78,5
35,N/A,N/A,N/A,776,811,N/A,84,5
33,N/A,N/A,N/A,743,776,N/A,90,5
28,N/A,N/A,N/A,715,743,N/A,95,4
14,N/A,N/A,N/A,701,715,N/A,100,3
15,N/A,N/A,N/A,686,701,N/A,106,3
7,N/A,N/A,N/A,679,686,N/A,110,1
14,N/A,N/A,N/A,665,679,N/A,116,1
29,N/A,N/A,N/A,636,665,N/A,119,4
10,N/A,N/A,N/A,626,636,N/A,122,1
44,N/A,N/A,N/A,582,626,N/A,127,6
23,N/A,N/A,N/A,559,582,N/A,130,3
23,N/A,N/A,N/A,536,559,N/A,136,3
25,N/A,N/A,N/A,962,987,N/A,4,4
25,N/A,N/A,N/A,937,962,N/A,10,4
14,N/A,N/A,N/A,923,937,N/A,13,1
13,N/A,N/A,N/A,910,923,N/A,19,1
13,N/A,N/A,N/A,897,910,N/A,25,1
7,N/A,N/A,N/A,890,897,N/A,31,1
13,N/A,N/A,N/A,877,890,N/A,37,1
22,N/A,N/A,N/A,855,877,N/A,40,4
8,N/A,N/A,N/A,847,855,N/A,43,1
7,N/A,N/A,N/A,840,847,N/A,49,1
33,N/A,N/A,N/A,807,840,N/A,53,5
31,N/A,N/A,N/A,776,807,N/A,58,4
13,N/A,N/A,N/A,763,776,N/A,62,2
43,N/A,N/A,N/A,720,763,N/A,66,6
14,N/A,N/A,N/A,706,720,N/A,69,3
13,N/A,N/A,N/A,693,706,N/A,73,1
34,N/A,N/A,N/A,659,693,N/A,77,5
33,N/A,N/A,N/A,626,659,N/A,83,5
36,N/A,N/A,N/A,590,626,N/A,89,5
23,N/A,N/A,N/A,567,590,N/A,94,4
9,N/A,N/A,N/A,558,567,N/A,97,1
43,N/A,N/A,N/A,515,558,N/A,102,6
6,N/A,N/A,N/A,509,515,N/A,108,0
28,N/A,N/A,N/A,481,509,N/A,112,4
15,N/A,N/A,N/A,466,481,N/A,116,2
16,N/A,N/A,N/A,450,466,N/A,122,2
37,N/A,N/A,N/A,413,450,N/A,125,5
25,N/A,N/A,N/A,388,413,N/A,130,4
11,N/A,N/A,N/A,377,388,N/A,133,1
7,N/A,N/A,N/A,370,377,N/A,139,1
36,N/A,N/A,N/A,751,787,N/A,4,5
32,N/A,N/A,N/A,719,751,N/A,10,5
17,N/A,N/A,N/A,702,719,N/A,14,3
10,N/A,N/A,N/A,692,702,N/A,19,2
44,N/A,N/A,N/A,648,692,N/A,23,6
30,N/A,N/A,N/A,618,648,N/A,27,4
10,N/A,N/A,N/A,608,618,N/A,31,2
41,N/A,N/A,N/A,567,608,N/A,35,6
16,N/A,N/A,N/A,551,567,N/A,38,3
41,N/A,N/A,N/A,510,551,N/A,41,6
6,N/A,N/A,N/A,504,510,N/A,47,0
33,N/A,N/A,N/A,471,504,N/A,52,5
21,N/A,N/A,N/A,450,471,N/A,56,3
42,N/A,N/A,N/A,408,450,N/A,59,6
25,N/A,N/A,N/A,383,408,N/A,63,4
16,N/A,N/A,N/A,367,383,N/A,68,3
13,N/A,N/A,N/A,354,367,N/A,72,1
30,N/A,N/A,N/A,324,354,N/A,75,4
22,N/A,N/A,N/A,302,324,N/A,80,3
12,N/A,N/A,N/A,290,302,N/A,85,2
32,N/A,N/A,N/A,258,290,N/A,88,5
22,N/A,N/A,N/A,236,258,N/A,93,4
14,N/A,N/A,N/A,222,236,N/A,97,2
12,N/A,N/A,N/A,210,222,N/A,102,1
39,N/A,N/A,N/A,171,210,N/A,106,5
15,N/A,N/A,N/A,156,171,N/A,109,2
12,N/A,N/A,N/A,144,156,N/A,114,1
35,N/A,N/A,N/A,109,144,N/A,118,5
11,N/A,N/A,N/A,98,109,N/A,121,2
33,N/A,N/A,N/A,65,98,N/A,124,5
42,N/A,N/A,N/A,1327,1369,N/A,4,6
39,N/A,N/A,N/A,1288,1327,N/A,9,5
15,N/A,N/A,N/A,1273,1288,N/A,13,3
15,N/A,N/A,N/A,1258,1273,N/A,18,2
8,N/A,N/A,N/A,1250,1258,N/A,23,1
11,N/A,N/A,N/A,1239,1250,N/A,29,1
8,N/A,N/A,N/A,1231,1239,N/A,35,1
43,N/A,N/A,N/A,1188,1231,N/A,40,6
33,N/A,N/A,N/A,1155,1188,N/A,45,5
26,N/A,N/A,N/A,1129,1155,N/A,50,4
14,N/A,N/A,N/A,1115,1129,N/A,53,1
33,N/A,N/A,N/A,1082,1115,N/A,57,5
33,N/A,N/A,N/A,1049,1082,N/A,63,5
35,N/A,N/A,N/A,1014,1049,N/A,69,5
22,N/A,N/A,N/A,992,1014,N/A,74,4
11,N/A,N/A,N/A,981,992,N/A,78,2
12,N/A,N/A,N/A,969,981,N/A,84,2
44,N/A,N/A,N/A,925,969,N/A,88,6
32,N/A,N/A,N/A,893,925,N/A,93,5
21,N/A,N/A,N/A,872,893,N/A,97,3
13,N/A,N/A,N/A,859,872,N/A,101,1
13,N/A,N/A,N/A,846,859,N/A,107,1
12,N/A,N/A,N/A,834,846,N/A,113,1
29,N/A,N/A,N/A,805,834,N/A,116,4
17,N/A,N/A,N/A,788,805,N/A,121,3
12,N/A,N/A,N/A,776,788,N/A,125,1
41,N/A,N/A,N/A,735,776,N/A,130,6
33,N/A,N/A,N/A,702,735,N/A,135,5
27,N/A,N/A,N/A,675,702,N/A,140,4
16,N/A,N/A,N/A,659,675,N/A,145,3
31,N/A,N/A,N/A,370,401,N/A,4,4
11,N/A,N/A,N/A,359,370,N/A,7,1
12,N/A,N/A,N/A,347,359,N/A,13,1
43,N/A,N/A,N/A,304,347,N/A,18,6
17,N/A,N/A,N/A,287,304,N/A,21,3
42,N/A,N/A,N/A,245,287,N/A,24,6
33,N/A,N/A,N/A,212,245,N/A,29,5
14,N/A,N/A,N/A,198,212,N/A,32,2
13,N/A,N/A,N/A,185,198,N/A,38,2
42,N/A,N/A,N/A,143,185,N/A,42,6
16,N/A,N/A,N/A,127,143,N/A,45,3
41,N/A,N/A,N/A,86,127,N/A,48,6
38,N/A,N/A,N/A,48,86,N/A,53,5
18,N/A,N/A,N/A,30,48,N/A,57,3
22,N/A,N/A,N/A,8,30,N/A,63,3
44,N/A,N/A,N/A,-36,8,N/A,66,6
11,N/A,N/A,N/A,618,629,N/A,4,1
44,N/A,N/A,N/A,574,618,N/A,9,6
23,N/A,N/A,N/A,551,574,N/A,12,3
13,N/A,N/A,N/A,538,551,N/A,17,2
36,N/A,N/A,N/A,502,538,N/A,20,5
14,N/A,N/A,N/A,488,502,N/A,23,2
13,N/A,N/A,N/A,475,488,N/A,29,2
13,N/A,N/A,N/A,462,475,N/A,34,1
14,N/A,N/A,N/A,448,462,N/A,40,1
29,N/A,N/A,N/A,419,448,N/A,43,4
11,N/A,N/A,N/A,408,419,N/A,46,1
11,N/A,N/A,N/A,397,408,N/A,52,1
29,N/A,N/A,N/A,368,397,N/A,55,4
8,N/A,N/A,N/A,360,368,N/A,58,1
31,N/A,N/A,N/A,329,360,N/A,61,4
15,N/A,N/A,N/A,314,329,N/A,65,2
36,N/A,N/A,N/A,278,314,N/A,68,5
25,N/A,N/A,N/A,253,278,N/A,73,4
13,N/A,N/A,N/A,240,253,N/A,77,2
35,N/A,N/A,N/A,205,240,N/A,80,5
39,N/A,N/A,N/A,166,205,N/A,86,5
19,N/A,N/A,N/A,147,166,N/A,90,3
42,N/A,N/A,N/A,105,147,N/A,93,6
8,N/A,N/A,N/A,97,105,N/A,99,0
23,N/A,N/A,N/A,74,97,N/A,103,4
14,N/A,N/A,N/A,60,74,N/A,108,3
42,N/A,N/A,N/A,18,60,N/A,111,6
23,N/A,N/A,N/A,-5,18,N/A,115,4
16,N/A,N/A,N/A,1155,1171,N/A,5,2
44,N/A,N/A,N/A,1111,1155,N/A,9,6
26,N/A,N/A,N/A,1085,1111,N/A,13,4
10,N/A,N/A,N/A,1075,1085,N/A,17,2
15,N/A,N/A,N/A,1060,1075,N/A,23,2
44,N/A,N/A,N/A,1016,1060,N/A,27,6
19,N/A,N/A,N/A,997,1016,N/A,30,3
19,N/A,N/A,N/A,978,997,N/A,36,3
14,N/A,N/A,N/A,964,978,N/A,42,3
10,N/A,N/A,N/A,954,964,N/A,46,1
29,N/A,N/A,N/A,925,954,N/A,49,4
17,N/A,N/A,N/A,908,925,N/A,53,2
7,N/A,N/A,N/A,901,908,N/A,58,1
9,N/A,N/A,N/A,892,901,N/A,64,1
41,N/A,N/A,N/A,851,892,N/A,69,6
9,N/A,N/A,N/A,842,851,N/A,75,0
39,N/A,N/A,N/A,803,842,N/A,80,5
38,N/A,N/A,N/A,765,803,N/A,86,5
22,N/A,N/A,N/A,743,765,N/A,90,3
11,N/A,N/A,N/A,732,743,N/A,95,2
43,N/A,N/A,N/A,689,732,N/A,99,6
36,N/A,N/A,N/A,653,689,N/A,104,5
34,N/A,N/A,N/A,619,653,N/A,110,5
23,N/A,N/A,N/A,596,619,N/A,114,3
14,N/A,N/A,N/A,582,596,N/A,119,2
7,N/A,N/A,N/A,575,582,N/A,124,1
14,N/A,N/A,N/A,561,575,N/A,130,1
26,N/A,N/A,N/A,535,561,N/A,133,4
16,N/A,N/A,N/A,519,535,N/A,137,2
14,N/A,N/A,N/A,505,519,N/A,142,1
14,N/A,N/A,N/A,954,968,N/A,6,1
24,N/A,N/A,N/A,930,954,N/A,9,4
24,N/A,N/A,N/A,906,930,N/A,15,4
7,N/A,N/A,N/A,899,906,N/A,18,1
9,N/A,N/A,N/A,890,899,N/A,24,1
7,N/A,N/A,N/A,883,890,N/A,30,1
28,N/A,N/A,N/A,855,883,N/A,33,4
12,N/A,N/A,N/A,843,855,N/A,36,1
38,N/A,N/A,N/A,805,843,N/A,40,5
28,N/A,N/A,N/A,777,805,N/A,45,4
13,N/A,N/A,N/A,764,777,N/A,49,2
12,N/A,N/A,N/A,752,764,N/A,54,1
7,N/A,N/A,N/A,745,752,N/A,60,1
37,N/A,N/A,N/A,708,745,N/A,64,5
26,N/A,N/A,N/A,682,708,N/A,69,4
21,N/A,N/A,N/A,661,682,N/A,74,3
19,N/A,N/A,N/A,642,661,N/A,80,3
44,N/A,N/A,N/A,598,642,N/A,83,6
8,N/A,N/A,N/A,590,598,N/A,89,0
28,N/A,N/A,N/A,562,590,N/A,93,4
16,N/A,N/A,N/A,546,562,N/A,97,2
42,N/A,N/A,N/A,504,546,N/A,101,6
24,N/A,N/A,N/A,480,504,N/A,105,4
30,N/A,N/A,N/A,450,480,N/A,111,4
22,N/A,N/A,N/A,428,450,N/A,116,3
12,N/A,N/A,N/A,416,428,N/A,120,1
44,N/A,N/A,N/A,372,416,N/A,125,6
7,N/A,N/A,N/A,365,372,N/A,131,0
41,N/A,N/A,N/A,324,365,N/A,137,6
22,N/A,N/A,N/A,302,324,N/A,140,3
27,N/A,N/A,N/A,1181,1208,N/A,4,4
10,N/A,N/A,N/A,1171,1181,N/A,7,1
39,N/A,N/A,N/A,1132,1171,N/A,11,5
24,N/A,N/A,N/A,1108,1132,N/A,16,4
32,N/A,N/A,N/A,1076,1108,N/A,22,4
31,N/A,N/A,N/A,1045,1076,N/A,28,4
8,N/A,N/A,N/A,1037,1045,N/A,31,1
43,N/A,N/A,N/A,994,1037,N/A,36,6
30,N/A,N/A,N/A,964,994,N/A,40,4
21,N/A,N/A,N/A,943,964,N/A,45,3
42,N/A,N/A,N/A,901,943,N/A,48,6
23,N/A,N/A,N/A,878,901,N/A,52,4
10,N/A,N/A,N/A,868,878,N/A,56,2
44,N/A,N/A,N/A,824,868,N/A,60,6
37,N/A,N/A,N/A,787,824,N/A,65,5
18,N/A,N/A,N/A,769,787,N/A,69,3
11,N/A,N/A,N/A,758,769,N/A,74,2
9,N/A,N/A,N/A,749,758,N/A,79,1
34,N/A,N/A,N/A,715,749,N/A,83,5
34,N/A,N/A,N/A,681,715,N/A,89,5
25,N/A,N/A,N/A,656,681,N/A,94,4
14,N/A,N/A,N/A,642,656,N/A,97,1
8,N/A,N/A,N/A,634,642,N/A,103,1
37,N/A,N/A,N/A,597,634,N/A,107,5
20,N/A,N/A,N/A,577,597,N/A,111,3
7,N/A,N/A,N/A,570,577,N/A,115,1
43,N/A,N/A,N/A,527,570,N/A,120,6
34,N/A,N/A,N/A,493,527,N/A,125,5
39,N/A,N/A,N/A,454,493,N/A,131,5
22,N/A,N/A,N/A,432,454,N/A,135,3
22,N/A,N/A,N/A,1913,1935,N/A,6,4
12,N/A,N/A,N/A,1901,1913,N/A,9,1
37,N/A,N/A,N/A,1864,1901,N/A,13,5
28,N/A,N/A,N/A,1836,1864,N/A,18,4
27,N/A,N/A,N/A,1809,1836,N/A,24,4
16,N/A,N/A,N/A,1793,1809,N/A,28,2
33,N/A,N/A,N/A,1760,1793,N/A,31,5
15,N/A,N/A,N/A,1745,1760,N/A,35,3
15,N/A,N/A,N/A,1730,1745,N/A,40,2
44,N/A,N/A,N/A,1686,1730,N/A,44,6
21,N/A,N/A,N/A,1665,1686,N/A,47,3
44,N/A,N/A,N/A,1621,1665,N/A,50,6
15,N/A,N/A,N/A,1606,1621,N/A,53,3
17,N/A,N/A,N/A,1589,1606,N/A,59,3
9,N/A,N/A,N/A,1580,1589,N/A,63,1
29,N/A,N/A,N/A,1551,1580,N/A,66,4
14,N/A,N/A,N/A,1537,1551,N/A,70,2
10,N/A,N/A,N/A,1527,1537,N/A,76,2
12,N/A,N/A,N/A,1515,1527,N/A,82,2
17,N/A,N/A,N/A,1498,1515,N/A,88,2
36,N/A,N/A,N/A,1462,1498,N/A,91,5
23,N/A,N/A,N/A,1439,1462,N/A,95,3
16,N/A,N/A,N/A,1423,1439,N/A,101,3
43,N/A,N/A,N/A,1380,1423,N/A,104,6
26,N/A,N/A,N/A,1354,1380,N/A,108,4
14,N/A,N/A,N/A,1340,1354,N/A,111,1
22,N/A,N/A,N/A,1318,1340,N/A,114,4
30,N/A,N/A,N/A,1288,1318,N/A,120,4
22,N/A,N/A,N/A,1266,1288,N/A,126,4
11,N/A,N/A,N/A,1255,1266,N/A,130,2
23,N/A,N/A,N/A,1759,1782,N/A,6,3
44,N/A,N/A,N/A,1715,1759,N/A,9,6
7,N/A,N/A,N/A,1708,1715,N/A,15,0
18,N/A,N/A,N/A,1690,1708,N/A,18,3
17,N/A,N/A,N/A,1673,1690,N/A,24,3
41,N/A,N/A,N/A,1632,1673,N/A,27,6
8,N/A,N/A,N/A,1624,1632,N/A,33,0
22,N/A,N/A,N/A,1602,1624,N/A,37,4
12,N/A,N/A,N/A,1590,1602,N/A,41,2
42,N/A,N/A,N/A,1548,1590,N/A,45,6
18,N/A,N/A,N/A,1530,1548,N/A,48,3
41,N/A,N/A,N/A,1489,1530,N/A,51,6
35,N/A,N/A,N/A,1454,1489,N/A,56,5
15,N/A,N/A,N/A,1439,1454,N/A,59,2
32,N/A,N/A,N/A,1407,1439,N/A,62,5
19,N/A,N/A,N/A,1388,1407,N/A,66,3
7,N/A,N/A,N/A,1381,1388,N/A,70,1
11,N/A,N/A,N/A,1370,1381,N/A,76,1
42,N/A,N/A,N/A,1328,1370,N/A,81,6
23,N/A,N/A,N/A,1305,1328,N/A,84,3
14,N/A,N/A,N/A,1291,1305,N/A,88,1
44,N/A,N/A,N/A,1247,1291,N/A,93,6
20,N/A,N/A,N/A,1227,1247,N/A,96,3
13,N/A,N/A,N/A,1214,1227,N/A,100,1
24,N/A,N/A,N/A,1190,1214,N/A,103,4
7,N/A,N/A,N/A,1183,1190,N/A,106,1
43,N/A,N/A,N/A,1140,1183,N/A,111,6
36,N/A,N/A,N/A,1104,1140,N/A,116,5
32,N/A,N/A,N/A,1072,1104,N/A,122,5
12,N/A,N/A,N/A,1060,1072,N/A,125,2
9,N/A,N/A,N/A,1226,1235,N/A,4,1
38,N/A,N/A,N/A,1188,1226,N/A,8,5
33,N/A,N/A,N/A,1155,1188,N/A,14,5
16,N/A,N/A,N/A,1139,1155,N/A,17,2
12,N/A,N/A,N/A,1127,1139,N/A,23,2
12,N/A,N/A,N/A,1115,1127,N/A,29,2
38,N/A,N/A,N/A,1077,1115,N/A,32,5
28,N/A,N/A,N/A,1049,1077,N/A,37,4
12,N/A,N/A,N/A,1037,1049,N/A,40,1
25,N/A,N/A,N/A,1012,1037,N/A,43,4
10,N/A,N/A,N/A,1002,1012,N/A,46,1
38,N/A,N/A,N/A,964,1002,N/A,50,5
38,N/A,N/A,N/A,926,964,N/A,56,5
32,N/A,N/A,N/A,894,926,N/A,62,5
28,N/A,N/A,N/A,866,894,N/A,67,4
31,N/A,N/A,N/A,835,866,N/A,73,4
13,N/A,N/A,N/A,822,835,N/A,77,2
41,N/A,N/A,N/A,781,822,N/A,81,6
29,N/A,N/A,N/A,752,781,N/A,85,4
32,N/A,N/A,N/A,720,752,N/A,91,4
12,N/A,N/A,N/A,708,720,N/A,94,1
32,N/A,N/A,N/A,676,708,N/A,97,4
13,N/A,N/A,N/A,663,676,N/A,100,1
42,N/A,N/A,N/A,621,663,N/A,105,6
8,N/A,N/A,N/A,613,621,N/A,111,0
21,N/A,N/A,N/A,592,613,N/A,114,3
8,N/A,N/A,N/A,584,592,N/A,118,1
39,N/A,N/A,N/A,545,584,N/A,122,5
15,N/A,N/A,N/A,530,545,N/A,125,2
14,N/A,N/A,N/A,516,530,N/A,131,2
42,N/A,N/A,N/A,1574,1616,N/A,6,6
32,N/A,N/A,N/A,1542,1574,N/A,11,5
28,N/A,N/A,N/A,1514,1542,N/A,16,4
27,N/A,N/A,N/A,1487,1514,N/A,22,4
23,N/A,N/A,N/A,1464,1487,N/A,28,4
19,N/A,N/A,N/A,1445,1464,N/A,33,3
7,N/A,N/A,N/A,1438,1445,N/A,37,1
25,N/A,N/A,N/A,1413,1438,N/A,40,4
16,N/A,N/A,N/A,1397,1413,N/A,45,3
11,N/A,N/A,N/A,1386,1397,N/A,49,1
43,N/A,N/A,N/A,1343,1386,N/A,54,6
37,N/A,N/A,N/A,1306,1343,N/A,59,5
15,N/A,N/A,N/A,1291,1306,N/A,62,2
13,N/A,N/A,N/A,1278,1291,N/A,67,1
23,N/A,N/A,N/A,1255,1278,N/A,70,4
22,N/A,N/A,N/A,1233,1255,N/A,75,3
8,N/A,N/A,N/A,1225,1233,N/A,79,1
14,N/A,N/A,N/A,1211,1225,N/A,85,1
44,N/A,N/A,N/A,1167,1211,N/A,90,6
35,N/A,N/A,N/A,1132,1167,N/A,95,5
23,N/A,N/A,N/A,1109,1132,N/A,99,3
41,N/A,N/A,N/A,1068,1109,N/A,102,6
21,N/A,N/A,N/A,1047,1068,N/A,105,3
15,N/A,N/A,N/A,1032,1047,N/A,111,3
8,N/A,N/A,N/A,1024,1032,N/A,115,1
44,N/A,N/A,N/A,980,1024,N/A,120,6
32,N/A,N/A,N/A,948,980,N/A,124,4
24,N/A,N/A,N/A,924,948,N/A,130,4
8,N/A,N/A,N/A,916,924,N/A,133,1
41,N/A,N/A,N/A,875,916,N/A,138,6
15,N/A,N/A,N/A,1448,1463,N/A,4,3
17,N/A,N/A,N/A,1431,1448,N/A,10,3
44,N/A,N/A,N/A,1387,1431,N/A,13,6
15,N/A,N/A,N/A,1372,1387,N/A,16,3
41,N/A,N/A,N/A,1331,1372,N/A,19,6
6,N/A,N/A,N/A,1325,1331,N/A,25,0
19,N/A,N/A,N/A,1306,1325,N/A,28,3
12,N/A,N/A,N/A,1294,1306,N/A,33,2
42,N/A,N/A,N/A,1252,1294,N/A,37,6
39,N/A,N/A,N/A,1213,1252,N/A,42,5
32,N/A,N/A,N/A,1181,1213,N/A,47,4
11,N/A,N/A,N/A,1170,1181,N/A,50,1
38,N/A,N/A,N/A,1132,1170,N/A,54,5
15,N/A,N/A,N/A,1117,1132,N/A,57,2
12,N/A,N/A,N/A,1105,1117,N/A,63,2
41,N/A,N/A,N/A,1064,1105,N/A,67,6
17,N/A,N/A,N/A,1047,1064,N/A,70,3
43,N/A,N/A,N/A,1004,1047,N/A,73,6
18,N/A,N/A,N/A,986,1004,N/A,76,3
17,N/A,N/A,N/A,969,986,N/A,81,2
41,N/A,N/A,N/A,928,969,N/A,85,6
16,N/A,N/A,N/A,912,928,N/A,88,3
17,N/A,N/A,N/A,895,912,N/A,93,2
14,N/A,N/A,N/A,881,895,N/A,98,1
28,N/A,N/A,N/A,853,881,N/A,101,4
22,N/A,N/A,N/A,831,853,N/A,107,4
11,N/A,N/A,N/A,820,831,N/A,111,2
36,N/A,N/A,N/A,784,820,N/A,114,5
15,N/A,N/A,N/A,769,784,N/A,118,3
10,N/A,N/A,N/A,759,769,N/A,122,1
11,N/A,N/A,N/A,973,984,N/A,6,1
13,N/A,N/A,N/A,960,973,N/A,12,1
38,N/A,N/A,N/A,922,960,N/A,16,5
34,N/A,N/A,N/A,888,922,N/A,22,5
15,N/A,N/A,N/A,873,888,N/A,25,2
14,N/A,N/A,N/A,859,873,N/A,30,1
44,N/A,N/A,N/A,815,859,N/A,35,6
9,N/A,N/A,N/A,806,815,N/A,41,0
32,N/A,N/A,N/A,774,806,N/A,46,5
25,N/A,N/A,N/A,749,774,N/A,51,4
13,N/A,N/A,N/A,736,749,N/A,55,2
34,N/A,N/A,N/A,702,736,N/A,58,5
18,N/A,N/A,N/A,684,702,N/A,62,3
18,N/A,N/A,N/A,666,684,N/A,68,3
23,N/A,N/A,N/A,643,666,N/A,74,3
13,N/A,N/A,N/A,630,643,N/A,79,2
13,N/A,N/A,N/A,617,630,N/A,85,2
10,N/A,N/A,N/A,607,617,N/A,90,1
42,N/A,N/A,N/A,565,607,N/A,95,6
19,N/A,N/A,N/A,546,565,N/A,98,3
16,N/A,N/A,N/A,530,546,N/A,103,2
7,N/A,N/A,N/A,523,530,N/A,108,1
14,N/A,N/A,N/A,509,523,N/A,114,1
23,N/A,N/A,N/A,486,509,N/A,117,4
13,N/A,N/A,N/A,473,486,N/A,120,1
26,N/A,N/A,N/A,447,473,N/A,123,4
25,N/A,N/A,N/A,422,447,N/A,129,4
28,N/A,N/A,N/A,394,422,N/A,135,4
13,N/A,N/A,N/A,381,394,N/A,139,2
15,N/A,N/A,N/A,366,381,N/A,145,2
32,N/A,N/A,N/A,1621,1653,N/A,4,5
10,N/A,N/A,N/A,1611,1621,N/A,7,2
11,N/A,N/A,N/A,1600,1611,N/A,12,1
29,N/A,N/A,N/A,1571,1600,N/A,15,4
7,N/A,N/A,N/A,1564,1571,N/A,18,1
37,N/A,N/A,N/A,1527,1564,N/A,22,5
23,N/A,N/A,N/A,1504,1527,N/A,26,3
16,N/A,N/A,N/A,1488,1504,N/A,32,3
17,N/A,N/A,N/A,1471,1488,N/A,37,2
39,N/A,N/A,N/A,1432,1471,N/A,40,5
17,N/A,N/A,N/A,1415,1432,N/A,44,3
8,N/A,N/A,N/A,1407,1415,N/A,48,1
35,N/A,N/A,N/A,1372,1407,N/A,52,5
25,N/A,N/A,N/A,1347,1372,N/A,57,4
13,N/A,N/A,N/A,1334,1347,N/A,61,2
36,N/A,N/A,N/A,1298,1334,N/A,64,5
14,N/A,N/A,N/A,1284,1298,N/A,67,2
16,N/A,N/A,N/A,1268,1284,N/A,73,2
41,N/A,N/A,N/A,1227,1268,N/A,77,6
23,N/A,N/A,N/A,1204,1227,N/A,80,3
44,N/A,N/A,N/A,1160,1204,N/A,83,6
19,N/A,N/A,N/A,1141,1160,N/A,86,3
44,N/A,N/A,N/A,1097,1141,N/A,89,6
36,N/A,N/A,N/A,1061,1097,N/A,94,5
27,N/A,N/A,N/A,1034,1061,N/A,99,4
14,N/A,N/A,N/A,1020,1034,N/A,103,2
32,N/A,N/A,N/A,988,1020,N/A,106,5
14,N/A,N/A,N/A,974,988,N/A,110,3
44,N/A,N/A,N/A,930,974,N/A,113,6
23,N/A,N/A,N/A,907,930,N/A,117,4
38,N/A,N/A,N/A,933,971,N/A,4,5
32,N/A,N/A,N/A,901,933,N/A,10,5
27,N/A,N/A,N/A,874,901,N/A,15,4
7,N/A,N/A,N/A,867,874,N/A,18,1
23,N/A,N/A,N/A,844,867,N/A,21,4
14,N/A,N/A,N/A,830,844,N/A,24,1
43,N/A,N/A,N/A,787,830,N/A,29,6
26,N/A,N/A,N/A,761,787,N/A,33,4
18,N/A,N/A,N/A,743,761,N/A,38,3
15,N/A,N/A,N/A,728,743,N/A,43,2
14,N/A,N/A,N/A,714,728,N/A,48,1
39,N/A,N/A,N/A,675,714,N/A,52,5
29,N/A,N/A,N/A,646,675,N/A,57,4
8,N/A,N/A,N/A,638,646,N/A,60,1
44,N/A,N/A,N/A,594,638,N/A,65,6
25,N/A,N/A,N/A,569,594,N/A,69,4
21,N/A,N/A,N/A,548,569,N/A,74,3
15,N/A,N/A,N/A,533,548,N/A,79,2
43,N/A,N/A,N/A,490,533,N/A,83,6
8,N/A,N/A,N/A,482,490,N/A,89,0
41,N/A,N/A,N/A,441,482,N/A,95,6
7,N/A,N/A,N/A,434,441,N/A,101,0
42,N/A,N/A,N/A,392,434,N/A,107,6
32,N/A,N/A,N/A,360,392,N/A,111,4
22,N/A,N/A,N/A,338,360,N/A,116,3
42,N/A,N/A,N/A,296,338,N/A,119,6
23,N/A,N/A,N/A,273,296,N/A,122,3
13,N/A,N/A,N/A,260,273,N/A,127,2
11,N/A,N/A,N/A,249,260,N/A,132,1
39,N/A,N/A,N/A,210,249,N/A,136,5
43,N/A,N/A,N/A,1743,1786,N/A,6,6
17,N/A,N/A,N/A,1726,1743,N/A,9,3
18,N/A,N/A,N/A,1708,1726,N/A,15,3
44,N/A,N/A,N/A,1664,1708,N/A,18,6
8,N/A,N/A,N/A,1656,1664,N/A,24,0
41,N/A,N/A,N/A,1615,1656,N/A,30,6
24,N/A,N/A,N/A,1591,1615,N/A,34,4
27,N/A,N/A,N/A,1564,1591,N/A,40,4
32,N/A,N/A,N/A,1532,1564,N/A,46,4
24,N/A,N/A,N/A,1508,1532,N/A,52,4
11,N/A,N/A,N/A,1497,1508,N/A,56,2
11,N/A,N/A,N/A,1486,1497,N/A,62,2
13,N/A,N/A,N/A,1473,1486,N/A,67,1
24,N/A,N/A,N/A,1449,1473,N/A,70,4
9,N/A,N/A,N/A,1440,1449,N/A,73,1
37,N/A,N/A,N/A,1403,1440,N/A,77,5
36,N/A,N/A,N/A,1367,1403,N/A,83,5
22,N/A,N/A,N/A,1345,1367,N/A,88,4
15,N/A,N/A,N/A,1330,1345,N/A,93,3
41,N/A,N/A,N/A,1289,1330,N/A,96,6
5,N/A,N/A,N/A,1284,1289,N/A,102,0
28,N/A,N/A,N/A,1256,1284,N/A,106,4
9,N/A,N/A,N/A,1247,1256,N/A,109,1
28,N/A,N/A,N/A,1219,1247,N/A,112,4
9,N/A,N/A,N/A,1210,1219,N/A,115,1
39,N/A,N/A,N/A,1171,1210,N/A,119,5
14,N/A,N/A,N/A,1157,1171,N/A,122,2
44,N/A,N/A,N/A,1113,1157,N/A,126,6
23,N/A,N/A,N/A,1090,1113,N/A,130,4
7,N/A,N/A,N/A,1083,1090,N/A,133,1
39,N/A,N/A,N/A,713,752,N/A,6,5
23,N/A,N/A,N/A,690,713,N/A,11,4
15,N/A,N/A,N/A,675,690,N/A,16,3
43,N/A,N/A,N/A,632,675,N/A,19,6
8,N/A,N/A,N/A,624,632,N/A,25,0
26,N/A,N/A,N/A,598,624,N/A,29,4
14,N/A,N/A,N/A,584,598,N/A,32,1
34,N/A,N/A,N/A,550,584,N/A,36,5
16,N/A,N/A,N/A,534,550,N/A,39,2
7,N/A,N/A,N/A,527,534,N/A,44,1
7,N/A,N/A,N/A,520,527,N/A,50,1
11,N/A,N/A,N/A,509,520,N/A,56,1
29,N/A,N/A,N/A,480,509,N/A,59,4
13,N/A,N/A,N/A,467,480,N/A,62,1
32,N/A,N/A,N/A,435,467,N/A,66,5
32,N/A,N/A,N/A,403,435,N/A,72,5
25,N/A,N/A,N/A,378,403,N/A,77,4
9,N/A,N/A,N/A,369,378,N/A,80,1
37,N/A,N/A,N/A,332,369,N/A,84,5
19,N/A,N/A,N/A,313,332,N/A,88,3
15,N/A,N/A,N/A,298,313,N/A,94,3
16,N/A,N/A,N/A,282,298,N/A,99,2
34,N/A,N/A,N/A,248,282,N/A,102,5
34,N/A,N/A,N/A,214,248,N/A,108,5
23,N/A,N/A,N/A,191,214,N/A,112,3
17,N/A,N/A,N/A,174,191,N/A,117,2
13,N/A,N/A,N/A,161,174,N/A,122,1
41,N/A,N/A,N/A,120,161,N/A,127,6
25,N/A,N/A,N/A,95,120,N/A,131,4
10,N/A,N/A,N/A,85,95,N/A,134,1
34,N/A,N/A,N/A,514,548,N/A,3,5
23,N/A,N/A,N/A,491,514,N/A,7,3
12,N/A,N/A,N/A,479,491,N/A,11,1
34,N/A,N/A,N/A,445,479,N/A,15,5
19,N/A,N/A,N/A,426,445,N/A,19,3
14,N/A,N/A,N/A,412,426,N/A,25,3
11,N/A,N/A,N/A,401,412,N/A,29,1
12,N/A,N/A,N/A,389,401,N/A,35,1
29,N/A,N/A,N/A,360,389,N/A,38,4
16,N/A,N/A,N/A,344,360,N/A,43,3
41,N/A,N/A,N/A,303,344,N/A,46,6
24,N/A,N/A,N/A,279,303,N/A,50,4
14,N/A,N/A,N/A,265,279,N/A,53,1
42,N/A,N/A,N/A,223,265,N/A,58,6
7,N/A,N/A,N/A,216,223,N/A,64,0
23,N/A,N/A,N/A,193,216,N/A,67,3
12,N/A,N/A,N/A,181,193,N/A,71,1
26,N/A,N/A,N/A,155,181,N/A,74,4
15,N/A,N/A,N/A,140,155,N/A,79,3
15,N/A,N/A,N/A,125,140,N/A,84,2
11,N/A,N/A,N/A,114,125,N/A,89,1
14,N/A,N/A,N/A,100,114,N/A,95,1
14,N/A,N/A,N/A,86,100,N/A,101,1
26,N/A,N/A,N/A,60,86,N/A,104,4
30,N/A,N/A,N/A,30,60,N/A,110,4
11,N/A,N/A,N/A,19,30,N/A,113,1
14,N/A,N/A,N/A,5,19,N/A,119,1
32,N/A,N/A,N/A,-27,5,N/A,122,4
23,N/A,N/A,N/A,461,484,N/A,6,4
13,N/A,N/A,N/A,448,461,N/A,10,2
42,N/A,N/A,N/A,406,448,N/A,14,6
9,N/A,N/A,N/A,397,406,N/A,20,0
27,N/A,N/A,N/A,370,397,N/A,24,4
17,N/A,N/A,N/A,353,370,N/A,28,2
12,N/A,N/A,N/A,341,353,N/A,34,2
33,N/A,N/A,N/A,308,341,N/A,37,5
28,N/A,N/A,N/A,280,308,N/A,42,4
30,N/A,N/A,N/A,250,280,N/A,48,4
7,N/A,N/A,N/A,243,250,N/A,51,1
41,N/A,N/A,N/A,202,243,N/A,56,6
14,N/A,N/A,N/A,188,202,N/A,59,3
15,N/A,N/A,N/A,173,188,N/A,64,2
16,N/A,N/A,N/A,157,173,N/A,70,2
14,N/A,N/A,N/A,143,157,N/A,76,2
8,N/A,N/A,N/A,135,143,N/A,81,1
34,N/A,N/A,N/A,101,135,N/A,85,5
15,N/A,N/A,N/A,86,101,N/A,88,2
11,N/A,N/A,N/A,75,86,N/A,93,1
23,N/A,N/A,N/A,52,75,N/A,96,4
23,N/A,N/A,N/A,29,52,N/A,101,3
11,N/A,N/A,N/A,18,29,N/A,106,2
14,N/A,N/A,N/A,4,18,N/A,111,1
29,N/A,N/A,N/A,-25,4,N/A,114,4
12,N/A,N/A,N/A,677,689,N/A,5,1
13,N/A,N/A,N/A,664,677,N/A,11,1
38,N/A,N/A,N/A,626,664,N/A,15,5
29,N/A,N/A,N/A,597,626,N/A,20,4
20,N/A,N/A,N/A,577,597,N/A,25,3
9,N/A,N/A,N/A,568,577,N/A,29,1
22,N/A,N/A,N/A,546,568,N/A,32,4
15,N/A,N/A,N/A,531,546,N/A,37,3
22,N/A,N/A,N/A,509,531,N/A,43,3
44,N/A,N/A,N/A,465,509,N/A,46,6
23,N/A,N/A,N/A,442,465,N/A,49,3
9,N/A,N/A,N/A,433,442,N/A,53,1
11,N/A,N/A,N/A,422,433,N/A,59,1
42,N/A,N/A,N/A,380,422,N/A,64,6
9,N/A,N/A,N/A,371,380,N/A,70,0
30,N/A,N/A,N/A,341,371,N/A,74,4
10,N/A,N/A,N/A,331,341,N/A,77,1
23,N/A,N/A,N/A,308,331,N/A,80,4
15,N/A,N/A,N/A,293,308,N/A,85,3
41,N/A,N/A,N/A,252,293,N/A,88,6
25,N/A,N/A,N/A,227,252,N/A,92,4
7,N/A,N/A,N/A,220,227,N/A,95,1
43,N/A,N/A,N/A,177,220,N/A,100,6
7,N/A,N/A,N/A,170,177,N/A,106,0
42,N/A,N/A,N/A,128,170,N/A,112,6
19,N/A,N/A,N/A,109,128,N/A,115,3
18,N/A,N/A,N/A,91,109,N/A,121,3
12,N/A,N/A,N/A,79,91,N/A,125,1
7,N/A,N/A,N/A,72,79,N/A,131,1
10,N/A,N/A,N/A,62,72,N/A,137,1
14,N/A,N/A,N/A,793,807,N/A,6,3
22,N/A,N/A,N/A,771,793,N/A,12,3
22,N/A,N/A,N/A,749,771,N/A,18,3
42,N/A,N/A,N/A,707,749,N/A,21,6
9,N/A,N/A,N/A,698,707,N/A,27,0
14,N/A,N/A,N/A,684,698,N/A,30,3
22,N/A,N/A,N/A,662,684,N/A,36,3
10,N/A,N/A,N/A,652,662,N/A,41,2
7,N/A,N/A,N/A,645,652,N/A,46,1
31,N/A,N/A,N/A,614,645,N/A,49,4
19,N/A,N/A,N/A,595,614,N/A,54,3
17,N/A,N/A,N/A,578,595,N/A,60,3
17,N/A,N/A,N/A,561,578,N/A,66,3
11,N/A,N/A,N/A,550,561,N/A,70,1
24,N/A,N/A,N/A,526,550,N/A,73,4
12,N/A,N/A,N/A,514,526,N/A,76,1
32,N/A,N/A,N/A,482,514,N/A,80,5
23,N/A,N/A,N/A,459,482,N/A,85,4
9,N/A,N/A,N/A,450,459,N/A,88,1
11,N/A,N/A,N/A,439,450,N/A,94,1
12,N/A,N/A,N/A,427,439,N/A,100,1
38,N/A,N/A,N/A,389,427,N/A,104,5
20,N/A,N/A,N/A,369,389,N/A,108,3
14,N/A,N/A,N/A,355,369,N/A,114,3
41,N/A,N/A,N/A,314,355,N/A,117,6
36,N/A,N/A,N/A,278,314,N/A,122,5
23,N/A,N/A,N/A,255,278,N/A,127,4
11,N/A,N/A,N/A,244,255,N/A,130,1
39,N/A,N/A,N/A,205,244,N/A,134,5
17,N/A,N/A,N/A,188,205,N/A,138,3
42,N/A,N/A,N/A,282,324,N/A,5,6
15,N/A,N/A,N/A,267,282,N/A,8,3
7,N/A,N/A,N/A,260,267,N/A,12,1
41,N/A,N/A,N/A,219,260,N/A,17,6
17,N/A,N/A,N/A,202,219,N/A,20,3
12,N/A,N/A,N/A,190,202,N/A,24,1
23,N/A,N/A,N/A,167,190,N/A,27,4
25,N/A,N/A,N/A,142,167,N/A,33,4
8,N/A,N/A,N/A,134,142,N/A,36,1
31,N/A,N/A,N/A,103,134,N/A,39,4
18,N/A,N/A,N/A,85,103,N/A,44,3
11,N/A,N/A,N/A,74,85,N/A,48,1
25,N/A,N/A,N/A,49,74,N/A,51,4
16,N/A,N/A,N/A,33,49,N/A,55,2
10,N/A,N/A,N/A,23,33,N/A,60,1
32,N/A,N/A,N/A,-9,23,N/A,63,4
38,N/A,N/A,N/A,495,533,N/A,4,5
20,N/A,N/A,N/A,475,495,N/A,8,3
13,N/A,N/A,N/A,462,475,N/A,13,2
13,N/A,N/A,N/A,449,462,N/A,19,2
10,N/A,N/A,N/A,439,449,N/A,25,2
43,N/A,N/A,N/A,396,439,N/A,29,6
33,N/A,N/A,N/A,363,396,N/A,34,5
32,N/A,N/A,N/A,331,363,N/A,39,4
8,N/A,N/A,N/A,323,331,N/A,42,1
37,N/A,N/A,N/A,286,323,N/A,46,5
32,N/A,N/A,N/A,254,286,N/A,51,4
16,N/A,N/A,N/A,238,254,N/A,55,2
43,N/A,N/A,N/A,195,238,N/A,59,6
6,N/A,N/A,N/A,189,195,N/A,65,0
29,N/A,N/A,N/A,160,189,N/A,69,4
12,N/A,N/A,N/A,148,160,N/A,72,1
31,N/A,N/A,N/A,117,148,N/A,75,4
8,N/A,N/A,N/A,109,117,N/A,78,1
34,N/A,N/A,N/A,75,109,N/A,82,5
17,N/A,N/A,N/A,58,75,N/A,86,3
19,N/A,N/A,N/A,39,58,N/A,92,3
13,N/A,N/A,N/A,26,39,N/A,97,2
11,N/A,N/A,N/A,15,26,N/A,103,2
10,N/A,N/A,N/A,5,15,N/A,108,1
42,N/A,N/A,N/A,-37,5,N/A,113,6
9,N/A,N/A,N/A,757,766,N/A,3,1
42,N/A,N/A,N/A,715,757,N/A,8,6
20,N/A,N/A,N/A,695,715,N/A,11,3
11,N/A,N/A,N/A,684,695,N/A,16,2
15,N/A,N/A,N/A,669,684,N/A,22,2
43,N/A,N/A,N/A,626,669,N/A,26,6
9,N/A,N/A,N/A,617,626,N/A,32,0
44,N/A,N/A,N/A,573,617,N/A,38,6
23,N/A,N/A,N/A,550,573,N/A,41,3
10,N/A,N/A,N/A,540,550,N/A,46,2
44,N/A,N/A,N/A,496,540,N/A,50,6
5,N/A,N/A,N/A,491,496,N/A,56,0
28,N/A,N/A,N/A,463,491,N/A,60,4
11,N/A,N/A,N/A,452,463,N/A,63,1
28,N/A,N/A,N/A,424,452,N/A,66,4
25,N/A,N/A,N/A,399,424,N/A,72,4
18,N/A,N/A,N/A,381,399,N/A,77,3
43,N/A,N/A,N/A,338,381,N/A,80,6
7,N/A,N/A,N/A,331,338,N/A,86,0
25,N/A,N/A,N/A,306,331,N/A,90,4
18,N/A,N/A,N/A,288,306,N/A,95,3
8,N/A,N/A,N/A,280,288,N/A,99,1
38,N/A,N/A,N/A,242,280,N/A,103,5
25,N/A,N/A,N/A,217,242,N/A,108,4
12,N/A,N/A,N/A,205,217,N/A,111,1
12,N/A,N/A,N/A,193,205,N/A,117,1
37,N/A,N/A,N/A,156,193,N/A,121,5
33,N/A,N/A,N/A,123,156,N/A,127,5
33,N/A,N/A,N/A,90,123,N/A,133,5
23,N/A,N/A,N/A,67,90,N/A,138,4
38,N/A,N/A,N/A,1526,1564,N/A,5,5
31,N/A,N/A,N/A,1495,1526,N/A,10,4
12,N/A,N/A,N/A,1483,1495,N/A,14,2
41,N/A,N/A,N/A,1442,1483,N/A,18,6
32,N/A,N/A,N/A,1410,1442,N/A,23,5
26,N/A,N/A,N/A,1384,1410,N/A,28,4
21,N/A,N/A,N/A,1363,1384,N/A,33,3
10,N/A,N/A,N/A,1353,1363,N/A,38,2
13,N/A,N/A,N/A,1340,1353,N/A,44,2
38,N/A,N/A,N/A,1302,1340,N/A,47,5
19,N/A,N/A,N/A,1283,1302,N/A,51,3
42,N/A,N/A,N/A,1241,1283,N/A,54,6
36,N/A,N/A,N/A,1205,1241,N/A,59,5
24,N/A,N/A,N/A,1181,1205,N/A,64,4
31,N/A,N/A,N/A,1150,1181,N/A,70,4
18,N/A,N/A,N/A,1132,1150,N/A,75,3
12,N/A,N/A,N/A,1120,1132,N/A,79,1
7,N/A,N/A,N/A,1113,1120,N/A,85,1
35,N/A,N/A,N/A,1078,1113,N/A,89,5
20,N/A,N/A,N/A,1058,1078,N/A,93,3
42,N/A,N/A,N/A,1016,1058,N/A,96,6
37,N/A,N/A,N/A,979,1016,N/A,101,5
24,N/A,N/A,N/A,955,979,N/A,106,4
17,N/A,N/A,N/A,938,955,N/A,111,3
17,N/A,N/A,N/A,921,938,N/A,116,2
13,N/A,N/A,N/A,908,921,N/A,121,1
23,N/A,N/A,N/A,885,908,N/A,124,4
21,N/A,N/A,N/A,864,885,N/A,129,3
41,N/A,N/A,N/A,823,864,N/A,132,6
27,N/A,N/A,N/A,796,823,N/A,136,4
31,N/A,N/A,N/A,1755,1786,N/A,3,4
18,N/A,N/A,N/A,1737,1755,N/A,8,3
15,N/A,N/A,N/A,1722,1737,N/A,13,2
41,N/A,N/A,N/A,1681,1722,N/A,17,6
23,N/A,N/A,N/A,1658,1681,N/A,20,3
8,N/A,N/A,N/A,1650,1658,N/A,24,1
35,N/A,N/A,N/A,1615,1650,N/A,28,5
17,N/A,N/A,N/A,1598,1615,N/A,31,2
38,N/A,N/A,N/A,1560,1598,N/A,34,5
12,N/A,N/A,N/A,1548,1560,N/A,37,2
39,N/A,N/A,N/A,1509,1548,N/A,40,5
26,N/A,N/A,N/A,1483,1509,N/A,45,4
14,N/A,N/A,N/A,1469,1483,N/A,49,2
32,N/A,N/A,N/A,1437,1469,N/A,52,5
11,N/A,N/A,N/A,1426,1437,N/A,55,2
42,N/A,N/A,N/A,1384,1426,N/A,59,6
27,N/A,N/A,N/A,1357,1384,N/A,63,4
17,N/A,N/A,N/A,1340,1357,N/A,67,2
10,N/A,N/A,N/A,1330,1340,N/A,72,1
9,N/A,N/A,N/A,1321,1330,N/A,78,1
25,N/A,N/A,N/A,1296,1321,N/A,81,4
11,N/A,N/A,N/A,1285,1296,N/A,85,2
9,N/A,N/A,N/A,1276,1285,N/A,90,1
34,N/A,N/A,N/A,1242,1276,N/A,94,5
19,N/A,N/A,N/A,1223,1242,N/A,98,3
16,N/A,N/A,N/A,1207,1223,N/A,103,2
43,N/A,N/A,N/A,1164,1207,N/A,107,6
21,N/A,N/A,N/A,1143,1164,N/A,110,3
42,N/A,N/A,N/A,1101,1143,N/A,113,6
21,N/A,N/A,N/A,1080,1101,N/A,116,3
14,N/A,N/A,N/A,1430,1444,N/A,6,1
23,N/A,N/A,N/A,1407,1430,N/A,9,4
24,N/A,N/A,N/A,1383,1407,N/A,15,4
32,N/A,N/A,N/A,1351,1383,N/A,21,4
23,N/A,N/A,N/A,1328,1351,N/A,27,4
14,N/A,N/A,N/A,1314,1328,N/A,32,3
42,N/A,N/A,N/A,1272,1314,N/A,35,6
5,N/A,N/A,N/A,1267,1272,N/A,41,0
17,N/A,N/A,N/A,1250,1267,N/A,44,3
14,N/A,N/A,N/A,1236,1250,N/A,50,3
44,N/A,N/A,N/A,1192,1236,N/A,53,6
31,N/A,N/A,N/A,1161,1192,N/A,57,4
23,N/A,N/A,N/A,1138,1161,N/A,63,4
13,N/A,N/A,N/A,1125,1138,N/A,66,1
11,N/A,N/A,N/A,1114,1125,N/A,72,1
32,N/A,N/A,N/A,1082,1114,N/A,76,5
15,N/A,N/A,N/A,1067,1082,N/A,79,2
11,N/A,N/A,N/A,1056,1067,N/A,84,1
35,N/A,N/A,N/A,1021,1056,N/A,88,5
12,N/A,N/A,N/A,1009,1021,N/A,91,2
10,N/A,N/A,N/A,999,1009,N/A,96,1
34,N/A,N/A,N/A,965,999,N/A,100,5
26,N/A,N/A,N/A,939,965,N/A,105,4
15,N/A,N/A,N/A,924,939,N/A,109,2
10,N/A,N/A,N/A,914,924,N/A,114,1
41,N/A,N/A,N/A,873,914,N/A,119,6
34,N/A,N/A,N/A,839,873,N/A,124,5
33,N/A,N/A,N/A,806,839,N/A,130,5
13,N/A,N/A,N/A,793,806,N/A,133,2
11,N/A,N/A,N/A,782,793,N/A,138,1
10,N/A,N/A,N/A,717,727,N/A,4,1
43,N/A,N/A,N/A,674,717,N/A,9,6
24,N/A,N/A,N/A,650,674,N/A,13,4
31,N/A,N/A,N/A,619,650,N/A,19,4
12,N/A,N/A,N/A,607,619,N/A,22,1
42,N/A,N/A,N/A,565,607,N/A,27,6
9,N/A,N/A,N/A,556,565,N/A,33,0
27,N/A,N/A,N/A,529,556,N/A,37,4
26,N/A,N/A,N/A,503,529,N/A,43,4
17,N/A,N/A,N/A,486,503,N/A,47,2
13,N/A,N/A,N/A,473,486,N/A,53,2
36,N/A,N/A,N/A,437,473,N/A,56,5
27,N/A,N/A,N/A,410,437,N/A,61,4
8,N/A,N/A,N/A,402,410,N/A,64,1
11,N/A,N/A,N/A,391,402,N/A,70,1
10,N/A,N/A,N/A,381,391,N/A,76,1
36,N/A,N/A,N/A,345,381,N/A,80,5
17,N/A,N/A,N/A,328,345,N/A,83,2
44,N/A,N/A,N/A,284,328,N/A,87,6
20,N/A,N/A,N/A,264,284,N/A,90,3
12,N/A,N/A,N/A,252,264,N/A,94,1
41,N/A,N/A,N/A,211,252,N/A,99,6
21,N/A,N/A,N/A,190,211,N/A,102,3
15,N/A,N/A,N/A,175,190,N/A,107,2
8,N/A,N/A,N/A,167,175,N/A,112,1
38,N/A,N/A,N/A,129,167,N/A,116,5
23,N/A,N/A,N/A,106,129,N/A,120,3
42,N/A,N/A,N/A,64,106,N/A,123,6
16,N/A,N/A,N/A,48,64,N/A,126,3
16,N/A,N/A,N/A,32,48,N/A,131,2
7,N/A,N/A,N/A,1202,1209,N/A,6,1
42,N/A,N/A,N/A,1160,1202,N/A,11,6
33,N/A,N/A,N/A,1127,1160,N/A,16,5
35,N/A,N/A,N/A,1092,1127,N/A,22,5
23,N/A,N/A,N/A,1069,1092,N/A,26,3
42,N/A,N/A,N/A,1027,1069,N/A,29,6
28,N/A,N/A,N/A,999,1027,N/A,33,4
22,N/A,N/A,N/A,977,999,N/A,38,3
17,N/A,N/A,N/A,960,977,N/A,43,2
8,N/A,N/A,N/A,952,960,N/A,48,1
26,N/A,N/A,N/A,926,952,N/A,51,4
11,N/A,N/A,N/A,915,926,N/A,55,2
10,N/A,N/A,N/A,905,915,N/A,61,2
11,N/A,N/A,N/A,894,905,N/A,67,2
12,N/A,N/A,N/A,882,894,N/A,72,1
39,N/A,N/A,N/A,843,882,N/A,76,5
34,N/A,N/A,N/A,809,843,N/A,82,5
38,N/A,N/A,N/A,771,809,N/A,88,5
39,N/A,N/A,N/A,732,771,N/A,94,5
17,N/A,N/A,N/A,715,732,N/A,98,3
10,N/A,N/A,N/A,705,715,N/A,102,1
9,N/A,N/A,N/A,696,705,N/A,108,1
42,N/A,N/A,N/A,654,696,N/A,113,6
31,N/A,N/A,N/A,623,654,N/A,117,4
17,N/A,N/A,N/A,606,623,N/A,121,2
37,N/A,N/A,N/A,569,606,N/A,124,5
25,N/A,N/A,N/A,544,569,N/A,129,4
15,N/A,N/A,N/A,529,544,N/A,134,3
22,N/A,N/A,N/A,507,529,N/A,140,3
41,N/A,N/A,N/A,466,507,N/A,143,6
41,N/A,N/A,N/A,616,657,N/A,6,6
16,N/A,N/A,N/A,600,616,N/A,9,3
15,N/A,N/A,N/A,585,600,N/A,14,2
14,N/A,N/A,N/A,571,585,N/A,20,2
12,N/A,N/A,N/A,559,571,N/A,25,1
44,N/A,N/A,N/A,515,559,N/A,30,6
21,N/A,N/A,N/A,494,515,N/A,33,3
9,N/A,N/A,N/A,485,494,N/A,37,1
12,N/A,N/A,N/A,473,485,N/A,43,1
44,N/A,N/A,N/A,429,473,N/A,48,6
31,N/A,N/A,N/A,398,429,N/A,52,4
7,N/A,N/A,N/A,391,398,N/A,55,1
36,N/A,N/A,N/A,355,391,N/A,59,5
23,N/A,N/A,N/A,332,355,N/A,64,4
32,N/A,N/A,N/A,300,332,N/A,70,4
11,N/A,N/A,N/A,289,300,N/A,73,1
29,N/A,N/A,N/A,260,289,N/A,76,4
23,N/A,N/A,N/A,237,260,N/A,81,3
17,N/A,N/A,N/A,220,237,N/A,87,3
10,N/A,N/A,N/A,210,220,N/A,91,1
24,N/A,N/A,N/A,186,210,N/A,94,4
13,N/A,N/A,N/A,173,186,N/A,98,2
37,N/A,N/A,N/A,136,173,N/A,101,5
27,N/A,N/A,N/A,109,136,N/A,106,4
11,N/A,N/A,N/A,98,109,N/A,109,1
36,N/A,N/A,N/A,62,98,N/A,113,5
23,N/A,N/A,N/A,39,62,N/A,118,4
16,N/A,N/A,N/A,23,39,N/A,123,3
14,N/A,N/A,N/A,9,23,N/A,127,1
35,N/A,N/A,N/A,-26,9,N/A,131,5
43,N/A,N/A,N/A,604,647,N/A,6,6
39,N/A,N/A,N/A,565,604,N/A,11,5
11,N/A,N/A,N/A,554,565,N/A,14,2
14,N/A,N/A,N/A,540,554,N/A,19,1
28,N/A,N/A,N/A,512,540,N/A,22,4
31,N/A,N/A,N/A,481,512,N/A,28,4
32,N/A,N/A,N/A,449,481,N/A,34,4
22,N/A,N/A,N/A,427,449,N/A,39,3
17,N/A,N/A,N/A,410,427,N/A,45,3
19,N/A,N/A,N/A,391,410,N/A,51,3
15,N/A,N/A,N/A,376,391,N/A,56,2
42,N/A,N/A,N/A,334,376,N/A,60,6
18,N/A,N/A,N/A,316,334,N/A,63,3
21,N/A,N/A,N/A,295,316,N/A,69,3
41,N/A,N/A,N/A,254,295,N/A,72,6
18,N/A,N/A,N/A,236,254,N/A,75,3
22,N/A,N/A,N/A,214,236,N/A,81,3
11,N/A,N/A,N/A,203,214,N/A,86,2
42,N/A,N/A,N/A,161,203,N/A,90,6
38,N/A,N/A,N/A,123,161,N/A,95,5
33,N/A,N/A,N/A,90,123,N/A,101,5
18,N/A,N/A,N/A,72,90,N/A,105,3
41,N/A,N/A,N/A,31,72,N/A,108,6
23,N/A,N/A,N/A,8,31,N/A,111,3
16,N/A,N/A,N/A,-8,8,N/A,116,2
13,N/A,N/A,N/A,753,766,N/A,5,1
42,N/A,N/A,N/A,711,753,N/A,10,6
5,N/A,N/A,N/A,706,711,N/A,16,0
23,N/A,N/A,N/A,683,706,N/A,20,4
13,N/A,N/A,N/A,670,683,N/A,24,2
36,N/A,N/A,N/A,634,670,N/A,27,5
22,N/A,N/A,N/A,612,634,N/A,31,3
10,N/A,N/A,N/A,602,612,N/A,36,2
13,N/A,N/A,N/A,589,602,N/A,41,1
41,N/A,N/A,N/A,548,589,N/A,46,6
8,N/A,N/A,N/A,540,548,N/A,52,0
27,N/A,N/A,N/A,513,540,N/A,56,4
9,N/A,N/A,N/A,504,513,N/A,59,1
8,N/A,N/A,N/A,496,504,N/A,65,1
30,N/A,N/A,N/A,466,496,N/A,68,4
19,N/A,N/A,N/A,447,466,N/A,73,3
16,N/A,N/A,N/A,431,447,N/A,79,3
17,N/A,N/A,N/A,414,431,N/A,85,3
12,N/A,N/A,N/A,402,414,N/A,89,1
14,N/A,N/A,N/A,388,402,N/A,95,1
43,N/A,N/A,N/A,345,388,N/A,100,6
34,N/A,N/A,N/A,311,345,N/A,105,5
17,N/A,N/A,N/A,294,311,N/A,108,2
17,N/A,N/A,N/A,277,294,N/A,114,2
13,N/A,N/A,N/A,264,277,N/A,120,2
13,N/A,N/A,N/A,251,264,N/A,125,1
43,N/A,N/A,N/A,208,251,N/A,130,6
6,N/A,N/A,N/A,202,208,N/A,136,0
35,N/A,N/A,N/A,167,202,N/A,141,5
35,N/A,N/A,N/A,132,167,N/A,147,5
38,N/A,N/A,N/A,1007,1045,N/A,4,5
34,N/A,N/A,N/A,973,1007,N/A,10,5
13,N/A,N/A,N/A,960,973,N/A,13,2
44,N/A,N/A,N/A,916,960,N/A,17,6
29,N/A,N/A,N/A,887,916,N/A,21,4
21,N/A,N/A,N/A,866,887,N/A,26,3
12,N/A,N/A,N/A,854,866,N/A,30,1
11,N/A,N/A,N/A,843,854,N/A,36,1
34,N/A,N/A,N/A,809,843,N/A,40,5
23,N/A,N/A,N/A,786,809,N/A,45,4
14,N/A,N/A,N/A,772,786,N/A,48,1
41,N/A,N/A,N/A,731,772,N/A,53,6
19,N/A,N/A,N/A,712,731,N/A,56,3
16,N/A,N/A,N/A,696,712,N/A,61,2
34,N/A,N/A,N/A,662,696,N/A,64,5
23,N/A,N/A,N/A,639,662,N/A,68,3
14,N/A,N/A,N/A,625,639,N/A,73,2
37,N/A,N/A,N/A,588,625,N/A,76,5
12,N/A,N/A,N/A,576,588,N/A,79,2
43,N/A,N/A,N/A,533,576,N/A,83,6
16,N/A,N/A,N/A,517,533,N/A,86,3
14,N/A,N/A,N/A,503,517,N/A,90,1
34,N/A,N/A,N/A,469,503,N/A,94,5
32,N/A,N/A,N/A,437,469,N/A,100,5
13,N/A,N/A,N/A,424,437,N/A,103,2
16,N/A,N/A,N/A,408,424,N/A,109,2
41,N/A,N/A,N/A,367,408,N/A,113,6
37,N/A,N/A,N/A,330,367,N/A,118,5
19,N/A,N/A,N/A,311,330,N/A,122,3
23,N/A,N/A,N/A,288,311,N/A,128,3
34,N/A,N/A,N/A,583,617,N/A,4,5
34,N/A,N/A,N/A,549,583,N/A,10,5
22,N/A,N/A,N/A,527,549,N/A,14,3
18,N/A,N/A,N/A,509,527,N/A,20,3
8,N/A,N/A,N/A,501,509,N/A,24,1
7,N/A,N/A,N/A,494,501,N/A,30,1
25,N/A,N/A,N/A,469,494,N/A,33,4
21,N/A,N/A,N/A,448,469,N/A,38,3
11,N/A,N/A,N/A,437,448,N/A,43,2
34,N/A,N/A,N/A,403,437,N/A,46,5
22,N/A,N/A,N/A,381,403,N/A,50,3
13,N/A,N/A,N/A,368,381,N/A,54,1
9,N/A,N/A,N/A,359,368,N/A,60,1
42,N/A,N/A,N/A,317,359,N/A,65,6
7,N/A,N/A,N/A,310,317,N/A,71,0
20,N/A,N/A,N/A,290,310,N/A,74,3
14,N/A,N/A,N/A,276,290,N/A,78,1
7,N/A,N/A,N/A,269,276,N/A,84,1
27,N/A,N/A,N/A,242,269,N/A,87,4
16,N/A,N/A,N/A,226,242,N/A,91,2
13,N/A,N/A,N/A,213,226,N/A,97,2
8,N/A,N/A,N/A,205,213,N/A,102,1
23,N/A,N/A,N/A,182,205,N/A,105,4
23,N/A,N/A,N/A,159,182,N/A,111,4
23,N/A,N/A,N/A,136,159,N/A,117,4
11,N/A,N/A,N/A,125,136,N/A,120,1
41,N/A,N/A,N/A,84,125,N/A,125,6
35,N/A,N/A,N/A,49,84,N/A,130,5
29,N/A,N/A,N/A,20,49,N/A,135,4
14,N/A,N/A,N/A,6,20,N/A,138,1
24,N/A,N/A,N/A,1328,1352,N/A,5,4
21,N/A,N/A,N/A,1307,1328,N/A,10,3
41,N/A,N/A,N/A,1266,1307,N/A,13,6
34,N/A,N/A,N/A,1232,1266,N/A,18,5
29,N/A,N/A,N/A,1203,1232,N/A,23,4
16,N/A,N/A,N/A,1187,1203,N/A,28,3
9,N/A,N/A,N/A,1178,1187,N/A,32,1
7,N/A,N/A,N/A,1171,1178,N/A,38,1
36,N/A,N/A,N/A,1135,1171,N/A,42,5
23,N/A,N/A,N/A,1112,1135,N/A,47,4
17,N/A,N/A,N/A,1095,1112,N/A,52,3
14,N/A,N/A,N/A,1081,1095,N/A,58,3
11,N/A,N/A,N/A,1070,1081,N/A,62,1
10,N/A,N/A,N/A,1060,1070,N/A,68,1
30,N/A,N/A,N/A,1030,1060,N/A,71,4
8,N/A,N/A,N/A,1022,1030,N/A,74,1
43,N/A,N/A,N/A,979,1022,N/A,79,6
29,N/A,N/A,N/A,950,979,N/A,83,4
23,N/A,N/A,N/A,927,950,N/A,88,3
13,N/A,N/A,N/A,914,927,N/A,93,2
14,N/A,N/A,N/A,900,914,N/A,98,1
8,N/A,N/A,N/A,892,900,N/A,104,1
30,N/A,N/A,N/A,862,892,N/A,107,4
30,N/A,N/A,N/A,832,862,N/A,113,4
8,N/A,N/A,N/A,824,832,N/A,116,1
22,N/A,N/A,N/A,802,824,N/A,119,4
20,N/A,N/A,N/A,782,802,N/A,124,3
18,N/A,N/A,N/A,764,782,N/A,130,3
12,N/A,N/A,N/A,752,764,N/A,135,2
13,N/A,N/A,N/A,739,752,N/A,140,1
18,N/A,N/A,N/A,1181,1199,N/A,6,3
43,N/A,N/A,N/A,1138,1181,N/A,9,6
23,N/A,N/A,N/A,1115,1138,N/A,12,3
21,N/A,N/A,N/A,1094,1115,N/A,18,3
16,N/A,N/A,N/A,1078,1094,N/A,24,3
9,N/A,N/A,N/A,1069,1078,N/A,28,1
30,N/A,N/A,N/A,1039,1069,N/A,31,4
14,N/A,N/A,N/A,1025,1039,N/A,34,1
11,N/A,N/A,N/A,1014,1025,N/A,40,1
33,N/A,N/A,N/A,981,1014,N/A,44,5
19,N/A,N/A,N/A,962,981,N/A,48,3
19,N/A,N/A,N/A,943,962,N/A,54,3
44,N/A,N/A,N/A,899,943,N/A,57,6
9,N/A,N/A,N/A,890,899,N/A,63,0
35,N/A,N/A,N/A,855,890,N/A,68,5
32,N/A,N/A,N/A,823,855,N/A,74,5
36,N/A,N/A,N/A,787,823,N/A,80,5
16,N/A,N/A,N/A,771,787,N/A,83,2
12,N/A,N/A,N/A,759,771,N/A,88,1
39,N/A,N/A,N/A,720,759,N/A,92,5
33,N/A,N/A,N/A,687,720,N/A,98,5
14,N/A,N/A,N/A,673,687,N/A,101,2
11,N/A,N/A,N/A,662,673,N/A,107,2
38,N/A,N/A,N/A,624,662,N/A,110,5
30,N/A,N/A,N/A,594,624,N/A,115,4
17,N/A,N/A,N/A,577,594,N/A,120,3
20,N/A,N/A,N/A,557,577,N/A,126,3
11,N/A,N/A,N/A,546,557,N/A,131,2
7,N/A,N/A,N/A,539,546,N/A,136,1
25,N/A,N/A,N/A,514,539,N/A,139,4
14,N/A,N/A,N/A,1710,1724,N/A,5,2
37,N/A,N/A,N/A,1673,1710,N/A,8,5
23,N/A,N/A,N/A,1650,1673,N/A,13,4
14,N/A,N/A,N/A,1636,1650,N/A,17,2
34,N/A,N/A,N/A,1602,1636,N/A,20,5
17,N/A,N/A,N/A,1585,1602,N/A,23,2
43,N/A,N/A,N/A,1542,1585,N/A,27,6
20,N/A,N/A,N/A,1522,1542,N/A,30,3
12,N/A,N/A,N/A,1510,1522,N/A,35,2
13,N/A,N/A,N/A,1497,1510,N/A,41,2
10,N/A,N/A,N/A,1487,1497,N/A,46,1
14,N/A,N/A,N/A,1473,1487,N/A,52,1
43,N/A,N/A,N/A,1430,1473,N/A,57,6
35,N/A,N/A,N/A,1395,1430,N/A,62,5
37,N/A,N/A,N/A,1358,1395,N/A,68,5
15,N/A,N/A,N/A,1343,1358,N/A,71,2
15,N/A,N/A,N/A,1328,1343,N/A,77,2
39,N/A,N/A,N/A,1289,1328,N/A,80,5
25,N/A,N/A,N/A,1264,1289,N/A,85,4
12,N/A,N/A,N/A,1252,1264,N/A,89,2
44,N/A,N/A,N/A,1208,1252,N/A,93,6
39,N/A,N/A,N/A,1169,1208,N/A,98,5
21,N/A,N/A,N/A,1148,1169,N/A,102,3
12,N/A,N/A,N/A,1136,1148,N/A,106,1
23,N/A,N/A,N/A,1113,1136,N/A,109,4
9,N/A,N/A,N/A,1104,1113,N/A,112,1
44,N/A,N/A,N/A,1060,1104,N/A,117,6
33,N/A,N/A,N/A,1027,1060,N/A,122,5
38,N/A,N/A,N/A,989,1027,N/A,128,5
21,N/A,N/A,N/A,968,989,N/A,132,3
34,N/A,N/A,N/A,398,432,N/A,3,5
10,N/A,N/A,N/A,388,398,N/A,6,2
32,N/A,N/A,N/A,356,388,N/A,9,5
17,N/A,N/A,N/A,339,356,N/A,13,3
13,N/A,N/A,N/A,326,339,N/A,17,1
28,N/A,N/A,N/A,298,326,N/A,20,4
22,N/A,N/A,N/A,276,298,N/A,26,4
23,N/A,N/A,N/A,253,276,N/A,32,4
29,N/A,N/A,N/A,224,253,N/A,38,4
12,N/A,N/A,N/A,212,224,N/A,41,1
43,N/A,N/A,N/A,169,212,N/A,46,6
35,N/A,N/A,N/A,134,169,N/A,51,5
16,N/A,N/A,N/A,118,134,N/A,55,3
17,N/A,N/A,N/A,101,118,N/A,60,2
38,N/A,N/A,N/A,63,101,N/A,63,5
11,N/A,N/A,N/A,52,63,N/A,66,2
44,N/A,N/A,N/A,8,52,N/A,70,6
38,N/A,N/A,N/A,-30,8,N/A,75,5
37,N/A,N/A,N/A,343,380,N/A,6,5
15,N/A,N/A,N/A,328,343,N/A,9,2
8,N/A,N/A,N/A,320,328,N/A,14,1
8,N/A,N/A,N/A,312,320,N/A,20,1
28,N/A,N/A,N/A,284,312,N/A,23,4
17,N/A,N/A,N/A,267,284,N/A,27,2
44,N/A,N/A,N/A,223,267,N/A,31,6
24,N/A,N/A,N/A,199,223,N/A,35,4
17,N/A,N/A,N/A,182,199,N/A,40,3
11,N/A,N/A,N/A,171,182,N/A,45,2
35,N/A,N/A,N/A,136,171,N/A,48,5
34,N/A,N/A,N/A,102,136,N/A,54,5
35,N/A,N/A,N/A,67,102,N/A,60,5
25,N/A,N/A,N/A,42,67,N/A,65,4
15,N/A,N/A,N/A,27,42,N/A,70,3
7,N/A,N/A,N/A,20,27,N/A,74,1
39,N/A,N/A,N/A,-19,20,N/A,78,5
15,N/A,N/A,N/A,741,756,N/A,6,2
44,N/A,N/A,N/A,697,741,N/A,10,6
33,N/A,N/A,N/A,664,697,N/A,15,5
19,N/A,N/A,N/A,645,664,N/A,19,3
12,N/A,N/A,N/A,633,645,N/A,24,2
10,N/A,N/A,N/A,623,633,N/A,29,1
44,N/A,N/A,N/A,579,623,N/A,34,6
16,N/A,N/A,N/A,563,579,N/A,37,3
14,N/A,N/A,N/A,549,563,N/A,41,1
8,N/A,N/A,N/A,541,549,N/A,47,1
34,N/A,N/A,N/A,507,541,N/A,51,5
22,N/A,N/A,N/A,485,507,N/A,56,4
20,N/A,N/A,N/A,465,485,N/A,61,3
14,N/A,N/A,N/A,451,465,N/A,65,1
37,N/A,N/A,N/A,414,451,N/A,69,5
13,N/A,N/A,N/A,401,414,N/A,72,2
34,N/A,N/A,N/A,367,401,N/A,75,5
17,N/A,N/A,N/A,350,367,N/A,79,3
17,N/A,N/A,N/A,333,350,N/A,85,3
44,N/A,N/A,N/A,289,333,N/A,88,6
34,N/A,N/A,N/A,255,289,N/A,93,5
35,N/A,N/A,N/A,220,255,N/A,99,5
30,N/A,N/A,N/A,190,220,N/A,104,4
30,N/A,N/A,N/A,160,190,N/A,110,4
21,N/A,N/A,N/A,139,160,N/A,115,3
16,N/A,N/A,N/A,123,139,N/A,120,2
12,N/A,N/A,N/A,111,123,N/A,125,1
36,N/A,N/A,N/A,75,111,N/A,129,5
30,N/A,N/A,N/A,45,75,N/A,134,4
18,N/A,N/A,N/A,27,45,N/A,139,3
38,N/A,N/A,N/A,450,488,N/A,4,5
34,N/A,N/A,N/A,416,450,N/A,10,5
15,N/A,N/A,N/A,401,416,N/A,13,2
14,N/A,N/A,N/A,387,401,N/A,18,1
39,N/A,N/A,N/A,348,387,N/A,22,5
10,N/A,N/A,N/A,338,348,N/A,25,2
42,N/A,N/A,N/A,296,338,N/A,29,6
6,N/A,N/A,N/A,290,296,N/A,35,0
44,N/A,N/A,N/A,246,290,N/A,41,6
15,N/A,N/A,N/A,231,246,N/A,44,3
17,N/A,N/A,N/A,214,231,N/A,49,2
17,N/A,N/A,N/A,197,214,N/A,55,2
43,N/A,N/A,N/A,154,197,N/A,59,6
32,N/A,N/A,N/A,122,154,N/A,63,4
18,N/A,N/A,N/A,104,122,N/A,68,3
12,N/A,N/A,N/A,92,104,N/A,72,1
30,N/A,N/A,N/A,62,92,N/A,75,4
18,N/A,N/A,N/A,44,62,N/A,80,3
10,N/A,N/A,N/A,34,44,N/A,85,2
7,N/A,N/A,N/A,27,34,N/A,90,1
7,N/A,N/A,N/A,20,27,N/A,96,1
42,N/A,N/A,N/A,-22,20,N/A,101,6
29,N/A,N/A,N/A,1793,1822,N/A,4,4
32,N/A,N/A,N/A,1761,1793,N/A,10,4
16,N/A,N/A,N/A,1745,1761,N/A,14,2
10,N/A,N/A,N/A,1735,1745,N/A,19,1
41,N/A,N/A,N/A,1694,1735,N/A,24,6
23,N/A,N/A,N/A,1671,1694,N/A,27,3
14,N/A,N/A,N/A,1657,1671,N/A,31,1
10,N/A,N/A,N/A,1647,1657,N/A,37,1
32,N/A,N/A,N/A,1615,1647,N/A,40,4
17,N/A,N/A,N/A,1598,1615,N/A,44,2
44,N/A,N/A,N/A,1554,1598,N/A,48,6
33,N/A,N/A,N/A,1521,1554,N/A,53,5
29,N/A,N/A,N/A,1492,1521,N/A,58,4
22,N/A,N/A,N/A,1470,1492,N/A,63,3
41,N/A,N/A,N/A,1429,1470,N/A,66,6
29,N/A,N/A,N/A,1400,1429,N/A,70,4
21,N/A,N/A,N/A,1379,1400,N/A,75,3
16,N/A,N/A,N/A,1363,1379,N/A,80,2
16,N/A,N/A,N/A,1347,1363,N/A,86,2
39,N/A,N/A,N/A,1308,1347,N/A,89,5
23,N/A,N/A,N/A,1285,1308,N/A,94,4
30,N/A,N/A,N/A,1255,1285,N/A,100,4
29,N/A,N/A,N/A,1226,1255,N/A,106,4
16,N/A,N/A,N/A,1210,1226,N/A,111,3
42,N/A,N/A,N/A,1168,1210,N/A,114,6
9,N/A,N/A,N/A,1159,1168,N/A,120,0
37,N/A,N/A,N/A,1122,1159,N/A,125,5
27,N/A,N/A,N/A,1095,1122,N/A,130,4
10,N/A,N/A,N/A,1085,1095,N/A,134,2
32,N/A,N/A,N/A,1053,1085,N/A,137,5
7,N/A,N/A,N/A,1598,1605,N/A,4,1
26,N/A,N/A,N/A,1572,1598,N/A,7,4
11,N/A,N/A,N/A,1561,1572,N/A,11,2
12,N/A,N/A,N/A,1549,1561,N/A,17,2
32,N/A,N/A,N/A,1517,1549,N/A,20,5
17,N/A,N/A,N/A,1500,1517,N/A,23,2
42,N/A,N/A,N/A,1458,1500,N/A,27,6
25,N/A,N/A,N/A,1433,1458,N/A,31,4
17,N/A,N/A,N/A,1416,1433,N/A,36,3
12,N/A,N/A,N/A,1404,1416,N/A,41,2
43,N/A,N/A,N/A,1361,1404,N/A,45,6
7,N/A,N/A,N/A,1354,1361,N/A,51,0
33,N/A,N/A,N/A,1321,1354,N/A,56,5
15,N/A,N/A,N/A,1306,1321,N/A,60,3
14,N/A,N/A,N/A,1292,1306,N/A,66,3
22,N/A,N/A,N/A,1270,1292,N/A,72,3
14,N/A,N/A,N/A,1256,1270,N/A,77,2
43,N/A,N/A,N/A,1213,1256,N/A,81,6
29,N/A,N/A,N/A,1184,1213,N/A,85,4
11,N/A,N/A,N/A,1173,1184,N/A,89,2
33,N/A,N/A,N/A,1140,1173,N/A,92,5
39,N/A,N/A,N/A,1101,1140,N/A,98,5
30,N/A,N/A,N/A,1071,1101,N/A,103,4
14,N/A,N/A,N/A,1057,1071,N/A,106,1
33,N/A,N/A,N/A,1024,1057,N/A,110,5
23,N/A,N/A,N/A,1001,1024,N/A,115,4
30,N/A,N/A,N/A,971,1001,N/A,121,4
14,N/A,N/A,N/A,957,971,N/A,124,1
41,N/A,N/A,N/A,916,957,N/A,129,6
7,N/A,N/A,N/A,909,916,N/A,135,0
10,N/A,N/A,N/A,1064,1074,N/A,4,1
11,N/A,N/A,N/A,1053,1064,N/A,10,1
8,N/A,N/A,N/A,1045,1053,N/A,16,1
32,N/A,N/A,N/A,1013,1045,N/A,19,4
14,N/A,N/A,N/A,999,1013,N/A,23,2
44,N/A,N/A,N/A,955,999,N/A,27,6
27,N/A,N/A,N/A,928,955,N/A,31,4
11,N/A,N/A,N/A,917,928,N/A,34,1
32,N/A,N/A,N/A,885,917,N/A,37,4
31,N/A,N/A,N/A,854,885,N/A,43,4
8,N/A,N/A,N/A,846,854,N/A,46,1
22,N/A,N/A,N/A,824,846,N/A,49,4
12,N/A,N/A,N/A,812,824,N/A,53,2
12,N/A,N/A,N/A,800,812,N/A,59,2
13,N/A,N/A,N/A,787,800,N/A,65,2
14,N/A,N/A,N/A,773,787,N/A,71,2
11,N/A,N/A,N/A,762,773,N/A,76,1
37,N/A,N/A,N/A,725,762,N/A,80,5
37,N/A,N/A,N/A,688,725,N/A,86,5
17,N/A,N/A,N/A,671,688,N/A,89,2
14,N/A,N/A,N/A,657,671,N/A,94,1
43,N/A,N/A,N/A,614,657,N/A,99,6
5,N/A,N/A,N/A,609,614,N/A,105,0
43,N/A,N/A,N/A,566,609,N/A,111,6
9,N/A,N/A,N/A,557,566,N/A,117,0
23,N/A,N/A,N/A,534,557,N/A,121,4
11,N/A,N/A,N/A,523,534,N/A,125,2
12,N/A,N/A,N/A,511,523,N/A,131,2
44,N/A,N/A,N/A,467,511,N/A,135,6
31,N/A,N/A,N/A,436,467,N/A,139,4
9,N/A,N/A,N/A,550,559,N/A,5,1
42,N/A,N/A,N/A,508,550,N/A,10,6
37,N/A,N/A,N/A,471,508,N/A,15,5
24,N/A,N/A,N/A,447,471,N/A,20,4
25,N/A,N/A,N/A,422,447,N/A,26,4
18,N/A,N/A,N/A,404,422,N/A,31,3
42,N/A,N/A,N/A,362,404,N/A,34,6
38,N/A,N/A,N/A,324,362,N/A,39,5
11,N/A,N/A,N/A,313,324,N/A,42,2
44,N/A,N/A,N/A,269,313,N/A,46,6
6,N/A,N/A,N/A,263,269,N/A,52,0
43,N/A,N/A,N/A,220,263,N/A,58,6
7,N/A,N/A,N/A,213,220,N/A,64,0
35,N/A,N/A,N/A,178,213,N/A,69,5
29,N/A,N/A,N/A,149,178,N/A,74,4
14,N/A,N/A,N/A,135,149,N/A,78,2
41,N/A,N/A,N/A,94,135,N/A,82,6
9,N/A,N/A,N/A,85,94,N/A,88,0
44,N/A,N/A,N/A,41,85,N/A,94,6
38,N/A,N/A,N/A,3,41,N/A,99,5
28,N/A,N/A,N/A,-25,3,N/A,104,4
11,N/A,N/A,N/A,1106,1117,N/A,3,1
35,N/A,N/A,N/A,1071,1106,N/A,7,5
38,N/A,N/A,N/A,1033,1071,N/A,13,5
17,N/A,N/A,N/A,1016,1033,N/A,16,2
43,N/A,N/A,N/A,973,1016,N/A,20,6
14,N/A,N/A,N/A,959,973,N/A,23,3
11,N/A,N/A,N/A,948,959,N/A,28,2
7,N/A,N/A,N/A,941,948,N/A,33,1
32,N/A,N/A,N/A,909,941,N/A,37,5
14,N/A,N/A,N/A,895,909,N/A,41,3
42,N/A,N/A,N/A,853,895,N/A,44,6
9,N/A,N/A,N/A,844,853,N/A,50,0
18,N/A,N/A,N/A,826,844,N/A,53,3
14,N/A,N/A,N/A,812,826,N/A,57,1
44,N/A,N/A,N/A,768,812,N/A,62,6
7,N/A,N/A,N/A,761,768,N/A,68,0
32,N/A,N/A,N/A,729,761,N/A,72,4
15,N/A,N/A,N/A,714,729,N/A,77,3
9,N/A,N/A,N/A,705,714,N/A,81,1
25,N/A,N/A,N/A,680,705,N/A,84,4
30,N/A,N/A,N/A,650,680,N/A,90,4
22,N/A,N/A,N/A,628,650,N/A,95,3
43,N/A,N/A,N/A,585,628,N/A,98,6
22,N/A,N/A,N/A,563,585,N/A,102,4
31,N/A,N/A,N/A,532,563,N/A,108,4
26,N/A,N/A,N/A,506,532,N/A,114,4
21,N/A,N/A,N/A,485,506,N/A,119,3
12,N/A,N/A,N/A,473,485,N/A,124,2
17,N/A,N/A,N/A,456,473,N/A,130,2
13,N/A,N/A,N/A,443,456,N/A,135,1
39,N/A,N/A,N/A,667,706,N/A,3,5
28,N/A,N/A,N/A,639,667,N/A,8,4
23,N/A,N/A,N/A,616,639,N/A,13,3
41,N/A,N/A,N/A,575,616,N/A,16,6
9,N/A,N/A,N/A,566,575,N/A,22,0
41,N/A,N/A,N/A,525,566,N/A,28,6
27,N/A,N/A,N/A,498,525,N/A,32,4
12,N/A,N/A,N/A,486,498,N/A,35,1
8,N/A,N/A,N/A,478,486,N/A,41,1
9,N/A,N/A,N/A,469,478,N/A,47,1
29,N/A,N/A,N/A,440,469,N/A,50,4
16,N/A,N/A,N/A,424,440,N/A,54,2
43,N/A,N/A,N/A,381,424,N/A,58,6
20,N/A,N/A,N/A,361,381,N/A,61,3
12,N/A,N/A,N/A,349,361,N/A,65,1
25,N/A,N/A,N/A,324,349,N/A,68,4
13,N/A,N/A,N/A,311,324,N/A,71,1
44,N/A,N/A,N/A,267,311,N/A,76,6
32,N/A,N/A,N/A,235,267,N/A,80,4
31,N/A,N/A,N/A,204,235,N/A,86,4
9,N/A,N/A,N/A,195,204,N/A,89,1
43,N/A,N/A,N/A,152,195,N/A,94,6
37,N/A,N/A,N/A,115,152,N/A,99,5
35,N/A,N/A,N/A,80,115,N/A,105,5
23,N/A,N/A,N/A,57,80,N/A,109,3
44,N/A,N/A,N/A,13,57,N/A,112,6
24,N/A,N/A,N/A,-11,13,N/A,116,4
20,N/A,N/A,N/A,424,444,N/A,4,3
11,N/A,N/A,N/A,413,424,N/A,8,1
32,N/A,N/A,N/A,381,413,N/A,11,4
13,N/A,N/A,N/A,368,381,N/A,14,1
8,N/A,N/A,N/A,360,368,N/A,20,1
43,N/A,N/A,N/A,317,360,N/A,25,6
32,N/A,N/A,N/A,285,317,N/A,30,5
13,N/A,N/A,N/A,272,285,N/A,33,2
33,N/A,N/A,N/A,239,272,N/A,36,5
10,N/A,N/A,N/A,229,239,N/A,39,2
14,N/A,N/A,N/A,215,229,N/A,45,2
15,N/A,N/A,N/A,200,215,N/A,51,2
11,N/A,N/A,N/A,189,200,N/A,56,1
12,N/A,N/A,N/A,177,189,N/A,62,1
34,N/A,N/A,N/A,143,177,N/A,66,5
13,N/A,N/A,N/A,130,143,N/A,69,2
17,N/A,N/A,N/A,113,130,N/A,75,2
8,N/A,N/A,N/A,105,113,N/A,80,1
41,N/A,N/A,N/A,64,105,N/A,85,6
20,N/A,N/A,N/A,44,64,N/A,88,3
43,N/A,N/A,N/A,1,44,N/A,91,6
33,N/A,N/A,N/A,-32,1,N/A,96,5
41,N/A,N/A,N/A,334,375,N/A,3,6
7,N/A,N/A,N/A,327,334,N/A,9,0
16,N/A,N/A,N/A,311,327,N/A,12,3
22,N/A,N/A,N/A,289,311,N/A,18,3
16,N/A,N/A,N/A,273,289,N/A,23,2
39,N/A,N/A,N/A,234,273,N/A,26,5
23,N/A,N/A,N/A,211,234,N/A,30,3
11,N/A,N/A,N/A,200,211,N/A,35,2
35,N/A,N/A,N/A,165,200,N/A,38,5
12,N/A,N/A,N/A,153,165,N/A,41,2
14,N/A,N/A,N/A,139,153,N/A,46,1
29,N/A,N/A,N/A,110,139,N/A,49,4
14,N/A,N/A,N/A,96,110,N/A,53,2
43,N/A,N/A,N/A,53,96,N/A,57,6
39,N/A,N/A,N/A,14,53,N/A,62,5
16,N/A,N/A,N/A,-2,14,N/A,66,3
14,N/A,N/A,N/A,1528,1542,N/A,5,3
11,N/A,N/A,N/A,1517,1528,N/A,10,2
8,N/A,N/A,N/A,1509,1517,N/A,15,1
34,N/A,N/A,N/A,1475,1509,N/A,19,5
34,N/A,N/A,N/A,1441,1475,N/A,25,5
14,N/A,N/A,N/A,1427,1441,N/A,28,2
16,N/A,N/A,N/A,1411,1427,N/A,34,2
13,N/A,N/A,N/A,1398,1411,N/A,39,1
43,N/A,N/A,N/A,1355,1398,N/A,44,6
9,N/A,N/A,N/A,1346,1355,N/A,50,0
41,N/A,N/A,N/A,1305,1346,N/A,56,6
28,N/A,N/A,N/A,1277,1305,N/A,60,4
16,N/A,N/A,N/A,1261,1277,N/A,64,2
14,N/A,N/A,N/A,1247,1261,N/A,69,1
11,N/A,N/A,N/A,1236,1247,N/A,75,1
13,N/A,N/A,N/A,1223,1236,N/A,81,1
26,N/A,N/A,N/A,1197,1223,N/A,84,4
27,N/A,N/A,N/A,1170,1197,N/A,90,4
17,N/A,N/A,N/A,1153,1170,N/A,94,2
12,N/A,N/A,N/A,1141,1153,N/A,100,2
42,N/A,N/A,N/A,1099,1141,N/A,104,6
8,N/A,N/A,N/A,1091,1099,N/A,110,0
23,N/A,N/A,N/A,1068,1091,N/A,113,3
12,N/A,N/A,N/A,1056,1068,N/A,117,1
32,N/A,N/A,N/A,1024,1056,N/A,121,5
23,N/A,N/A,N/A,1001,1024,N/A,125,3
17,N/A,N/A,N/A,984,1001,N/A,130,2
10,N/A,N/A,N/A,974,984,N/A,135,1
9,N/A,N/A,N/A,965,974,N/A,141,1
33,N/A,N/A,N/A,932,965,N/A,145,5
41,N/A,N/A,N/A,475,516,N/A,4,6
7,N/A,N/A,N/A,468,475,N/A,10,0
16,N/A,N/A,N/A,452,468,N/A,13,3
11,N/A,N/A,N/A,441,452,N/A,18,2
42,N/A,N/A,N/A,399,441,N/A,22,6
8,N/A,N/A,N/A,391,399,N/A,28,0
35,N/A,N/A,N/A,356,391,N/A,33,5
30,N/A,N/A,N/A,326,356,N/A,38,4
10,N/A,N/A,N/A,316,326,N/A,41,1
38,N/A,N/A,N/A,278,316,N/A,45,5
20,N/A,N/A,N/A,258,278,N/A,49,3
16,N/A,N/A,N/A,242,258,N/A,54,2
12,N/A,N/A,N/A,230,242,N/A,59,1
11,N/A,N/A,N/A,219,230,N/A,65,1
11,N/A,N/A,N/A,208,219,N/A,71,1
32,N/A,N/A,N/A,176,208,N/A,75,5
27,N/A,N/A,N/A,149,176,N/A,80,4
32,N/A,N/A,N/A,117,149,N/A,86,4
17,N/A,N/A,N/A,100,117,N/A,90,2
8,N/A,N/A,N/A,92,100,N/A,95,1
26,N/A,N/A,N/A,66,92,N/A,98,4
9,N/A,N/A,N/A,57,66,N/A,101,1
32,N/A,N/A,N/A,25,57,N/A,104,4
17,N/A,N/A,N/A,8,25,N/A,109,3
9,N/A,N/A,N/A,-1,8,N/A,113,1
17,N/A,N/A,N/A,916,933,N/A,4,2
42,N/A,N/A,N/A,874,916,N/A,8,6
31,N/A,N/A,N/A,843,874,N/A,12,4
11,N/A,N/A,N/A,832,843,N/A,15,1
37,N/A,N/A,N/A,795,832,N/A,19,5
18,N/A,N/A,N/A,777,795,N/A,23,3
16,N/A,N/A,N/A,761,777,N/A,29,3
23,N/A,N/A,N/A,738,761,N/A,35,3
7,N/A,N/A,N/A,731,738,N/A,39,1
43,N/A,N/A,N/A,688,731,N/A,44,6
7,N/A,N/A,N/A,681,688,N/A,50,0
23,N/A,N/A,N/A,658,681,N/A,53,3
14,N/A,N/A,N/A,644,658,N/A,59,3
22,N/A,N/A,N/A,622,644,N/A,65,3
42,N/A,N/A,N/A,580,622,N/A,68,6
32,N/A,N/A,N/A,548,580,N/A,72,4
15,N/A,N/A,N/A,533,548,N/A,76,2
7,N/A,N/A,N/A,526,533,N/A,81,1
26,N/A,N/A,N/A,500,526,N/A,84,4
9,N/A,N/A,N/A,491,500,N/A,87,1
34,N/A,N/A,N/A,457,491,N/A,91,5
16,N/A,N/A,N/A,441,457,N/A,95,3
12,N/A,N/A,N/A,429,441,N/A,99,1
41,N/A,N/A,N/A,388,429,N/A,104,6
22,N/A,N/A,N/A,366,388,N/A,108,4
14,N/A,N/A,N/A,352,366,N/A,112,2
44,N/A,N/A,N/A,308,352,N/A,116,6
5,N/A,N/A,N/A,303,308,N/A,122,0
24,N/A,N/A,N/A,279,303,N/A,126,4
18,N/A,N/A,N/A,261,279,N/A,131,3
7,N/A,N/A,N/A,1426,1433,N/A,5,1
7,N/A,N/A,N/A,1419,1426,N/A,11,1
25,N/A,N/A,N/A,1394,1419,N/A,14,4
18,N/A,N/A,N/A,1376,1394,N/A,19,3
44,N/A,N/A,N/A,1332,1376,N/A,22,6
28,N/A,N/A,N/A,1304,1332,N/A,26,4
23,N/A,N/A,N/A,1281,1304,N/A,31,3
41,N/A,N/A,N/A,1240,1281,N/A,34,6
23,N/A,N/A,N/A,1217,1240,N/A,38,4
23,N/A,N/A,N/A,1194,1217,N/A,44,4
23,N/A,N/A,N/A,1171,1194,N/A,49,3
13,N/A,N/A,N/A,1158,1171,N/A,53,1
44,N/A,N/A,N/A,1114,1158,N/A,58,6
5,N/A,N/A,N/A,1109,1114,N/A,64,0
32,N/A,N/A,N/A,1077,1109,N/A,69,5
15,N/A,N/A,N/A,1062,1077,N/A,73,3
7,N/A,N/A,N/A,1055,1062,N/A,77,1
32,N/A,N/A,N/A,1023,1055,N/A,80,4
13,N/A,N/A,N/A,1010,1023,N/A,84,2
10,N/A,N/A,N/A,1000,1010,N/A,89,1
33,N/A,N/A,N/A,967,1000,N/A,93,5
35,N/A,N/A,N/A,932,967,N/A,99,5
15,N/A,N/A,N/A,917,932,N/A,102,2
39,N/A,N/A,N/A,878,917,N/A,105,5
17,N/A,N/A,N/A,861,878,N/A,109,3
11,N/A,N/A,N/A,850,861,N/A,114,2
15,N/A,N/A,N/A,835,850,N/A,120,2
39,N/A,N/A,N/A,796,835,N/A,123,5
23,N/A,N/A,N/A,773,796,N/A,128,4
21,N/A,N/A,N/A,752,773,N/A,133,3
42,N/A,N/A,N/A,951,993,N/A,5,6
8,N/A,N/A,N/A,943,951,N/A,11,0
22,N/A,N/A,N/A,921,943,N/A,14,3
12,N/A,N/A,N/A,909,921,N/A,19,2
32,N/A,N/A,N/A,877,909,N/A,22,5
35,N/A,N/A,N/A,842,877,N/A,28,5
23,N/A,N/A,N/A,819,842,N/A,32,3
41,N/A,N/A,N/A,778,819,N/A,35,6
19,N/A,N/A,N/A,759,778,N/A,38,3
44,N/A,N/A,N/A,715,759,N/A,41,6
20,N/A,N/A,N/A,695,715,N/A,44,3
15,N/A,N/A,N/A,680,695,N/A,50,3
11,N/A,N/A,N/A,669,680,N/A,55,2
15,N/A,N/A,N/A,654,669,N/A,61,2
37,N/A,N/A,N/A,617,654,N/A,64,5
15,N/A,N/A,N/A,602,617,N/A,67,2
12,N/A,N/A,N/A,590,602,N/A,73,2
34,N/A,N/A,N/A,556,590,N/A,76,5
23,N/A,N/A,N/A,533,556,N/A,80,3
20,N/A,N/A,N/A,513,533,N/A,86,3
23,N/A,N/A,N/A,490,513,N/A,92,3
14,N/A,N/A,N/A,476,490,N/A,98,3
12,N/A,N/A,N/A,464,476,N/A,103,2
14,N/A,N/A,N/A,450,464,N/A,108,1
8,N/A,N/A,N/A,442,450,N/A,114,1
39,N/A,N/A,N/A,403,442,N/A,118,5
17,N/A,N/A,N/A,386,403,N/A,122,3
14,N/A,N/A,N/A,372,386,N/A,127,2
12,N/A,N/A,N/A,360,372,N/A,132,1
35,N/A,N/A,N/A,325,360,N/A,136,5
32,N/A,N/A,N/A,1707,1739,N/A,4,4
17,N/A,N/A,N/A,1690,1707,N/A,9,3
17,N/A,N/A,N/A,1673,1690,N/A,15,3
21,N/A,N/A,N/A,1652,1673,N/A,21,3
16,N/A,N/A,N/A,1636,1652,N/A,26,2
11,N/A,N/A,N/A,1625,1636,N/A,31,1
41,N/A,N/A,N/A,1584,1625,N/A,36,6
6,N/A,N/A,N/A,1578,1584,N/A,42,0
31,N/A,N/A,N/A,1547,1578,N/A,46,4
15,N/A,N/A,N/A,1532,1547,N/A,51,3
22,N/A,N/A,N/A,1510,1532,N/A,57,3
23,N/A,N/A,N/A,1487,1510,N/A,63,3
14,N/A,N/A,N/A,1473,1487,N/A,69,3
16,N/A,N/A,N/A,1457,1473,N/A,75,3
22,N/A,N/A,N/A,1435,1457,N/A,81,3
13,N/A,N/A,N/A,1422,1435,N/A,85,1
43,N/A,N/A,N/A,1379,1422,N/A,90,6
6,N/A,N/A,N/A,1373,1379,N/A,96,0
44,N/A,N/A,N/A,1329,1373,N/A,102,6
22,N/A,N/A,N/A,1307,1329,N/A,106,4
12,N/A,N/A,N/A,1295,1307,N/A,110,2
11,N/A,N/A,N/A,1284,1295,N/A,115,1
26,N/A,N/A,N/A,1258,1284,N/A,118,4
17,N/A,N/A,N/A,1241,1258,N/A,123,3
22,N/A,N/A,N/A,1219,1241,N/A,129,3
16,N/A,N/A,N/A,1203,1219,N/A,135,3
17,N/A,N/A,N/A,1186,1203,N/A,140,2
44,N/A,N/A,N/A,1142,1186,N/A,144,6
7,N/A,N/A,N/A,1135,1142,N/A,150,0
19,N/A,N/A,N/A,1116,1135,N/A,153,3
18,N/A,N/A,N/A,1110,1128,N/A,6,3
11,N/A,N/A,N/A,1099,1110,N/A,10,1
25,N/A,N/A,N/A,1074,1099,N/A,13,4
13,N/A,N/A,N/A,1061,1074,N/A,17,2
13,N/A,N/A,N/A,1048,1061,N/A,22,1
35,N/A,N/A,N/A,1013,1048,N/A,26,5
27,N/A,N/A,N/A,986,1013,N/A,31,4
19,N/A,N/A,N/A,967,986,N/A,36,3
14,N/A,N/A,N/A,953,967,N/A,40,1
7,N/A,N/A,N/A,946,953,N/A,46,1
10,N/A,N/A,N/A,936,946,N/A,52,1
37,N/A,N/A,N/A,899,936,N/A,56,5
13,N/A,N/A,N/A,886,899,N/A,59,2
8,N/A,N/A,N/A,878,886,N/A,64,1
44,N/A,N/A,N/A,834,878,N/A,69,6
5,N/A,N/A,N/A,829,834,N/A,75,0
39,N/A,N/A,N/A,790,829,N/A,80,5
31,N/A,N/A,N/A,759,790,N/A,85,4
15,N/A,N/A,N/A,744,759,N/A,89,2
34,N/A,N/A,N/A,710,744,N/A,92,5
16,N/A,N/A,N/A,694,710,N/A,95,2
16,N/A,N/A,N/A,678,694,N/A,101,2
17,N/A,N/A,N/A,661,678,N/A,107,2
13,N/A,N/A,N/A,648,661,N/A,112,1
9,N/A,N/A,N/A,639,648,N/A,118,1
30,N/A,N/A,N/A,609,639,N/A,121,4
20,N/A,N/A,N/A,589,609,N/A,126,3
13,N/A,N/A,N/A,576,589,N/A,131,2
12,N/A,N/A,N/A,564,576,N/A,136,1
39,N/A,N/A,N/A,525,564,N/A,140,5
14,N/A,N/A,N/A,1116,1130,N/A,3,1
9,N/A,N/A,N/A,1107,1116,N/A,9,1
9,N/A,N/A,N/A,1098,1107,N/A,15,1
13,N/A,N/A,N/A,1085,1098,N/A,21,1
32,N/A,N/A,N/A,1053,1085,N/A,25,5
11,N/A,N/A,N/A,1042,1053,N/A,28,2
14,N/A,N/A,N/A,1028,1042,N/A,34,2
41,N/A,N/A,N/A,987,1028,N/A,38,6
39,N/A,N/A,N/A,948,987,N/A,43,5
32,N/A,N/A,N/A,916,948,N/A,49,5
13,N/A,N/A,N/A,903,916,N/A,52,2
32,N/A,N/A,N/A,871,903,N/A,55,5
31,N/A,N/A,N/A,840,871,N/A,60,4
15,N/A,N/A,N/A,825,840,N/A,64,2
41,N/A,N/A,N/A,784,825,N/A,68,6
25,N/A,N/A,N/A,759,784,N/A,72,4
30,N/A,N/A,N/A,729,759,N/A,78,4
17,N/A,N/A,N/A,712,729,N/A,83,3
18,N/A,N/A,N/A,694,712,N/A,89,3
17,N/A,N/A,N/A,677,694,N/A,95,3
42,N/A,N/A,N/A,635,677,N/A,98,6
33,N/A,N/A,N/A,602,635,N/A,103,5
23,N/A,N/A,N/A,579,602,N/A,107,3
17,N/A,N/A,N/A,562,579,N/A,113,3
19,N/A,N/A,N/A,543,562,N/A,119,3
18,N/A,N/A,N/A,525,543,N/A,125,3
17,N/A,N/A,N/A,508,525,N/A,130,2
11,N/A,N/A,N/A,497,508,N/A,136,2
42,N/A,N/A,N/A,455,497,N/A,140,6
16,N/A,N/A,N/A,439,455,N/A,143,3
28,N/A,N/A,N/A,744,772,N/A,6,4
15,N/A,N/A,N/A,729,744,N/A,11,3
19,N/A,N/A,N/A,710,729,N/A,17,3
43,N/A,N/A,N/A,667,710,N/A,20,6
23,N/A,N/A,N/A,644,667,N/A,24,4
14,N/A,N/A,N/A,630,644,N/A,27,1
14,N/A,N/A,N/A,616,630,N/A,33,1
44,N/A,N/A,N/A,572,616,N/A,38,6
23,N/A,N/A,N/A,549,572,N/A,41,3
19,N/A,N/A,N/A,530,549,N/A,47,3
21,N/A,N/A,N/A,509,530,N/A,53,3
11,N/A,N/A,N/A,498,509,N/A,57,1
13,N/A,N/A,N/A,485,498,N/A,63,1
41,N/A,N/A,N/A,444,485,N/A,68,6
18,N/A,N/A,N/A,426,444,N/A,71,3
9,N/A,N/A,N/A,417,426,N/A,75,1
44,N/A,N/A,N/A,373,417,N/A,80,6
22,N/A,N/A,N/A,351,373,N/A,84,4
16,N/A,N/A,N/A,335,351,N/A,88,2
41,N/A,N/A,N/A,294,335,N/A,92,6
25,N/A,N/A,N/A,269,294,N/A,96,4
26,N/A,N/A,N/A,243,269,N/A,102,4
15,N/A,N/A,N/A,228,243,N/A,107,3
18,N/A,N/A,N/A,210,228,N/A,113,3
14,N/A,N/A,N/A,196,210,N/A,117,1
30,N/A,N/A,N/A,166,196,N/A,120,4
32,N/A,N/A,N/A,134,166,N/A,126,4
19,N/A,N/A,N/A,115,134,N/A,131,3
43,N/A,N/A,N/A,72,115,N/A,134,6
23,N/A,N/A,N/A,49,72,N/A,137,3
13,N/A,N/A,N/A,574,587,N/A,5,2
10,N/A,N/A,N/A,564,574,N/A,10,1
26,N/A,N/A,N/A,538,564,N/A,13,4
15,N/A,N/A,N/A,523,538,N/A,18,3
11,N/A,N/A,N/A,512,523,N/A,23,2
9,N/A,N/A,N/A,503,512,N/A,28,1
22,N/A,N/A,N/A,481,503,N/A,31,4
14,N/A,N/A,N/A,467,481,N/A,36,3
18,N/A,N/A,N/A,449,467,N/A,42,3
42,N/A,N/A,N/A,407,449,N/A,45,6
32,N/A,N/A,N/A,375,407,N/A,49,4
10,N/A,N/A,N/A,365,375,N/A,52,1
43,N/A,N/A,N/A,322,365,N/A,57,6
15,N/A,N/A,N/A,307,322,N/A,60,3
42,N/A,N/A,N/A,265,307,N/A,63,6
5,N/A,N/A,N/A,260,265,N/A,69,0
28,N/A,N/A,N/A,232,260,N/A,73,4
15,N/A,N/A,N/A,217,232,N/A,78,3
14,N/A,N/A,N/A,203,217,N/A,84,3
10,N/A,N/A,N/A,193,203,N/A,88,1
42,N/A,N/A,N/A,151,193,N/A,93,6
32,N/A,N/A,N/A,119,151,N/A,98,5
18,N/A,N/A,N/A,101,119,N/A,102,3
11,N/A,N/A,N/A,90,101,N/A,106,1
22,N/A,N/A,N/A,68,90,N/A,109,4
12,N/A,N/A,N/A,56,68,N/A,113,2
43,N/A,N/A,N/A,13,56,N/A,117,6
6,N/A,N/A,N/A,7,13,N/A,123,0
42,N/A,N/A,N/A,-35,7,N/A,129,6
26,N/A,N/A,N/A,1338,1364,N/A,6,4
29,N/A,N/A,N/A,1309,1338,N/A,12,4
21,N/A,N/A,N/A,1288,1309,N/A,17,3
14,N/A,N/A,N/A,1274,1288,N/A,21,1
35,N/A,N/A,N/A,1239,1274,N/A,25,5
36,N/A,N/A,N/A,1203,1239,N/A,31,5
33,N/A,N/A,N/A,1170,1203,N/A,37,5
32,N/A,N/A,N/A,1138,1170,N/A,43,5
13,N/A,N/A,N/A,1125,1138,N/A,46,2
9,N/A,N/A,N/A,1116,1125,N/A,51,1
44,N/A,N/A,N/A,1072,1116,N/A,56,6
23,N/A,N/A,N/A,1049,1072,N/A,59,3
44,N/A,N/A,N/A,1005,1049,N/A,62,6
27,N/A,N/A,N/A,978,1005,N/A,66,4
21,N/A,N/A,N/A,957,978,N/A,71,3
9,N/A,N/A,N/A,948,957,N/A,75,1
8,N/A,N/A,N/A,940,948,N/A,81,1
28,N/A,N/A,N/A,912,940,N/A,84,4
13,N/A,N/A,N/A,899,912,N/A,87,1
9,N/A,N/A,N/A,890,899,N/A,93,1
44,N/A,N/A,N/A,846,890,N/A,98,6
5,N/A,N/A,N/A,841,846,N/A,104,0
44,N/A,N/A,N/A,797,841,N/A,110,6
22,N/A,N/A,N/A,775,797,N/A,113,3
8,N/A,N/A,N/A,767,775,N/A,117,1
42,N/A,N/A,N/A,725,767,N/A,122,6
32,N/A,N/A,N/A,693,725,N/A,127,5
39,N/A,N/A,N/A,654,693,N/A,133,5
32,N/A,N/A,N/A,622,654,N/A,139,5
22,N/A,N/A,N/A,600,622,N/A,144,4
32,N/A,N/A,N/A,926,958,N/A,4,4
13,N/A,N/A,N/A,913,926,N/A,8,2
37,N/A,N/A,N/A,876,913,N/A,11,5
32,N/A,N/A,N/A,844,876,N/A,17,5
33,N/A,N/A,N/A,811,844,N/A,23,5
32,N/A,N/A,N/A,779,811,N/A,28,4
13,N/A,N/A,N/A,766,779,N/A,31,1
41,N/A,N/A,N/A,725,766,N/A,36,6
36,N/A,N/A,N/A,689,725,N/A,41,5
11,N/A,N/A,N/A,678,689,N/A,44,2
14,N/A,N/A,N/A,664,678,N/A,49,1
30,N/A,N/A,N/A,634,664,N/A,52,4
7,N/A,N/A,N/A,627,634,N/A,55,1
37,N/A,N/A,N/A,590,627,N/A,59,5
22,N/A,N/A,N/A,568,590,N/A,63,3
23,N/A,N/A,N/A,545,568,N/A,69,3
13,N/A,N/A,N/A,532,545,N/A,73,1
43,N/A,N/A,N/A,489,532,N/A,78,6
30,N/A,N/A,N/A,459,489,N/A,82,4
13,N/A,N/A,N/A,446,459,N/A,86,2
8,N/A,N/A,N/A,438,446,N/A,91,1
39,N/A,N/A,N/A,399,438,N/A,95,5
26,N/A,N/A,N/A,373,399,N/A,100,4
19,N/A,N/A,N/A,354,373,N/A,105,3
14,N/A,N/A,N/A,340,354,N/A,110,2
12,N/A,N/A,N/A,328,340,N/A,116,2
17,N/A,N/A,N/A,311,328,N/A,122,2
42,N/A,N/A,N/A,269,311,N/A,126,6
36,N/A,N/A,N/A,233,269,N/A,131,5
17,N/A,N/A,N/A,216,233,N/A,135,3
12,N/A,N/A,N/A,450,462,N/A,6,1
44,N/A,N/A,N/A,406,450,N/A,11,6
20,N/A,N/A,N/A,386,406,N/A,14,3
42,N/A,N/A,N/A,344,386,N/A,17,6
35,N/A,N/A,N/A,309,344,N/A,22,5
39,N/A,N/A,N/A,270,309,N/A,28,5
33,N/A,N/A,N/A,237,270,N/A,34,5
24,N/A,N/A,N/A,213,237,N/A,39,4
29,N/A,N/A,N/A,184,213,N/A,45,4
22,N/A,N/A,N/A,162,184,N/A,51,4
17,N/A,N/A,N/A,145,162,N/A,55,2
12,N/A,N/A,N/A,133,145,N/A,61,2
12,N/A,N/A,N/A,121,133,N/A,67,2
7,N/A,N/A,N/A,114,121,N/A,72,1
23,N/A,N/A,N/A,91,114,N/A,75,4
13,N/A,N/A,N/A,78,91,N/A,78,1
7,N/A,N/A,N/A,71,78,N/A,84,1
12,N/A,N/A,N/A,59,71,N/A,90,1
24,N/A,N/A,N/A,35,59,N/A,93,4
28,N/A,N/A,N/A,7,35,N/A,99,4
19,N/A,N/A,N/A,-12,7,N/A,104,3
42,N/A,N/A,N/A,1746,1788,N/A,6,6
37,N/A,N/A,N/A,1709,1746,N/A,11,5
21,N/A,N/A,N/A,1688,1709,N/A,15,3
19,N/A,N/A,N/A,1669,1688,N/A,21,3
8,N/A,N/A,N/A,1661,1669,N/A,25,1
13,N/A,N/A,N/A,1648,1661,N/A,31,1
44,N/A,N/A,N/A,1604,1648,N/A,36,6
39,N/A,N/A,N/A,1565,1604,N/A,41,5
37,N/A,N/A,N/A,1528,1565,N/A,47,5
23,N/A,N/A,N/A,1505,1528,N/A,51,3
43,N/A,N/A,N/A,1462,1505,N/A,54,6
29,N/A,N/A,N/A,1433,1462,N/A,58,4
21,N/A,N/A,N/A,1412,1433,N/A,63,3
12,N/A,N/A,N/A,1400,1412,N/A,68,2
42,N/A,N/A,N/A,1358,1400,N/A,72,6
22,N/A,N/A,N/A,1336,1358,N/A,75,3
13,N/A,N/A,N/A,1323,1336,N/A,80,2
13,N/A,N/A,N/A,1310,1323,N/A,85,1
35,N/A,N/A,N/A,1275,1310,N/A,89,5
14,N/A,N/A,N/A,1261,1275,N/A,92,2
12,N/A,N/A,N/A,1249,1261,N/A,98,2
11,N/A,N/A,N/A,1238,1249,N/A,103,1
41,N/A,N/A,N/A,1197,1238,N/A,108,6
23,N/A,N/A,N/A,1174,1197,N/A,111,3
15,N/A,N/A,N/A,1159,1174,N/A,116,2
13,N/A,N/A,N/A,1146,1159,N/A,121,1
27,N/A,N/A,N/A,1119,1146,N/A,124,4
13,N/A,N/A,N/A,1106,1119,N/A,128,2
39,N/A,N/A,N/A,1067,1106,N/A,131,5
33,N/A,N/A,N/A,1034,1067,N/A,137,5
11,N/A,N/A,N/A,1225,1236,N/A,3,2
16,N/A,N/A,N/A,1209,1225,N/A,9,2
14,N/A,N/A,N/A,1195,1209,N/A,15,2
10,N/A,N/A,N/A,1185,1195,N/A,21,2
12,N/A,N/A,N/A,1173,1185,N/A,27,2
11,N/A,N/A,N/A,1162,1173,N/A,32,1
8,N/A,N/A,N/A,1154,1162,N/A,38,1
14,N/A,N/A,N/A,1140,1154,N/A,44,1
44,N/A,N/A,N/A,1096,1140,N/A,49,6
17,N/A,N/A,N/A,1079,1096,N/A,52,3
15,N/A,N/A,N/A,1064,1079,N/A,57,2
9,N/A,N/A,N/A,1055,1064,N/A,62,1
25,N/A,N/A,N/A,1030,1055,N/A,65,4
22,N/A,N/A,N/A,1008,1030,N/A,70,3
16,N/A,N/A,N/A,992,1008,N/A,75,2
35,N/A,N/A,N/A,957,992,N/A,78,5
15,N/A,N/A,N/A,942,957,N/A,82,3
20,N/A,N/A,N/A,922,942,N/A,88,3
12,N/A,N/A,N/A,910,922,N/A,93,2
17,N/A,N/A,N/A,893,910,N/A,99,2
39,N/A,N/A,N/A,854,893,N/A,102,5
30,N/A,N/A,N/A,824,854,N/A,107,4
20,N/A,N/A,N/A,804,824,N/A,112,3
14,N/A,N/A,N/A,790,804,N/A,117,2
37,N/A,N/A,N/A,753,790,N/A,120,5
23,N/A,N/A,N/A,730,753,N/A,125,4
31,N/A,N/A,N/A,699,730,N/A,131,4
8,N/A,N/A,N/A,691,699,N/A,134,1
32,N/A,N/A,N/A,659,691,N/A,138,5
12,N/A,N/A,N/A,647,659,N/A,141,2
34,N/A,N/A,N/A,1446,1480,N/A,5,5
31,N/A,N/A,N/A,1415,1446,N/A,10,4
9,N/A,N/A,N/A,1406,1415,N/A,13,1
41,N/A,N/A,N/A,1365,1406,N/A,18,6
22,N/A,N/A,N/A,1343,1365,N/A,21,3
44,N/A,N/A,N/A,1299,1343,N/A,24,6
27,N/A,N/A,N/A,1272,1299,N/A,28,4
16,N/A,N/A,N/A,1256,1272,N/A,32,2
17,N/A,N/A,N/A,1239,1256,N/A,38,2
43,N/A,N/A,N/A,1196,1239,N/A,42,6
6,N/A,N/A,N/A,1190,1196,N/A,48,0
22,N/A,N/A,N/A,1168,1190,N/A,52,4
8,N/A,N/A,N/A,1160,1168,N/A,55,1
29,N/A,N/A,N/A,1131,1160,N/A,58,4
11,N/A,N/A,N/A,1120,1131,N/A,61,1
13,N/A,N/A,N/A,1107,1120,N/A,67,1
13,N/A,N/A,N/A,1094,1107,N/A,73,1
44,N/A,N/A,N/A,1050,1094,N/A,78,6
35,N/A,N/A,N/A,1015,1050,N/A,83,5
32,N/A,N/A,N/A,983,1015,N/A,88,4
12,N/A,N/A,N/A,971,983,N/A,91,1
27,N/A,N/A,N/A,944,971,N/A,94,4
32,N/A,N/A,N/A,912,944,N/A,100,4
23,N/A,N/A,N/A,889,912,N/A,106,4
17,N/A,N/A,N/A,872,889,N/A,111,3
20,N/A,N/A,N/A,852,872,N/A,117,3
9,N/A,N/A,N/A,843,852,N/A,121,1
44,N/A,N/A,N/A,799,843,N/A,126,6
36,N/A,N/A,N/A,763,799,N/A,131,5
15,N/A,N/A,N/A,748,763,N/A,135,3
41,N/A,N/A,N/A,1716,1757,N/A,3,6
22,N/A,N/A,N/A,1694,1716,N/A,7,4
14,N/A,N/A,N/A,1680,1694,N/A,10,1
41,N/A,N/A,N/A,1639,1680,N/A,15,6
34,N/A,N/A,N/A,1605,1639,N/A,20,5
21,N/A,N/A,N/A,1584,1605,N/A,24,3
12,N/A,N/A,N/A,1572,1584,N/A,29,2
39,N/A,N/A,N/A,1533,1572,N/A,32,5
13,N/A,N/A,N/A,1520,1533,N/A,35,2
37,N/A,N/A,N/A,1483,1520,N/A,38,5
33,N/A,N/A,N/A,1450,1483,N/A,44,5
35,N/A,N/A,N/A,1415,1450,N/A,50,5
15,N/A,N/A,N/A,1400,1415,N/A,53,2
10,N/A,N/A,N/A,1390,1400,N/A,58,1
29,N/A,N/A,N/A,1361,1390,N/A,61,4
17,N/A,N/A,N/A,1344,1361,N/A,65,2
37,N/A,N/A,N/A,1307,1344,N/A,68,5
10,N/A,N/A,N/A,1297,1307,N/A,71,2
10,N/A,N/A,N/A,1287,1297,N/A,76,1
26,N/A,N/A,N/A,1261,1287,N/A,79,4
25,N/A,N/A,N/A,1236,1261,N/A,85,4
23,N/A,N/A,N/A,1213,1236,N/A,91,4
17,N/A,N/A,N/A,1196,1213,N/A,95,2
38,N/A,N/A,N/A,1158,1196,N/A,98,5
20,N/A,N/A,N/A,1138,1158,N/A,102,3
13,N/A,N/A,N/A,1125,1138,N/A,107,2
36,N/A,N/A,N/A,1089,1125,N/A,110,5
29,N/A,N/A,N/A,1060,1089,N/A,115,4
12,N/A,N/A,N/A,1048,1060,N/A,119,2
43,N/A,N/A,N/A,1005,1048,N/A,123,6
37,N/A,N/A,N/A,812,849,N/A,4,5
22,N/A,N/A,N/A,790,812,N/A,8,3
9,N/A,N/A,N/A,781,790,N/A,12,1
12,N/A,N/A,N/A,769,781,N/A,18,1
28,N/A,N/A,N/A,741,769,N/A,21,4
28,N/A,N/A,N/A,713,741,N/A,27,4
16,N/A,N/A,N/A,697,713,N/A,31,2
38,N/A,N/A,N/A,659,697,N/A,34,5
10,N/A,N/A,N/A,649,659,N/A,37,2
9,N/A,N/A,N/A,640,649,N/A,42,1
38,N/A,N/A,N/A,602,640,N/A,46,5
13,N/A,N/A,N/A,589,602,N/A,49,2
13,N/A,N/A,N/A,576,589,N/A,55,2
42,N/A,N/A,N/A,534,576,N/A,59,6
35,N/A,N/A,N/A,499,534,N/A,64,5
39,N/A,N/A,N/A,460,499,N/A,70,5
10,N/A,N/A,N/A,450,460,N/A,73,2
41,N/A,N/A,N/A,409,450,N/A,77,6
32,N/A,N/A,N/A,377,409,N/A,82,5
21,N/A,N/A,N/A,356,377,N/A,86,3
44,N/A,N/A,N/A,312,356,N/A,89,6
8,N/A,N/A,N/A,304,312,N/A,95,0
15,N/A,N/A,N/A,289,304,N/A,98,3
8,N/A,N/A,N/A,281,289,N/A,102,1
41,N/A,N/A,N/A,240,281,N/A,107,6
19,N/A,N/A,N/A,221,240,N/A,110,3
14,N/A,N/A,N/A,207,221,N/A,116,3
41,N/A,N/A,N/A,166,207,N/A,119,6
29,N/A,N/A,N/A,137,166,N/A,123,4
14,N/A,N/A,N/A,123,137,N/A,127,2
14,N/A,N/A,N/A,1049,1063,N/A,5,2
12,N/A,N/A,N/A,1037,1049,N/A,11,2
37,N/A,N/A,N/A,1000,1037,N/A,14,5
27,N/A,N/A,N/A,973,1000,N/A,19,4
17,N/A,N/A,N/A,956,973,N/A,23,2
13,N/A,N/A,N/A,943,956,N/A,28,1
42,N/A,N/A,N/A,901,943,N/A,33,6
21,N/A,N/A,N/A,880,901,N/A,36,3
13,N/A,N/A,N/A,867,880,N/A,40,1
9,N/A,N/A,N/A,858,867,N/A,46,1
35,N/A,N/A,N/A,823,858,N/A,50,5
16,N/A,N/A,N/A,807,823,N/A,53,2
41,N/A,N/A,N/A,766,807,N/A,57,6
23,N/A,N/A,N/A,743,766,N/A,61,4
32,N/A,N/A,N/A,711,743,N/A,67,4
11,N/A,N/A,N/A,700,711,N/A,71,2
13,N/A,N/A,N/A,687,700,N/A,76,1
32,N/A,N/A,N/A,655,687,N/A,80,5
11,N/A,N/A,N/A,644,655,N/A,83,2
41,N/A,N/A,N/A,603,644,N/A,87,6
30,N/A,N/A,N/A,573,603,N/A,91,4
9,N/A,N/A,N/A,564,573,N/A,94,1
26,N/A,N/A,N/A,538,564,N/A,97,4
17,N/A,N/A,N/A,521,538,N/A,101,2
43,N/A,N/A,N/A,478,521,N/A,105,6
32,N/A,N/A,N/A,446,478,N/A,109,4
16,N/A,N/A,N/A,430,446,N/A,113,2
10,N/A,N/A,N/A,420,430,N/A,119,2
44,N/A,N/A,N/A,376,420,N/A,123,6
7,N/A,N/A,N/A,369,376,N/A,129,0
36,N/A,N/A,N/A,1915,1951,N/A,5,5
33,N/A,N/A,N/A,1882,1915,N/A,11,5
29,N/A,N/A,N/A,1853,1882,N/A,16,4
9,N/A,N/A,N/A,1844,1853,N/A,19,1
8,N/A,N/A,N/A,1836,1844,N/A,25,1
34,N/A,N/A,N/A,1802,1836,N/A,29,5
39,N/A,N/A,N/A,1763,1802,N/A,35,5
23,N/A,N/A,N/A,1740,1763,N/A,39,3
43,N/A,N/A,N/A,1697,1740,N/A,42,6
9,N/A,N/A,N/A,1688,1697,N/A,48,0
28,N/A,N/A,N/A,1660,1688,N/A,52,4
12,N/A,N/A,N/A,1648,1660,N/A,55,1
24,N/A,N/A,N/A,1624,1648,N/A,58,4
18,N/A,N/A,N/A,1606,1624,N/A,63,3
42,N/A,N/A,N/A,1564,1606,N/A,66,6
23,N/A,N/A,N/A,1541,1564,N/A,69,3
13,N/A,N/A,N/A,1528,1541,N/A,73,1
34,N/A,N/A,N/A,1494,1528,N/A,77,5
16,N/A,N/A,N/A,1478,1494,N/A,81,3
19,N/A,N/A,N/A,1459,1478,N/A,87,3
14,N/A,N/A,N/A,1445,1459,N/A,92,2
34,N/A,N/A,N/A,1411,1445,N/A,95,5
13,N/A,N/A,N/A,1398,1411,N/A,98,2
38,N/A,N/A,N/A,1360,1398,N/A,101,5
15,N/A,N/A,N/A,1345,1360,N/A,105,3
42,N/A,N/A,N/A,1303,1345,N/A,108,6
30,N/A,N/A,N/A,1273,1303,N/A,112,4
22,N/A,N/A,N/A,1251,1273,N/A,117,3
41,N/A,N/A,N/A,1210,1251,N/A,120,6
6,N/A,N/A,N/A,1204,1210,N/A,126,0
22,N/A,N/A,N/A,344,366,N/A,5,3
42,N/A,N/A,N/A,302,344,N/A,8,6
38,N/A,N/A,N/A,264,302,N/A,13,5
29,N/A,N/A,N/A,235,264,N/A,18,4
13,N/A,N/A,N/A,222,235,N/A,22,2
12,N/A,N/A,N/A,210,222,N/A,28,2
13,N/A,N/A,N/A,197,210,N/A,34,2
10,N/A,N/A,N/A,187,197,N/A,40,2
16,N/A,N/A,N/A,171,187,N/A,46,2
37,N/A,N/A,N/A,134,171,N/A,49,5
26,N/A,N/A,N/A,108,134,N/A,54,4
8,N/A,N/A,N/A,100,108,N/A,57,1
37,N/A,N/A,N/A,63,100,N/A,61,5
22,N/A,N/A,N/A,41,63,N/A,66,4
15,N/A,N/A,N/A,26,41,N/A,70,2
44,N/A,N/A,N/A,-18,26,N/A,74,6
32,N/A,N/A,N/A,1069,1101,N/A,3,5
23,N/A,N/A,N/A,1046,1069,N/A,8,4
22,N/A,N/A,N/A,1024,1046,N/A,14,4
32,N/A,N/A,N/A,992,1024,N/A,20,4
32,N/A,N/A,N/A,960,992,N/A,26,4
15,N/A,N/A,N/A,945,960,N/A,31,3
23,N/A,N/A,N/A,922,945,N/A,37,3
23,N/A,N/A,N/A,899,922,N/A,43,3
20,N/A,N/A,N/A,879,899,N/A,49,3
23,N/A,N/A,N/A,856,879,N/A,55,3
21,N/A,N/A,N/A,835,856,N/A,61,3
14,N/A,N/A,N/A,821,835,N/A,66,2
43,N/A,N/A,N/A,778,821,N/A,70,6
36,N/A,N/A,N/A,742,778,N/A,75,5
15,N/A,N/A,N/A,727,742,N/A,79,3
22,N/A,N/A,N/A,705,727,N/A,85,3
14,N/A,N/A,N/A,691,705,N/A,91,3
42,N/A,N/A,N/A,649,691,N/A,94,6
7,N/A,N/A,N/A,642,649,N/A,100,0
14,N/A,N/A,N/A,628,642,N/A,103,3
17,N/A,N/A,N/A,611,628,N/A,109,3
43,N/A,N/A,N/A,568,611,N/A,112,6
26,N/A,N/A,N/A,542,568,N/A,116,4
13,N/A,N/A,N/A,529,542,N/A,120,2
36,N/A,N/A,N/A,493,529,N/A,123,5
34,N/A,N/A,N/A,459,493,N/A,129,5
32,N/A,N/A,N/A,427,459,N/A,135,5
34,N/A,N/A,N/A,393,427,N/A,141,5
38,N/A,N/A,N/A,355,393,N/A,147,5
17,N/A,N/A,N/A,338,355,N/A,151,3
33,N/A,N/A,N/A,1581,1614,N/A,5,5
16,N/A,N/A,N/A,1565,1581,N/A,9,3
16,N/A,N/A,N/A,1549,1565,N/A,15,3
15,N/A,N/A,N/A,1534,1549,N/A,20,2
42,N/A,N/A,N/A,1492,1534,N/A,24,6
23,N/A,N/A,N/A,1469,1492,N/A,27,3
19,N/A,N/A,N/A,1450,1469,N/A,33,3
44,N/A,N/A,N/A,1406,1450,N/A,36,6
27,N/A,N/A,N/A,1379,1406,N/A,40,4
10,N/A,N/A,N/A,1369,1379,N/A,43,1
32,N/A,N/A,N/A,1337,1369,N/A,47,5
12,N/A,N/A,N/A,1325,1337,N/A,50,2
39,N/A,N/A,N/A,1286,1325,N/A,53,5
38,N/A,N/A,N/A,1248,1286,N/A,59,5
22,N/A,N/A,N/A,1226,1248,N/A,63,3
41,N/A,N/A,N/A,1185,1226,N/A,66,6
35,N/A,N/A,N/A,1150,1185,N/A,71,5
12,N/A,N/A,N/A,1138,1150,N/A,74,2
36,N/A,N/A,N/A,1102,1138,N/A,77,5
32,N/A,N/A,N/A,1070,1102,N/A,83,5
28,N/A,N/A,N/A,1042,1070,N/A,88,4
23,N/A,N/A,N/A,1019,1042,N/A,93,3
41,N/A,N/A,N/A,978,1019,N/A,96,6
34,N/A,N/A,N/A,944,978,N/A,101,5
29,N/A,N/A,N/A,915,944,N/A,106,4
10,N/A,N/A,N/A,905,915,N/A,109,1
44,N/A,N/A,N/A,861,905,N/A,114,6
32,N/A,N/A,N/A,829,861,N/A,118,4
29,N/A,N/A,N/A,800,829,N/A,124,4
26,N/A,N/A,N/A,774,800,N/A,130,4
41,N/A,N/A,N/A,1491,1532,N/A,4,6
19,N/A,N/A,N/A,1472,1491,N/A,7,3
44,N/A,N/A,N/A,1428,1472,N/A,10,6
29,N/A,N/A,N/A,1399,1428,N/A,14,4
23,N/A,N/A,N/A,1376,1399,N/A,20,4
12,N/A,N/A,N/A,1364,1376,N/A,24,2
11,N/A,N/A,N/A,1353,1364,N/A,30,2
11,N/A,N/A,N/A,1342,1353,N/A,35,1
44,N/A,N/A,N/A,1298,1342,N/A,40,6
27,N/A,N/A,N/A,1271,1298,N/A,44,4
23,N/A,N/A,N/A,1248,1271,N/A,49,3
42,N/A,N/A,N/A,1206,1248,N/A,52,6
29,N/A,N/A,N/A,1177,1206,N/A,56,4
15,N/A,N/A,N/A,1162,1177,N/A,60,2
12,N/A,N/A,N/A,1150,1162,N/A,66,2
44,N/A,N/A,N/A,1106,1150,N/A,70,6
18,N/A,N/A,N/A,1088,1106,N/A,73,3
44,N/A,N/A,N/A,1044,1088,N/A,76,6
32,N/A,N/A,N/A,1012,1044,N/A,81,5
20,N/A,N/A,N/A,992,1012,N/A,85,3
20,N/A,N/A,N/A,972,992,N/A,91,3
19,N/A,N/A,N/A,953,972,N/A,97,3
42,N/A,N/A,N/A,911,953,N/A,100,6
39,N/A,N/A,N/A,872,911,N/A,105,5
39,N/A,N/A,N/A,833,872,N/A,111,5
26,N/A,N/A,N/A,807,833,N/A,116,4
16,N/A,N/A,N/A,791,807,N/A,120,2
41,N/A,N/A,N/A,750,791,N/A,124,6
8,N/A,N/A,N/A,742,750,N/A,130,0
37,N/A,N/A,N/A,705,742,N/A,135,5
21,N/A,N/A,N/A,855,876,N/A,4,3
43,N/A,N/A,N/A,812,855,N/A,7,6
8,N/A,N/A,N/A,804,812,N/A,13,0
37,N/A,N/A,N/A,767,804,N/A,18,5
38,N/A,N/A,N/A,729,767,N/A,24,5
27,N/A,N/A,N/A,702,729,N/A,29,4
7,N/A,N/A,N/A,695,702,N/A,32,1
43,N/A,N/A,N/A,652,695,N/A,37,6
39,N/A,N/A,N/A,613,652,N/A,42,5
26,N/A,N/A,N/A,587,613,N/A,47,4
31,N/A,N/A,N/A,556,587,N/A,53,4
17,N/A,N/A,N/A,539,556,N/A,58,3
17,N/A,N/A,N/A,522,539,N/A,64,3
20,N/A,N/A,N/A,502,522,N/A,70,3
16,N/A,N/A,N/A,486,502,N/A,75,2
15,N/A,N/A,N/A,471,486,N/A,81,2
44,N/A,N/A,N/A,427,471,N/A,85,6
28,N/A,N/A,N/A,399,427,N/A,89,4
11,N/A,N/A,N/A,388,399,N/A,92,1
34,N/A,N/A,N/A,354,388,N/A,96,5
36,N/A,N/A,N/A,318,354,N/A,102,5
15,N/A,N/A,N/A,303,318,N/A,106,3
12,N/A,N/A,N/A,291,303,N/A,111,2
44,N/A,N/A,N/A,247,291,N/A,115,6
6,N/A,N/A,N/A,241,247,N/A,121,0
42,N/A,N/A,N/A,199,241,N/A,127,6
6,N/A,N/A,N/A,193,199,N/A,133,0
23,N/A,N/A,N/A,170,193,N/A,136,3
18,N/A,N/A,N/A,152,170,N/A,142,3
9,N/A,N/A,N/A,143,152,N/A,146,1
22,N/A,N/A,N/A,907,929,N/A,3,3
10,N/A,N/A,N/A,897,907,N/A,8,2
8,N/A,N/A,N/A,889,897,N/A,13,1
36,N/A,N/A,N/A,853,889,N/A,17,5
14,N/A,N/A,N/A,839,853,N/A,20,2
16,N/A,N/A,N/A,823,839,N/A,26,2
36,N/A,N/A,N/A,787,823,N/A,29,5
15,N/A,N/A,N/A,772,787,N/A,33,3
13,N/A,N/A,N/A,759,772,N/A,37,1
11,N/A,N/A,N/A,748,759,N/A,43,1
42,N/A,N/A,N/A,706,748,N/A,48,6
29,N/A,N/A,N/A,677,706,N/A,52,4
14,N/A,N/A,N/A,663,677,N/A,55,1
32,N/A,N/A,N/A,631,663,N/A,59,5
18,N/A,N/A,N/A,613,631,N/A,63,3
12,N/A,N/A,N/A,601,613,N/A,68,2
14,N/A,N/A,N/A,587,601,N/A,74,2
44,N/A,N/A,N/A,543,587,N/A,78,6
15,N/A,N/A,N/A,528,543,N/A,81,3
10,N/A,N/A,N/A,518,528,N/A,85,1
7,N/A,N/A,N/A,511,518,N/A,91,1
31,N/A,N/A,N/A,480,511,N/A,94,4
23,N/A,N/A,N/A,457,480,N/A,99,3
23,N/A,N/A,N/A,434,457,N/A,105,3
43,N/A,N/A,N/A,391,434,N/A,108,6
32,N/A,N/A,N/A,359,391,N/A,113,5
16,N/A,N/A,N/A,343,359,N/A,117,3
13,N/A,N/A,N/A,330,343,N/A,122,2
8,N/A,N/A,N/A,322,330,N/A,127,1
33,N/A,N/A,N/A,289,322,N/A,131,5
34,N/A,N/A,N/A,559,593,N/A,4,5
17,N/A,N/A,N/A,542,559,N/A,8,3
21,N/A,N/A,N/A,521,542,N/A,14,3
7,N/A,N/A,N/A,514,521,N/A,18,1
9,N/A,N/A,N/A,505,514,N/A,24,1
41,N/A,N/A,N/A,464,505,N/A,29,6
5,N/A,N/A,N/A,459,464,N/A,35,0
34,N/A,N/A,N/A,425,459,N/A,40,5
36,N/A,N/A,N/A,389,425,N/A,46,5
27,N/A,N/A,N/A,362,389,N/A,51,4
23,N/A,N/A,N/A,339,362,N/A,57,4
14,N/A,N/A,N/A,325,339,N/A,61,2
15,N/A,N/A,N/A,310,325,N/A,67,2
44,N/A,N/A,N/A,266,310,N/A,71,6
37,N/A,N/A,N/A,229,266,N/A,76,5
15,N/A,N/A,N/A,214,229,N/A,79,2
41,N/A,N/A,N/A,173,214,N/A,83,6
7,N/A,N/A,N/A,166,173,N/A,89,0
23,N/A,N/A,N/A,143,166,N/A,92,3
11,N/A,N/A,N/A,132,143,N/A,96,1
32,N/A,N/A,N/A,100,132,N/A,100,5
31,N/A,N/A,N/A,69,100,N/A,105,4
18,N/A,N/A,N/A,51,69,N/A,110,3
43,N/A,N/A,N/A,8,51,N/A,113,6
8,N/A,N/A,N/A,0,8,N/A,119,0
44,N/A,N/A,N/A,1577,1621,N/A,6,6
26,N/A,N/A,N/A,1551,1577,N/A,10,4
17,N/A,N/A,N/A,1534,1551,N/A,14,2
37,N/A,N/A,N/A,1497,1534,N/A,17,5
11,N/A,N/A,N/A,1486,1497,N/A,20,2
8,N/A,N/A,N/A,1478,1486,N/A,25,1
29,N/A,N/A,N/A,1449,1478,N/A,28,4
22,N/A,N/A,N/A,1427,1449,N/A,33,3
14,N/A,N/A,N/A,1413,1427,N/A,37,1
10,N/A,N/A,N/A,1403,1413,N/A,43,1
37,N/A,N/A,N/A,1366,1403,N/A,47,5
14,N/A,N/A,N/A,1352,1366,N/A,51,3
11,N/A,N/A,N/A,1341,1352,N/A,56,2
42,N/A,N/A,N/A,1299,1341,N/A,60,6
6,N/A,N/A,N/A,1293,1299,N/A,66,0
20,N/A,N/A,N/A,1273,1293,N/A,69,3
41,N/A,N/A,N/A,1232,1273,N/A,72,6
8,N/A,N/A,N/A,1224,1232,N/A,78,0
41,N/A,N/A,N/A,1183,1224,N/A,84,6
5,N/A,N/A,N/A,1178,1183,N/A,90,0
37,N/A,N/A,N/A,1141,1178,N/A,95,5
17,N/A,N/A,N/A,1124,1141,N/A,98,2
12,N/A,N/A,N/A,1112,1124,N/A,104,2
36,N/A,N/A,N/A,1076,1112,N/A,107,5
14,N/A,N/A,N/A,1062,1076,N/A,110,2
36,N/A,N/A,N/A,1026,1062,N/A,113,5
35,N/A,N/A,N/A,991,1026,N/A,119,5
39,N/A,N/A,N/A,952,991,N/A,125,5
13,N/A,N/A,N/A,939,952,N/A,128,2
43,N/A,N/A,N/A,896,939,N/A,132,6
13,N/A,N/A,N/A,1360,1373,N/A,3,2
39,N/A,N/A,N/A,1321,1360,N/A,6,5
31,N/A,N/A,N/A,1290,1321,N/A,11,4
30,N/A,N/A,N/A,1260,1290,N/A,17,4
10,N/A,N/A,N/A,1250,1260,N/A,20,1
27,N/A,N/A,N/A,1223,1250,N/A,23,4
11,N/A,N/A,N/A,1212,1223,N/A,27,2
41,N/A,N/A,N/A,1171,1212,N/A,31,6
32,N/A,N/A,N/A,1139,1171,N/A,35,4
19,N/A,N/A,N/A,1120,1139,N/A,40,3
14,N/A,N/A,N/A,1106,1120,N/A,46,3
15,N/A,N/A,N/A,1091,1106,N/A,51,2
44,N/A,N/A,N/A,1047,1091,N/A,55,6
35,N/A,N/A,N/A,1012,1047,N/A,60,5
32,N/A,N/A,N/A,980,1012,N/A,66,5
15,N/A,N/A,N/A,965,980,N/A,69,2
42,N/A,N/A,N/A,923,965,N/A,73,6
6,N/A,N/A,N/A,917,923,N/A,79,0
35,N/A,N/A,N/A,882,917,N/A,84,5
36,N/A,N/A,N/A,846,882,N/A,90,5
21,N/A,N/A,N/A,825,846,N/A,94,3
23,N/A,N/A,N/A,802,825,N/A,100,3
19,N/A,N/A,N/A,783,802,N/A,106,3
9,N/A,N/A,N/A,774,783,N/A,110,1
32,N/A,N/A,N/A,742,774,N/A,114,5
36,N/A,N/A,N/A,706,742,N/A,120,5
17,N/A,N/A,N/A,689,706,N/A,124,3
44,N/A,N/A,N/A,645,689,N/A,127,6
19,N/A,N/A,N/A,626,645,N/A,130,3
42,N/A,N/A,N/A,584,626,N/A,133,6
35,N/A,N/A,N/A,991,1026,N/A,6,5
18,N/A,N/A,N/A,973,991,N/A,10,3
18,N/A,N/A,N/A,955,973,N/A,16,3
41,N/A,N/A,N/A,914,955,N/A,19,6
37,N/A,N/A,N/A,877,914,N/A,24,5
37,N/A,N/A,N/A,840,877,N/A,30,5
37,N/A,N/A,N/A,803,840,N/A,36,5
28,N/A,N/A,N/A,775,803,N/A,41,4
10,N/A,N/A,N/A,765,775,N/A,44,1
43,N/A,N/A,N/A,722,765,N/A,49,6
35,N/A,N/A,N/A,687,722,N/A,54,5
10,N/A,N/A,N/A,677,687,N/A,57,2
13,N/A,N/A,N/A,664,677,N/A,62,1
23,N/A,N/A,N/A,641,664,N/A,65,4
22,N/A,N/A,N/A,619,641,N/A,70,3
22,N/A,N/A,N/A,597,619,N/A,76,3
9,N/A,N/A,N/A,588,597,N/A,80,1
41,N/A,N/A,N/A,547,588,N/A,85,6
34,N/A,N/A,N/A,513,547,N/A,90,5
32,N/A,N/A,N/A,481,513,N/A,95,4
15,N/A,N/A,N/A,466,481,N/A,100,3
7,N/A,N/A,N/A,459,466,N/A,104,1
32,N/A,N/A,N/A,427,459,N/A,107,4
15,N/A,N/A,N/A,412,427,N/A,111,2
32,N/A,N/A,N/A,380,412,N/A,114,5
31,N/A,N/A,N/A,349,380,N/A,119,4
10,N/A,N/A,N/A,339,349,N/A,123,2
13,N/A,N/A,N/A,326,339,N/A,128,1
9,N/A,N/A,N/A,317,326,N/A,134,1
25,N/A,N/A,N/A,292,317,N/A,137,4
8,N/A,N/A,N/A,1747,1755,N/A,6,1
11,N/A,N/A,N/A,1736,1747,N/A,12,1
26,N/A,N/A,N/A,1710,1736,N/A,15,4
8,N/A,N/A,N/A,1702,1710,N/A,18,1
35,N/A,N/A,N/A,1667,1702,N/A,22,5
15,N/A,N/A,N/A,1652,1667,N/A,26,3
41,N/A,N/A,N/A,1611,1652,N/A,29,6
36,N/A,N/A,N/A,1575,1611,N/A,34,5
32,N/A,N/A,N/A,1543,1575,N/A,40,5
16,N/A,N/A,N/A,1527,1543,N/A,44,3
13,N/A,N/A,N/A,1514,1527,N/A,49,2
13,N/A,N/A,N/A,1501,1514,N/A,54,1
43,N/A,N/A,N/A,1458,1501,N/A,59,6
26,N/A,N/A,N/A,1432,1458,N/A,63,4
23,N/A,N/A,N/A,1409,1432,N/A,69,4
24,N/A,N/A,N/A,1385,1409,N/A,75,4
21,N/A,N/A,N/A,1364,1385,N/A,80,3
42,N/A,N/A,N/A,1322,1364,N/A,83,6
16,N/A,N/A,N/A,1306,1322,N/A,86,3
9,N/A,N/A,N/A,1297,1306,N/A,90,1
28,N/A,N/A,N/A,1269,1297,N/A,93,4
30,N/A,N/A,N/A,1239,1269,N/A,99,4
27,N/A,N/A,N/A,1212,1239,N/A,105,4
17,N/A,N/A,N/A,1195,1212,N/A,109,2
13,N/A,N/A,N/A,1182,1195,N/A,115,2
7,N/A,N/A,N/A,1175,1182,N/A,120,1
12,N/A,N/A,N/A,1163,1175,N/A,126,1
23,N/A,N/A,N/A,1140,1163,N/A,129,4
23,N/A,N/A,N/A,1117,1140,N/A,135,4
16,N/A,N/A,N/A,1101,1117,N/A,139,2
16,N/A,N/A,N/A,1432,1448,N/A,3,3
18,N/A,N/A,N/A,1414,1432,N/A,9,3
10,N/A,N/A,N/A,1404,1414,N/A,13,1
33,N/A,N/A,N/A,1371,1404,N/A,17,5
34,N/A,N/A,N/A,1337,1371,N/A,23,5
14,N/A,N/A,N/A,1323,1337,N/A,26,2
13,N/A,N/A,N/A,1310,1323,N/A,32,2
12,N/A,N/A,N/A,1298,1310,N/A,37,1
34,N/A,N/A,N/A,1264,1298,N/A,41,5
24,N/A,N/A,N/A,1240,1264,N/A,46,4
32,N/A,N/A,N/A,1208,1240,N/A,52,4
14,N/A,N/A,N/A,1194,1208,N/A,57,3
11,N/A,N/A,N/A,1183,1194,N/A,61,1
37,N/A,N/A,N/A,1146,1183,N/A,65,5
36,N/A,N/A,N/A,1110,1146,N/A,71,5
31,N/A,N/A,N/A,1079,1110,N/A,76,4
11,N/A,N/A,N/A,1068,1079,N/A,80,2
43,N/A,N/A,N/A,1025,1068,N/A,84,6
7,N/A,N/A,N/A,1018,1025,N/A,90,0
22,N/A,N/A,N/A,996,1018,N/A,93,3
41,N/A,N/A,N/A,955,996,N/A,96,6
22,N/A,N/A,N/A,933,955,N/A,100,4
16,N/A,N/A,N/A,917,933,N/A,104,2
32,N/A,N/A,N/A,885,917,N/A,107,5
27,N/A,N/A,N/A,858,885,N/A,112,4
12,N/A,N/A,N/A,846,858,N/A,115,1
43,N/A,N/A,N/A,803,846,N/A,120,6
39,N/A,N/A,N/A,764,803,N/A,125,5
28,N/A,N/A,N/A,736,764,N/A,130,4
7,N/A,N/A,N/A,729,736,N/A,133,1
31,N/A,N/A,N/A,738,769,N/A,5,4
31,N/A,N/A,N/A,707,738,N/A,11,4
13,N/A,N/A,N/A,694,707,N/A,15,2
39,N/A,N/A,N/A,655,694,N/A,18,5
36,N/A,N/A,N/A,619,655,N/A,24,5
39,N/A,N/A,N/A,580,619,N/A,30,5
17,N/A,N/A,N/A,563,580,N/A,34,3
44,N/A,N/A,N/A,519,563,N/A,37,6
27,N/A,N/A,N/A,492,519,N/A,41,4
15,N/A,N/A,N/A,477,492,N/A,45,2
8,N/A,N/A,N/A,469,477,N/A,50,1
29,N/A,N/A,N/A,440,469,N/A,53,4
12,N/A,N/A,N/A,428,440,N/A,56,1
32,N/A,N/A,N/A,396,428,N/A,59,4
29,N/A,N/A,N/A,367,396,N/A,65,4
24,N/A,N/A,N/A,343,367,N/A,71,4
11,N/A,N/A,N/A,332,343,N/A,75,2
13,N/A,N/A,N/A,319,332,N/A,81,2
13,N/A,N/A,N/A,306,319,N/A,87,2
7,N/A,N/A,N/A,299,306,N/A,92,1
7,N/A,N/A,N/A,292,299,N/A,98,1
10,N/A,N/A,N/A,282,292,N/A,104,1
12,N/A,N/A,N/A,270,282,N/A,110,1
36,N/A,N/A,N/A,234,270,N/A,114,5
15,N/A,N/A,N/A,219,234,N/A,118,3
14,N/A,N/A,N/A,205,219,N/A,122,1
32,N/A,N/A,N/A,173,205,N/A,126,5
19,N/A,N/A,N/A,154,173,N/A,130,3
10,N/A,N/A,N/A,144,154,N/A,135,2
42,N/A,N/A,N/A,102,144,N/A,139,6
13,N/A,N/A,N/A,1113,1126,N/A,3,1
34,N/A,N/A,N/A,1079,1113,N/A,7,5
14,N/A,N/A,N/A,1065,1079,N/A,11,3
41,N/A,N/A,N/A,1024,1065,N/A,14,6
38,N/A,N/A,N/A,986,1024,N/A,19,5
28,N/A,N/A,N/A,958,986,N/A,24,4
32,N/A,N/A,N/A,926,958,N/A,30,4
15,N/A,N/A,N/A,911,926,N/A,34,2
32,N/A,N/A,N/A,879,911,N/A,37,5
10,N/A,N/A,N/A,869,879,N/A,40,2
42,N/A,N/A,N/A,827,869,N/A,44,6
9,N/A,N/A,N/A,818,827,N/A,50,0
18,N/A,N/A,N/A,800,818,N/A,53,3
10,N/A,N/A,N/A,790,800,N/A,58,2
13,N/A,N/A,N/A,777,790,N/A,64,2
38,N/A,N/A,N/A,739,777,N/A,67,5
39,N/A,N/A,N/A,700,739,N/A,73,5
28,N/A,N/A,N/A,672,700,N/A,78,4
17,N/A,N/A,N/A,655,672,N/A,83,3
20,N/A,N/A,N/A,635,655,N/A,89,3
15,N/A,N/A,N/A,620,635,N/A,95,3
15,N/A,N/A,N/A,605,620,N/A,100,2
41,N/A,N/A,N/A,564,605,N/A,104,6
21,N/A,N/A,N/A,543,564,N/A,107,3
10,N/A,N/A,N/A,533,543,N/A,111,1
37,N/A,N/A,N/A,496,533,N/A,115,5
32,N/A,N/A,N/A,464,496,N/A,121,5
21,N/A,N/A,N/A,443,464,N/A,125,3
42,N/A,N/A,N/A,401,443,N/A,128,6
22,N/A,N/A,N/A,379,401,N/A,132,4
15,N/A,N/A,N/A,1741,1756,N/A,6,2
42,N/A,N/A,N/A,1699,1741,N/A,10,6
5,N/A,N/A,N/A,1694,1699,N/A,16,0
17,N/A,N/A,N/A,1677,1694,N/A,19,3
43,N/A,N/A,N/A,1634,1677,N/A,22,6
33,N/A,N/A,N/A,1601,1634,N/A,27,5
37,N/A,N/A,N/A,1564,1601,N/A,33,5
37,N/A,N/A,N/A,1527,1564,N/A,39,5
16,N/A,N/A,N/A,1511,1527,N/A,42,2
41,N/A,N/A,N/A,1470,1511,N/A,46,6
9,N/A,N/A,N/A,1461,1470,N/A,52,0
39,N/A,N/A,N/A,1422,1461,N/A,57,5
22,N/A,N/A,N/A,1400,1422,N/A,61,3
16,N/A,N/A,N/A,1384,1400,N/A,66,2
41,N/A,N/A,N/A,1343,1384,N/A,70,6
24,N/A,N/A,N/A,1319,1343,N/A,74,4
10,N/A,N/A,N/A,1309,1319,N/A,78,2
43,N/A,N/A,N/A,1266,1309,N/A,82,6
28,N/A,N/A,N/A,1238,1266,N/A,86,4
29,N/A,N/A,N/A,1209,1238,N/A,92,4
30,N/A,N/A,N/A,1179,1209,N/A,98,4
27,N/A,N/A,N/A,1152,1179,N/A,104,4
13,N/A,N/A,N/A,1139,1152,N/A,107,1
10,N/A,N/A,N/A,1129,1139,N/A,113,1
44,N/A,N/A,N/A,1085,1129,N/A,118,6
8,N/A,N/A,N/A,1077,1085,N/A,124,0
17,N/A,N/A,N/A,1060,1077,N/A,127,3
23,N/A,N/A,N/A,1037,1060,N/A,133,3
21,N/A,N/A,N/A,1016,1037,N/A,139,3
43,N/A,N/A,N/A,973,1016,N/A,142,6
28,N/A,N/A,N/A,647,675,N/A,6,4
13,N/A,N/A,N/A,634,647,N/A,10,2
17,N/A,N/A,N/A,617,634,N/A,16,2
42,N/A,N/A,N/A,575,617,N/A,20,6
5,N/A,N/A,N/A,570,575,N/A,26,0
29,N/A,N/A,N/A,541,570,N/A,30,4
29,N/A,N/A,N/A,512,541,N/A,36,4
16,N/A,N/A,N/A,496,512,N/A,41,3
43,N/A,N/A,N/A,453,496,N/A,44,6
5,N/A,N/A,N/A,448,453,N/A,50,0
29,N/A,N/A,N/A,419,448,N/A,54,4
32,N/A,N/A,N/A,387,419,N/A,60,4
29,N/A,N/A,N/A,358,387,N/A,66,4
14,N/A,N/A,N/A,344,358,N/A,70,2
13,N/A,N/A,N/A,331,344,N/A,75,1
9,N/A,N/A,N/A,322,331,N/A,81,1
7,N/A,N/A,N/A,315,322,N/A,87,1
13,N/A,N/A,N/A,302,315,N/A,93,1
10,N/A,N/A,N/A,292,302,N/A,99,1
43,N/A,N/A,N/A,249,292,N/A,104,6
19,N/A,N/A,N/A,230,249,N/A,107,3
41,N/A,N/A,N/A,189,230,N/A,110,6
22,N/A,N/A,N/A,167,189,N/A,113,3
14,N/A,N/A,N/A,153,167,N/A,118,2
36,N/A,N/A,N/A,117,153,N/A,121,5
17,N/A,N/A,N/A,100,117,N/A,124,2
42,N/A,N/A,N/A,58,100,N/A,128,6
7,N/A,N/A,N/A,51,58,N/A,134,0
22,N/A,N/A,N/A,29,51,N/A,137,3
18,N/A,N/A,N/A,11,29,N/A,143,3
33,N/A,N/A,N/A,853,886,N/A,6,5
15,N/A,N/A,N/A,838,853,N/A,9,2
41,N/A,N/A,N/A,797,838,N/A,13,6
8,N/A,N/A,N/A,789,797,N/A,19,0
43,N/A,N/A,N/A,746,789,N/A,25,6
22,N/A,N/A,N/A,724,746,N/A,28,3
16,N/A,N/A,N/A,708,724,N/A,33,2
13,N/A,N/A,N/A,695,708,N/A,39,2
33,N/A,N/A,N/A,662,695,N/A,42,5
33,N/A,N/A,N/A,629,662,N/A,48,5
33,N/A,N/A,N/A,596,629,N/A,54,5
17,N/A,N/A,N/A,579,596,N/A,58,3
10,N/A,N/A,N/A,569,579,N/A,63,2
41,N/A,N/A,N/A,528,569,N/A,67,6
39,N/A,N/A,N/A,489,528,N/A,72,5
17,N/A,N/A,N/A,472,489,N/A,76,3
10,N/A,N/A,N/A,462,472,N/A,81,2
14,N/A,N/A,N/A,448,462,N/A,87,2
36,N/A,N/A,N/A,412,448,N/A,90,5
38,N/A,N/A,N/A,374,412,N/A,96,5
13,N/A,N/A,N/A,361,374,N/A,99,2
11,N/A,N/A,N/A,350,361,N/A,105,2
11,N/A,N/A,N/A,339,350,N/A,110,1
43,N/A,N/A,N/A,296,339,N/A,115,6
22,N/A,N/A,N/A,274,296,N/A,119,4
29,N/A,N/A,N/A,245,274,N/A,125,4
25,N/A,N/A,N/A,220,245,N/A,131,4
13,N/A,N/A,N/A,207,220,N/A,135,2
15,N/A,N/A,N/A,192,207,N/A,141,2
32,N/A,N/A,N/A,160,192,N/A,144,5
34,N/A,N/A,N/A,1639,1673,N/A,3,5
30,N/A,N/A,N/A,1609,1639,N/A,8,4
11,N/A,N/A,N/A,1598,1609,N/A,12,2
33,N/A,N/A,N/A,1565,1598,N/A,15,5
18,N/A,N/A,N/A,1547,1565,N/A,19,3
16,N/A,N/A,N/A,1531,1547,N/A,25,3
42,N/A,N/A,N/A,1489,1531,N/A,28,6
22,N/A,N/A,N/A,1467,1489,N/A,31,3
41,N/A,N/A,N/A,1426,1467,N/A,34,6
6,N/A,N/A,N/A,1420,1426,N/A,40,0
29,N/A,N/A,N/A,1391,1420,N/A,44,4
20,N/A,N/A,N/A,1371,1391,N/A,49,3
21,N/A,N/A,N/A,1350,1371,N/A,55,3
14,N/A,N/A,N/A,1336,1350,N/A,60,2
10,N/A,N/A,N/A,1326,1336,N/A,66,2
11,N/A,N/A,N/A,1315,1326,N/A,72,2
11,N/A,N/A,N/A,1304,1315,N/A,78,2
44,N/A,N/A,N/A,1260,1304,N/A,82,6
28,N/A,N/A,N/A,1232,1260,N/A,86,4
22,N/A,N/A,N/A,1210,1232,N/A,92,4
23,N/A,N/A,N/A,1187,1210,N/A,98,4
16,N/A,N/A,N/A,1171,1187,N/A,103,3
17,N/A,N/A,N/A,1154,1171,N/A,109,3
17,N/A,N/A,N/A,1137,1154,N/A,114,2
41,N/A,N/A,N/A,1096,1137,N/A,118,6
30,N/A,N/A,N/A,1066,1096,N/A,122,4
23,N/A,N/A,N/A,1043,1066,N/A,128,4
12,N/A,N/A,N/A,1031,1043,N/A,131,1
41,N/A,N/A,N/A,990,1031,N/A,136,6
34,N/A,N/A,N/A,956,990,N/A,141,5
36,N/A,N/A,N/A,1500,1536,N/A,4,5
12,N/A,N/A,N/A,1488,1500,N/A,7,2
42,N/A,N/A,N/A,1446,1488,N/A,11,6
16,N/A,N/A,N/A,1430,1446,N/A,14,3
14,N/A,N/A,N/A,1416,1430,N/A,19,2
14,N/A,N/A,N/A,1402,1416,N/A,25,2
10,N/A,N/A,N/A,1392,1402,N/A,30,1
38,N/A,N/A,N/A,1354,1392,N/A,34,5
38,N/A,N/A,N/A,1316,1354,N/A,40,5
34,N/A,N/A,N/A,1282,1316,N/A,46,5
38,N/A,N/A,N/A,1244,1282,N/A,52,5
25,N/A,N/A,N/A,1219,1244,N/A,57,4
15,N/A,N/A,N/A,1204,1219,N/A,62,3
11,N/A,N/A,N/A,1193,1204,N/A,67,2
41,N/A,N/A,N/A,1152,1193,N/A,71,6
6,N/A,N/A,N/A,1146,1152,N/A,77,0
42,N/A,N/A,N/A,1104,1146,N/A,83,6
8,N/A,N/A,N/A,1096,1104,N/A,89,0
20,N/A,N/A,N/A,1076,1096,N/A,92,3
43,N/A,N/A,N/A,1033,1076,N/A,95,6
17,N/A,N/A,N/A,1016,1033,N/A,98,3
10,N/A,N/A,N/A,1006,1016,N/A,102,1
42,N/A,N/A,N/A,964,1006,N/A,107,6
21,N/A,N/A,N/A,943,964,N/A,110,3
13,N/A,N/A,N/A,930,943,N/A,115,2
44,N/A,N/A,N/A,886,930,N/A,119,6
5,N/A,N/A,N/A,881,886,N/A,125,0
26,N/A,N/A,N/A,855,881,N/A,129,4
11,N/A,N/A,N/A,844,855,N/A,133,2
8,N/A,N/A,N/A,836,844,N/A,138,1
39,N/A,N/A,N/A,1185,1224,N/A,6,5
19,N/A,N/A,N/A,1166,1185,N/A,10,3
10,N/A,N/A,N/A,1156,1166,N/A,14,1
24,N/A,N/A,N/A,1132,1156,N/A,17,4
7,N/A,N/A,N/A,1125,1132,N/A,20,1
28,N/A,N/A,N/A,1097,1125,N/A,23,4
11,N/A,N/A,N/A,1086,1097,N/A,26,1
44,N/A,N/A,N/A,1042,1086,N/A,31,6
29,N/A,N/A,N/A,1013,1042,N/A,35,4
23,N/A,N/A,N/A,990,1013,N/A,40,3
22,N/A,N/A,N/A,968,990,N/A,46,3
44,N/A,N/A,N/A,924,968,N/A,49,6
36,N/A,N/A,N/A,888,924,N/A,54,5
23,N/A,N/A,N/A,865,888,N/A,58,3
15,N/A,N/A,N/A,850,865,N/A,63,2
10,N/A,N/A,N/A,840,850,N/A,68,1
38,N/A,N/A,N/A,802,840,N/A,72,5
11,N/A,N/A,N/A,791,802,N/A,75,2
44,N/A,N/A,N/A,747,791,N/A,79,6
6,N/A,N/A,N/A,741,747,N/A,85,0
25,N/A,N/A,N/A,716,741,N/A,89,4
12,N/A,N/A,N/A,704,716,N/A,92,1
44,N/A,N/A,N/A,660,704,N/A,97,6
39,N/A,N/A,N/A,621,660,N/A,102,5
27,N/A,N/A,N/A,594,621,N/A,107,4
15,N/A,N/A,N/A,579,594,N/A,112,3
41,N/A,N/A,N/A,538,579,N/A,115,6
28,N/A,N/A,N/A,510,538,N/A,119,4
23,N/A,N/A,N/A,487,510,N/A,125,4
10,N/A,N/A,N/A,477,487,N/A,129,2
43,N/A,N/A,N/A,1856,1899,N/A,6,6
15,N/A,N/A,N/A,1841,1856,N/A,9,3
22,N/A,N/A,N/A,1819,1841,N/A,15,3
44,N/A,N/A,N/A,1775,1819,N/A,18,6
37,N/A,N/A,N/A,1738,1775,N/A,23,5
18,N/A,N/A,N/A,1720,1738,N/A,27,3
14,N/A,N/A,N/A,1706,1720,N/A,33,3
15,N/A,N/A,N/A,1691,1706,N/A,38,2
13,N/A,N/A,N/A,1678,1691,N/A,44,2
12,N/A,N/A,N/A,1666,1678,N/A,49,1
10,N/A,N/A,N/A,1656,1666,N/A,55,1
11,N/A,N/A,N/A,1645,1656,N/A,61,1
24,N/A,N/A,N/A,1621,1645,N/A,64,4
16,N/A,N/A,N/A,1605,1621,N/A,68,2
9,N/A,N/A,N/A,1596,1605,N/A,73,1
9,N/A,N/A,N/A,1587,1596,N/A,79,1
22,N/A,N/A,N/A,1565,1587,N/A,82,4
10,N/A,N/A,N/A,1555,1565,N/A,85,1
33,N/A,N/A,N/A,1522,1555,N/A,89,5
29,N/A,N/A,N/A,1493,1522,N/A,94,4
9,N/A,N/A,N/A,1484,1493,N/A,97,1
39,N/A,N/A,N/A,1445,1484,N/A,101,5
32,N/A,N/A,N/A,1413,1445,N/A,107,5
17,N/A,N/A,N/A,1396,1413,N/A,110,2
9,N/A,N/A,N/A,1387,1396,N/A,115,1
22,N/A,N/A,N/A,1365,1387,N/A,118,4
10,N/A,N/A,N/A,1355,1365,N/A,122,2
34,N/A,N/A,N/A,1321,1355,N/A,125,5
22,N/A,N/A,N/A,1299,1321,N/A,129,3
8,N/A,N/A,N/A,1291,1299,N/A,133,1
35,N/A,N/A,N/A,1932,1967,N/A,6,5
28,N/A,N/A,N/A,1904,1932,N/A,11,4
20,N/A,N/A,N/A,1884,1904,N/A,16,3
43,N/A,N/A,N/A,1841,1884,N/A,19,6
34,N/A,N/A,N/A,1807,1841,N/A,24,5
32,N/A,N/A,N/A,1775,1807,N/A,30,5
14,N/A,N/A,N/A,1761,1775,N/A,34,3
8,N/A,N/A,N/A,1753,1761,N/A,38,1
33,N/A,N/A,N/A,1720,1753,N/A,42,5
35,N/A,N/A,N/A,1685,1720,N/A,48,5
34,N/A,N/A,N/A,1651,1685,N/A,54,5
28,N/A,N/A,N/A,1623,1651,N/A,59,4
25,N/A,N/A,N/A,1598,1623,N/A,65,4
16,N/A,N/A,N/A,1582,1598,N/A,70,3
22,N/A,N/A,N/A,1560,1582,N/A,76,3
11,N/A,N/A,N/A,1549,1560,N/A,81,2
15,N/A,N/A,N/A,1534,1549,N/A,87,2
35,N/A,N/A,N/A,1499,1534,N/A,90,5
17,N/A,N/A,N/A,1482,1499,N/A,94,3
42,N/A,N/A,N/A,1440,1482,N/A,97,6
6,N/A,N/A,N/A,1434,1440,N/A,103,0
23,N/A,N/A,N/A,1411,1434,N/A,106,3
12,N/A,N/A,N/A,1399,1411,N/A,110,1
27,N/A,N/A,N/A,1372,1399,N/A,113,4
10,N/A,N/A,N/A,1362,1372,N/A,117,2
43,N/A,N/A,N/A,1319,1362,N/A,121,6
33,N/A,N/A,N/A,1286,1319,N/A,126,5
11,N/A,N/A,N/A,1275,1286,N/A,129,2
11,N/A,N/A,N/A,1264,1275,N/A,134,1
32,N/A,N/A,N/A,1232,1264,N/A,137,4
17,N/A,N/A,N/A,713,730,N/A,3,3
16,N/A,N/A,N/A,697,713,N/A,8,2
41,N/A,N/A,N/A,656,697,N/A,12,6
32,N/A,N/A,N/A,624,656,N/A,17,5
18,N/A,N/A,N/A,606,624,N/A,21,3
16,N/A,N/A,N/A,590,606,N/A,26,2
12,N/A,N/A,N/A,578,590,N/A,32,2
13,N/A,N/A,N/A,565,578,N/A,38,2
11,N/A,N/A,N/A,554,565,N/A,43,1
12,N/A,N/A,N/A,542,554,N/A,49,1
36,N/A,N/A,N/A,506,542,N/A,53,5
35,N/A,N/A,N/A,471,506,N/A,59,5
11,N/A,N/A,N/A,460,471,N/A,62,2
32,N/A,N/A,N/A,428,460,N/A,65,5
35,N/A,N/A,N/A,393,428,N/A,71,5
33,N/A,N/A,N/A,360,393,N/A,77,5
32,N/A,N/A,N/A,328,360,N/A,83,5
37,N/A,N/A,N/A,291,328,N/A,89,5
17,N/A,N/A,N/A,274,291,N/A,93,3
17,N/A,N/A,N/A,257,274,N/A,99,3
16,N/A,N/A,N/A,241,257,N/A,104,2
13,N/A,N/A,N/A,228,241,N/A,109,1
32,N/A,N/A,N/A,196,228,N/A,112,4
19,N/A,N/A,N/A,177,196,N/A,117,3
23,N/A,N/A,N/A,154,177,N/A,123,3
14,N/A,N/A,N/A,140,154,N/A,128,2
33,N/A,N/A,N/A,107,140,N/A,131,5
32,N/A,N/A,N/A,75,107,N/A,136,4
15,N/A,N/A,N/A,60,75,N/A,140,2
44,N/A,N/A,N/A,16,60,N/A,144,6
42,N/A,N/A,N/A,1359,1401,N/A,3,6
7,N/A,N/A,N/A,1352,1359,N/A,9,0
42,N/A,N/A,N/A,1310,1352,N/A,15,6
33,N/A,N/A,N/A,1277,1310,N/A,20,5
15,N/A,N/A,N/A,1262,1277,N/A,24,3
19,N/A,N/A,N/A,1243,1262,N/A,30,3
10,N/A,N/A,N/A,1233,1243,N/A,35,2
41,N/A,N/A,N/A,1192,1233,N/A,39,6
15,N/A,N/A,N/A,1177,1192,N/A,42,3
9,N/A,N/A,N/A,1168,1177,N/A,46,1
13,N/A,N/A,N/A,1155,1168,N/A,52,1
12,N/A,N/A,N/A,1143,1155,N/A,58,1
39,N/A,N/A,N/A,1104,1143,N/A,62,5
23,N/A,N/A,N/A,1081,1104,N/A,67,4
15,N/A,N/A,N/A,1066,1081,N/A,72,3
13,N/A,N/A,N/A,1053,1066,N/A,76,1
32,N/A,N/A,N/A,1021,1053,N/A,79,4
30,N/A,N/A,N/A,991,1021,N/A,85,4
14,N/A,N/A,N/A,977,991,N/A,89,2
16,N/A,N/A,N/A,961,977,N/A,95,2
14,N/A,N/A,N/A,947,961,N/A,101,2
39,N/A,N/A,N/A,908,947,N/A,104,5
25,N/A,N/A,N/A,883,908,N/A,109,4
7,N/A,N/A,N/A,876,883,N/A,112,1
9,N/A,N/A,N/A,867,876,N/A,118,1
42,N/A,N/A,N/A,825,867,N/A,123,6
29,N/A,N/A,N/A,796,825,N/A,127,4
10,N/A,N/A,N/A,786,796,N/A,131,2
17,N/A,N/A,N/A,769,786,N/A,137,2
14,N/A,N/A,N/A,755,769,N/A,143,2
11,N/A,N/A,N/A,699,710,N/A,5,1
42,N/A,N/A,N/A,657,699,N/A,10,6
22,N/A,N/A,N/A,635,657,N/A,13,3
11,N/A,N/A,N/A,624,635,N/A,17,1
41,N/A,N/A,N/A,583,624,N/A,22,6
38,N/A,N/A,N/A,545,583,N/A,27,5
30,N/A,N/A,N/A,515,545,N/A,32,4
14,N/A,N/A,N/A,501,515,N/A,36,2
43,N/A,N/A,N/A,458,501,N/A,40,6
36,N/A,N/A,N/A,422,458,N/A,45,5
39,N/A,N/A,N/A,383,422,N/A,51,5
15,N/A,N/A,N/A,368,383,N/A,54,2
36,N/A,N/A,N/A,332,368,N/A,57,5
22,N/A,N/A,N/A,310,332,N/A,61,3
20,N/A,N/A,N/A,290,310,N/A,67,3
41,N/A,N/A,N/A,249,290,N/A,70,6
23,N/A,N/A,N/A,226,249,N/A,74,4
10,N/A,N/A,N/A,216,226,N/A,78,2
37,N/A,N/A,N/A,179,216,N/A,81,5
18,N/A,N/A,N/A,161,179,N/A,85,3
16,N/A,N/A,N/A,145,161,N/A,91,3
14,N/A,N/A,N/A,131,145,N/A,97,3
11,N/A,N/A,N/A,120,131,N/A,101,1
7,N/A,N/A,N/A,113,120,N/A,107,1
32,N/A,N/A,N/A,81,113,N/A,111,5
29,N/A,N/A,N/A,52,81,N/A,116,4
16,N/A,N/A,N/A,36,52,N/A,121,3
22,N/A,N/A,N/A,14,36,N/A,127,3
11,N/A,N/A,N/A,3,14,N/A,131,1
42,N/A,N/A,N/A,-39,3,N/A,136,6
39,N/A,N/A,N/A,479,518,N/A,3,5
31,N/A,N/A,N/A,448,479,N/A,8,4
8,N/A,N/A,N/A,440,448,N/A,11,1
13,N/A,N/A,N/A,427,440,N/A,17,1
12,N/A,N/A,N/A,415,427,N/A,23,1
44,N/A,N/A,N/A,371,415,N/A,28,6
9,N/A,N/A,N/A,362,371,N/A,34,0
30,N/A,N/A,N/A,332,362,N/A,38,4
23,N/A,N/A,N/A,309,332,N/A,44,4
25,N/A,N/A,N/A,284,309,N/A,50,4
22,N/A,N/A,N/A,262,284,N/A,55,3
19,N/A,N/A,N/A,243,262,N/A,61,3
13,N/A,N/A,N/A,230,243,N/A,66,2
14,N/A,N/A,N/A,216,230,N/A,72,2
33,N/A,N/A,N/A,183,216,N/A,75,5
22,N/A,N/A,N/A,161,183,N/A,80,4
13,N/A,N/A,N/A,148,161,N/A,83,1
38,N/A,N/A,N/A,110,148,N/A,87,5
23,N/A,N/A,N/A,87,110,N/A,91,3
20,N/A,N/A,N/A,67,87,N/A,97,3
7,N/A,N/A,N/A,60,67,N/A,101,1
35,N/A,N/A,N/A,25,60,N/A,105,5
24,N/A,N/A,N/A,1,25,N/A,110,4
15,N/A,N/A,N/A,-14,1,N/A,114,2
29,N/A,N/A,N/A,543,572,N/A,3,4
32,N/A,N/A,N/A,511,543,N/A,9,4
9,N/A,N/A,N/A,502,511,N/A,12,1
44,N/A,N/A,N/A,458,502,N/A,17,6
35,N/A,N/A,N/A,423,458,N/A,22,5
22,N/A,N/A,N/A,401,423,N/A,26,3
11,N/A,N/A,N/A,390,401,N/A,30,1
44,N/A,N/A,N/A,346,390,N/A,35,6
7,N/A,N/A,N/A,339,346,N/A,41,0
37,N/A,N/A,N/A,302,339,N/A,46,5
11,N/A,N/A,N/A,291,302,N/A,49,2
15,N/A,N/A,N/A,276,291,N/A,55,2
9,N/A,N/A,N/A,267,276,N/A,60,1
8,N/A,N/A,N/A,259,267,N/A,66,1
43,N/A,N/A,N/A,216,259,N/A,71,6
8,N/A,N/A,N/A,208,216,N/A,77,0
31,N/A,N/A,N/A,177,208,N/A,81,4
27,N/A,N/A,N/A,150,177,N/A,87,4
31,N/A,N/A,N/A,119,150,N/A,93,4
20,N/A,N/A,N/A,99,119,N/A,98,3
9,N/A,N/A,N/A,90,99,N/A,102,1
38,N/A,N/A,N/A,52,90,N/A,106,5
15,N/A,N/A,N/A,37,52,N/A,109,2
14,N/A,N/A,N/A,23,37,N/A,114,1
44,N/A,N/A,N/A,-21,23,N/A,119,6
12,N/A,N/A,N/A,403,415,N/A,3,2
11,N/A,N/A,N/A,392,403,N/A,8,1
33,N/A,N/A,N/A,359,392,N/A,12,5
36,N/A,N/A,N/A,323,359,N/A,18,5
17,N/A,N/A,N/A,306,323,N/A,22,3
13,N/A,N/A,N/A,293,306,N/A,26,1
44,N/A,N/A,N/A,249,293,N/A,31,6
7,N/A,N/A,N/A,242,249,N/A,37,0
28,N/A,N/A,N/A,214,242,N/A,41,4
10,N/A,N/A,N/A,204,214,N/A,44,1
14,N/A,N/A,N/A,190,204,N/A,50,1
39,N/A,N/A,N/A,151,190,N/A,54,5
22,N/A,N/A,N/A,129,151,N/A,59,4
12,N/A,N/A,N/A,117,129,N/A,62,1
23,N/A,N/A,N/A,94,117,N/A,65,4
16,N/A,N/A,N/A,78,94,N/A,69,2
14,N/A,N/A,N/A,64,78,N/A,74,1
13,N/A,N/A,N/A,51,64,N/A,80,1
23,N/A,N/A,N/A,28,51,N/A,83,4
12,N/A,N/A,N/A,16,28,N/A,87,2
35,N/A,N/A,N/A,-19,16,N/A,90,5
11,N/A,N/A,N/A,1506,1517,N/A,5,2
13,N/A,N/A,N/A,1493,1506,N/A,10,1
22,N/A,N/A,N/A,1471,1493,N/A,13,4
14,N/A,N/A,N/A,1457,1471,N/A,18,3
12,N/A,N/A,N/A,1445,1457,N/A,22,1
12,N/A,N/A,N/A,1433,1445,N/A,28,1
43,N/A,N/A,N/A,1390,1433,N/A,33,6
32,N/A,N/A,N/A,1358,1390,N/A,38,5
37,N/A,N/A,N/A,1321,1358,N/A,44,5
14,N/A,N/A,N/A,1307,1321,N/A,48,3
23,N/A,N/A,N/A,1284,1307,N/A,54,3
17,N/A,N/A,N/A,1267,1284,N/A,60,3
15,N/A,N/A,N/A,1252,1267,N/A,65,2
12,N/A,N/A,N/A,1240,1252,N/A,71,2
10,N/A,N/A,N/A,1230,1240,N/A,76,1
25,N/A,N/A,N/A,1205,1230,N/A,79,4
20,N/A,N/A,N/A,1185,1205,N/A,84,3
42,N/A,N/A,N/A,1143,1185,N/A,87,6
27,N/A,N/A,N/A,1116,1143,N/A,91,4
14,N/A,N/A,N/A,1102,1116,N/A,95,2
14,N/A,N/A,N/A,1088,1102,N/A,101,2
12,N/A,N/A,N/A,1076,1088,N/A,106,1
34,N/A,N/A,N/A,1042,1076,N/A,110,5
26,N/A,N/A,N/A,1016,1042,N/A,115,4
27,N/A,N/A,N/A,989,1016,N/A,121,4
23,N/A,N/A,N/A,966,989,N/A,126,3
41,N/A,N/A,N/A,925,966,N/A,129,6
33,N/A,N/A,N/A,892,925,N/A,134,5
34,N/A,N/A,N/A,858,892,N/A,140,5
15,N/A,N/A,N/A,843,858,N/A,143,2
8,N/A,N/A,N/A,1536,1544,N/A,4,1
8,N/A,N/A,N/A,1528,1536,N/A,10,1
12,N/A,N/A,N/A,1516,1528,N/A,16,1
35,N/A,N/A,N/A,1481,1516,N/A,20,5
21,N/A,N/A,N/A,1460,1481,N/A,24,3
17,N/A,N/A,N/A,1443,1460,N/A,29,2
39,N/A,N/A,N/A,1404,1443,N/A,32,5
15,N/A,N/A,N/A,1389,1404,N/A,35,2
11,N/A,N/A,N/A,1378,1389,N/A,40,1
37,N/A,N/A,N/A,1341,1378,N/A,44,5
16,N/A,N/A,N/A,1325,1341,N/A,47,2
34,N/A,N/A,N/A,1291,1325,N/A,50,5
33,N/A,N/A,N/A,1258,1291,N/A,56,5
23,N/A,N/A,N/A,1235,1258,N/A,60,3
44,N/A,N/A,N/A,1191,1235,N/A,63,6
19,N/A,N/A,N/A,1172,1191,N/A,66,3
9,N/A,N/A,N/A,1163,1172,N/A,70,1
12,N/A,N/A,N/A,1151,1163,N/A,76,1
32,N/A,N/A,N/A,1119,1151,N/A,80,5
11,N/A,N/A,N/A,1108,1119,N/A,83,2
14,N/A,N/A,N/A,1094,1108,N/A,88,1
41,N/A,N/A,N/A,1053,1094,N/A,93,6
32,N/A,N/A,N/A,1021,1053,N/A,97,4
17,N/A,N/A,N/A,1004,1021,N/A,101,2
15,N/A,N/A,N/A,989,1004,N/A,107,2
42,N/A,N/A,N/A,947,989,N/A,111,6
22,N/A,N/A,N/A,925,947,N/A,114,3
42,N/A,N/A,N/A,883,925,N/A,117,6
31,N/A,N/A,N/A,852,883,N/A,121,4
16,N/A,N/A,N/A,836,852,N/A,125,2
22,N/A,N/A,N/A,1660,1682,N/A,4,4
12,N/A,N/A,N/A,1648,1660,N/A,7,1
31,N/A,N/A,N/A,1617,1648,N/A,10,4
23,N/A,N/A,N/A,1594,1617,N/A,16,4
23,N/A,N/A,N/A,1571,1594,N/A,22,4
15,N/A,N/A,N/A,1556,1571,N/A,27,3
13,N/A,N/A,N/A,1543,1556,N/A,32,2
13,N/A,N/A,N/A,1530,1543,N/A,38,2
44,N/A,N/A,N/A,1486,1530,N/A,42,6
23,N/A,N/A,N/A,1463,1486,N/A,45,3
15,N/A,N/A,N/A,1448,1463,N/A,50,2
42,N/A,N/A,N/A,1406,1448,N/A,54,6
8,N/A,N/A,N/A,1398,1406,N/A,60,0
32,N/A,N/A,N/A,1366,1398,N/A,64,4
14,N/A,N/A,N/A,1352,1366,N/A,69,3
14,N/A,N/A,N/A,1338,1352,N/A,74,2
10,N/A,N/A,N/A,1328,1338,N/A,79,1
12,N/A,N/A,N/A,1316,1328,N/A,85,1
33,N/A,N/A,N/A,1283,1316,N/A,89,5
28,N/A,N/A,N/A,1255,1283,N/A,94,4
11,N/A,N/A,N/A,1244,1255,N/A,98,2
36,N/A,N/A,N/A,1208,1244,N/A,101,5
12,N/A,N/A,N/A,1196,1208,N/A,104,2
37,N/A,N/A,N/A,1159,1196,N/A,107,5
14,N/A,N/A,N/A,1145,1159,N/A,110,2
43,N/A,N/A,N/A,1102,1145,N/A,114,6
7,N/A,N/A,N/A,1095,1102,N/A,120,0
14,N/A,N/A,N/A,1081,1095,N/A,123,3
23,N/A,N/A,N/A,1058,1081,N/A,129,3
9,N/A,N/A,N/A,1049,1058,N/A,133,1
33,N/A,N/A,N/A,1798,1831,N/A,3,5
32,N/A,N/A,N/A,1766,1798,N/A,8,4
14,N/A,N/A,N/A,1752,1766,N/A,13,3
16,N/A,N/A,N/A,1736,1752,N/A,18,2
11,N/A,N/A,N/A,1725,1736,N/A,23,1
42,N/A,N/A,N/A,1683,1725,N/A,28,6
35,N/A,N/A,N/A,1648,1683,N/A,33,5
32,N/A,N/A,N/A,1616,1648,N/A,39,5
14,N/A,N/A,N/A,1602,1616,N/A,43,3
7,N/A,N/A,N/A,1595,1602,N/A,47,1
31,N/A,N/A,N/A,1564,1595,N/A,50,4
30,N/A,N/A,N/A,1534,1564,N/A,56,4
22,N/A,N/A,N/A,1512,1534,N/A,61,3
13,N/A,N/A,N/A,1499,1512,N/A,65,1
39,N/A,N/A,N/A,1460,1499,N/A,69,5
15,N/A,N/A,N/A,1445,1460,N/A,72,2
8,N/A,N/A,N/A,1437,1445,N/A,77,1
41,N/A,N/A,N/A,1396,1437,N/A,82,6
37,N/A,N/A,N/A,1359,1396,N/A,87,5
11,N/A,N/A,N/A,1348,1359,N/A,90,2
33,N/A,N/A,N/A,1315,1348,N/A,93,5
14,N/A,N/A,N/A,1301,1315,N/A,97,3
12,N/A,N/A,N/A,1289,1301,N/A,102,2
12,N/A,N/A,N/A,1277,1289,N/A,107,1
27,N/A,N/A,N/A,1250,1277,N/A,110,4
10,N/A,N/A,N/A,1240,1250,N/A,113,1
35,N/A,N/A,N/A,1205,1240,N/A,117,5
15,N/A,N/A,N/A,1190,1205,N/A,120,2
13,N/A,N/A,N/A,1177,1190,N/A,126,2
15,N/A,N/A,N/A,1162,1177,N/A,132,2
23,N/A,N/A,N/A,408,431,N/A,6,3
43,N/A,N/A,N/A,365,408,N/A,9,6
37,N/A,N/A,N/A,328,365,N/A,14,5
16,N/A,N/A,N/A,312,328,N/A,18,3
9,N/A,N/A,N/A,303,312,N/A,22,1
23,N/A,N/A,N/A,280,303,N/A,25,4
13,N/A,N/A,N/A,267,280,N/A,29,2
16,N/A,N/A,N/A,251,267,N/A,35,2
42,N/A,N/A,N/A,209,251,N/A,39,6
30,N/A,N/A,N/A,179,209,N/A,43,4
16,N/A,N/A,N/A,163,179,N/A,47,2
11,N/A,N/A,N/A,152,163,N/A,53,2
13,N/A,N/A,N/A,139,152,N/A,58,1
33,N/A,N/A,N/A,106,139,N/A,62,5
17,N/A,N/A,N/A,89,106,N/A,65,2
15,N/A,N/A,N/A,74,89,N/A,71,2
32,N/A,N/A,N/A,42,74,N/A,74,5
15,N/A,N/A,N/A,27,42,N/A,78,3
41,N/A,N/A,N/A,-14,27,N/A,81,6
7,N/A,N/A,N/A,1233,1240,N/A,3,1
32,N/A,N/A,N/A,1201,1233,N/A,6,4
31,N/A,N/A,N/A,1170,1201,N/A,12,4
22,N/A,N/A,N/A,1148,1170,N/A,17,3
16,N/A,N/A,N/A,1132,1148,N/A,23,3
8,N/A,N/A,N/A,1124,1132,N/A,27,1
22,N/A,N/A,N/A,1102,1124,N/A,30,4
22,N/A,N/A,N/A,1080,1102,N/A,36,4
17,N/A,N/A,N/A,1063,1080,N/A,40,2
11,N/A,N/A,N/A,1052,1063,N/A,45,1
36,N/A,N/A,N/A,1016,1052,N/A,49,5
31,N/A,N/A,N/A,985,1016,N/A,54,4
14,N/A,N/A,N/A,971,985,N/A,57,1
27,N/A,N/A,N/A,944,971,N/A,60,4
21,N/A,N/A,N/A,923,944,N/A,65,3
41,N/A,N/A,N/A,882,923,N/A,68,6
26,N/A,N/A,N/A,856,882,N/A,72,4
15,N/A,N/A,N/A,841,856,N/A,77,3
41,N/A,N/A,N/A,800,841,N/A,80,6
37,N/A,N/A,N/A,763,800,N/A,85,5
23,N/A,N/A,N/A,740,763,N/A,89,3
9,N/A,N/A,N/A,731,740,N/A,93,1
22,N/A,N/A,N/A,709,731,N/A,96,4
17,N/A,N/A,N/A,692,709,N/A,100,2
15,N/A,N/A,N/A,677,692,N/A,106,2
11,N/A,N/A,N/A,666,677,N/A,111,1
30,N/A,N/A,N/A,636,666,N/A,114,4
15,N/A,N/A,N/A,621,636,N/A,119,3
12,N/A,N/A,N/A,609,621,N/A,124,2
41,N/A,N/A,N/A,568,609,N/A,128,6
38,N/A,N/A,N/A,1855,1893,N/A,3,5
12,N/A,N/A,N/A,1843,1855,N/A,6,2
34,N/A,N/A,N/A,1809,1843,N/A,9,5
18,N/A,N/A,N/A,1791,1809,N/A,13,3
13,N/A,N/A,N/A,1778,1791,N/A,17,1
43,N/A,N/A,N/A,1735,1778,N/A,22,6
14,N/A,N/A,N/A,1721,1735,N/A,25,3
19,N/A,N/A,N/A,1702,1721,N/A,31,3
42,N/A,N/A,N/A,1660,1702,N/A,34,6
17,N/A,N/A,N/A,1643,1660,N/A,37,3
14,N/A,N/A,N/A,1629,1643,N/A,41,1
41,N/A,N/A,N/A,1588,1629,N/A,46,6
25,N/A,N/A,N/A,1563,1588,N/A,50,4
22,N/A,N/A,N/A,1541,1563,N/A,55,3
20,N/A,N/A,N/A,1521,1541,N/A,61,3
16,N/A,N/A,N/A,1505,1521,N/A,66,2
42,N/A,N/A,N/A,1463,1505,N/A,70,6
7,N/A,N/A,N/A,1456,1463,N/A,76,0
23,N/A,N/A,N/A,1433,1456,N/A,80,4
8,N/A,N/A,N/A,1425,1433,N/A,83,1
30,N/A,N/A,N/A,1395,1425,N/A,86,4
9,N/A,N/A,N/A,1386,1395,N/A,89,1
9,N/A,N/A,N/A,1377,1386,N/A,95,1
38,N/A,N/A,N/A,1339,1377,N/A,99,5
25,N/A,N/A,N/A,1314,1339,N/A,104,4
20,N/A,N/A,N/A,1294,1314,N/A,109,3
21,N/A,N/A,N/A,1273,1294,N/A,115,3
11,N/A,N/A,N/A,1262,1273,N/A,119,1
42,N/A,N/A,N/A,1220,1262,N/A,124,6
9,N/A,N/A,N/A,1211,1220,N/A,130,0
9,N/A,N/A,N/A,1682,1691,N/A,4,1
11,N/A,N/A,N/A,1671,1682,N/A,10,1
35,N/A,N/A,N/A,1636,1671,N/A,14,5
38,N/A,N/A,N/A,1598,1636,N/A,20,5
29,N/A,N/A,N/A,1569,1598,N/A,25,4
17,N/A,N/A,N/A,1552,1569,N/A,29,2
38,N/A,N/A,N/A,1514,1552,N/A,32,5
31,N/A,N/A,N/A,1483,1514,N/A,37,4
21,N/A,N/A,N/A,1462,1483,N/A,42,3
11,N/A,N/A,N/A,1451,1462,N/A,47,2
41,N/A,N/A,N/A,1410,1451,N/A,51,6
26,N/A,N/A,N/A,1384,1410,N/A,55,4
11,N/A,N/A,N/A,1373,1384,N/A,59,2
13,N/A,N/A,N/A,1360,1373,N/A,64,1
37,N/A,N/A,N/A,1323,1360,N/A,68,5
17,N/A,N/A,N/A,1306,1323,N/A,71,2
17,N/A,N/A,N/A,1289,1306,N/A,77,2
8,N/A,N/A,N/A,1281,1289,N/A,82,1
39,N/A,N/A,N/A,1242,1281,N/A,86,5
11,N/A,N/A,N/A,1231,1242,N/A,89,2
14,N/A,N/A,N/A,1217,1231,N/A,94,1
14,N/A,N/A,N/A,1203,1217,N/A,100,1
32,N/A,N/A,N/A,1171,1203,N/A,103,4
24,N/A,N/A,N/A,1147,1171,N/A,109,4
7,N/A,N/A,N/A,1140,1147,N/A,112,1
42,N/A,N/A,N/A,1098,1140,N/A,117,6
29,N/A,N/A,N/A,1069,1098,N/A,121,4
16,N/A,N/A,N/A,1053,1069,N/A,126,3
43,N/A,N/A,N/A,1010,1053,N/A,129,6
35,N/A,N/A,N/A,975,1010,N/A,134,5
13,N/A,N/A,N/A,1650,1663,N/A,6,2
44,N/A,N/A,N/A,1606,1650,N/A,10,6
35,N/A,N/A,N/A,1571,1606,N/A,15,5
23,N/A,N/A,N/A,1548,1571,N/A,20,4
10,N/A,N/A,N/A,1538,1548,N/A,24,2
37,N/A,N/A,N/A,1501,1538,N/A,27,5
14,N/A,N/A,N/A,1487,1501,N/A,31,3
11,N/A,N/A,N/A,1476,1487,N/A,35,1
28,N/A,N/A,N/A,1448,1476,N/A,38,4
14,N/A,N/A,N/A,1434,1448,N/A,41,1
44,N/A,N/A,N/A,1390,1434,N/A,46,6
16,N/A,N/A,N/A,1374,1390,N/A,49,3
8,N/A,N/A,N/A,1366,1374,N/A,53,1
36,N/A,N/A,N/A,1330,1366,N/A,57,5
37,N/A,N/A,N/A,1293,1330,N/A,63,5
27,N/A,N/A,N/A,1266,1293,N/A,68,4
11,N/A,N/A,N/A,1255,1266,N/A,72,2
13,N/A,N/A,N/A,1242,1255,N/A,78,2
15,N/A,N/A,N/A,1227,1242,N/A,84,2
33,N/A,N/A,N/A,1194,1227,N/A,87,5
10,N/A,N/A,N/A,1184,1194,N/A,90,2
33,N/A,N/A,N/A,1151,1184,N/A,93,5
14,N/A,N/A,N/A,1137,1151,N/A,96,2
12,N/A,N/A,N/A,1125,1137,N/A,102,2
9,N/A,N/A,N/A,1116,1125,N/A,107,1
30,N/A,N/A,N/A,1086,1116,N/A,110,4
12,N/A,N/A,N/A,1074,1086,N/A,113,1
32,N/A,N/A,N/A,1042,1074,N/A,116,4
28,N/A,N/A,N/A,1014,1042,N/A,122,4
9,N/A,N/A,N/A,1005,1014,N/A,125,1
12,N/A,N/A,N/A,1756,1768,N/A,5,1
42,N/A,N/A,N/A,1714,1756,N/A,10,6
35,N/A,N/A,N/A,1679,1714,N/A,15,5
21,N/A,N/A,N/A,1658,1679,N/A,19,3
21,N/A,N/A,N/A,1637,1658,N/A,25,3
44,N/A,N/A,N/A,1593,1637,N/A,28,6
39,N/A,N/A,N/A,1554,1593,N/A,33,5
18,N/A,N/A,N/A,1536,1554,N/A,37,3
13,N/A,N/A,N/A,1523,1536,N/A,41,1
10,N/A,N/A,N/A,1513,1523,N/A,47,1
37,N/A,N/A,N/A,1476,1513,N/A,51,5
24,N/A,N/A,N/A,1452,1476,N/A,56,4
10,N/A,N/A,N/A,1442,1452,N/A,59,1
39,N/A,N/A,N/A,1403,1442,N/A,63,5
12,N/A,N/A,N/A,1391,1403,N/A,66,2
9,N/A,N/A,N/A,1382,1391,N/A,71,1
43,N/A,N/A,N/A,1339,1382,N/A,76,6
8,N/A,N/A,N/A,1331,1339,N/A,82,0
36,N/A,N/A,N/A,1295,1331,N/A,87,5
35,N/A,N/A,N/A,1260,1295,N/A,93,5
28,N/A,N/A,N/A,1232,1260,N/A,98,4
14,N/A,N/A,N/A,1218,1232,N/A,103,3
17,N/A,N/A,N/A,1201,1218,N/A,109,3
12,N/A,N/A,N/A,1189,1201,N/A,113,1
28,N/A,N/A,N/A,1161,1189,N/A,116,4
19,N/A,N/A,N/A,1142,1161,N/A,121,3
22,N/A,N/A,N/A,1120,1142,N/A,127,3
42,N/A,N/A,N/A,1078,1120,N/A,130,6
34,N/A,N/A,N/A,1044,1078,N/A,135,5
26,N/A,N/A,N/A,1018,1044,N/A,140,4
20,N/A,N/A,N/A,397,417,N/A,4,3
44,N/A,N/A,N/A,353,397,N/A,7,6
25,N/A,N/A,N/A,328,353,N/A,11,4
23,N/A,N/A,N/A,305,328,N/A,17,4
10,N/A,N/A,N/A,295,305,N/A,21,2
14,N/A,N/A,N/A,281,295,N/A,26,1
10,N/A,N/A,N/A,271,281,N/A,32,1
24,N/A,N/A,N/A,247,271,N/A,35,4
13,N/A,N/A,N/A,234,247,N/A,38,1
31,N/A,N/A,N/A,203,234,N/A,41,4
22,N/A,N/A,N/A,181,203,N/A,47,4
16,N/A,N/A,N/A,165,181,N/A,51,2
42,N/A,N/A,N/A,123,165,N/A,55,6
5,N/A,N/A,N/A,118,123,N/A,61,0
16,N/A,N/A,N/A,102,118,N/A,64,3
16,N/A,N/A,N/A,86,102,N/A,70,3
18,N/A,N/A,N/A,68,86,N/A,76,3
10,N/A,N/A,N/A,58,68,N/A,81,2
33,N/A,N/A,N/A,25,58,N/A,84,5
38,N/A,N/A,N/A,-13,25,N/A,90,5
36,N/A,N/A,N/A,703,739,N/A,4,5
29,N/A,N/A,N/A,674,703,N/A,9,4
17,N/A,N/A,N/A,657,674,N/A,14,3
42,N/A,N/A,N/A,615,657,N/A,17,6
20,N/A,N/A,N/A,595,615,N/A,20,3
18,N/A,N/A,N/A,577,595,N/A,26,3
14,N/A,N/A,N/A,563,577,N/A,31,2
41,N/A,N/A,N/A,522,563,N/A,35,6
30,N/A,N/A,N/A,492,522,N/A,39,4
12,N/A,N/A,N/A,480,492,N/A,42,1
26,N/A,N/A,N/A,454,480,N/A,45,4
10,N/A,N/A,N/A,444,454,N/A,48,1
43,N/A,N/A,N/A,401,444,N/A,53,6
7,N/A,N/A,N/A,394,401,N/A,59,0
14,N/A,N/A,N/A,380,394,N/A,62,3
43,N/A,N/A,N/A,337,380,N/A,65,6
30,N/A,N/A,N/A,307,337,N/A,69,4
17,N/A,N/A,N/A,290,307,N/A,73,2
36,N/A,N/A,N/A,254,290,N/A,76,5
37,N/A,N/A,N/A,217,254,N/A,82,5
31,N/A,N/A,N/A,186,217,N/A,87,4
13,N/A,N/A,N/A,173,186,N/A,91,2
36,N/A,N/A,N/A,137,173,N/A,94,5
30,N/A,N/A,N/A,107,137,N/A,99,4
19,N/A,N/A,N/A,88,107,N/A,104,3
14,N/A,N/A,N/A,74,88,N/A,109,2
41,N/A,N/A,N/A,33,74,N/A,113,6
32,N/A,N/A,N/A,1,33,N/A,118,5
37,N/A,N/A,N/A,-36,1,N/A,124,5
14,N/A,N/A,N/A,1661,1675,N/A,5,2
42,N/A,N/A,N/A,1619,1661,N/A,9,6
26,N/A,N/A,N/A,1593,1619,N/A,13,4
14,N/A,N/A,N/A,1579,1593,N/A,18,3
22,N/A,N/A,N/A,1557,1579,N/A,24,3
43,N/A,N/A,N/A,1514,1557,N/A,27,6
5,N/A,N/A,N/A,1509,1514,N/A,33,0
30,N/A,N/A,N/A,1479,1509,N/A,37,4
32,N/A,N/A,N/A,1447,1479,N/A,43,4
10,N/A,N/A,N/A,1437,1447,N/A,47,2
37,N/A,N/A,N/A,1400,1437,N/A,50,5
10,N/A,N/A,N/A,1390,1400,N/A,53,2
12,N/A,N/A,N/A,1378,1390,N/A,58,1
23,N/A,N/A,N/A,1355,1378,N/A,61,4
16,N/A,N/A,N/A,1339,1355,N/A,66,3
41,N/A,N/A,N/A,1298,1339,N/A,69,6
9,N/A,N/A,N/A,1289,1298,N/A,75,0
32,N/A,N/A,N/A,1257,1289,N/A,79,4
10,N/A,N/A,N/A,1247,1257,N/A,82,1
8,N/A,N/A,N/A,1239,1247,N/A,88,1
37,N/A,N/A,N/A,1202,1239,N/A,92,5
12,N/A,N/A,N/A,1190,1202,N/A,95,2
35,N/A,N/A,N/A,1155,1190,N/A,98,5
22,N/A,N/A,N/A,1133,1155,N/A,103,4
18,N/A,N/A,N/A,1115,1133,N/A,108,3
22,N/A,N/A,N/A,1093,1115,N/A,114,3
43,N/A,N/A,N/A,1050,1093,N/A,117,6
32,N/A,N/A,N/A,1018,1050,N/A,122,5
16,N/A,N/A,N/A,1002,1018,N/A,126,3
10,N/A,N/A,N/A,992,1002,N/A,131,2
9,N/A,N/A,N/A,1647,1656,N/A,5,1
7,N/A,N/A,N/A,1640,1647,N/A,11,1
12,N/A,N/A,N/A,1628,1640,N/A,17,1
8,N/A,N/A,N/A,1620,1628,N/A,23,1
35,N/A,N/A,N/A,1585,1620,N/A,27,5
16,N/A,N/A,N/A,1569,1585,N/A,30,2
44,N/A,N/A,N/A,1525,1569,N/A,34,6
15,N/A,N/A,N/A,1510,1525,N/A,37,3
13,N/A,N/A,N/A,1497,1510,N/A,41,1
32,N/A,N/A,N/A,1465,1497,N/A,44,4
8,N/A,N/A,N/A,1457,1465,N/A,47,1
43,N/A,N/A,N/A,1414,1457,N/A,52,6
23,N/A,N/A,N/A,1391,1414,N/A,55,3
7,N/A,N/A,N/A,1384,1391,N/A,59,1
42,N/A,N/A,N/A,1342,1384,N/A,64,6
37,N/A,N/A,N/A,1305,1342,N/A,69,5
22,N/A,N/A,N/A,1283,1305,N/A,74,4
23,N/A,N/A,N/A,1260,1283,N/A,79,3
42,N/A,N/A,N/A,1218,1260,N/A,82,6
5,N/A,N/A,N/A,1213,1218,N/A,88,0
41,N/A,N/A,N/A,1172,1213,N/A,94,6
28,N/A,N/A,N/A,1144,1172,N/A,98,4
30,N/A,N/A,N/A,1114,1144,N/A,104,4
17,N/A,N/A,N/A,1097,1114,N/A,108,2
10,N/A,N/A,N/A,1087,1097,N/A,113,1
9,N/A,N/A,N/A,1078,1087,N/A,119,1
43,N/A,N/A,N/A,1035,1078,N/A,124,6
32,N/A,N/A,N/A,1003,1035,N/A,128,4
16,N/A,N/A,N/A,987,1003,N/A,133,3
9,N/A,N/A,N/A,978,987,N/A,137,1
16,N/A,N/A,N/A,570,586,N/A,5,2
39,N/A,N/A,N/A,531,570,N/A,8,5
27,N/A,N/A,N/A,504,531,N/A,13,4
10,N/A,N/A,N/A,494,504,N/A,16,1
23,N/A,N/A,N/A,471,494,N/A,19,4
8,N/A,N/A,N/A,463,471,N/A,22,1
39,N/A,N/A,N/A,424,463,N/A,26,5
29,N/A,N/A,N/A,395,424,N/A,31,4
10,N/A,N/A,N/A,385,395,N/A,35,2
8,N/A,N/A,N/A,377,385,N/A,40,1
31,N/A,N/A,N/A,346,377,N/A,43,4
11,N/A,N/A,N/A,335,346,N/A,46,1
9,N/A,N/A,N/A,326,335,N/A,52,1
27,N/A,N/A,N/A,299,326,N/A,55,4
27,N/A,N/A,N/A,272,299,N/A,61,4
26,N/A,N/A,N/A,246,272,N/A,67,4
14,N/A,N/A,N/A,232,246,N/A,72,3
14,N/A,N/A,N/A,218,232,N/A,78,3
12,N/A,N/A,N/A,206,218,N/A,83,2
10,N/A,N/A,N/A,196,206,N/A,89,2
12,N/A,N/A,N/A,184,196,N/A,94,1
13,N/A,N/A,N/A,171,184,N/A,100,1
11,N/A,N/A,N/A,160,171,N/A,106,1
32,N/A,N/A,N/A,128,160,N/A,109,4
22,N/A,N/A,N/A,106,128,N/A,114,3
41,N/A,N/A,N/A,65,106,N/A,117,6
36,N/A,N/A,N/A,29,65,N/A,122,5
21,N/A,N/A,N/A,8,29,N/A,126,3
12,N/A,N/A,N/A,-4,8,N/A,131,2
26,N/A,N/A,N/A,418,444,N/A,6,4
27,N/A,N/A,N/A,391,418,N/A,12,4
16,N/A,N/A,N/A,375,391,N/A,17,3
16,N/A,N/A,N/A,359,375,N/A,23,3
17,N/A,N/A,N/A,342,359,N/A,28,2
38,N/A,N/A,N/A,304,342,N/A,31,5
22,N/A,N/A,N/A,282,304,N/A,36,4
12,N/A,N/A,N/A,270,282,N/A,40,2
11,N/A,N/A,N/A,259,270,N/A,46,2
39,N/A,N/A,N/A,220,259,N/A,49,5
12,N/A,N/A,N/A,208,220,N/A,52,2
32,N/A,N/A,N/A,176,208,N/A,55,5
23,N/A,N/A,N/A,153,176,N/A,59,3
44,N/A,N/A,N/A,109,153,N/A,62,6
34,N/A,N/A,N/A,75,109,N/A,67,5
15,N/A,N/A,N/A,60,75,N/A,70,2
15,N/A,N/A,N/A,45,60,N/A,76,2
8,N/A,N/A,N/A,37,45,N/A,81,1
7,N/A,N/A,N/A,30,37,N/A,87,1
37,N/A,N/A,N/A,-7,30,N/A,91,5
31,N/A,N/A,N/A,1408,1439,N/A,6,4
11,N/A,N/A,N/A,1397,1408,N/A,10,2
44,N/A,N/A,N/A,1353,1397,N/A,14,6
5,N/A,N/A,N/A,1348,1353,N/A,20,0
31,N/A,N/A,N/A,1317,1348,N/A,24,4
17,N/A,N/A,N/A,1300,1317,N/A,28,2
14,N/A,N/A,N/A,1286,1300,N/A,34,2
41,N/A,N/A,N/A,1245,1286,N/A,38,6
39,N/A,N/A,N/A,1206,1245,N/A,43,5
23,N/A,N/A,N/A,1183,1206,N/A,47,3
11,N/A,N/A,N/A,1172,1183,N/A,51,1
7,N/A,N/A,N/A,1165,1172,N/A,57,1
27,N/A,N/A,N/A,1138,1165,N/A,60,4
13,N/A,N/A,N/A,1125,1138,N/A,63,1
9,N/A,N/A,N/A,1116,1125,N/A,69,1
11,N/A,N/A,N/A,1105,1116,N/A,75,1
33,N/A,N/A,N/A,1072,1105,N/A,79,5
32,N/A,N/A,N/A,1040,1072,N/A,84,4
11,N/A,N/A,N/A,1029,1040,N/A,88,2
13,N/A,N/A,N/A,1016,1029,N/A,94,2
14,N/A,N/A,N/A,1002,1016,N/A,99,1
8,N/A,N/A,N/A,994,1002,N/A,105,1
28,N/A,N/A,N/A,966,994,N/A,108,4
14,N/A,N/A,N/A,952,966,N/A,111,1
7,N/A,N/A,N/A,945,952,N/A,117,1
10,N/A,N/A,N/A,935,945,N/A,123,1
32,N/A,N/A,N/A,903,935,N/A,126,4
17,N/A,N/A,N/A,886,903,N/A,130,2
43,N/A,N/A,N/A,843,886,N/A,134,6
9,N/A,N/A,N/A,834,843,N/A,140,0
15,N/A,N/A,N/A,834,849,N/A,4,3
10,N/A,N/A,N/A,824,834,N/A,9,2
10,N/A,N/A,N/A,814,824,N/A,15,2
38,N/A,N/A,N/A,776,814,N/A,18,5
35,N/A,N/A,N/A,741,776,N/A,24,5
11,N/A,N/A,N/A,730,741,N/A,27,2
42,N/A,N/A,N/A,688,730,N/A,31,6
35,N/A,N/A,N/A,653,688,N/A,36,5
24,N/A,N/A,N/A,629,653,N/A,41,4
17,N/A,N/A,N/A,612,629,N/A,46,3
41,N/A,N/A,N/A,571,612,N/A,49,6
35,N/A,N/A,N/A,536,571,N/A,54,5
16,N/A,N/A,N/A,520,536,N/A,58,3
44,N/A,N/A,N/A,476,520,N/A,61,6
6,N/A,N/A,N/A,470,476,N/A,67,0
30,N/A,N/A,N/A,440,470,N/A,71,4
32,N/A,N/A,N/A,408,440,N/A,77,4
18,N/A,N/A,N/A,390,408,N/A,82,3
41,N/A,N/A,N/A,349,390,N/A,85,6
18,N/A,N/A,N/A,331,349,N/A,88,3
42,N/A,N/A,N/A,289,331,N/A,91,6
19,N/A,N/A,N/A,270,289,N/A,94,3
13,N/A,N/A,N/A,257,270,N/A,98,1
41,N/A,N/A,N/A,216,257,N/A,103,6
17,N/A,N/A,N/A,199,216,N/A,106,3
10,N/A,N/A,N/A,189,199,N/A,110,1
44,N/A,N/A,N/A,145,189,N/A,115,6
19,N/A,N/A,N/A,126,145,N/A,118,3
15,N/A,N/A,N/A,111,126,N/A,124,3
14,N/A,N/A,N/A,97,111,N/A,128,1
10,N/A,N/A,N/A,555,565,N/A,6,1
36,N/A,N/A,N/A,519,555,N/A,10,5
31,N/A,N/A,N/A,488,519,N/A,15,4
22,N/A,N/A,N/A,466,488,N/A,21,4
26,N/A,N/A,N/A,440,466,N/A,27,4
23,N/A,N/A,N/A,417,440,N/A,33,4
16,N/A,N/A,N/A,401,417,N/A,38,3
20,N/A,N/A,N/A,381,401,N/A,44,3
20,N/A,N/A,N/A,361,381,N/A,50,3
18,N/A,N/A,N/A,343,361,N/A,56,3
13,N/A,N/A,N/A,330,343,N/A,60,1
25,N/A,N/A,N/A,305,330,N/A,63,4
15,N/A,N/A,N/A,290,305,N/A,68,3
43,N/A,N/A,N/A,247,290,N/A,71,6
8,N/A,N/A,N/A,239,247,N/A,77,0
31,N/A,N/A,N/A,208,239,N/A,81,4
29,N/A,N/A,N/A,179,208,N/A,87,4
14,N/A,N/A,N/A,165,179,N/A,92,3
13,N/A,N/A,N/A,152,165,N/A,96,1
9,N/A,N/A,N/A,143,152,N/A,102,1
25,N/A,N/A,N/A,118,143,N/A,105,4
26,N/A,N/A,N/A,92,118,N/A,111,4
30,N/A,N/A,N/A,62,92,N/A,117,4
22,N/A,N/A,N/A,40,62,N/A,122,3
14,N/A,N/A,N/A,26,40,N/A,128,3
10,N/A,N/A,N/A,16,26,N/A,133,2
35,N/A,N/A,N/A,-19,16,N/A,136,5
14,N/A,N/A,N/A,1171,1185,N/A,4,3
14,N/A,N/A,N/A,1157,1171,N/A,9,2
41,N/A,N/A,N/A,1116,1157,N/A,13,6
23,N/A,N/A,N/A,1093,1116,N/A,16,3
21,N/A,N/A,N/A,1072,1093,N/A,22,3
9,N/A,N/A,N/A,1063,1072,N/A,26,1
9,N/A,N/A,N/A,1054,1063,N/A,32,1
43,N/A,N/A,N/A,1011,1054,N/A,37,6
32,N/A,N/A,N/A,979,1011,N/A,42,5
15,N/A,N/A,N/A,964,979,N/A,45,2
41,N/A,N/A,N/A,923,964,N/A,49,6
36,N/A,N/A,N/A,887,923,N/A,54,5
25,N/A,N/A,N/A,862,887,N/A,59,4
10,N/A,N/A,N/A,852,862,N/A,63,2
14,N/A,N/A,N/A,838,852,N/A,68,1
39,N/A,N/A,N/A,799,838,N/A,72,5
26,N/A,N/A,N/A,773,799,N/A,77,4
23,N/A,N/A,N/A,750,773,N/A,83,4
12,N/A,N/A,N/A,738,750,N/A,86,1
43,N/A,N/A,N/A,695,738,N/A,91,6
9,N/A,N/A,N/A,686,695,N/A,97,0
22,N/A,N/A,N/A,664,686,N/A,101,4
15,N/A,N/A,N/A,649,664,N/A,106,3
14,N/A,N/A,N/A,635,649,N/A,111,2
8,N/A,N/A,N/A,627,635,N/A,116,1
34,N/A,N/A,N/A,593,627,N/A,120,5
15,N/A,N/A,N/A,578,593,N/A,124,3
21,N/A,N/A,N/A,557,578,N/A,130,3
17,N/A,N/A,N/A,540,557,N/A,136,3
10,N/A,N/A,N/A,530,540,N/A,141,2
26,N/A,N/A,N/A,1195,1221,N/A,5,4
30,N/A,N/A,N/A,1165,1195,N/A,11,4
16,N/A,N/A,N/A,1149,1165,N/A,15,2
17,N/A,N/A,N/A,1132,1149,N/A,21,2
10,N/A,N/A,N/A,1122,1132,N/A,26,1
37,N/A,N/A,N/A,1085,1122,N/A,30,5
27,N/A,N/A,N/A,1058,1085,N/A,35,4
10,N/A,N/A,N/A,1048,1058,N/A,39,2
11,N/A,N/A,N/A,1037,1048,N/A,44,1
27,N/A,N/A,N/A,1010,1037,N/A,47,4
27,N/A,N/A,N/A,983,1010,N/A,53,4
13,N/A,N/A,N/A,970,983,N/A,57,2
41,N/A,N/A,N/A,929,970,N/A,61,6
16,N/A,N/A,N/A,913,929,N/A,64,3
44,N/A,N/A,N/A,869,913,N/A,67,6
38,N/A,N/A,N/A,831,869,N/A,72,5
18,N/A,N/A,N/A,813,831,N/A,76,3
16,N/A,N/A,N/A,797,813,N/A,81,2
13,N/A,N/A,N/A,784,797,N/A,87,2
12,N/A,N/A,N/A,772,784,N/A,93,2
44,N/A,N/A,N/A,728,772,N/A,97,6
6,N/A,N/A,N/A,722,728,N/A,103,0
43,N/A,N/A,N/A,679,722,N/A,109,6
7,N/A,N/A,N/A,672,679,N/A,115,0
44,N/A,N/A,N/A,628,672,N/A,121,6
34,N/A,N/A,N/A,594,628,N/A,126,5
15,N/A,N/A,N/A,579,594,N/A,130,3
22,N/A,N/A,N/A,557,579,N/A,136,3
41,N/A,N/A,N/A,516,557,N/A,139,6
22,N/A,N/A,N/A,494,516,N/A,143,4
13,N/A,N/A,N/A,1287,1300,N/A,3,2
38,N/A,N/A,N/A,1249,1287,N/A,6,5
13,N/A,N/A,N/A,1236,1249,N/A,9,2
16,N/A,N/A,N/A,1220,1236,N/A,15,2
36,N/A,N/A,N/A,1184,1220,N/A,18,5
22,N/A,N/A,N/A,1162,1184,N/A,23,4
10,N/A,N/A,N/A,1152,1162,N/A,27,2
14,N/A,N/A,N/A,1138,1152,N/A,32,1
11,N/A,N/A,N/A,1127,1138,N/A,38,1
42,N/A,N/A,N/A,1085,1127,N/A,43,6
39,N/A,N/A,N/A,1046,1085,N/A,48,5
34,N/A,N/A,N/A,1012,1046,N/A,54,5
25,N/A,N/A,N/A,987,1012,N/A,59,4
23,N/A,N/A,N/A,964,987,N/A,64,3
19,N/A,N/A,N/A,945,964,N/A,70,3
20,N/A,N/A,N/A,925,945,N/A,76,3
42,N/A,N/A,N/A,883,925,N/A,79,6
23,N/A,N/A,N/A,860,883,N/A,83,4
18,N/A,N/A,N/A,842,860,N/A,88,3
21,N/A,N/A,N/A,821,842,N/A,94,3
44,N/A,N/A,N/A,777,821,N/A,97,6
18,N/A,N/A,N/A,759,777,N/A,100,3
11,N/A,N/A,N/A,748,759,N/A,105,2
15,N/A,N/A,N/A,733,748,N/A,111,2
15,N/A,N/A,N/A,718,733,N/A,117,2
14,N/A,N/A,N/A,704,718,N/A,123,2
44,N/A,N/A,N/A,660,704,N/A,127,6
17,N/A,N/A,N/A,643,660,N/A,130,3
14,N/A,N/A,N/A,629,643,N/A,136,3
11,N/A,N/A,N/A,618,629,N/A,141,2
10,N/A,N/A,N/A,791,801,N/A,5,1
35,N/A,N/A,N/A,756,791,N/A,9,5
15,N/A,N/A,N/A,741,756,N/A,12,2
7,N/A,N/A,N/A,734,741,N/A,17,1
24,N/A,N/A,N/A,710,734,N/A,20,4
7,N/A,N/A,N/A,703,710,N/A,23,1
13,N/A,N/A,N/A,690,703,N/A,29,1
30,N/A,N/A,N/A,660,690,N/A,32,4
10,N/A,N/A,N/A,650,660,N/A,35,1
36,N/A,N/A,N/A,614,650,N/A,39,5
34,N/A,N/A,N/A,580,614,N/A,45,5
34,N/A,N/A,N/A,546,580,N/A,51,5
21,N/A,N/A,N/A,525,546,N/A,55,3
13,N/A,N/A,N/A,512,525,N/A,60,2
8,N/A,N/A,N/A,504,512,N/A,65,1
43,N/A,N/A,N/A,461,504,N/A,70,6
28,N/A,N/A,N/A,433,461,N/A,74,4
31,N/A,N/A,N/A,402,433,N/A,80,4
32,N/A,N/A,N/A,370,402,N/A,86,4
28,N/A,N/A,N/A,342,370,N/A,92,4
19,N/A,N/A,N/A,323,342,N/A,97,3
16,N/A,N/A,N/A,307,323,N/A,102,2
41,N/A,N/A,N/A,266,307,N/A,106,6
21,N/A,N/A,N/A,245,266,N/A,109,3
11,N/A,N/A,N/A,234,245,N/A,113,1
29,N/A,N/A,N/A,205,234,N/A,116,4
28,N/A,N/A,N/A,177,205,N/A,122,4
13,N/A,N/A,N/A,164,177,N/A,125,1
22,N/A,N/A,N/A,142,164,N/A,128,4
22,N/A,N/A,N/A,120,142,N/A,133,3
11,N/A,N/A,N/A,687,698,N/A,4,2
42,N/A,N/A,N/A,645,687,N/A,8,6
37,N/A,N/A,N/A,608,645,N/A,13,5
22,N/A,N/A,N/A,586,608,N/A,18,4
16,N/A,N/A,N/A,570,586,N/A,22,2
32,N/A,N/A,N/A,538,570,N/A,25,5
10,N/A,N/A,N/A,528,538,N/A,28,2
42,N/A,N/A,N/A,486,528,N/A,32,6
25,N/A,N/A,N/A,461,486,N/A,36,4
11,N/A,N/A,N/A,450,461,N/A,40,2
14,N/A,N/A,N/A,436,450,N/A,45,1
42,N/A,N/A,N/A,394,436,N/A,50,6
33,N/A,N/A,N/A,361,394,N/A,55,5
11,N/A,N/A,N/A,350,361,N/A,58,2
37,N/A,N/A,N/A,313,350,N/A,61,5
22,N/A,N/A,N/A,291,313,N/A,65,3
11,N/A,N/A,N/A,280,291,N/A,69,1
38,N/A,N/A,N/A,242,280,N/A,73,5
25,N/A,N/A,N/A,217,242,N/A,78,4
16,N/A,N/A,N/A,201,217,N/A,82,2
43,N/A,N/A,N/A,158,201,N/A,86,6
6,N/A,N/A,N/A,152,158,N/A,92,0
28,N/A,N/A,N/A,124,152,N/A,96,4
30,N/A,N/A,N/A,94,124,N/A,102,4
17,N/A,N/A,N/A,77,94,N/A,107,3
16,N/A,N/A,N/A,61,77,N/A,112,2
36,N/A,N/A,N/A,25,61,N/A,115,5
23,N/A,N/A,N/A,2,25,N/A,119,3
8,N/A,N/A,N/A,-6,2,N/A,123,1
7,N/A,N/A,N/A,606,613,N/A,6,1
38,N/A,N/A,N/A,568,606,N/A,10,5
11,N/A,N/A,N/A,557,568,N/A,13,2
43,N/A,N/A,N/A,514,557,N/A,17,6
25,N/A,N/A,N/A,489,514,N/A,21,4
10,N/A,N/A,N/A,479,489,N/A,25,2
13,N/A,N/A,N/A,466,479,N/A,30,1
32,N/A,N/A,N/A,434,466,N/A,33,4
11,N/A,N/A,N/A,423,434,N/A,36,1
38,N/A,N/A,N/A,385,423,N/A,40,5
24,N/A,N/A,N/A,361,385,N/A,45,4
16,N/A,N/A,N/A,345,361,N/A,50,3
15,N/A,N/A,N/A,330,345,N/A,55,2
43,N/A,N/A,N/A,287,330,N/A,59,6
27,N/A,N/A,N/A,260,287,N/A,63,4
22,N/A,N/A,N/A,238,260,N/A,68,3
17,N/A,N/A,N/A,221,238,N/A,74,3
42,N/A,N/A,N/A,179,221,N/A,77,6
7,N/A,N/A,N/A,172,179,N/A,83,0
23,N/A,N/A,N/A,149,172,N/A,87,4
29,N/A,N/A,N/A,120,149,N/A,93,4
16,N/A,N/A,N/A,104,120,N/A,97,2
35,N/A,N/A,N/A,69,104,N/A,100,5
32,N/A,N/A,N/A,37,69,N/A,106,5
33,N/A,N/A,N/A,4,37,N/A,112,5
37,N/A,N/A,N/A,-33,4,N/A,118,5
11,N/A,N/A,N/A,1066,1077,N/A,6,2
41,N/A,N/A,N/A,1025,1066,N/A,10,6
35,N/A,N/A,N/A,990,1025,N/A,15,5
23,N/A,N/A,N/A,967,990,N/A,20,4
28,N/A,N/A,N/A,939,967,N/A,26,4
11,N/A,N/A,N/A,928,939,N/A,29,1
44,N/A,N/A,N/A,884,928,N/A,34,6
9,N/A,N/A,N/A,875,884,N/A,40,0
31,N/A,N/A,N/A,844,875,N/A,44,4
17,N/A,N/A,N/A,827,844,N/A,48,2
11,N/A,N/A,N/A,816,827,N/A,54,2
43,N/A,N/A,N/A,773,816,N/A,58,6
6,N/A,N/A,N/A,767,773,N/A,64,0
36,N/A,N/A,N/A,731,767,N/A,69,5
17,N/A,N/A,N/A,714,731,N/A,72,2
41,N/A,N/A,N/A,673,714,N/A,76,6
23,N/A,N/A,N/A,650,673,N/A,80,4
14,N/A,N/A,N/A,636,650,N/A,84,2
14,N/A,N/A,N/A,622,636,N/A,90,2
42,N/A,N/A,N/A,580,622,N/A,94,6
30,N/A,N/A,N/A,550,580,N/A,98,4
28,N/A,N/A,N/A,522,550,N/A,104,4
17,N/A,N/A,N/A,505,522,N/A,108,2
11,N/A,N/A,N/A,494,505,N/A,114,2
34,N/A,N/A,N/A,460,494,N/A,117,5
21,N/A,N/A,N/A,439,460,N/A,121,3
41,N/A,N/A,N/A,398,439,N/A,124,6
24,N/A,N/A,N/A,374,398,N/A,128,4
11,N/A,N/A,N/A,363,374,N/A,131,1
11,N/A,N/A,N/A,352,363,N/A,137,1
38,N/A,N/A,N/A,1141,1179,N/A,4,5
14,N/A,N/A,N/A,1127,1141,N/A,7,2
42,N/A,N/A,N/A,1085,1127,N/A,11,6
39,N/A,N/A,N/A,1046,1085,N/A,16,5
32,N/A,N/A,N/A,1014,1046,N/A,21,4
12,N/A,N/A,N/A,1002,1014,N/A,25,2
38,N/A,N/A,N/A,964,1002,N/A,28,5
34,N/A,N/A,N/A,930,964,N/A,34,5
19,N/A,N/A,N/A,911,930,N/A,38,3
42,N/A,N/A,N/A,869,911,N/A,41,6
15,N/A,N/A,N/A,854,869,N/A,44,3
42,N/A,N/A,N/A,812,854,N/A,47,6
37,N/A,N/A,N/A,775,812,N/A,52,5
14,N/A,N/A,N/A,761,775,N/A,56,3
12,N/A,N/A,N/A,749,761,N/A,61,2
15,N/A,N/A,N/A,734,749,N/A,67,2
43,N/A,N/A,N/A,691,734,N/A,71,6
9,N/A,N/A,N/A,682,691,N/A,77,0
36,N/A,N/A,N/A,646,682,N/A,82,5
38,N/A,N/A,N/A,608,646,N/A,88,5
38,N/A,N/A,N/A,570,608,N/A,94,5
14,N/A,N/A,N/A,556,570,N/A,97,2
36,N/A,N/A,N/A,520,556,N/A,100,5
37,N/A,N/A,N/A,483,520,N/A,106,5
12,N/A,N/A,N/A,471,483,N/A,109,2
44,N/A,N/A,N/A,427,471,N/A,113,6
23,N/A,N/A,N/A,404,427,N/A,116,3
20,N/A,N/A,N/A,384,404,N/A,122,3
44,N/A,N/A,N/A,340,384,N/A,125,6
37,N/A,N/A,N/A,303,340,N/A,130,5
44,N/A,N/A,N/A,350,394,N/A,6,6
24,N/A,N/A,N/A,326,350,N/A,10,4
10,N/A,N/A,N/A,316,326,N/A,14,2
42,N/A,N/A,N/A,274,316,N/A,18,6
7,N/A,N/A,N/A,267,274,N/A,24,0
32,N/A,N/A,N/A,235,267,N/A,29,5
14,N/A,N/A,N/A,221,235,N/A,33,3
15,N/A,N/A,N/A,206,221,N/A,38,2
41,N/A,N/A,N/A,165,206,N/A,42,6
35,N/A,N/A,N/A,130,165,N/A,47,5
23,N/A,N/A,N/A,107,130,N/A,52,4
13,N/A,N/A,N/A,94,107,N/A,56,2
16,N/A,N/A,N/A,78,94,N/A,62,2
44,N/A,N/A,N/A,34,78,N/A,66,6
21,N/A,N/A,N/A,13,34,N/A,69,3
21,N/A,N/A,N/A,-8,13,N/A,75,3
7,N/A,N/A,N/A,1789,1796,N/A,6,1
43,N/A,N/A,N/A,1746,1789,N/A,11,6
31,N/A,N/A,N/A,1715,1746,N/A,15,4
31,N/A,N/A,N/A,1684,1715,N/A,21,4
14,N/A,N/A,N/A,1670,1684,N/A,26,3
15,N/A,N/A,N/A,1655,1670,N/A,32,3
14,N/A,N/A,N/A,1641,1655,N/A,38,3
12,N/A,N/A,N/A,1629,1641,N/A,43,2
37,N/A,N/A,N/A,1592,1629,N/A,46,5
36,N/A,N/A,N/A,1556,1592,N/A,52,5
20,N/A,N/A,N/A,1536,1556,N/A,56,3
42,N/A,N/A,N/A,1494,1536,N/A,59,6
23,N/A,N/A,N/A,1471,1494,N/A,63,4
11,N/A,N/A,N/A,1460,1471,N/A,66,1
36,N/A,N/A,N/A,1424,1460,N/A,70,5
19,N/A,N/A,N/A,1405,1424,N/A,74,3
12,N/A,N/A,N/A,1393,1405,N/A,78,1
7,N/A,N/A,N/A,1386,1393,N/A,84,1
26,N/A,N/A,N/A,1360,1386,N/A,87,4
9,N/A,N/A,N/A,1351,1360,N/A,90,1
36,N/A,N/A,N/A,1315,1351,N/A,94,5
13,N/A,N/A,N/A,1302,1315,N/A,97,2
14,N/A,N/A,N/A,1288,1302,N/A,102,1
29,N/A,N/A,N/A,1259,1288,N/A,105,4
25,N/A,N/A,N/A,1234,1259,N/A,111,4
11,N/A,N/A,N/A,1223,1234,N/A,115,2
37,N/A,N/A,N/A,1186,1223,N/A,118,5
33,N/A,N/A,N/A,1153,1186,N/A,124,5
26,N/A,N/A,N/A,1127,1153,N/A,129,4
20,N/A,N/A,N/A,1107,1127,N/A,134,3
14,N/A,N/A,N/A,1239,1253,N/A,3,1
32,N/A,N/A,N/A,1207,1239,N/A,6,4
20,N/A,N/A,N/A,1187,1207,N/A,11,3
17,N/A,N/A,N/A,1170,1187,N/A,17,3
8,N/A,N/A,N/A,1162,1170,N/A,21,1
44,N/A,N/A,N/A,1118,1162,N/A,26,6
15,N/A,N/A,N/A,1103,1118,N/A,29,3
42,N/A,N/A,N/A,1061,1103,N/A,32,6
5,N/A,N/A,N/A,1056,1061,N/A,38,0
21,N/A,N/A,N/A,1035,1056,N/A,41,3
21,N/A,N/A,N/A,1014,1035,N/A,47,3
42,N/A,N/A,N/A,972,1014,N/A,50,6
6,N/A,N/A,N/A,966,972,N/A,56,0
18,N/A,N/A,N/A,948,966,N/A,59,3
41,N/A,N/A,N/A,907,948,N/A,62,6
5,N/A,N/A,N/A,902,907,N/A,68,0
27,N/A,N/A,N/A,875,902,N/A,72,4
10,N/A,N/A,N/A,865,875,N/A,76,2
42,N/A,N/A,N/A,823,865,N/A,80,6
20,N/A,N/A,N/A,803,823,N/A,83,3
20,N/A,N/A,N/A,783,803,N/A,89,3
10,N/A,N/A,N/A,773,783,N/A,93,1
11,N/A,N/A,N/A,762,773,N/A,99,1
38,N/A,N/A,N/A,724,762,N/A,103,5
21,N/A,N/A,N/A,703,724,N/A,107,3
20,N/A,N/A,N/A,683,703,N/A,113,3
23,N/A,N/A,N/A,660,683,N/A,119,3
12,N/A,N/A,N/A,648,660,N/A,123,1
24,N/A,N/A,N/A,624,648,N/A,126,4
17,N/A,N/A,N/A,607,624,N/A,130,2
36,N/A,N/A,N/A,1447,1483,N/A,3,5
12,N/A,N/A,N/A,1435,1447,N/A,6,2
35,N/A,N/A,N/A,1400,1435,N/A,9,5
17,N/A,N/A,N/A,1383,1400,N/A,13,3
17,N/A,N/A,N/A,1366,1383,N/A,18,2
14,N/A,N/A,N/A,1352,1366,N/A,23,1
34,N/A,N/A,N/A,1318,1352,N/A,27,5
33,N/A,N/A,N/A,1285,1318,N/A,33,5
21,N/A,N/A,N/A,1264,1285,N/A,37,3
12,N/A,N/A,N/A,1252,1264,N/A,41,1
43,N/A,N/A,N/A,1209,1252,N/A,46,6
9,N/A,N/A,N/A,1200,1209,N/A,52,0
19,N/A,N/A,N/A,1181,1200,N/A,55,3
7,N/A,N/A,N/A,1174,1181,N/A,59,1
26,N/A,N/A,N/A,1148,1174,N/A,62,4
19,N/A,N/A,N/A,1129,1148,N/A,67,3
44,N/A,N/A,N/A,1085,1129,N/A,70,6
14,N/A,N/A,N/A,1071,1085,N/A,73,3
7,N/A,N/A,N/A,1064,1071,N/A,77,1
42,N/A,N/A,N/A,1022,1064,N/A,82,6
18,N/A,N/A,N/A,1004,1022,N/A,85,3
12,N/A,N/A,N/A,992,1004,N/A,89,1
36,N/A,N/A,N/A,956,992,N/A,93,5
32,N/A,N/A,N/A,924,956,N/A,99,5
23,N/A,N/A,N/A,901,924,N/A,104,4
15,N/A,N/A,N/A,886,901,N/A,108,2
7,N/A,N/A,N/A,879,886,N/A,113,1
27,N/A,N/A,N/A,852,879,N/A,116,4
27,N/A,N/A,N/A,825,852,N/A,122,4
21,N/A,N/A,N/A,804,825,N/A,127,3
24,N/A,N/A,N/A,640,664,N/A,4,4
13,N/A,N/A,N/A,627,640,N/A,8,2
12,N/A,N/A,N/A,615,627,N/A,14,2
44,N/A,N/A,N/A,571,615,N/A,18,6
7,N/A,N/A,N/A,564,571,N/A,24,0
42,N/A,N/A,N/A,522,564,N/A,30,6
7,N/A,N/A,N/A,515,522,N/A,36,0
17,N/A,N/A,N/A,498,515,N/A,39,3
12,N/A,N/A,N/A,486,498,N/A,44,2
10,N/A,N/A,N/A,476,486,N/A,49,1
27,N/A,N/A,N/A,449,476,N/A,52,4
29,N/A,N/A,N/A,420,449,N/A,58,4
21,N/A,N/A,N/A,399,420,N/A,63,3
14,N/A,N/A,N/A,385,399,N/A,68,2
16,N/A,N/A,N/A,369,385,N/A,74,2
32,N/A,N/A,N/A,337,369,N/A,77,5
14,N/A,N/A,N/A,323,337,N/A,80,2
11,N/A,N/A,N/A,312,323,N/A,86,2
41,N/A,N/A,N/A,271,312,N/A,90,6
21,N/A,N/A,N/A,250,271,N/A,93,3
8,N/A,N/A,N/A,242,250,N/A,97,1
43,N/A,N/A,N/A,199,242,N/A,102,6
32,N/A,N/A,N/A,167,199,N/A,107,5
17,N/A,N/A,N/A,150,167,N/A,110,2
41,N/A,N/A,N/A,109,150,N/A,114,6
18,N/A,N/A,N/A,91,109,N/A,117,3
44,N/A,N/A,N/A,47,91,N/A,120,6
29,N/A,N/A,N/A,18,47,N/A,124,4
12,N/A,N/A,N/A,6,18,N/A,127,1
24,N/A,N/A,N/A,-18,6,N/A,130,4
22,N/A,N/A,N/A,1846,1868,N/A,6,4
14,N/A,N/A,N/A,1832,1846,N/A,10,2
9,N/A,N/A,N/A,1823,1832,N/A,15,1
44,N/A,N/A,N/A,1779,1823,N/A,20,6
34,N/A,N/A,N/A,1745,1779,N/A,25,5
24,N/A,N/A,N/A,1721,1745,N/A,30,4
16,N/A,N/A,N/A,1705,1721,N/A,34,2
32,N/A,N/A,N/A,1673,1705,N/A,37,5
28,N/A,N/A,N/A,1645,1673,N/A,42,4
7,N/A,N/A,N/A,1638,1645,N/A,45,1
23,N/A,N/A,N/A,1615,1638,N/A,48,4
25,N/A,N/A,N/A,1590,1615,N/A,54,4
31,N/A,N/A,N/A,1559,1590,N/A,60,4
31,N/A,N/A,N/A,1528,1559,N/A,66,4
16,N/A,N/A,N/A,1512,1528,N/A,71,3
17,N/A,N/A,N/A,1495,1512,N/A,76,2
44,N/A,N/A,N/A,1451,1495,N/A,80,6
31,N/A,N/A,N/A,1420,1451,N/A,84,4
13,N/A,N/A,N/A,1407,1420,N/A,87,1
41,N/A,N/A,N/A,1366,1407,N/A,92,6
34,N/A,N/A,N/A,1332,1366,N/A,97,5
35,N/A,N/A,N/A,1297,1332,N/A,103,5
39,N/A,N/A,N/A,1258,1297,N/A,109,5
25,N/A,N/A,N/A,1233,1258,N/A,114,4
25,N/A,N/A,N/A,1208,1233,N/A,120,4
22,N/A,N/A,N/A,1186,1208,N/A,125,3
17,N/A,N/A,N/A,1169,1186,N/A,131,3
44,N/A,N/A,N/A,1125,1169,N/A,134,6
5,N/A,N/A,N/A,1120,1125,N/A,140,0
34,N/A,N/A,N/A,1086,1120,N/A,145,5
19,N/A,N/A,N/A,1814,1833,N/A,5,3
11,N/A,N/A,N/A,1803,1814,N/A,9,1
29,N/A,N/A,N/A,1774,1803,N/A,12,4
27,N/A,N/A,N/A,1747,1774,N/A,18,4
29,N/A,N/A,N/A,1718,1747,N/A,24,4
31,N/A,N/A,N/A,1687,1718,N/A,30,4
10,N/A,N/A,N/A,1677,1687,N/A,34,2
43,N/A,N/A,N/A,1634,1677,N/A,38,6
34,N/A,N/A,N/A,1600,1634,N/A,43,5
14,N/A,N/A,N/A,1586,1600,N/A,47,3
41,N/A,N/A,N/A,1545,1586,N/A,50,6
16,N/A,N/A,N/A,1529,1545,N/A,53,3
15,N/A,N/A,N/A,1514,1529,N/A,58,2
9,N/A,N/A,N/A,1505,1514,N/A,63,1
14,N/A,N/A,N/A,1491,1505,N/A,69,1
31,N/A,N/A,N/A,1460,1491,N/A,72,4
11,N/A,N/A,N/A,1449,1460,N/A,76,2
8,N/A,N/A,N/A,1441,1449,N/A,81,1
44,N/A,N/A,N/A,1397,1441,N/A,86,6
15,N/A,N/A,N/A,1382,1397,N/A,89,3
44,N/A,N/A,N/A,1338,1382,N/A,92,6
17,N/A,N/A,N/A,1321,1338,N/A,95,3
43,N/A,N/A,N/A,1278,1321,N/A,98,6
16,N/A,N/A,N/A,1262,1278,N/A,101,3
44,N/A,N/A,N/A,1218,1262,N/A,104,6
39,N/A,N/A,N/A,1179,1218,N/A,109,5
19,N/A,N/A,N/A,1160,1179,N/A,113,3
14,N/A,N/A,N/A,1146,1160,N/A,118,2
13,N/A,N/A,N/A,1133,1146,N/A,123,1
10,N/A,N/A,N/A,1123,1133,N/A,129,1
44,N/A,N/A,N/A,1873,1917,N/A,6,6
8,N/A,N/A,N/A,1865,1873,N/A,12,0
33,N/A,N/A,N/A,1832,1865,N/A,17,5
32,N/A,N/A,N/A,1800,1832,N/A,23,5
15,N/A,N/A,N/A,1785,1800,N/A,27,3
18,N/A,N/A,N/A,1767,1785,N/A,33,3
42,N/A,N/A,N/A,1725,1767,N/A,36,6
7,N/A,N/A,N/A,1718,1725,N/A,42,0
32,N/A,N/A,N/A,1686,1718,N/A,46,4
8,N/A,N/A,N/A,1678,1686,N/A,49,1
43,N/A,N/A,N/A,1635,1678,N/A,54,6
35,N/A,N/A,N/A,1600,1635,N/A,59,5
17,N/A,N/A,N/A,1583,1600,N/A,63,3
21,N/A,N/A,N/A,1562,1583,N/A,69,3
12,N/A,N/A,N/A,1550,1562,N/A,74,2
38,N/A,N/A,N/A,1512,1550,N/A,77,5
35,N/A,N/A,N/A,1477,1512,N/A,83,5
29,N/A,N/A,N/A,1448,1477,N/A,88,4
22,N/A,N/A,N/A,1426,1448,N/A,94,4
16,N/A,N/A,N/A,1410,1426,N/A,98,2
13,N/A,N/A,N/A,1397,1410,N/A,103,1
14,N/A,N/A,N/A,1383,1397,N/A,109,1
43,N/A,N/A,N/A,1340,1383,N/A,114,6
26,N/A,N/A,N/A,1314,1340,N/A,118,4
21,N/A,N/A,N/A,1293,1314,N/A,123,3
12,N/A,N/A,N/A,1281,1293,N/A,127,1
37,N/A,N/A,N/A,1244,1281,N/A,131,5
11,N/A,N/A,N/A,1233,1244,N/A,134,2
37,N/A,N/A,N/A,1196,1233,N/A,137,5
19,N/A,N/A,N/A,1177,1196,N/A,141,3
13,N/A,N/A,N/A,558,571,N/A,4,2
11,N/A,N/A,N/A,547,558,N/A,9,1
11,N/A,N/A,N/A,536,547,N/A,15,1
41,N/A,N/A,N/A,495,536,N/A,20,6
22,N/A,N/A,N/A,473,495,N/A,24,4
18,N/A,N/A,N/A,455,473,N/A,29,3
12,N/A,N/A,N/A,443,455,N/A,34,2
12,N/A,N/A,N/A,431,443,N/A,40,2
13,N/A,N/A,N/A,418,431,N/A,46,2
12,N/A,N/A,N/A,406,418,N/A,51,1
23,N/A,N/A,N/A,383,406,N/A,54,4
20,N/A,N/A,N/A,363,383,N/A,59,3
44,N/A,N/A,N/A,319,363,N/A,62,6
24,N/A,N/A,N/A,295,319,N/A,66,4
10,N/A,N/A,N/A,285,295,N/A,69,1
42,N/A,N/A,N/A,243,285,N/A,74,6
19,N/A,N/A,N/A,224,243,N/A,77,3
17,N/A,N/A,N/A,207,224,N/A,83,3
13,N/A,N/A,N/A,194,207,N/A,87,1
26,N/A,N/A,N/A,168,194,N/A,90,4
7,N/A,N/A,N/A,161,168,N/A,93,1
8,N/A,N/A,N/A,153,161,N/A,99,1
22,N/A,N/A,N/A,131,153,N/A,102,4
22,N/A,N/A,N/A,109,131,N/A,108,4
13,N/A,N/A,N/A,96,109,N/A,111,1
35,N/A,N/A,N/A,61,96,N/A,115,5
17,N/A,N/A,N/A,44,61,N/A,118,2
10,N/A,N/A,N/A,34,44,N/A,124,2
12,N/A,N/A,N/A,22,34,N/A,130,2
12,N/A,N/A,N/A,10,22,N/A,136,2
41,N/A,N/A,N/A,1898,1939,N/A,4,6
5,N/A,N/A,N/A,1893,1898,N/A,10,0
44,N/A,N/A,N/A,1849,1893,N/A,16,6
21,N/A,N/A,N/A,1828,1849,N/A,19,3
8,N/A,N/A,N/A,1820,1828,N/A,23,1
23,N/A,N/A,N/A,1797,1820,N/A,26,4
12,N/A,N/A,N/A,1785,1797,N/A,30,2
12,N/A,N/A,N/A,1773,1785,N/A,35,1
13,N/A,N/A,N/A,1760,1773,N/A,41,1
43,N/A,N/A,N/A,1717,1760,N/A,46,6
24,N/A,N/A,N/A,1693,1717,N/A,50,4
13,N/A,N/A,N/A,1680,1693,N/A,54,2
33,N/A,N/A,N/A,1647,1680,N/A,57,5
23,N/A,N/A,N/A,1624,1647,N/A,62,4
27,N/A,N/A,N/A,1597,1624,N/A,68,4
30,N/A,N/A,N/A,1567,1597,N/A,74,4
12,N/A,N/A,N/A,1555,1567,N/A,78,2
42,N/A,N/A,N/A,1513,1555,N/A,82,6
35,N/A,N/A,N/A,1478,1513,N/A,87,5
37,N/A,N/A,N/A,1441,1478,N/A,93,5
33,N/A,N/A,N/A,1408,1441,N/A,99,5
25,N/A,N/A,N/A,1383,1408,N/A,104,4
21,N/A,N/A,N/A,1362,1383,N/A,109,3
42,N/A,N/A,N/A,1320,1362,N/A,112,6
29,N/A,N/A,N/A,1291,1320,N/A,116,4
14,N/A,N/A,N/A,1277,1291,N/A,121,3
44,N/A,N/A,N/A,1233,1277,N/A,124,6
5,N/A,N/A,N/A,1228,1233,N/A,130,0
22,N/A,N/A,N/A,1206,1228,N/A,133,3
11,N/A,N/A,N/A,1195,1206,N/A,137,1
42,N/A,N/A,N/A,1118,1160,N/A,3,6
7,N/A,N/A,N/A,1111,1118,N/A,9,0
14,N/A,N/A,N/A,1097,1111,N/A,12,3
10,N/A,N/A,N/A,1087,1097,N/A,16,1
32,N/A,N/A,N/A,1055,1087,N/A,19,4
10,N/A,N/A,N/A,1045,1055,N/A,23,2
38,N/A,N/A,N/A,1007,1045,N/A,26,5
25,N/A,N/A,N/A,982,1007,N/A,31,4
31,N/A,N/A,N/A,951,982,N/A,37,4
11,N/A,N/A,N/A,940,951,N/A,40,1
42,N/A,N/A,N/A,898,940,N/A,45,6
22,N/A,N/A,N/A,876,898,N/A,48,3
14,N/A,N/A,N/A,862,876,N/A,54,3
10,N/A,N/A,N/A,852,862,N/A,59,2
42,N/A,N/A,N/A,810,852,N/A,63,6
24,N/A,N/A,N/A,786,810,N/A,67,4
11,N/A,N/A,N/A,775,786,N/A,70,1
12,N/A,N/A,N/A,763,775,N/A,76,1
39,N/A,N/A,N/A,724,763,N/A,80,5
23,N/A,N/A,N/A,701,724,N/A,84,3
13,N/A,N/A,N/A,688,701,N/A,89,2
7,N/A,N/A,N/A,681,688,N/A,94,1
35,N/A,N/A,N/A,646,681,N/A,98,5
39,N/A,N/A,N/A,607,646,N/A,104,5
23,N/A,N/A,N/A,584,607,N/A,108,3
44,N/A,N/A,N/A,540,584,N/A,111,6
34,N/A,N/A,N/A,506,540,N/A,116,5
32,N/A,N/A,N/A,474,506,N/A,122,5
38,N/A,N/A,N/A,436,474,N/A,128,5
27,N/A,N/A,N/A,409,436,N/A,133,4
13,N/A,N/A,N/A,876,889,N/A,3,2
44,N/A,N/A,N/A,832,876,N/A,7,6
22,N/A,N/A,N/A,810,832,N/A,10,3
16,N/A,N/A,N/A,794,810,N/A,15,2
13,N/A,N/A,N/A,781,794,N/A,20,1
32,N/A,N/A,N/A,749,781,N/A,24,5
34,N/A,N/A,N/A,715,749,N/A,30,5
30,N/A,N/A,N/A,685,715,N/A,35,4
25,N/A,N/A,N/A,660,685,N/A,41,4
30,N/A,N/A,N/A,630,660,N/A,47,4
8,N/A,N/A,N/A,622,630,N/A,50,1
42,N/A,N/A,N/A,580,622,N/A,55,6
24,N/A,N/A,N/A,556,580,N/A,59,4
14,N/A,N/A,N/A,542,556,N/A,63,2
37,N/A,N/A,N/A,505,542,N/A,66,5
17,N/A,N/A,N/A,488,505,N/A,70,3
42,N/A,N/A,N/A,446,488,N/A,73,6
16,N/A,N/A,N/A,430,446,N/A,76,3
21,N/A,N/A,N/A,409,430,N/A,82,3
7,N/A,N/A,N/A,402,409,N/A,86,1
42,N/A,N/A,N/A,360,402,N/A,91,6
32,N/A,N/A,N/A,328,360,N/A,95,4
21,N/A,N/A,N/A,307,328,N/A,100,3
41,N/A,N/A,N/A,266,307,N/A,103,6
35,N/A,N/A,N/A,231,266,N/A,108,5
36,N/A,N/A,N/A,195,231,N/A,114,5
34,N/A,N/A,N/A,161,195,N/A,120,5
11,N/A,N/A,N/A,150,161,N/A,123,2
35,N/A,N/A,N/A,115,150,N/A,126,5
23,N/A,N/A,N/A,92,115,N/A,130,3
14,N/A,N/A,N/A,1021,1035,N/A,4,3
44,N/A,N/A,N/A,977,1021,N/A,7,6
5,N/A,N/A,N/A,972,977,N/A,13,0
22,N/A,N/A,N/A,950,972,N/A,16,3
41,N/A,N/A,N/A,909,950,N/A,19,6
20,N/A,N/A,N/A,889,909,N/A,22,3
16,N/A,N/A,N/A,873,889,N/A,27,2
39,N/A,N/A,N/A,834,873,N/A,30,5
27,N/A,N/A,N/A,807,834,N/A,35,4
14,N/A,N/A,N/A,793,807,N/A,38,1
29,N/A,N/A,N/A,764,793,N/A,41,4
17,N/A,N/A,N/A,747,764,N/A,45,2
9,N/A,N/A,N/A,738,747,N/A,50,1
32,N/A,N/A,N/A,706,738,N/A,54,5
10,N/A,N/A,N/A,696,706,N/A,57,2
17,N/A,N/A,N/A,679,696,N/A,63,2
14,N/A,N/A,N/A,665,679,N/A,68,1
39,N/A,N/A,N/A,626,665,N/A,72,5
39,N/A,N/A,N/A,587,626,N/A,78,5
18,N/A,N/A,N/A,569,587,N/A,82,3
14,N/A,N/A,N/A,555,569,N/A,87,2
9,N/A,N/A,N/A,546,555,N/A,92,1
39,N/A,N/A,N/A,507,546,N/A,96,5
14,N/A,N/A,N/A,493,507,N/A,99,2
12,N/A,N/A,N/A,481,493,N/A,105,2
43,N/A,N/A,N/A,438,481,N/A,109,6
16,N/A,N/A,N/A,422,438,N/A,112,3
43,N/A,N/A,N/A,379,422,N/A,115,6
19,N/A,N/A,N/A,360,379,N/A,118,3
42,N/A,N/A,N/A,318,360,N/A,121,6
44,N/A,N/A,N/A,1102,1146,N/A,3,6
18,N/A,N/A,N/A,1084,1102,N/A,6,3
16,N/A,N/A,N/A,1068,1084,N/A,12,3
8,N/A,N/A,N/A,1060,1068,N/A,16,1
12,N/A,N/A,N/A,1048,1060,N/A,22,1
38,N/A,N/A,N/A,1010,1048,N/A,26,5
32,N/A,N/A,N/A,978,1010,N/A,32,5
15,N/A,N/A,N/A,963,978,N/A,35,2
42,N/A,N/A,N/A,921,963,N/A,39,6
6,N/A,N/A,N/A,915,921,N/A,45,0
15,N/A,N/A,N/A,900,915,N/A,48,3
15,N/A,N/A,N/A,885,900,N/A,53,2
43,N/A,N/A,N/A,842,885,N/A,57,6
37,N/A,N/A,N/A,805,842,N/A,62,5
13,N/A,N/A,N/A,792,805,N/A,65,2
35,N/A,N/A,N/A,757,792,N/A,68,5
17,N/A,N/A,N/A,740,757,N/A,71,2
43,N/A,N/A,N/A,697,740,N/A,75,6
34,N/A,N/A,N/A,663,697,N/A,80,5
16,N/A,N/A,N/A,647,663,N/A,84,3
12,N/A,N/A,N/A,635,647,N/A,89,2
15,N/A,N/A,N/A,620,635,N/A,95,2
13,N/A,N/A,N/A,607,620,N/A,100,1
25,N/A,N/A,N/A,582,607,N/A,103,4
30,N/A,N/A,N/A,552,582,N/A,109,4
30,N/A,N/A,N/A,522,552,N/A,115,4
13,N/A,N/A,N/A,509,522,N/A,119,2
13,N/A,N/A,N/A,496,509,N/A,124,1
44,N/A,N/A,N/A,452,496,N/A,129,6
36,N/A,N/A,N/A,416,452,N/A,134,5
9,N/A,N/A,N/A,1631,1640,N/A,5,1
13,N/A,N/A,N/A,1618,1631,N/A,11,1
14,N/A,N/A,N/A,1604,1618,N/A,17,1
9,N/A,N/A,N/A,1595,1604,N/A,23,1
27,N/A,N/A,N/A,1568,1595,N/A,26,4
13,N/A,N/A,N/A,1555,1568,N/A,30,2
44,N/A,N/A,N/A,1511,1555,N/A,34,6
16,N/A,N/A,N/A,1495,1511,N/A,37,3
10,N/A,N/A,N/A,1485,1495,N/A,42,2
15,N/A,N/A,N/A,1470,1485,N/A,48,2
10,N/A,N/A,N/A,1460,1470,N/A,53,1
13,N/A,N/A,N/A,1447,1460,N/A,59,1
33,N/A,N/A,N/A,1414,1447,N/A,63,5
33,N/A,N/A,N/A,1381,1414,N/A,69,5
21,N/A,N/A,N/A,1360,1381,N/A,73,3
44,N/A,N/A,N/A,1316,1360,N/A,76,6
7,N/A,N/A,N/A,1309,1316,N/A,82,0
14,N/A,N/A,N/A,1295,1309,N/A,85,3
22,N/A,N/A,N/A,1273,1295,N/A,91,3
10,N/A,N/A,N/A,1263,1273,N/A,95,1
12,N/A,N/A,N/A,1251,1263,N/A,101,1
44,N/A,N/A,N/A,1207,1251,N/A,106,6
30,N/A,N/A,N/A,1177,1207,N/A,110,4
13,N/A,N/A,N/A,1164,1177,N/A,113,1
41,N/A,N/A,N/A,1123,1164,N/A,118,6
16,N/A,N/A,N/A,1107,1123,N/A,121,3
22,N/A,N/A,N/A,1085,1107,N/A,127,3
16,N/A,N/A,N/A,1069,1085,N/A,132,2
11,N/A,N/A,N/A,1058,1069,N/A,138,2
36,N/A,N/A,N/A,1022,1058,N/A,141,5
37,N/A,N/A,N/A,1689,1726,N/A,6,5
10,N/A,N/A,N/A,1679,1689,N/A,9,2
13,N/A,N/A,N/A,1666,1679,N/A,15,2
9,N/A,N/A,N/A,1657,1666,N/A,20,1
9,N/A,N/A,N/A,1648,1657,N/A,26,1
9,N/A,N/A,N/A,1639,1648,N/A,32,1
39,N/A,N/A,N/A,1600,1639,N/A,36,5
18,N/A,N/A,N/A,1582,1600,N/A,40,3
19,N/A,N/A,N/A,1563,1582,N/A,46,3
8,N/A,N/A,N/A,1555,1563,N/A,50,1
38,N/A,N/A,N/A,1517,1555,N/A,54,5
27,N/A,N/A,N/A,1490,1517,N/A,59,4
13,N/A,N/A,N/A,1477,1490,N/A,62,1
25,N/A,N/A,N/A,1452,1477,N/A,65,4
14,N/A,N/A,N/A,1438,1452,N/A,70,3
10,N/A,N/A,N/A,1428,1438,N/A,75,2
43,N/A,N/A,N/A,1385,1428,N/A,79,6
24,N/A,N/A,N/A,1361,1385,N/A,83,4
21,N/A,N/A,N/A,1340,1361,N/A,88,3
43,N/A,N/A,N/A,1297,1340,N/A,91,6
22,N/A,N/A,N/A,1275,1297,N/A,95,4
17,N/A,N/A,N/A,1258,1275,N/A,99,2
38,N/A,N/A,N/A,1220,1258,N/A,102,5
39,N/A,N/A,N/A,1181,1220,N/A,108,5
36,N/A,N/A,N/A,1145,1181,N/A,114,5
14,N/A,N/A,N/A,1131,1145,N/A,117,2
43,N/A,N/A,N/A,1088,1131,N/A,121,6
38,N/A,N/A,N/A,1050,1088,N/A,126,5
25,N/A,N/A,N/A,1025,1050,N/A,131,4
21,N/A,N/A,N/A,1004,1025,N/A,136,3
11,N/A,N/A,N/A,1292,1303,N/A,3,1
42,N/A,N/A,N/A,1250,1292,N/A,8,6
32,N/A,N/A,N/A,1218,1250,N/A,12,4
14,N/A,N/A,N/A,1204,1218,N/A,15,1
44,N/A,N/A,N/A,1160,1204,N/A,20,6
16,N/A,N/A,N/A,1144,1160,N/A,23,3
15,N/A,N/A,N/A,1129,1144,N/A,28,2
35,N/A,N/A,N/A,1094,1129,N/A,31,5
14,N/A,N/A,N/A,1080,1094,N/A,34,2
41,N/A,N/A,N/A,1039,1080,N/A,38,6
37,N/A,N/A,N/A,1002,1039,N/A,43,5
26,N/A,N/A,N/A,976,1002,N/A,48,4
32,N/A,N/A,N/A,944,976,N/A,54,4
16,N/A,N/A,N/A,928,944,N/A,59,3
41,N/A,N/A,N/A,887,928,N/A,62,6
14,N/A,N/A,N/A,873,887,N/A,65,3
14,N/A,N/A,N/A,859,873,N/A,69,1
10,N/A,N/A,N/A,849,859,N/A,75,1
11,N/A,N/A,N/A,838,849,N/A,81,1
42,N/A,N/A,N/A,796,838,N/A,86,6
32,N/A,N/A,N/A,764,796,N/A,90,4
15,N/A,N/A,N/A,749,764,N/A,95,3
17,N/A,N/A,N/A,732,749,N/A,101,3
14,N/A,N/A,N/A,718,732,N/A,105,1
44,N/A,N/A,N/A,674,718,N/A,110,6
14,N/A,N/A,N/A,660,674,N/A,113,3
9,N/A,N/A,N/A,651,660,N/A,117,1
44,N/A,N/A,N/A,607,651,N/A,122,6
24,N/A,N/A,N/A,583,607,N/A,126,4
11,N/A,N/A,N/A,572,583,N/A,130,2
23,N/A,N/A,N/A,833,856,N/A,6,3
16,N/A,N/A,N/A,817,833,N/A,12,3
15,N/A,N/A,N/A,802,817,N/A,18,3
10,N/A,N/A,N/A,792,802,N/A,23,2
16,N/A,N/A,N/A,776,792,N/A,29,2
33,N/A,N/A,N/A,743,776,N/A,32,5
20,N/A,N/A,N/A,723,743,N/A,36,3
15,N/A,N/A,N/A,708,723,N/A,41,2
35,N/A,N/A,N/A,673,708,N/A,44,5
12,N/A,N/A,N/A,661,673,N/A,47,2
44,N/A,N/A,N/A,617,661,N/A,51,6
7,N/A,N/A,N/A,610,617,N/A,57,0
39,N/A,N/A,N/A,571,610,N/A,62,5
12,N/A,N/A,N/A,559,571,N/A,65,2
9,N/A,N/A,N/A,550,559,N/A,70,1
43,N/A,N/A,N/A,507,550,N/A,75,6
8,N/A,N/A,N/A,499,507,N/A,81,0
41,N/A,N/A,N/A,458,499,N/A,87,6
23,N/A,N/A,N/A,435,458,N/A,91,4
23,N/A,N/A,N/A,412,435,N/A,96,3
14,N/A,N/A,N/A,398,412,N/A,100,1
34,N/A,N/A,N/A,364,398,N/A,104,5
13,N/A,N/A,N/A,351,364,N/A,107,2
8,N/A,N/A,N/A,343,351,N/A,112,1
35,N/A,N/A,N/A,308,343,N/A,116,5
13,N/A,N/A,N/A,295,308,N/A,119,2
11,N/A,N/A,N/A,284,295,N/A,124,1
13,N/A,N/A,N/A,271,284,N/A,130,1
39,N/A,N/A,N/A,232,271,N/A,134,5
15,N/A,N/A,N/A,217,232,N/A,138,3
13,N/A,N/A,N/A,1971,1984,N/A,3,2
16,N/A,N/A,N/A,1955,1971,N/A,9,2
35,N/A,N/A,N/A,1920,1955,N/A,12,5
16,N/A,N/A,N/A,1904,1920,N/A,15,2
42,N/A,N/A,N/A,1862,1904,N/A,19,6
19,N/A,N/A,N/A,1843,1862,N/A,22,3
15,N/A,N/A,N/A,1828,1843,N/A,27,2
11,N/A,N/A,N/A,1817,1828,N/A,32,1
13,N/A,N/A,N/A,1804,1817,N/A,38,1
26,N/A,N/A,N/A,1778,1804,N/A,41,4
11,N/A,N/A,N/A,1767,1778,N/A,44,1
24,N/A,N/A,N/A,1743,1767,N/A,47,4
12,N/A,N/A,N/A,1731,1743,N/A,51,2
42,N/A,N/A,N/A,1689,1731,N/A,55,6
9,N/A,N/A,N/A,1680,1689,N/A,61,0
42,N/A,N/A,N/A,1638,1680,N/A,67,6
5,N/A,N/A,N/A,1633,1638,N/A,73,0
35,N/A,N/A,N/A,1598,1633,N/A,78,5
23,N/A,N/A,N/A,1575,1598,N/A,82,3
12,N/A,N/A,N/A,1563,1575,N/A,86,1
11,N/A,N/A,N/A,1552,1563,N/A,92,1
38,N/A,N/A,N/A,1514,1552,N/A,96,5
24,N/A,N/A,N/A,1490,1514,N/A,101,4
19,N/A,N/A,N/A,1471,1490,N/A,106,3
12,N/A,N/A,N/A,1459,1471,N/A,111,2
43,N/A,N/A,N/A,1416,1459,N/A,115,6
25,N/A,N/A,N/A,1391,1416,N/A,119,4
31,N/A,N/A,N/A,1360,1391,N/A,125,4
12,N/A,N/A,N/A,1348,1360,N/A,129,2
14,N/A,N/A,N/A,1334,1348,N/A,135,2
10,N/A,N/A,N/A,1640,1650,N/A,5,1
35,N/A,N/A,N/A,1605,1640,N/A,9,5
32,N/A,N/A,N/A,1573,1605,N/A,14,4
16,N/A,N/A,N/A,1557,1573,N/A,19,3
41,N/A,N/A,N/A,1516,1557,N/A,22,6
23,N/A,N/A,N/A,1493,1516,N/A,25,3
17,N/A,N/A,N/A,1476,1493,N/A,30,2
11,N/A,N/A,N/A,1465,1476,N/A,36,2
7,N/A,N/A,N/A,1458,1465,N/A,41,1
10,N/A,N/A,N/A,1448,1458,N/A,47,1
32,N/A,N/A,N/A,1416,1448,N/A,51,5
25,N/A,N/A,N/A,1391,1416,N/A,56,4
16,N/A,N/A,N/A,1375,1391,N/A,61,3
13,N/A,N/A,N/A,1362,1375,N/A,66,2
11,N/A,N/A,N/A,1351,1362,N/A,72,2
36,N/A,N/A,N/A,1315,1351,N/A,75,5
30,N/A,N/A,N/A,1285,1315,N/A,80,4
14,N/A,N/A,N/A,1271,1285,N/A,83,1
31,N/A,N/A,N/A,1240,1271,N/A,86,4
17,N/A,N/A,N/A,1223,1240,N/A,91,3
14,N/A,N/A,N/A,1209,1223,N/A,95,1
27,N/A,N/A,N/A,1182,1209,N/A,98,4
17,N/A,N/A,N/A,1165,1182,N/A,102,2
38,N/A,N/A,N/A,1127,1165,N/A,105,5
13,N/A,N/A,N/A,1114,1127,N/A,108,2
17,N/A,N/A,N/A,1097,1114,N/A,114,2
43,N/A,N/A,N/A,1054,1097,N/A,118,6
14,N/A,N/A,N/A,1040,1054,N/A,121,3
12,N/A,N/A,N/A,1028,1040,N/A,125,1
38,N/A,N/A,N/A,990,1028,N/A,129,5
20,N/A,N/A,N/A,1048,1068,N/A,6,3
20,N/A,N/A,N/A,1028,1048,N/A,12,3
19,N/A,N/A,N/A,1009,1028,N/A,18,3
44,N/A,N/A,N/A,965,1009,N/A,21,6
26,N/A,N/A,N/A,939,965,N/A,25,4
12,N/A,N/A,N/A,927,939,N/A,28,1
34,N/A,N/A,N/A,893,927,N/A,32,5
35,N/A,N/A,N/A,858,893,N/A,38,5
29,N/A,N/A,N/A,829,858,N/A,43,4
28,N/A,N/A,N/A,801,829,N/A,49,4
24,N/A,N/A,N/A,777,801,N/A,55,4
28,N/A,N/A,N/A,749,777,N/A,61,4
14,N/A,N/A,N/A,735,749,N/A,64,1
38,N/A,N/A,N/A,697,735,N/A,68,5
10,N/A,N/A,N/A,687,697,N/A,71,2
41,N/A,N/A,N/A,646,687,N/A,75,6
28,N/A,N/A,N/A,618,646,N/A,79,4
16,N/A,N/A,N/A,602,618,N/A,83,2
37,N/A,N/A,N/A,565,602,N/A,86,5
35,N/A,N/A,N/A,530,565,N/A,92,5
16,N/A,N/A,N/A,514,530,N/A,95,2
44,N/A,N/A,N/A,470,514,N/A,99,6
34,N/A,N/A,N/A,436,470,N/A,104,5
10,N/A,N/A,N/A,426,436,N/A,107,2
11,N/A,N/A,N/A,415,426,N/A,113,2
13,N/A,N/A,N/A,402,415,N/A,118,1
37,N/A,N/A,N/A,365,402,N/A,122,5
20,N/A,N/A,N/A,345,365,N/A,126,3
42,N/A,N/A,N/A,303,345,N/A,129,6
31,N/A,N/A,N/A,272,303,N/A,133,4
41,N/A,N/A,N/A,1816,1857,N/A,4,6
38,N/A,N/A,N/A,1778,1816,N/A,9,5
21,N/A,N/A,N/A,1757,1778,N/A,13,3
13,N/A,N/A,N/A,1744,1757,N/A,17,1
43,N/A,N/A,N/A,1701,1744,N/A,22,6
35,N/A,N/A,N/A,1666,1701,N/A,27,5
17,N/A,N/A,N/A,1649,1666,N/A,30,2
9,N/A,N/A,N/A,1640,1649,N/A,35,1
41,N/A,N/A,N/A,1599,1640,N/A,40,6
9,N/A,N/A,N/A,1590,1599,N/A,46,0
34,N/A,N/A,N/A,1556,1590,N/A,51,5
14,N/A,N/A,N/A,1542,1556,N/A,54,2
11,N/A,N/A,N/A,1531,1542,N/A,60,2
16,N/A,N/A,N/A,1515,1531,N/A,66,2
41,N/A,N/A,N/A,1474,1515,N/A,70,6
19,N/A,N/A,N/A,1455,1474,N/A,73,3
19,N/A,N/A,N/A,1436,1455,N/A,79,3
7,N/A,N/A,N/A,1429,1436,N/A,83,1
24,N/A,N/A,N/A,1405,1429,N/A,86,4
11,N/A,N/A,N/A,1394,1405,N/A,90,2
12,N/A,N/A,N/A,1382,1394,N/A,95,1
7,N/A,N/A,N/A,1375,1382,N/A,101,1
30,N/A,N/A,N/A,1345,1375,N/A,104,4
23,N/A,N/A,N/A,1322,1345,N/A,110,4
9,N/A,N/A,N/A,1313,1322,N/A,113,1
32,N/A,N/A,N/A,1281,1313,N/A,117,5
36,N/A,N/A,N/A,1245,1281,N/A,123,5
29,N/A,N/A,N/A,1216,1245,N/A,128,4
17,N/A,N/A,N/A,1199,1216,N/A,132,2
9,N/A,N/A,N/A,1190,1199,N/A,137,1
23,N/A,N/A,N/A,1680,1703,N/A,3,3
10,N/A,N/A,N/A,1670,1680,N/A,8,2
43,N/A,N/A,N/A,1627,1670,N/A,12,6
8,N/A,N/A,N/A,1619,1627,N/A,18,0
33,N/A,N/A,N/A,1586,1619,N/A,23,5
37,N/A,N/A,N/A,1549,1586,N/A,29,5
32,N/A,N/A,N/A,1517,1549,N/A,34,4
22,N/A,N/A,N/A,1495,1517,N/A,39,3
13,N/A,N/A,N/A,1482,1495,N/A,44,2
34,N/A,N/A,N/A,1448,1482,N/A,47,5
27,N/A,N/A,N/A,1421,1448,N/A,52,4
29,N/A,N/A,N/A,1392,1421,N/A,58,4
12,N/A,N/A,N/A,1380,1392,N/A,62,2
44,N/A,N/A,N/A,1336,1380,N/A,66,6
37,N/A,N/A,N/A,1299,1336,N/A,71,5
33,N/A,N/A,N/A,1266,1299,N/A,77,5
18,N/A,N/A,N/A,1248,1266,N/A,81,3
44,N/A,N/A,N/A,1204,1248,N/A,84,6
20,N/A,N/A,N/A,1184,1204,N/A,87,3
14,N/A,N/A,N/A,1170,1184,N/A,91,1
27,N/A,N/A,N/A,1143,1170,N/A,94,4
9,N/A,N/A,N/A,1134,1143,N/A,97,1
41,N/A,N/A,N/A,1093,1134,N/A,102,6
33,N/A,N/A,N/A,1060,1093,N/A,107,5
24,N/A,N/A,N/A,1036,1060,N/A,112,4
10,N/A,N/A,N/A,1026,1036,N/A,116,2
11,N/A,N/A,N/A,1015,1026,N/A,122,2
36,N/A,N/A,N/A,979,1015,N/A,125,5
16,N/A,N/A,N/A,963,979,N/A,128,2
38,N/A,N/A,N/A,925,963,N/A,131,5
22,N/A,N/A,N/A,638,660,N/A,6,3
7,N/A,N/A,N/A,631,638,N/A,10,1
43,N/A,N/A,N/A,588,631,N/A,15,6
30,N/A,N/A,N/A,558,588,N/A,19,4
22,N/A,N/A,N/A,536,558,N/A,24,3
10,N/A,N/A,N/A,526,536,N/A,28,1
27,N/A,N/A,N/A,499,526,N/A,31,4
28,N/A,N/A,N/A,471,499,N/A,37,4
11,N/A,N/A,N/A,460,471,N/A,41,2
12,N/A,N/A,N/A,448,460,N/A,47,2
7,N/A,N/A,N/A,441,448,N/A,52,1
12,N/A,N/A,N/A,429,441,N/A,58,1
44,N/A,N/A,N/A,385,429,N/A,63,6
33,N/A,N/A,N/A,352,385,N/A,68,5
27,N/A,N/A,N/A,325,352,N/A,73,4
12,N/A,N/A,N/A,313,325,N/A,77,2
42,N/A,N/A,N/A,271,313,N/A,81,6
34,N/A,N/A,N/A,237,271,N/A,86,5
16,N/A,N/A,N/A,221,237,N/A,89,2
17,N/A,N/A,N/A,204,221,N/A,95,2
34,N/A,N/A,N/A,170,204,N/A,98,5
16,N/A,N/A,N/A,154,170,N/A,102,3
8,N/A,N/A,N/A,146,154,N/A,106,1
41,N/A,N/A,N/A,105,146,N/A,111,6
23,N/A,N/A,N/A,82,105,N/A,114,3
42,N/A,N/A,N/A,40,82,N/A,117,6
7,N/A,N/A,N/A,33,40,N/A,123,0
21,N/A,N/A,N/A,12,33,N/A,126,3
19,N/A,N/A,N/A,-7,12,N/A,132,3
27,N/A,N/A,N/A,1101,1128,N/A,4,4
7,N/A,N/A,N/A,1094,1101,N/A,7,1
13,N/A,N/A,N/A,1081,1094,N/A,13,1
9,N/A,N/A,N/A,1072,1081,N/A,19,1
39,N/A,N/A,N/A,1033,1072,N/A,23,5
22,N/A,N/A,N/A,1011,1033,N/A,28,4
10,N/A,N/A,N/A,1001,1011,N/A,32,2
39,N/A,N/A,N/A,962,1001,N/A,35,5
10,N/A,N/A,N/A,952,962,N/A,38,2
11,N/A,N/A,N/A,941,952,N/A,43,1
26,N/A,N/A,N/A,915,941,N/A,46,4
8,N/A,N/A,N/A,907,915,N/A,49,1
10,N/A,N/A,N/A,897,907,N/A,55,1
43,N/A,N/A,N/A,854,897,N/A,60,6
9,N/A,N/A,N/A,845,854,N/A,66,0
42,N/A,N/A,N/A,803,845,N/A,72,6
16,N/A,N/A,N/A,787,803,N/A,75,3
43,N/A,N/A,N/A,744,787,N/A,78,6
35,N/A,N/A,N/A,709,744,N/A,83,5
31,N/A,N/A,N/A,678,709,N/A,88,4
14,N/A,N/A,N/A,664,678,N/A,91,1
36,N/A,N/A,N/A,628,664,N/A,95,5
15,N/A,N/A,N/A,613,628,N/A,98,2
39,N/A,N/A,N/A,574,613,N/A,101,5
27,N/A,N/A,N/A,547,574,N/A,106,4
15,N/A,N/A,N/A,532,547,N/A,110,2
14,N/A,N/A,N/A,518,532,N/A,115,1
12,N/A,N/A,N/A,506,518,N/A,121,1
25,N/A,N/A,N/A,481,506,N/A,124,4
16,N/A,N/A,N/A,465,481,N/A,128,2
8,N/A,N/A,N/A,1433,1441,N/A,4,1
29,N/A,N/A,N/A,1404,1433,N/A,7,4
9,N/A,N/A,N/A,1395,1404,N/A,10,1
32,N/A,N/A,N/A,1363,1395,N/A,13,4
14,N/A,N/A,N/A,1349,1363,N/A,16,1
11,N/A,N/A,N/A,1338,1349,N/A,22,1
42,N/A,N/A,N/A,1296,1338,N/A,27,6
36,N/A,N/A,N/A,1260,1296,N/A,32,5
35,N/A,N/A,N/A,1225,1260,N/A,38,5
34,N/A,N/A,N/A,1191,1225,N/A,44,5
34,N/A,N/A,N/A,1157,1191,N/A,50,5
32,N/A,N/A,N/A,1125,1157,N/A,55,4
13,N/A,N/A,N/A,1112,1125,N/A,59,2
35,N/A,N/A,N/A,1077,1112,N/A,62,5
19,N/A,N/A,N/A,1058,1077,N/A,66,3
16,N/A,N/A,N/A,1042,1058,N/A,72,3
11,N/A,N/A,N/A,1031,1042,N/A,77,2
33,N/A,N/A,N/A,998,1031,N/A,80,5
14,N/A,N/A,N/A,984,998,N/A,84,3
21,N/A,N/A,N/A,963,984,N/A,90,3
10,N/A,N/A,N/A,953,963,N/A,94,1
41,N/A,N/A,N/A,912,953,N/A,99,6
24,N/A,N/A,N/A,888,912,N/A,103,4
10,N/A,N/A,N/A,878,888,N/A,107,2
14,N/A,N/A,N/A,864,878,N/A,112,1
32,N/A,N/A,N/A,832,864,N/A,115,4
29,N/A,N/A,N/A,803,832,N/A,121,4
22,N/A,N/A,N/A,781,803,N/A,126,3
17,N/A,N/A,N/A,764,781,N/A,132,3
15,N/A,N/A,N/A,749,764,N/A,138,3
14,N/A,N/A,N/A,1174,1188,N/A,6,2
17,N/A,N/A,N/A,1157,1174,N/A,12,2
42,N/A,N/A,N/A,1115,1157,N/A,16,6
35,N/A,N/A,N/A,1080,1115,N/A,21,5
27,N/A,N/A,N/A,1053,1080,N/A,26,4
18,N/A,N/A,N/A,1035,1053,N/A,31,3
18,N/A,N/A,N/A,1017,1035,N/A,37,3
11,N/A,N/A,N/A,1006,1017,N/A,42,2
43,N/A,N/A,N/A,963,1006,N/A,46,6
38,N/A,N/A,N/A,925,963,N/A,51,5
10,N/A,N/A,N/A,915,925,N/A,54,2
13,N/A,N/A,N/A,902,915,N/A,60,2
36,N/A,N/A,N/A,866,902,N/A,63,5
13,N/A,N/A,N/A,853,866,N/A,66,2
10,N/A,N/A,N/A,843,853,N/A,72,2
38,N/A,N/A,N/A,805,843,N/A,75,5
37,N/A,N/A,N/A,768,805,N/A,81,5
29,N/A,N/A,N/A,739,768,N/A,86,4
17,N/A,N/A,N/A,722,739,N/A,90,2
42,N/A,N/A,N/A,680,722,N/A,94,6
22,N/A,N/A,N/A,658,680,N/A,98,4
22,N/A,N/A,N/A,636,658,N/A,103,3
7,N/A,N/A,N/A,629,636,N/A,107,1
32,N/A,N/A,N/A,597,629,N/A,111,5
28,N/A,N/A,N/A,569,597,N/A,116,4
25,N/A,N/A,N/A,544,569,N/A,122,4
21,N/A,N/A,N/A,523,544,N/A,127,3
42,N/A,N/A,N/A,481,523,N/A,130,6
6,N/A,N/A,N/A,475,481,N/A,136,0
41,N/A,N/A,N/A,434,475,N/A,142,6
14,N/A,N/A,N/A,325,339,N/A,4,1
13,N/A,N/A,N/A,312,325,N/A,10,1
7,N/A,N/A,N/A,305,312,N/A,16,1
12,N/A,N/A,N/A,293,305,N/A,22,1
7,N/A,N/A,N/A,286,293,N/A,28,1
32,N/A,N/A,N/A,254,286,N/A,32,5
16,N/A,N/A,N/A,238,254,N/A,36,3
14,N/A,N/A,N/A,224,238,N/A,42,3
8,N/A,N/A,N/A,216,224,N/A,46,1
41,N/A,N/A,N/A,175,216,N/A,51,6
32,N/A,N/A,N/A,143,175,N/A,56,5
35,N/A,N/A,N/A,108,143,N/A,62,5
39,N/A,N/A,N/A,69,108,N/A,68,5
18,N/A,N/A,N/A,51,69,N/A,72,3
14,N/A,N/A,N/A,37,51,N/A,77,2
14,N/A,N/A,N/A,23,37,N/A,83,2
10,N/A,N/A,N/A,13,23,N/A,88,1
36,N/A,N/A,N/A,-23,13,N/A,92,5
13,N/A,N/A,N/A,1527,1540,N/A,5,2
44,N/A,N/A,N/A,1483,1527,N/A,9,6
22,N/A,N/A,N/A,1461,1483,N/A,12,3
44,N/A,N/A,N/A,1417,1461,N/A,15,6
5,N/A,N/A,N/A,1412,1417,N/A,21,0
16,N/A,N/A,N/A,1396,1412,N/A,24,3
7,N/A,N/A,N/A,1389,1396,N/A,28,1
7,N/A,N/A,N/A,1382,1389,N/A,34,1
29,N/A,N/A,N/A,1353,1382,N/A,37,4
27,N/A,N/A,N/A,1326,1353,N/A,43,4
14,N/A,N/A,N/A,1312,1326,N/A,47,2
9,N/A,N/A,N/A,1303,1312,N/A,52,1
37,N/A,N/A,N/A,1266,1303,N/A,56,5
14,N/A,N/A,N/A,1252,1266,N/A,59,2
39,N/A,N/A,N/A,1213,1252,N/A,62,5
16,N/A,N/A,N/A,1197,1213,N/A,66,3
17,N/A,N/A,N/A,1180,1197,N/A,71,2
43,N/A,N/A,N/A,1137,1180,N/A,75,6
20,N/A,N/A,N/A,1117,1137,N/A,78,3
44,N/A,N/A,N/A,1073,1117,N/A,81,6
7,N/A,N/A,N/A,1066,1073,N/A,87,0
22,N/A,N/A,N/A,1044,1066,N/A,91,4
21,N/A,N/A,N/A,1023,1044,N/A,96,3
13,N/A,N/A,N/A,1010,1023,N/A,101,2
11,N/A,N/A,N/A,999,1010,N/A,107,2
44,N/A,N/A,N/A,955,999,N/A,111,6
27,N/A,N/A,N/A,928,955,N/A,115,4
9,N/A,N/A,N/A,919,928,N/A,118,1
43,N/A,N/A,N/A,876,919,N/A,123,6
18,N/A,N/A,N/A,858,876,N/A,126,3
11,N/A,N/A,N/A,569,580,N/A,5,1
13,N/A,N/A,N/A,556,569,N/A,11,1
27,N/A,N/A,N/A,529,556,N/A,14,4
10,N/A,N/A,N/A,519,529,N/A,18,2
12,N/A,N/A,N/A,507,519,N/A,24,2
14,N/A,N/A,N/A,493,507,N/A,30,2
34,N/A,N/A,N/A,459,493,N/A,33,5
16,N/A,N/A,N/A,443,459,N/A,36,2
37,N/A,N/A,N/A,406,443,N/A,39,5
15,N/A,N/A,N/A,391,406,N/A,42,2
35,N/A,N/A,N/A,356,391,N/A,45,5
14,N/A,N/A,N/A,342,356,N/A,48,2
43,N/A,N/A,N/A,299,342,N/A,52,6
5,N/A,N/A,N/A,294,299,N/A,58,0
32,N/A,N/A,N/A,262,294,N/A,62,4
11,N/A,N/A,N/A,251,262,N/A,66,2
33,N/A,N/A,N/A,218,251,N/A,69,5
29,N/A,N/A,N/A,189,218,N/A,74,4
16,N/A,N/A,N/A,173,189,N/A,78,2
10,N/A,N/A,N/A,163,173,N/A,83,1
42,N/A,N/A,N/A,121,163,N/A,88,6
23,N/A,N/A,N/A,98,121,N/A,91,3
41,N/A,N/A,N/A,57,98,N/A,94,6
25,N/A,N/A,N/A,32,57,N/A,98,4
31,N/A,N/A,N/A,1,32,N/A,104,4
29,N/A,N/A,N/A,-28,1,N/A,110,4
21,N/A,N/A,N/A,362,383,N/A,3,3
7,N/A,N/A,N/A,355,362,N/A,7,1
36,N/A,N/A,N/A,319,355,N/A,11,5
34,N/A,N/A,N/A,285,319,N/A,17,5
34,N/A,N/A,N/A,251,285,N/A,23,5
30,N/A,N/A,N/A,221,251,N/A,28,4
21,N/A,N/A,N/A,200,221,N/A,33,3
10,N/A,N/A,N/A,190,200,N/A,38,2
32,N/A,N/A,N/A,158,190,N/A,41,5
20,N/A,N/A,N/A,138,158,N/A,45,3
12,N/A,N/A,N/A,126,138,N/A,49,1
38,N/A,N/A,N/A,88,126,N/A,53,5
31,N/A,N/A,N/A,57,88,N/A,58,4
10,N/A,N/A,N/A,47,57,N/A,62,2
13,N/A,N/A,N/A,34,47,N/A,68,2
15,N/A,N/A,N/A,19,34,N/A,74,2
11,N/A,N/A,N/A,8,19,N/A,79,1
38,N/A,N/A,N/A,-30,8,N/A,83,5
16,N/A,N/A,N/A,1748,1764,N/A,5,2
42,N/A,N/A,N/A,1706,1748,N/A,9,6
8,N/A,N/A,N/A,1698,1706,N/A,15,0
36,N/A,N/A,N/A,1662,1698,N/A,20,5
14,N/A,N/A,N/A,1648,1662,N/A,24,3
42,N/A,N/A,N/A,1606,1648,N/A,27,6
9,N/A,N/A,N/A,1597,1606,N/A,33,0
32,N/A,N/A,N/A,1565,1597,N/A,38,5
26,N/A,N/A,N/A,1539,1565,N/A,43,4
16,N/A,N/A,N/A,1523,1539,N/A,47,2
13,N/A,N/A,N/A,1510,1523,N/A,52,1
41,N/A,N/A,N/A,1469,1510,N/A,57,6
8,N/A,N/A,N/A,1461,1469,N/A,63,0
14,N/A,N/A,N/A,1447,1461,N/A,66,3
15,N/A,N/A,N/A,1432,1447,N/A,72,3
43,N/A,N/A,N/A,1389,1432,N/A,75,6
24,N/A,N/A,N/A,1365,1389,N/A,79,4
22,N/A,N/A,N/A,1343,1365,N/A,85,4
15,N/A,N/A,N/A,1328,1343,N/A,90,3
11,N/A,N/A,N/A,1317,1328,N/A,94,1
32,N/A,N/A,N/A,1285,1317,N/A,98,5
10,N/A,N/A,N/A,1275,1285,N/A,101,2
38,N/A,N/A,N/A,1237,1275,N/A,104,5
36,N/A,N/A,N/A,1201,1237,N/A,110,5
22,N/A,N/A,N/A,1179,1201,N/A,115,4
29,N/A,N/A,N/A,1150,1179,N/A,121,4
23,N/A,N/A,N/A,1127,1150,N/A,126,3
14,N/A,N/A,N/A,1113,1127,N/A,130,1
39,N/A,N/A,N/A,1074,1113,N/A,134,5
36,N/A,N/A,N/A,1038,1074,N/A,140,5
22,N/A,N/A,N/A,414,436,N/A,5,3
14,N/A,N/A,N/A,400,414,N/A,11,3
42,N/A,N/A,N/A,358,400,N/A,14,6
25,N/A,N/A,N/A,333,358,N/A,18,4
18,N/A,N/A,N/A,315,333,N/A,23,3
11,N/A,N/A,N/A,304,315,N/A,27,1
26,N/A,N/A,N/A,278,304,N/A,30,4
18,N/A,N/A,N/A,260,278,N/A,35,3
12,N/A,N/A,N/A,248,260,N/A,40,2
43,N/A,N/A,N/A,205,248,N/A,44,6
15,N/A,N/A,N/A,190,205,N/A,47,3
10,N/A,N/A,N/A,180,190,N/A,52,2
44,N/A,N/A,N/A,136,180,N/A,56,6
21,N/A,N/A,N/A,115,136,N/A,59,3
14,N/A,N/A,N/A,101,115,N/A,64,2
9,N/A,N/A,N/A,92,101,N/A,69,1
25,N/A,N/A,N/A,67,92,N/A,72,4
25,N/A,N/A,N/A,42,67,N/A,78,4
21,N/A,N/A,N/A,21,42,N/A,83,3
22,N/A,N/A,N/A,-1,21,N/A,89,3
19,N/A,N/A,N/A,1312,1331,N/A,3,3
42,N/A,N/A,N/A,1270,1312,N/A,6,6
24,N/A,N/A,N/A,1246,1270,N/A,10,4
24,N/A,N/A,N/A,1222,1246,N/A,16,4
17,N/A,N/A,N/A,1205,1222,N/A,21,3
44,N/A,N/A,N/A,1161,1205,N/A,24,6
32,N/A,N/A,N/A,1129,1161,N/A,28,4
8,N/A,N/A,N/A,1121,1129,N/A,31,1
12,N/A,N/A,N/A,1109,1121,N/A,37,1
32,N/A,N/A,N/A,1077,1109,N/A,41,5
11,N/A,N/A,N/A,1066,1077,N/A,44,2
10,N/A,N/A,N/A,1056,1066,N/A,49,1
29,N/A,N/A,N/A,1027,1056,N/A,52,4
26,N/A,N/A,N/A,1001,1027,N/A,58,4
31,N/A,N/A,N/A,970,1001,N/A,64,4
13,N/A,N/A,N/A,957,970,N/A,68,2
32,N/A,N/A,N/A,925,957,N/A,71,5
30,N/A,N/A,N/A,895,925,N/A,76,4
10,N/A,N/A,N/A,885,895,N/A,80,2
14,N/A,N/A,N/A,871,885,N/A,85,1
31,N/A,N/A,N/A,840,871,N/A,88,4
17,N/A,N/A,N/A,823,840,N/A,93,3
44,N/A,N/A,N/A,779,823,N/A,96,6
23,N/A,N/A,N/A,756,779,N/A,99,3
44,N/A,N/A,N/A,712,756,N/A,102,6
20,N/A,N/A,N/A,692,712,N/A,105,3
10,N/A,N/A,N/A,682,692,N/A,109,1
41,N/A,N/A,N/A,641,682,N/A,114,6
7,N/A,N/A,N/A,634,641,N/A,120,0
39,N/A,N/A,N/A,595,634,N/A,125,5
43,N/A,N/A,N/A,858,901,N/A,5,6
39,N/A,N/A,N/A,819,858,N/A,10,5
22,N/A,N/A,N/A,797,819,N/A,14,3
14,N/A,N/A,N/A,783,797,N/A,20,3
41,N/A,N/A,N/A,742,783,N/A,23,6
37,N/A,N/A,N/A,705,742,N/A,28,5
38,N/A,N/A,N/A,667,705,N/A,34,5
12,N/A,N/A,N/A,655,667,N/A,37,2
14,N/A,N/A,N/A,641,655,N/A,43,2
10,N/A,N/A,N/A,631,641,N/A,49,2
33,N/A,N/A,N/A,598,631,N/A,52,5
25,N/A,N/A,N/A,573,598,N/A,57,4
11,N/A,N/A,N/A,562,573,N/A,60,1
31,N/A,N/A,N/A,531,562,N/A,63,4
11,N/A,N/A,N/A,520,531,N/A,67,2
14,N/A,N/A,N/A,506,520,N/A,72,1
8,N/A,N/A,N/A,498,506,N/A,78,1
44,N/A,N/A,N/A,454,498,N/A,83,6
25,N/A,N/A,N/A,429,454,N/A,87,4
13,N/A,N/A,N/A,416,429,N/A,91,2
44,N/A,N/A,N/A,372,416,N/A,95,6
19,N/A,N/A,N/A,353,372,N/A,98,3
15,N/A,N/A,N/A,338,353,N/A,103,2
10,N/A,N/A,N/A,328,338,N/A,109,2
16,N/A,N/A,N/A,312,328,N/A,115,2
41,N/A,N/A,N/A,271,312,N/A,119,6
5,N/A,N/A,N/A,266,271,N/A,125,0
24,N/A,N/A,N/A,242,266,N/A,129,4
13,N/A,N/A,N/A,229,242,N/A,133,2
14,N/A,N/A,N/A,215,229,N/A,139,2
26,N/A,N/A,N/A,1892,1918,N/A,4,4
12,N/A,N/A,N/A,1880,1892,N/A,7,1
43,N/A,N/A,N/A,1837,1880,N/A,12,6
18,N/A,N/A,N/A,1819,1837,N/A,15,3
42,N/A,N/A,N/A,1777,1819,N/A,18,6
5,N/A,N/A,N/A,1772,1777,N/A,24,0
41,N/A,N/A,N/A,1731,1772,N/A,30,6
21,N/A,N/A,N/A,1710,1731,N/A,33,3
14,N/A,N/A,N/A,1696,1710,N/A,39,3
44,N/A,N/A,N/A,1652,1696,N/A,42,6
28,N/A,N/A,N/A,1624,1652,N/A,46,4
8,N/A,N/A,N/A,1616,1624,N/A,49,1
11,N/A,N/A,N/A,1605,1616,N/A,55,1
28,N/A,N/A,N/A,1577,1605,N/A,58,4
13,N/A,N/A,N/A,1564,1577,N/A,62,2
34,N/A,N/A,N/A,1530,1564,N/A,65,5
34,N/A,N/A,N/A,1496,1530,N/A,71,5
22,N/A,N/A,N/A,1474,1496,N/A,76,4
15,N/A,N/A,N/A,1459,1474,N/A,80,2
7,N/A,N/A,N/A,1452,1459,N/A,85,1
39,N/A,N/A,N/A,1413,1452,N/A,89,5
14,N/A,N/A,N/A,1399,1413,N/A,92,2
16,N/A,N/A,N/A,1383,1399,N/A,98,2
13,N/A,N/A,N/A,1370,1383,N/A,103,1
37,N/A,N/A,N/A,1333,1370,N/A,107,5
39,N/A,N/A,N/A,1294,1333,N/A,113,5
38,N/A,N/A,N/A,1256,1294,N/A,119,5
14,N/A,N/A,N/A,1242,1256,N/A,123,3
15,N/A,N/A,N/A,1227,1242,N/A,129,3
22,N/A,N/A,N/A,1205,1227,N/A,135,3
11,N/A,N/A,N/A,1768,1779,N/A,6,2
12,N/A,N/A,N/A,1756,1768,N/A,11,1
7,N/A,N/A,N/A,1749,1756,N/A,17,1
32,N/A,N/A,N/A,1717,1749,N/A,21,5
14,N/A,N/A,N/A,1703,1717,N/A,24,2
38,N/A,N/A,N/A,1665,1703,N/A,27,5
10,N/A,N/A,N/A,1655,1665,N/A,30,2
12,N/A,N/A,N/A,1643,1655,N/A,35,1
42,N/A,N/A,N/A,1601,1643,N/A,40,6
22,N/A,N/A,N/A,1579,1601,N/A,44,4
14,N/A,N/A,N/A,1565,1579,N/A,47,1
9,N/A,N/A,N/A,1556,1565,N/A,53,1
29,N/A,N/A,N/A,1527,1556,N/A,56,4
30,N/A,N/A,N/A,1497,1527,N/A,62,4
7,N/A,N/A,N/A,1490,1497,N/A,65,1
25,N/A,N/A,N/A,1465,1490,N/A,68,4
14,N/A,N/A,N/A,1451,1465,N/A,72,2
11,N/A,N/A,N/A,1440,1451,N/A,78,2
32,N/A,N/A,N/A,1408,1440,N/A,81,5
35,N/A,N/A,N/A,1373,1408,N/A,87,5
15,N/A,N/A,N/A,1358,1373,N/A,90,2
15,N/A,N/A,N/A,1343,1358,N/A,96,2
39,N/A,N/A,N/A,1304,1343,N/A,99,5
18,N/A,N/A,N/A,1286,1304,N/A,103,3
15,N/A,N/A,N/A,1271,1286,N/A,109,3
15,N/A,N/A,N/A,1256,1271,N/A,114,2
43,N/A,N/A,N/A,1213,1256,N/A,118,6
28,N/A,N/A,N/A,1185,1213,N/A,122,4
31,N/A,N/A,N/A,1154,1185,N/A,128,4
7,N/A,N/A,N/A,1147,1154,N/A,131,1
14,N/A,N/A,N/A,376,390,N/A,4,1
44,N/A,N/A,N/A,332,376,N/A,9,6
14,N/A,N/A,N/A,318,332,N/A,12,3
16,N/A,N/A,N/A,302,318,N/A,18,3
17,N/A,N/A,N/A,285,302,N/A,23,2
16,N/A,N/A,N/A,269,285,N/A,29,2
11,N/A,N/A,N/A,258,269,N/A,35,2
10,N/A,N/A,N/A,248,258,N/A,41,2
9,N/A,N/A,N/A,239,248,N/A,46,1
29,N/A,N/A,N/A,210,239,N/A,49,4
17,N/A,N/A,N/A,193,210,N/A,54,3
23,N/A,N/A,N/A,170,193,N/A,60,3
12,N/A,N/A,N/A,158,170,N/A,65,2
44,N/A,N/A,N/A,114,158,N/A,69,6
34,N/A,N/A,N/A,80,114,N/A,74,5
38,N/A,N/A,N/A,42,80,N/A,80,5
11,N/A,N/A,N/A,31,42,N/A,83,2
15,N/A,N/A,N/A,16,31,N/A,89,2
10,N/A,N/A,N/A,6,16,N/A,94,1
44,N/A,N/A,N/A,-38,6,N/A,99,6
44,N/A,N/A,N/A,1506,1550,N/A,6,6
16,N/A,N/A,N/A,1490,1506,N/A,9,3
11,N/A,N/A,N/A,1479,1490,N/A,13,1
43,N/A,N/A,N/A,1436,1479,N/A,18,6
18,N/A,N/A,N/A,1418,1436,N/A,21,3
13,N/A,N/A,N/A,1405,1418,N/A,26,2
8,N/A,N/A,N/A,1397,1405,N/A,31,1
30,N/A,N/A,N/A,1367,1397,N/A,34,4
21,N/A,N/A,N/A,1346,1367,N/A,39,3
9,N/A,N/A,N/A,1337,1346,N/A,43,1
36,N/A,N/A,N/A,1301,1337,N/A,47,5
34,N/A,N/A,N/A,1267,1301,N/A,53,5
16,N/A,N/A,N/A,1251,1267,N/A,56,2
9,N/A,N/A,N/A,1242,1251,N/A,61,1
24,N/A,N/A,N/A,1218,1242,N/A,64,4
11,N/A,N/A,N/A,1207,1218,N/A,67,1
32,N/A,N/A,N/A,1175,1207,N/A,71,5
10,N/A,N/A,N/A,1165,1175,N/A,74,2
41,N/A,N/A,N/A,1124,1165,N/A,78,6
33,N/A,N/A,N/A,1091,1124,N/A,83,5
24,N/A,N/A,N/A,1067,1091,N/A,88,4
26,N/A,N/A,N/A,1041,1067,N/A,94,4
13,N/A,N/A,N/A,1028,1041,N/A,97,1
32,N/A,N/A,N/A,996,1028,N/A,101,5
34,N/A,N/A,N/A,962,996,N/A,107,5
16,N/A,N/A,N/A,946,962,N/A,110,2
13,N/A,N/A,N/A,933,946,N/A,116,2
43,N/A,N/A,N/A,890,933,N/A,120,6
17,N/A,N/A,N/A,873,890,N/A,123,3
15,N/A,N/A,N/A,858,873,N/A,129,3
19,N/A,N/A,N/A,490,509,N/A,3,3
17,N/A,N/A,N/A,473,490,N/A,9,3
17,N/A,N/A,N/A,456,473,N/A,14,2
12,N/A,N/A,N/A,444,456,N/A,20,2
37,N/A,N/A,N/A,407,444,N/A,23,5
20,N/A,N/A,N/A,387,407,N/A,27,3
19,N/A,N/A,N/A,368,387,N/A,33,3
43,N/A,N/A,N/A,325,368,N/A,36,6
5,N/A,N/A,N/A,320,325,N/A,42,0
27,N/A,N/A,N/A,293,320,N/A,46,4
11,N/A,N/A,N/A,282,293,N/A,49,1
7,N/A,N/A,N/A,275,282,N/A,55,1
30,N/A,N/A,N/A,245,275,N/A,58,4
27,N/A,N/A,N/A,218,245,N/A,64,4
7,N/A,N/A,N/A,211,218,N/A,67,1
10,N/A,N/A,N/A,201,211,N/A,73,1
33,N/A,N/A,N/A,168,201,N/A,77,5
22,N/A,N/A,N/A,146,168,N/A,82,4
16,N/A,N/A,N/A,130,146,N/A,86,2
10,N/A,N/A,N/A,120,130,N/A,92,2
13,N/A,N/A,N/A,107,120,N/A,98,2
38,N/A,N/A,N/A,69,107,N/A,101,5
19,N/A,N/A,N/A,50,69,N/A,105,3
42,N/A,N/A,N/A,8,50,N/A,108,6
5,N/A,N/A,N/A,3,8,N/A,114,0
41,N/A,N/A,N/A,-38,3,N/A,120,6
19,N/A,N/A,N/A,1895,1914,N/A,5,3
12,N/A,N/A,N/A,1883,1895,N/A,9,1
7,N/A,N/A,N/A,1876,1883,N/A,15,1
44,N/A,N/A,N/A,1832,1876,N/A,20,6
23,N/A,N/A,N/A,1809,1832,N/A,23,3
41,N/A,N/A,N/A,1768,1809,N/A,26,6
18,N/A,N/A,N/A,1750,1768,N/A,29,3
41,N/A,N/A,N/A,1709,1750,N/A,32,6
26,N/A,N/A,N/A,1683,1709,N/A,36,4
12,N/A,N/A,N/A,1671,1683,N/A,40,2
15,N/A,N/A,N/A,1656,1671,N/A,46,2
39,N/A,N/A,N/A,1617,1656,N/A,49,5
14,N/A,N/A,N/A,1603,1617,N/A,52,2
32,N/A,N/A,N/A,1571,1603,N/A,55,5
19,N/A,N/A,N/A,1552,1571,N/A,59,3
44,N/A,N/A,N/A,1508,1552,N/A,62,6
6,N/A,N/A,N/A,1502,1508,N/A,68,0
32,N/A,N/A,N/A,1470,1502,N/A,72,4
25,N/A,N/A,N/A,1445,1470,N/A,78,4
13,N/A,N/A,N/A,1432,1445,N/A,82,2
15,N/A,N/A,N/A,1417,1432,N/A,88,2
13,N/A,N/A,N/A,1404,1417,N/A,93,1
31,N/A,N/A,N/A,1373,1404,N/A,96,4
15,N/A,N/A,N/A,1358,1373,N/A,100,2
44,N/A,N/A,N/A,1314,1358,N/A,104,6
19,N/A,N/A,N/A,1295,1314,N/A,107,3
14,N/A,N/A,N/A,1281,1295,N/A,112,2
38,N/A,N/A,N/A,1243,1281,N/A,115,5
31,N/A,N/A,N/A,1212,1243,N/A,120,4
23,N/A,N/A,N/A,1189,1212,N/A,125,3
13,N/A,N/A,N/A,1890,1903,N/A,6,1
10,N/A,N/A,N/A,1880,1890,N/A,12,1
28,N/A,N/A,N/A,1852,1880,N/A,15,4
8,N/A,N/A,N/A,1844,1852,N/A,18,1
23,N/A,N/A,N/A,1821,1844,N/A,21,4
22,N/A,N/A,N/A,1799,1821,N/A,27,4
13,N/A,N/A,N/A,1786,1799,N/A,31,2
10,N/A,N/A,N/A,1776,1786,N/A,36,1
42,N/A,N/A,N/A,1734,1776,N/A,41,6
23,N/A,N/A,N/A,1711,1734,N/A,44,3
42,N/A,N/A,N/A,1669,1711,N/A,47,6
39,N/A,N/A,N/A,1630,1669,N/A,52,5
32,N/A,N/A,N/A,1598,1630,N/A,58,5
16,N/A,N/A,N/A,1582,1598,N/A,62,3
7,N/A,N/A,N/A,1575,1582,N/A,66,1
9,N/A,N/A,N/A,1566,1575,N/A,72,1
13,N/A,N/A,N/A,1553,1566,N/A,78,1
37,N/A,N/A,N/A,1516,1553,N/A,82,5
38,N/A,N/A,N/A,1478,1516,N/A,88,5
15,N/A,N/A,N/A,1463,1478,N/A,91,2
8,N/A,N/A,N/A,1455,1463,N/A,96,1
14,N/A,N/A,N/A,1441,1455,N/A,102,1
36,N/A,N/A,N/A,1405,1441,N/A,106,5
37,N/A,N/A,N/A,1368,1405,N/A,112,5
10,N/A,N/A,N/A,1358,1368,N/A,115,2
42,N/A,N/A,N/A,1316,1358,N/A,119,6
7,N/A,N/A,N/A,1309,1316,N/A,125,0
42,N/A,N/A,N/A,1267,1309,N/A,131,6
33,N/A,N/A,N/A,1234,1267,N/A,136,5
14,N/A,N/A,N/A,1220,1234,N/A,139,2
27,N/A,N/A,N/A,1908,1935,N/A,3,4
13,N/A,N/A,N/A,1895,1908,N/A,6,1
8,N/A,N/A,N/A,1887,1895,N/A,12,1
22,N/A,N/A,N/A,1865,1887,N/A,15,4
22,N/A,N/A,N/A,1843,1865,N/A,20,3
11,N/A,N/A,N/A,1832,1843,N/A,24,1
34,N/A,N/A,N/A,1798,1832,N/A,28,5
11,N/A,N/A,N/A,1787,1798,N/A,31,2
34,N/A,N/A,N/A,1753,1787,N/A,34,5
38,N/A,N/A,N/A,1715,1753,N/A,40,5
20,N/A,N/A,N/A,1695,1715,N/A,44,3
18,N/A,N/A,N/A,1677,1695,N/A,50,3
16,N/A,N/A,N/A,1661,1677,N/A,56,3
22,N/A,N/A,N/A,1639,1661,N/A,62,3
18,N/A,N/A,N/A,1621,1639,N/A,68,3
14,N/A,N/A,N/A,1607,1621,N/A,72,1
36,N/A,N/A,N/A,1571,1607,N/A,76,5
34,N/A,N/A,N/A,1537,1571,N/A,82,5
32,N/A,N/A,N/A,1505,1537,N/A,88,5
34,N/A,N/A,N/A,1471,1505,N/A,94,5
10,N/A,N/A,N/A,1461,1471,N/A,97,2
34,N/A,N/A,N/A,1427,1461,N/A,100,5
34,N/A,N/A,N/A,1393,1427,N/A,106,5
18,N/A,N/A,N/A,1375,1393,N/A,110,3
21,N/A,N/A,N/A,1354,1375,N/A,116,3
15,N/A,N/A,N/A,1339,1354,N/A,121,2
44,N/A,N/A,N/A,1295,1339,N/A,125,6
6,N/A,N/A,N/A,1289,1295,N/A,131,0
19,N/A,N/A,N/A,1270,1289,N/A,134,3
15,N/A,N/A,N/A,1255,1270,N/A,140,3
27,N/A,N/A,N/A,1448,1475,N/A,6,4
15,N/A,N/A,N/A,1433,1448,N/A,10,2
16,N/A,N/A,N/A,1417,1433,N/A,16,2
7,N/A,N/A,N/A,1410,1417,N/A,21,1
7,N/A,N/A,N/A,1403,1410,N/A,27,1
14,N/A,N/A,N/A,1389,1403,N/A,33,1
41,N/A,N/A,N/A,1348,1389,N/A,38,6
20,N/A,N/A,N/A,1328,1348,N/A,41,3
8,N/A,N/A,N/A,1320,1328,N/A,45,1
32,N/A,N/A,N/A,1288,1320,N/A,49,5
10,N/A,N/A,N/A,1278,1288,N/A,52,2
16,N/A,N/A,N/A,1262,1278,N/A,58,2
42,N/A,N/A,N/A,1220,1262,N/A,62,6
6,N/A,N/A,N/A,1214,1220,N/A,68,0
15,N/A,N/A,N/A,1199,1214,N/A,71,3
7,N/A,N/A,N/A,1192,1199,N/A,75,1
39,N/A,N/A,N/A,1153,1192,N/A,79,5
15,N/A,N/A,N/A,1138,1153,N/A,83,3
42,N/A,N/A,N/A,1096,1138,N/A,86,6
35,N/A,N/A,N/A,1061,1096,N/A,91,5
17,N/A,N/A,N/A,1044,1061,N/A,94,2
42,N/A,N/A,N/A,1002,1044,N/A,98,6
23,N/A,N/A,N/A,979,1002,N/A,101,3
41,N/A,N/A,N/A,938,979,N/A,104,6
8,N/A,N/A,N/A,930,938,N/A,110,0
39,N/A,N/A,N/A,891,930,N/A,115,5
12,N/A,N/A,N/A,879,891,N/A,118,2
13,N/A,N/A,N/A,866,879,N/A,123,1
37,N/A,N/A,N/A,829,866,N/A,127,5
24,N/A,N/A,N/A,805,829,N/A,132,4
10,N/A,N/A,N/A,1635,1645,N/A,6,2
37,N/A,N/A,N/A,1598,1635,N/A,9,5
27,N/A,N/A,N/A,1571,1598,N/A,14,4
10,N/A,N/A,N/A,1561,1571,N/A,17,1
38,N/A,N/A,N/A,1523,1561,N/A,21,5
18,N/A,N/A,N/A,1505,1523,N/A,25,3
17,N/A,N/A,N/A,1488,1505,N/A,30,2
10,N/A,N/A,N/A,1478,1488,N/A,36,2
8,N/A,N/A,N/A,1470,1478,N/A,41,1
14,N/A,N/A,N/A,1456,1470,N/A,47,1
43,N/A,N/A,N/A,1413,1456,N/A,52,6
28,N/A,N/A,N/A,1385,1413,N/A,56,4
23,N/A,N/A,N/A,1362,1385,N/A,62,4
12,N/A,N/A,N/A,1350,1362,N/A,65,1
42,N/A,N/A,N/A,1308,1350,N/A,70,6
27,N/A,N/A,N/A,1281,1308,N/A,74,4
10,N/A,N/A,N/A,1271,1281,N/A,78,2
37,N/A,N/A,N/A,1234,1271,N/A,81,5
32,N/A,N/A,N/A,1202,1234,N/A,87,5
18,N/A,N/A,N/A,1184,1202,N/A,91,3
19,N/A,N/A,N/A,1165,1184,N/A,97,3
42,N/A,N/A,N/A,1123,1165,N/A,100,6
20,N/A,N/A,N/A,1103,1123,N/A,103,3
23,N/A,N/A,N/A,1080,1103,N/A,109,3
16,N/A,N/A,N/A,1064,1080,N/A,115,3
44,N/A,N/A,N/A,1020,1064,N/A,118,6
19,N/A,N/A,N/A,1001,1020,N/A,121,3
16,N/A,N/A,N/A,985,1001,N/A,127,3
21,N/A,N/A,N/A,964,985,N/A,133,3
44,N/A,N/A,N/A,920,964,N/A,136,6
15,N/A,N/A,N/A,1628,1643,N/A,6,2
11,N/A,N/A,N/A,1617,1628,N/A,11,1
41,N/A,N/A,N/A,1576,1617,N/A,16,6
9,N/A,N/A,N/A,1567,1576,N/A,22,0
15,N/A,N/A,N/A,1552,1567,N/A,25,3
14,N/A,N/A,N/A,1538,1552,N/A,29,1
28,N/A,N/A,N/A,1510,1538,N/A,32,4
14,N/A,N/A,N/A,1496,1510,N/A,35,1
31,N/A,N/A,N/A,1465,1496,N/A,38,4
12,N/A,N/A,N/A,1453,1465,N/A,42,2
13,N/A,N/A,N/A,1440,1453,N/A,48,2
11,N/A,N/A,N/A,1429,1440,N/A,53,1
28,N/A,N/A,N/A,1401,1429,N/A,56,4
22,N/A,N/A,N/A,1379,1401,N/A,61,3
44,N/A,N/A,N/A,1335,1379,N/A,64,6
32,N/A,N/A,N/A,1303,1335,N/A,69,5
18,N/A,N/A,N/A,1285,1303,N/A,73,3
13,N/A,N/A,N/A,1272,1285,N/A,77,1
44,N/A,N/A,N/A,1228,1272,N/A,82,6
8,N/A,N/A,N/A,1220,1228,N/A,88,0
43,N/A,N/A,N/A,1177,1220,N/A,94,6
24,N/A,N/A,N/A,1153,1177,N/A,98,4
26,N/A,N/A,N/A,1127,1153,N/A,104,4
9,N/A,N/A,N/A,1118,1127,N/A,107,1
42,N/A,N/A,N/A,1076,1118,N/A,112,6
23,N/A,N/A,N/A,1053,1076,N/A,115,3
43,N/A,N/A,N/A,1010,1053,N/A,118,6
17,N/A,N/A,N/A,993,1010,N/A,121,3
42,N/A,N/A,N/A,951,993,N/A,124,6
6,N/A,N/A,N/A,945,951,N/A,130,0
38,N/A,N/A,N/A,357,395,N/A,6,5
21,N/A,N/A,N/A,336,357,N/A,10,3
42,N/A,N/A,N/A,294,336,N/A,13,6
38,N/A,N/A,N/A,256,294,N/A,18,5
14,N/A,N/A,N/A,242,256,N/A,22,3
44,N/A,N/A,N/A,198,242,N/A,25,6
5,N/A,N/A,N/A,193,198,N/A,31,0
32,N/A,N/A,N/A,161,193,N/A,36,5
34,N/A,N/A,N/A,127,161,N/A,42,5
31,N/A,N/A,N/A,96,127,N/A,47,4
11,N/A,N/A,N/A,85,96,N/A,51,2
11,N/A,N/A,N/A,74,85,N/A,57,2
12,N/A,N/A,N/A,62,74,N/A,62,1
43,N/A,N/A,N/A,19,62,N/A,67,6
25,N/A,N/A,N/A,-6,19,N/A,71,4
