amount,category,date,name,newBalance,previousBalance,reference,timeDiff,dayOfWeek
5,N/A,N/A,N/A,1972,1977,N/A,4,5
5,N/A,N/A,N/A,1967,1972,N/A,10,5
4,N/A,N/A,N/A,1963,1967,N/A,15,4
3,N/A,N/A,N/A,1960,1963,N/A,20,3
1,N/A,N/A,N/A,1959,1960,N/A,24,1
4,N/A,N/A,N/A,1955,1959,N/A,27,4
1,N/A,N/A,N/A,1954,1955,N/A,30,1
3,N/A,N/A,N/A,1951,1954,N/A,33,4
3,N/A,N/A,N/A,1948,1951,N/A,39,4
3,N/A,N/A,N/A,1945,1948,N/A,43,2
2,N/A,N/A,N/A,1943,1945,N/A,48,1
3,N/A,N/A,N/A,1940,1943,N/A,51,4
3,N/A,N/A,N/A,1937,1940,N/A,57,4
3,N/A,N/A,N/A,1934,1937,N/A,63,4
2,N/A,N/A,N/A,1932,1934,N/A,66,1
6,N/A,N/A,N/A,1926,1932,N/A,71,6
6,N/A,N/A,N/A,1920,1926,N/A,76,5
6,N/A,N/A,N/A,1914,1920,N/A,82,5
2,N/A,N/A,N/A,1912,1914,N/A,86,3
3,N/A,N/A,N/A,1909,1912,N/A,92,3
7,N/A,N/A,N/A,1902,1909,N/A,95,6
2,N/A,N/A,N/A,1900,1902,N/A,98,3
7,N/A,N/A,N/A,1893,1900,N/A,101,6
5,N/A,N/A,N/A,1888,1893,N/A,106,5
2,N/A,N/A,N/A,1886,1888,N/A,109,2
5,N/A,N/A,N/A,1881,1886,N/A,112,5
6,N/A,N/A,N/A,1875,1881,N/A,118,5
3,N/A,N/A,N/A,1872,1875,N/A,121,2
6,N/A,N/A,N/A,1866,1872,N/A,124,5
5,N/A,N/A,N/A,1861,1866,N/A,130,5
6,N/A,N/A,N/A,1478,1484,N/A,3,5
3,N/A,N/A,N/A,1475,1478,N/A,6,2
1,N/A,N/A,N/A,1474,1475,N/A,11,1
3,N/A,N/A,N/A,1471,1474,N/A,14,4
3,N/A,N/A,N/A,1468,1471,N/A,18,2
1,N/A,N/A,N/A,1467,1468,N/A,23,1
6,N/A,N/A,N/A,1461,1467,N/A,28,6
4,N/A,N/A,N/A,1457,1461,N/A,32,4
2,N/A,N/A,N/A,1455,1457,N/A,36,2
3,N/A,N/A,N/A,1452,1455,N/A,42,2
6,N/A,N/A,N/A,1446,1452,N/A,46,6
1,N/A,N/A,N/A,1445,1446,N/A,52,0
3,N/A,N/A,N/A,1442,1445,N/A,55,3
2,N/A,N/A,N/A,1440,1442,N/A,60,2
1,N/A,N/A,N/A,1439,1440,N/A,65,1
5,N/A,N/A,N/A,1434,1439,N/A,69,5
5,N/A,N/A,N/A,1429,1434,N/A,75,5
3,N/A,N/A,N/A,1426,1429,N/A,79,3
3,N/A,N/A,N/A,1423,1426,N/A,85,3
2,N/A,N/A,N/A,1421,1423,N/A,90,2
1,N/A,N/A,N/A,1420,1421,N/A,95,1
6,N/A,N/A,N/A,1414,1420,N/A,99,5
4,N/A,N/A,N/A,1410,1414,N/A,104,4
3,N/A,N/A,N/A,1407,1410,N/A,109,3
2,N/A,N/A,N/A,1405,1407,N/A,115,3
2,N/A,N/A,N/A,1403,1405,N/A,119,1
2,N/A,N/A,N/A,1401,1403,N/A,125,1
7,N/A,N/A,N/A,1394,1401,N/A,130,6
4,N/A,N/A,N/A,1390,1394,N/A,134,4
3,N/A,N/A,N/A,1387,1390,N/A,139,3
2,N/A,N/A,N/A,1290,1292,N/A,6,3
7,N/A,N/A,N/A,1283,1290,N/A,9,6
2,N/A,N/A,N/A,1281,1283,N/A,15,0
2,N/A,N/A,N/A,1279,1281,N/A,18,3
2,N/A,N/A,N/A,1277,1279,N/A,24,3
7,N/A,N/A,N/A,1270,1277,N/A,27,6
2,N/A,N/A,N/A,1268,1270,N/A,33,0
6,N/A,N/A,N/A,1262,1268,N/A,39,6
3,N/A,N/A,N/A,1259,1262,N/A,43,4
3,N/A,N/A,N/A,1256,1259,N/A,49,4
3,N/A,N/A,N/A,1253,1256,N/A,53,2
3,N/A,N/A,N/A,1250,1253,N/A,59,2
3,N/A,N/A,N/A,1247,1250,N/A,65,2
2,N/A,N/A,N/A,1245,1247,N/A,71,2
7,N/A,N/A,N/A,1238,1245,N/A,75,6
5,N/A,N/A,N/A,1233,1238,N/A,80,5
2,N/A,N/A,N/A,1231,1233,N/A,83,2
2,N/A,N/A,N/A,1229,1231,N/A,88,1
4,N/A,N/A,N/A,1225,1229,N/A,91,4
2,N/A,N/A,N/A,1223,1225,N/A,96,3
2,N/A,N/A,N/A,1221,1223,N/A,101,2
7,N/A,N/A,N/A,1214,1221,N/A,105,6
6,N/A,N/A,N/A,1208,1214,N/A,110,5
6,N/A,N/A,N/A,1202,1208,N/A,116,5
2,N/A,N/A,N/A,1200,1202,N/A,119,2
3,N/A,N/A,N/A,1197,1200,N/A,125,2
6,N/A,N/A,N/A,1191,1197,N/A,128,5
5,N/A,N/A,N/A,1186,1191,N/A,134,5
2,N/A,N/A,N/A,1184,1186,N/A,137,2
6,N/A,N/A,N/A,1178,1184,N/A,140,5
3,N/A,N/A,N/A,350,353,N/A,6,3
7,N/A,N/A,N/A,343,350,N/A,9,6
1,N/A,N/A,N/A,342,343,N/A,15,0
7,N/A,N/A,N/A,335,342,N/A,21,6
6,N/A,N/A,N/A,329,335,N/A,26,5
3,N/A,N/A,N/A,326,329,N/A,30,3
6,N/A,N/A,N/A,320,326,N/A,33,6
6,N/A,N/A,N/A,314,320,N/A,38,5
3,N/A,N/A,N/A,311,314,N/A,42,3
3,N/A,N/A,N/A,308,311,N/A,47,2
6,N/A,N/A,N/A,302,308,N/A,50,5
4,N/A,N/A,N/A,298,302,N/A,55,4
2,N/A,N/A,N/A,296,298,N/A,59,2
1,N/A,N/A,N/A,295,296,N/A,64,1
5,N/A,N/A,N/A,290,295,N/A,68,5
3,N/A,N/A,N/A,287,290,N/A,73,4
2,N/A,N/A,N/A,285,287,N/A,77,2
2,N/A,N/A,N/A,283,285,N/A,82,1
5,N/A,N/A,N/A,278,283,N/A,86,5
6,N/A,N/A,N/A,272,278,N/A,92,5
4,N/A,N/A,N/A,268,272,N/A,97,4
3,N/A,N/A,N/A,265,268,N/A,103,4
2,N/A,N/A,N/A,263,265,N/A,107,2
5,N/A,N/A,N/A,258,263,N/A,110,5
5,N/A,N/A,N/A,253,258,N/A,116,5
2,N/A,N/A,N/A,251,253,N/A,120,3
2,N/A,N/A,N/A,249,251,N/A,126,3
6,N/A,N/A,N/A,243,249,N/A,129,6
3,N/A,N/A,N/A,240,243,N/A,133,4
4,N/A,N/A,N/A,236,240,N/A,139,4
6,N/A,N/A,N/A,1016,1022,N/A,5,6
3,N/A,N/A,N/A,1013,1016,N/A,8,3
3,N/A,N/A,N/A,1010,1013,N/A,14,3
2,N/A,N/A,N/A,1008,1010,N/A,18,1
1,N/A,N/A,N/A,1007,1008,N/A,24,1
5,N/A,N/A,N/A,1002,1007,N/A,28,5
3,N/A,N/A,N/A,999,1002,N/A,31,2
7,N/A,N/A,N/A,992,999,N/A,35,6
3,N/A,N/A,N/A,989,992,N/A,39,4
3,N/A,N/A,N/A,986,989,N/A,44,3
3,N/A,N/A,N/A,983,986,N/A,49,2
3,N/A,N/A,N/A,980,983,N/A,55,2
2,N/A,N/A,N/A,978,980,N/A,60,1
4,N/A,N/A,N/A,974,978,N/A,63,4
3,N/A,N/A,N/A,971,974,N/A,68,3
2,N/A,N/A,N/A,969,971,N/A,74,3
6,N/A,N/A,N/A,963,969,N/A,77,6
4,N/A,N/A,N/A,959,963,N/A,81,4
2,N/A,N/A,N/A,957,959,N/A,86,3
3,N/A,N/A,N/A,954,957,N/A,92,3
7,N/A,N/A,N/A,947,954,N/A,95,6
2,N/A,N/A,N/A,945,947,N/A,98,3
6,N/A,N/A,N/A,939,945,N/A,101,6
5,N/A,N/A,N/A,934,939,N/A,106,5
3,N/A,N/A,N/A,931,934,N/A,110,3
7,N/A,N/A,N/A,924,931,N/A,113,6
5,N/A,N/A,N/A,919,924,N/A,118,5
5,N/A,N/A,N/A,914,919,N/A,124,5
2,N/A,N/A,N/A,912,914,N/A,128,3
1,N/A,N/A,N/A,911,912,N/A,132,1
3,N/A,N/A,N/A,503,506,N/A,5,2
1,N/A,N/A,N/A,502,503,N/A,10,1
6,N/A,N/A,N/A,496,502,N/A,14,5
4,N/A,N/A,N/A,492,496,N/A,19,4
3,N/A,N/A,N/A,489,492,N/A,25,4
4,N/A,N/A,N/A,485,489,N/A,31,4
3,N/A,N/A,N/A,482,485,N/A,35,2
6,N/A,N/A,N/A,476,482,N/A,38,5
6,N/A,N/A,N/A,470,476,N/A,44,5
4,N/A,N/A,N/A,466,470,N/A,49,4
4,N/A,N/A,N/A,462,466,N/A,55,4
3,N/A,N/A,N/A,459,462,N/A,59,2
2,N/A,N/A,N/A,457,459,N/A,65,2
6,N/A,N/A,N/A,451,457,N/A,69,6
3,N/A,N/A,N/A,448,451,N/A,72,3
6,N/A,N/A,N/A,442,448,N/A,75,6
3,N/A,N/A,N/A,439,442,N/A,78,3
2,N/A,N/A,N/A,437,439,N/A,82,1
4,N/A,N/A,N/A,433,437,N/A,85,4
2,N/A,N/A,N/A,431,433,N/A,90,3
2,N/A,N/A,N/A,429,431,N/A,96,3
3,N/A,N/A,N/A,426,429,N/A,101,2
2,N/A,N/A,N/A,424,426,N/A,106,1
6,N/A,N/A,N/A,418,424,N/A,110,5
3,N/A,N/A,N/A,415,418,N/A,115,4
4,N/A,N/A,N/A,411,415,N/A,121,4
2,N/A,N/A,N/A,409,411,N/A,125,2
2,N/A,N/A,N/A,407,409,N/A,131,2
7,N/A,N/A,N/A,400,407,N/A,135,6
2,N/A,N/A,N/A,398,400,N/A,138,3
2,N/A,N/A,N/A,1691,1693,N/A,6,1
6,N/A,N/A,N/A,1685,1691,N/A,10,5
2,N/A,N/A,N/A,1683,1685,N/A,14,3
2,N/A,N/A,N/A,1681,1683,N/A,19,2
2,N/A,N/A,N/A,1679,1681,N/A,25,2
1,N/A,N/A,N/A,1678,1679,N/A,30,1
4,N/A,N/A,N/A,1674,1678,N/A,33,4
3,N/A,N/A,N/A,1671,1674,N/A,37,2
2,N/A,N/A,N/A,1669,1671,N/A,42,1
6,N/A,N/A,N/A,1663,1669,N/A,46,5
2,N/A,N/A,N/A,1661,1663,N/A,50,3
2,N/A,N/A,N/A,1659,1661,N/A,55,2
5,N/A,N/A,N/A,1654,1659,N/A,58,5
5,N/A,N/A,N/A,1649,1654,N/A,64,5
4,N/A,N/A,N/A,1645,1649,N/A,69,4
2,N/A,N/A,N/A,1643,1645,N/A,74,3
2,N/A,N/A,N/A,1641,1643,N/A,79,2
3,N/A,N/A,N/A,1638,1641,N/A,85,2
6,N/A,N/A,N/A,1632,1638,N/A,88,5
2,N/A,N/A,N/A,1630,1632,N/A,91,2
5,N/A,N/A,N/A,1625,1630,N/A,94,5
5,N/A,N/A,N/A,1620,1625,N/A,100,5
3,N/A,N/A,N/A,1617,1620,N/A,104,3
6,N/A,N/A,N/A,1611,1617,N/A,107,6
3,N/A,N/A,N/A,1608,1611,N/A,111,4
2,N/A,N/A,N/A,1606,1608,N/A,115,2
2,N/A,N/A,N/A,1604,1606,N/A,121,2
3,N/A,N/A,N/A,1601,1604,N/A,127,2
6,N/A,N/A,N/A,1595,1601,N/A,130,5
5,N/A,N/A,N/A,1590,1595,N/A,136,5
5,N/A,N/A,N/A,1786,1791,N/A,4,5
3,N/A,N/A,N/A,1783,1786,N/A,8,3
3,N/A,N/A,N/A,1780,1783,N/A,13,2
6,N/A,N/A,N/A,1774,1780,N/A,16,5
2,N/A,N/A,N/A,1772,1774,N/A,20,3
2,N/A,N/A,N/A,1770,1772,N/A,24,1
4,N/A,N/A,N/A,1766,1770,N/A,27,4
2,N/A,N/A,N/A,1764,1766,N/A,30,1
4,N/A,N/A,N/A,1760,1764,N/A,33,4
4,N/A,N/A,N/A,1756,1760,N/A,39,4
3,N/A,N/A,N/A,1753,1756,N/A,45,4
2,N/A,N/A,N/A,1751,1753,N/A,48,1
6,N/A,N/A,N/A,1745,1751,N/A,53,6
5,N/A,N/A,N/A,1740,1745,N/A,58,5
6,N/A,N/A,N/A,1734,1740,N/A,64,5
2,N/A,N/A,N/A,1732,1734,N/A,68,3
3,N/A,N/A,N/A,1729,1732,N/A,73,2
1,N/A,N/A,N/A,1728,1729,N/A,78,1
2,N/A,N/A,N/A,1726,1728,N/A,84,1
4,N/A,N/A,N/A,1722,1726,N/A,87,4
2,N/A,N/A,N/A,1720,1722,N/A,92,3
2,N/A,N/A,N/A,1718,1720,N/A,97,2
1,N/A,N/A,N/A,1717,1718,N/A,102,1
6,N/A,N/A,N/A,1711,1717,N/A,107,6
4,N/A,N/A,N/A,1707,1711,N/A,111,4
3,N/A,N/A,N/A,1704,1707,N/A,115,2
7,N/A,N/A,N/A,1697,1704,N/A,119,6
3,N/A,N/A,N/A,1694,1697,N/A,122,3
2,N/A,N/A,N/A,1692,1694,N/A,128,3
3,N/A,N/A,N/A,1689,1692,N/A,133,2
1,N/A,N/A,N/A,355,356,N/A,5,1
5,N/A,N/A,N/A,350,355,N/A,9,5
2,N/A,N/A,N/A,348,350,N/A,13,3
6,N/A,N/A,N/A,342,348,N/A,16,6
3,N/A,N/A,N/A,339,342,N/A,19,3
3,N/A,N/A,N/A,336,339,N/A,25,3
2,N/A,N/A,N/A,334,336,N/A,31,3
2,N/A,N/A,N/A,332,334,N/A,35,1
7,N/A,N/A,N/A,325,332,N/A,40,6
1,N/A,N/A,N/A,324,325,N/A,46,0
3,N/A,N/A,N/A,321,324,N/A,50,4
3,N/A,N/A,N/A,318,321,N/A,55,3
2,N/A,N/A,N/A,316,318,N/A,59,1
6,N/A,N/A,N/A,310,316,N/A,63,5
6,N/A,N/A,N/A,304,310,N/A,69,5
3,N/A,N/A,N/A,301,304,N/A,72,2
5,N/A,N/A,N/A,296,301,N/A,75,5
6,N/A,N/A,N/A,290,296,N/A,81,5
3,N/A,N/A,N/A,287,290,N/A,86,4
2,N/A,N/A,N/A,285,287,N/A,90,2
7,N/A,N/A,N/A,278,285,N/A,94,6
3,N/A,N/A,N/A,275,278,N/A,97,3
3,N/A,N/A,N/A,272,275,N/A,102,2
3,N/A,N/A,N/A,269,272,N/A,108,2
6,N/A,N/A,N/A,263,269,N/A,112,6
2,N/A,N/A,N/A,261,263,N/A,115,3
2,N/A,N/A,N/A,259,261,N/A,119,1
1,N/A,N/A,N/A,258,259,N/A,125,1
3,N/A,N/A,N/A,255,258,N/A,128,4
3,N/A,N/A,N/A,252,255,N/A,134,4
7,N/A,N/A,N/A,547,554,N/A,5,6
6,N/A,N/A,N/A,541,547,N/A,10,5
5,N/A,N/A,N/A,536,541,N/A,16,5
4,N/A,N/A,N/A,532,536,N/A,21,4
3,N/A,N/A,N/A,529,532,N/A,25,2
6,N/A,N/A,N/A,523,529,N/A,29,6
5,N/A,N/A,N/A,518,523,N/A,34,5
4,N/A,N/A,N/A,514,518,N/A,39,4
2,N/A,N/A,N/A,512,514,N/A,44,3
3,N/A,N/A,N/A,509,512,N/A,50,3
6,N/A,N/A,N/A,503,509,N/A,53,6
2,N/A,N/A,N/A,501,503,N/A,59,0
2,N/A,N/A,N/A,499,501,N/A,62,3
2,N/A,N/A,N/A,497,499,N/A,66,1
2,N/A,N/A,N/A,495,497,N/A,72,1
4,N/A,N/A,N/A,491,495,N/A,75,4
3,N/A,N/A,N/A,488,491,N/A,79,2
2,N/A,N/A,N/A,486,488,N/A,85,2
6,N/A,N/A,N/A,480,486,N/A,88,5
3,N/A,N/A,N/A,477,480,N/A,92,3
6,N/A,N/A,N/A,471,477,N/A,95,6
5,N/A,N/A,N/A,466,471,N/A,100,5
3,N/A,N/A,N/A,463,466,N/A,105,4
3,N/A,N/A,N/A,460,463,N/A,110,3
2,N/A,N/A,N/A,458,460,N/A,115,2
2,N/A,N/A,N/A,456,458,N/A,121,2
3,N/A,N/A,N/A,453,456,N/A,127,2
3,N/A,N/A,N/A,450,453,N/A,133,2
1,N/A,N/A,N/A,449,450,N/A,138,1
5,N/A,N/A,N/A,444,449,N/A,142,5
3,N/A,N/A,N/A,1258,1261,N/A,3,2
7,N/A,N/A,N/A,1251,1258,N/A,7,6
5,N/A,N/A,N/A,1246,1251,N/A,12,5
3,N/A,N/A,N/A,1243,1246,N/A,15,2
6,N/A,N/A,N/A,1237,1243,N/A,18,5
2,N/A,N/A,N/A,1235,1237,N/A,21,2
6,N/A,N/A,N/A,1229,1235,N/A,24,5
3,N/A,N/A,N/A,1226,1229,N/A,27,2
1,N/A,N/A,N/A,1225,1226,N/A,32,1
7,N/A,N/A,N/A,1218,1225,N/A,37,6
2,N/A,N/A,N/A,1216,1218,N/A,43,0
4,N/A,N/A,N/A,1212,1216,N/A,47,4
4,N/A,N/A,N/A,1208,1212,N/A,53,4
1,N/A,N/A,N/A,1207,1208,N/A,56,1
6,N/A,N/A,N/A,1201,1207,N/A,61,6
6,N/A,N/A,N/A,1195,1201,N/A,66,5
6,N/A,N/A,N/A,1189,1195,N/A,72,5
2,N/A,N/A,N/A,1187,1189,N/A,75,2
6,N/A,N/A,N/A,1181,1187,N/A,79,6
6,N/A,N/A,N/A,1175,1181,N/A,84,5
3,N/A,N/A,N/A,1172,1175,N/A,89,4
3,N/A,N/A,N/A,1169,1172,N/A,95,4
2,N/A,N/A,N/A,1167,1169,N/A,99,2
2,N/A,N/A,N/A,1165,1167,N/A,104,1
1,N/A,N/A,N/A,1164,1165,N/A,110,1
3,N/A,N/A,N/A,1161,1164,N/A,113,4
2,N/A,N/A,N/A,1159,1161,N/A,116,1
3,N/A,N/A,N/A,1156,1159,N/A,119,4
2,N/A,N/A,N/A,1154,1156,N/A,122,1
4,N/A,N/A,N/A,1150,1154,N/A,125,4
4,N/A,N/A,N/A,1322,1326,N/A,5,4
2,N/A,N/A,N/A,1320,1322,N/A,8,1
3,N/A,N/A,N/A,1317,1320,N/A,11,4
3,N/A,N/A,N/A,1314,1317,N/A,16,3
1,N/A,N/A,N/A,1313,1314,N/A,20,1
6,N/A,N/A,N/A,1307,1313,N/A,24,5
3,N/A,N/A,N/A,1304,1307,N/A,29,4
3,N/A,N/A,N/A,1301,1304,N/A,35,4
3,N/A,N/A,N/A,1298,1301,N/A,41,4
2,N/A,N/A,N/A,1296,1298,N/A,46,3
6,N/A,N/A,N/A,1290,1296,N/A,49,6
6,N/A,N/A,N/A,1284,1290,N/A,54,5
6,N/A,N/A,N/A,1278,1284,N/A,60,5
2,N/A,N/A,N/A,1276,1278,N/A,64,3
2,N/A,N/A,N/A,1274,1276,N/A,70,3
2,N/A,N/A,N/A,1272,1274,N/A,74,1
6,N/A,N/A,N/A,1266,1272,N/A,78,5
3,N/A,N/A,N/A,1263,1266,N/A,82,3
2,N/A,N/A,N/A,1261,1263,N/A,87,2
6,N/A,N/A,N/A,1255,1261,N/A,90,5
3,N/A,N/A,N/A,1252,1255,N/A,93,2
2,N/A,N/A,N/A,1250,1252,N/A,98,1
7,N/A,N/A,N/A,1243,1250,N/A,103,6
5,N/A,N/A,N/A,1238,1243,N/A,108,5
5,N/A,N/A,N/A,1233,1238,N/A,114,5
5,N/A,N/A,N/A,1228,1233,N/A,120,5
6,N/A,N/A,N/A,1222,1228,N/A,126,5
3,N/A,N/A,N/A,1219,1222,N/A,130,3
2,N/A,N/A,N/A,1217,1219,N/A,134,1
4,N/A,N/A,N/A,1213,1217,N/A,137,4
5,N/A,N/A,N/A,736,741,N/A,5,5
5,N/A,N/A,N/A,731,736,N/A,11,5
2,N/A,N/A,N/A,729,731,N/A,15,3
2,N/A,N/A,N/A,727,729,N/A,21,3
3,N/A,N/A,N/A,724,727,N/A,26,2
2,N/A,N/A,N/A,722,724,N/A,32,2
7,N/A,N/A,N/A,715,722,N/A,36,6
4,N/A,N/A,N/A,711,715,N/A,40,4
2,N/A,N/A,N/A,709,711,N/A,44,2
5,N/A,N/A,N/A,704,709,N/A,47,5
2,N/A,N/A,N/A,702,704,N/A,51,3
2,N/A,N/A,N/A,700,702,N/A,56,2
7,N/A,N/A,N/A,693,700,N/A,60,6
5,N/A,N/A,N/A,688,693,N/A,65,5
6,N/A,N/A,N/A,682,688,N/A,71,5
4,N/A,N/A,N/A,678,682,N/A,76,4
2,N/A,N/A,N/A,676,678,N/A,80,2
6,N/A,N/A,N/A,670,676,N/A,83,5
5,N/A,N/A,N/A,665,670,N/A,89,5
4,N/A,N/A,N/A,661,665,N/A,94,4
3,N/A,N/A,N/A,658,661,N/A,100,4
2,N/A,N/A,N/A,656,658,N/A,104,2
2,N/A,N/A,N/A,654,656,N/A,109,1
6,N/A,N/A,N/A,648,654,N/A,114,6
6,N/A,N/A,N/A,642,648,N/A,119,5
3,N/A,N/A,N/A,639,642,N/A,122,2
3,N/A,N/A,N/A,636,639,N/A,128,2
6,N/A,N/A,N/A,630,636,N/A,131,5
5,N/A,N/A,N/A,625,630,N/A,137,5
5,N/A,N/A,N/A,620,625,N/A,143,5
3,N/A,N/A,N/A,373,376,N/A,5,2
1,N/A,N/A,N/A,372,373,N/A,10,1
5,N/A,N/A,N/A,367,372,N/A,14,5
3,N/A,N/A,N/A,364,367,N/A,19,4
4,N/A,N/A,N/A,360,364,N/A,25,4
2,N/A,N/A,N/A,358,360,N/A,29,2
2,N/A,N/A,N/A,356,358,N/A,35,2
3,N/A,N/A,N/A,353,356,N/A,41,2
6,N/A,N/A,N/A,347,353,N/A,44,5
2,N/A,N/A,N/A,345,347,N/A,47,2
5,N/A,N/A,N/A,340,345,N/A,50,5
5,N/A,N/A,N/A,335,340,N/A,56,5
4,N/A,N/A,N/A,331,335,N/A,61,4
3,N/A,N/A,N/A,328,331,N/A,65,2
2,N/A,N/A,N/A,326,328,N/A,71,2
3,N/A,N/A,N/A,323,326,N/A,77,2
2,N/A,N/A,N/A,321,323,N/A,82,1
7,N/A,N/A,N/A,314,321,N/A,87,6
3,N/A,N/A,N/A,311,314,N/A,91,4
3,N/A,N/A,N/A,308,311,N/A,95,2
6,N/A,N/A,N/A,302,308,N/A,98,5
3,N/A,N/A,N/A,299,302,N/A,102,3
2,N/A,N/A,N/A,297,299,N/A,107,2
2,N/A,N/A,N/A,295,297,N/A,112,1
3,N/A,N/A,N/A,292,295,N/A,115,4
3,N/A,N/A,N/A,289,292,N/A,119,2
1,N/A,N/A,N/A,288,289,N/A,124,1
2,N/A,N/A,N/A,286,288,N/A,130,1
5,N/A,N/A,N/A,281,286,N/A,134,5
2,N/A,N/A,N/A,279,281,N/A,138,3
2,N/A,N/A,N/A,1326,1328,N/A,6,3
1,N/A,N/A,N/A,1325,1326,N/A,10,1
3,N/A,N/A,N/A,1322,1325,N/A,13,4
1,N/A,N/A,N/A,1321,1322,N/A,16,1
5,N/A,N/A,N/A,1316,1321,N/A,20,5
2,N/A,N/A,N/A,1314,1316,N/A,24,3
7,N/A,N/A,N/A,1307,1314,N/A,27,6
5,N/A,N/A,N/A,1302,1307,N/A,32,5
6,N/A,N/A,N/A,1296,1302,N/A,38,5
2,N/A,N/A,N/A,1294,1296,N/A,41,2
6,N/A,N/A,N/A,1288,1294,N/A,45,6
6,N/A,N/A,N/A,1282,1288,N/A,50,5
2,N/A,N/A,N/A,1280,1282,N/A,53,2
2,N/A,N/A,N/A,1278,1280,N/A,59,2
1,N/A,N/A,N/A,1277,1278,N/A,64,1
6,N/A,N/A,N/A,1271,1277,N/A,69,6
5,N/A,N/A,N/A,1266,1271,N/A,74,5
5,N/A,N/A,N/A,1261,1266,N/A,80,5
6,N/A,N/A,N/A,1255,1261,N/A,86,5
4,N/A,N/A,N/A,1251,1255,N/A,91,4
4,N/A,N/A,N/A,1247,1251,N/A,97,4
2,N/A,N/A,N/A,1245,1247,N/A,100,1
6,N/A,N/A,N/A,1239,1245,N/A,105,6
2,N/A,N/A,N/A,1237,1239,N/A,108,3
3,N/A,N/A,N/A,1234,1237,N/A,114,3
6,N/A,N/A,N/A,1228,1234,N/A,117,6
2,N/A,N/A,N/A,1226,1228,N/A,120,3
2,N/A,N/A,N/A,1224,1226,N/A,124,1
2,N/A,N/A,N/A,1222,1224,N/A,130,1
6,N/A,N/A,N/A,1216,1222,N/A,134,5
1,N/A,N/A,N/A,1489,1490,N/A,5,1
5,N/A,N/A,N/A,1484,1489,N/A,9,5
2,N/A,N/A,N/A,1482,1484,N/A,13,3
3,N/A,N/A,N/A,1479,1482,N/A,18,2
2,N/A,N/A,N/A,1477,1479,N/A,24,2
2,N/A,N/A,N/A,1475,1477,N/A,30,2
1,N/A,N/A,N/A,1474,1475,N/A,35,1
6,N/A,N/A,N/A,1468,1474,N/A,40,6
3,N/A,N/A,N/A,1465,1468,N/A,43,3
3,N/A,N/A,N/A,1462,1465,N/A,49,3
2,N/A,N/A,N/A,1460,1462,N/A,55,3
2,N/A,N/A,N/A,1458,1460,N/A,59,1
4,N/A,N/A,N/A,1454,1458,N/A,62,4
3,N/A,N/A,N/A,1451,1454,N/A,67,3
2,N/A,N/A,N/A,1449,1451,N/A,72,2
6,N/A,N/A,N/A,1443,1449,N/A,76,6
1,N/A,N/A,N/A,1442,1443,N/A,82,0
3,N/A,N/A,N/A,1439,1442,N/A,86,4
1,N/A,N/A,N/A,1438,1439,N/A,89,1
2,N/A,N/A,N/A,1436,1438,N/A,95,1
1,N/A,N/A,N/A,1435,1436,N/A,101,1
5,N/A,N/A,N/A,1430,1435,N/A,105,5
2,N/A,N/A,N/A,1428,1430,N/A,109,3
6,N/A,N/A,N/A,1422,1428,N/A,112,6
2,N/A,N/A,N/A,1420,1422,N/A,118,0
2,N/A,N/A,N/A,1418,1420,N/A,121,3
2,N/A,N/A,N/A,1416,1418,N/A,126,2
1,N/A,N/A,N/A,1415,1416,N/A,131,1
5,N/A,N/A,N/A,1410,1415,N/A,135,5
2,N/A,N/A,N/A,1408,1410,N/A,139,3
3,N/A,N/A,N/A,768,771,N/A,6,2
5,N/A,N/A,N/A,763,768,N/A,9,5
4,N/A,N/A,N/A,759,763,N/A,14,4
1,N/A,N/A,N/A,758,759,N/A,17,1
6,N/A,N/A,N/A,752,758,N/A,21,5
4,N/A,N/A,N/A,748,752,N/A,26,4
3,N/A,N/A,N/A,745,748,N/A,31,3
3,N/A,N/A,N/A,742,745,N/A,37,3
7,N/A,N/A,N/A,735,742,N/A,40,6
6,N/A,N/A,N/A,729,735,N/A,45,5
3,N/A,N/A,N/A,726,729,N/A,48,2
5,N/A,N/A,N/A,721,726,N/A,51,5
3,N/A,N/A,N/A,718,721,N/A,55,3
6,N/A,N/A,N/A,712,718,N/A,58,6
2,N/A,N/A,N/A,710,712,N/A,61,3
2,N/A,N/A,N/A,708,710,N/A,66,2
6,N/A,N/A,N/A,702,708,N/A,69,5
4,N/A,N/A,N/A,698,702,N/A,74,4
4,N/A,N/A,N/A,694,698,N/A,80,4
3,N/A,N/A,N/A,691,694,N/A,85,3
2,N/A,N/A,N/A,689,691,N/A,91,3
3,N/A,N/A,N/A,686,689,N/A,96,2
7,N/A,N/A,N/A,679,686,N/A,100,6
2,N/A,N/A,N/A,677,679,N/A,103,3
6,N/A,N/A,N/A,671,677,N/A,106,6
3,N/A,N/A,N/A,668,671,N/A,109,3
3,N/A,N/A,N/A,665,668,N/A,115,3
1,N/A,N/A,N/A,664,665,N/A,119,1
1,N/A,N/A,N/A,663,664,N/A,125,1
5,N/A,N/A,N/A,658,663,N/A,129,5
3,N/A,N/A,N/A,1101,1104,N/A,5,2
3,N/A,N/A,N/A,1098,1101,N/A,11,2
1,N/A,N/A,N/A,1097,1098,N/A,16,1
5,N/A,N/A,N/A,1092,1097,N/A,20,5
3,N/A,N/A,N/A,1089,1092,N/A,24,3
2,N/A,N/A,N/A,1087,1089,N/A,28,1
5,N/A,N/A,N/A,1082,1087,N/A,32,5
2,N/A,N/A,N/A,1080,1082,N/A,36,3
1,N/A,N/A,N/A,1079,1080,N/A,40,1
7,N/A,N/A,N/A,1072,1079,N/A,45,6
1,N/A,N/A,N/A,1071,1072,N/A,51,0
4,N/A,N/A,N/A,1067,1071,N/A,55,4
3,N/A,N/A,N/A,1064,1067,N/A,60,3
3,N/A,N/A,N/A,1061,1064,N/A,66,3
1,N/A,N/A,N/A,1060,1061,N/A,70,1
4,N/A,N/A,N/A,1056,1060,N/A,73,4
1,N/A,N/A,N/A,1055,1056,N/A,76,1
3,N/A,N/A,N/A,1052,1055,N/A,79,4
3,N/A,N/A,N/A,1049,1052,N/A,84,3
2,N/A,N/A,N/A,1047,1049,N/A,89,2
7,N/A,N/A,N/A,1040,1047,N/A,93,6
6,N/A,N/A,N/A,1034,1040,N/A,98,5
4,N/A,N/A,N/A,1030,1034,N/A,103,4
2,N/A,N/A,N/A,1028,1030,N/A,107,2
6,N/A,N/A,N/A,1022,1028,N/A,111,6
3,N/A,N/A,N/A,1019,1022,N/A,115,4
3,N/A,N/A,N/A,1016,1019,N/A,121,4
3,N/A,N/A,N/A,1013,1016,N/A,125,2
6,N/A,N/A,N/A,1007,1013,N/A,128,5
3,N/A,N/A,N/A,1004,1007,N/A,133,4
4,N/A,N/A,N/A,502,506,N/A,5,4
2,N/A,N/A,N/A,500,502,N/A,8,1
4,N/A,N/A,N/A,496,500,N/A,11,4
3,N/A,N/A,N/A,493,496,N/A,16,3
6,N/A,N/A,N/A,487,493,N/A,19,6
6,N/A,N/A,N/A,481,487,N/A,24,5
3,N/A,N/A,N/A,478,481,N/A,27,2
3,N/A,N/A,N/A,475,478,N/A,33,2
2,N/A,N/A,N/A,473,475,N/A,38,1
7,N/A,N/A,N/A,466,473,N/A,43,6
6,N/A,N/A,N/A,460,466,N/A,48,5
3,N/A,N/A,N/A,457,460,N/A,52,3
6,N/A,N/A,N/A,451,457,N/A,55,6
2,N/A,N/A,N/A,449,451,N/A,61,0
7,N/A,N/A,N/A,442,449,N/A,67,6
2,N/A,N/A,N/A,440,442,N/A,73,0
6,N/A,N/A,N/A,434,440,N/A,78,5
3,N/A,N/A,N/A,431,434,N/A,81,2
7,N/A,N/A,N/A,424,431,N/A,85,6
2,N/A,N/A,N/A,422,424,N/A,91,0
3,N/A,N/A,N/A,419,422,N/A,94,3
2,N/A,N/A,N/A,417,419,N/A,99,2
7,N/A,N/A,N/A,410,417,N/A,103,6
5,N/A,N/A,N/A,405,410,N/A,108,5
5,N/A,N/A,N/A,400,405,N/A,114,5
2,N/A,N/A,N/A,398,400,N/A,118,3
2,N/A,N/A,N/A,396,398,N/A,123,2
2,N/A,N/A,N/A,394,396,N/A,128,1
3,N/A,N/A,N/A,391,394,N/A,131,4
1,N/A,N/A,N/A,390,391,N/A,134,1
6,N/A,N/A,N/A,904,910,N/A,3,5
5,N/A,N/A,N/A,899,904,N/A,9,5
2,N/A,N/A,N/A,897,899,N/A,13,3
2,N/A,N/A,N/A,895,897,N/A,19,3
2,N/A,N/A,N/A,893,895,N/A,25,3
6,N/A,N/A,N/A,887,893,N/A,28,6
3,N/A,N/A,N/A,884,887,N/A,32,4
2,N/A,N/A,N/A,882,884,N/A,36,2
2,N/A,N/A,N/A,880,882,N/A,42,2
6,N/A,N/A,N/A,874,880,N/A,46,6
1,N/A,N/A,N/A,873,874,N/A,52,0
6,N/A,N/A,N/A,867,873,N/A,58,6
5,N/A,N/A,N/A,862,867,N/A,63,5
2,N/A,N/A,N/A,860,862,N/A,67,3
2,N/A,N/A,N/A,858,860,N/A,72,2
2,N/A,N/A,N/A,856,858,N/A,77,1
6,N/A,N/A,N/A,850,856,N/A,82,6
3,N/A,N/A,N/A,847,850,N/A,86,4
3,N/A,N/A,N/A,844,847,N/A,91,3
3,N/A,N/A,N/A,841,844,N/A,96,2
6,N/A,N/A,N/A,835,841,N/A,100,6
2,N/A,N/A,N/A,833,835,N/A,106,0
6,N/A,N/A,N/A,827,833,N/A,111,5
5,N/A,N/A,N/A,822,827,N/A,117,5
2,N/A,N/A,N/A,820,822,N/A,120,2
6,N/A,N/A,N/A,814,820,N/A,123,5
3,N/A,N/A,N/A,811,814,N/A,128,4
2,N/A,N/A,N/A,809,811,N/A,133,3
7,N/A,N/A,N/A,802,809,N/A,136,6
5,N/A,N/A,N/A,797,802,N/A,141,5
2,N/A,N/A,N/A,1107,1109,N/A,3,3
1,N/A,N/A,N/A,1106,1107,N/A,7,1
4,N/A,N/A,N/A,1102,1106,N/A,10,4
3,N/A,N/A,N/A,1099,1102,N/A,16,4
3,N/A,N/A,N/A,1096,1099,N/A,22,4
3,N/A,N/A,N/A,1093,1096,N/A,28,4
1,N/A,N/A,N/A,1092,1093,N/A,31,1
4,N/A,N/A,N/A,1088,1092,N/A,34,4
4,N/A,N/A,N/A,1084,1088,N/A,40,4
3,N/A,N/A,N/A,1081,1084,N/A,45,3
6,N/A,N/A,N/A,1075,1081,N/A,48,6
6,N/A,N/A,N/A,1069,1075,N/A,53,5
4,N/A,N/A,N/A,1065,1069,N/A,58,4
2,N/A,N/A,N/A,1063,1065,N/A,62,2
7,N/A,N/A,N/A,1056,1063,N/A,66,6
1,N/A,N/A,N/A,1055,1056,N/A,72,0
6,N/A,N/A,N/A,1049,1055,N/A,78,6
3,N/A,N/A,N/A,1046,1049,N/A,81,3
2,N/A,N/A,N/A,1044,1046,N/A,85,1
3,N/A,N/A,N/A,1041,1044,N/A,88,4
3,N/A,N/A,N/A,1038,1041,N/A,94,4
2,N/A,N/A,N/A,1036,1038,N/A,99,3
2,N/A,N/A,N/A,1034,1036,N/A,103,1
3,N/A,N/A,N/A,1031,1034,N/A,106,4
3,N/A,N/A,N/A,1028,1031,N/A,111,3
3,N/A,N/A,N/A,1025,1028,N/A,116,2
6,N/A,N/A,N/A,1019,1025,N/A,119,5
5,N/A,N/A,N/A,1014,1019,N/A,125,5
2,N/A,N/A,N/A,1012,1014,N/A,128,2
2,N/A,N/A,N/A,1010,1012,N/A,133,1
2,N/A,N/A,N/A,1195,1197,N/A,5,2
2,N/A,N/A,N/A,1193,1195,N/A,11,2
5,N/A,N/A,N/A,1188,1193,N/A,14,5
2,N/A,N/A,N/A,1186,1188,N/A,17,2
5,N/A,N/A,N/A,1181,1186,N/A,20,5
6,N/A,N/A,N/A,1175,1181,N/A,26,5
6,N/A,N/A,N/A,1169,1175,N/A,32,5
2,N/A,N/A,N/A,1167,1169,N/A,36,3
6,N/A,N/A,N/A,1161,1167,N/A,39,6
2,N/A,N/A,N/A,1159,1161,N/A,45,0
3,N/A,N/A,N/A,1156,1159,N/A,49,4
2,N/A,N/A,N/A,1154,1156,N/A,52,1
2,N/A,N/A,N/A,1152,1154,N/A,58,1
1,N/A,N/A,N/A,1151,1152,N/A,64,1
6,N/A,N/A,N/A,1145,1151,N/A,68,5
4,N/A,N/A,N/A,1141,1145,N/A,73,4
3,N/A,N/A,N/A,1138,1141,N/A,77,2
2,N/A,N/A,N/A,1136,1138,N/A,82,1
3,N/A,N/A,N/A,1133,1136,N/A,85,4
1,N/A,N/A,N/A,1132,1133,N/A,88,1
5,N/A,N/A,N/A,1127,1132,N/A,92,5
4,N/A,N/A,N/A,1123,1127,N/A,97,4
3,N/A,N/A,N/A,1120,1123,N/A,103,4
3,N/A,N/A,N/A,1117,1120,N/A,108,3
3,N/A,N/A,N/A,1114,1117,N/A,114,3
6,N/A,N/A,N/A,1108,1114,N/A,117,6
2,N/A,N/A,N/A,1106,1108,N/A,120,3
6,N/A,N/A,N/A,1100,1106,N/A,123,6
1,N/A,N/A,N/A,1099,1100,N/A,129,0
7,N/A,N/A,N/A,1092,1099,N/A,135,6
5,N/A,N/A,N/A,1469,1474,N/A,4,5
3,N/A,N/A,N/A,1466,1469,N/A,8,3
2,N/A,N/A,N/A,1464,1466,N/A,13,2
2,N/A,N/A,N/A,1462,1464,N/A,18,1
3,N/A,N/A,N/A,1459,1462,N/A,21,4
2,N/A,N/A,N/A,1457,1459,N/A,24,1
6,N/A,N/A,N/A,1451,1457,N/A,29,6
6,N/A,N/A,N/A,1445,1451,N/A,34,5
2,N/A,N/A,N/A,1443,1445,N/A,38,3
3,N/A,N/A,N/A,1440,1443,N/A,44,3
1,N/A,N/A,N/A,1439,1440,N/A,48,1
3,N/A,N/A,N/A,1436,1439,N/A,51,4
4,N/A,N/A,N/A,1432,1436,N/A,57,4
3,N/A,N/A,N/A,1429,1432,N/A,61,2
3,N/A,N/A,N/A,1426,1429,N/A,67,2
5,N/A,N/A,N/A,1421,1426,N/A,70,5
3,N/A,N/A,N/A,1418,1421,N/A,74,3
1,N/A,N/A,N/A,1417,1418,N/A,78,1
3,N/A,N/A,N/A,1414,1417,N/A,81,4
1,N/A,N/A,N/A,1413,1414,N/A,84,1
6,N/A,N/A,N/A,1407,1413,N/A,89,6
6,N/A,N/A,N/A,1401,1407,N/A,94,5
4,N/A,N/A,N/A,1397,1401,N/A,99,4
4,N/A,N/A,N/A,1393,1397,N/A,105,4
3,N/A,N/A,N/A,1390,1393,N/A,110,3
1,N/A,N/A,N/A,1389,1390,N/A,114,1
6,N/A,N/A,N/A,1383,1389,N/A,118,5
5,N/A,N/A,N/A,1378,1383,N/A,124,5
3,N/A,N/A,N/A,1375,1378,N/A,129,4
3,N/A,N/A,N/A,1372,1375,N/A,135,4
6,N/A,N/A,N/A,342,348,N/A,6,5
5,N/A,N/A,N/A,337,342,N/A,12,5
2,N/A,N/A,N/A,335,337,N/A,16,3
3,N/A,N/A,N/A,332,335,N/A,22,3
7,N/A,N/A,N/A,325,332,N/A,25,6
1,N/A,N/A,N/A,324,325,N/A,31,0
5,N/A,N/A,N/A,319,324,N/A,36,5
2,N/A,N/A,N/A,317,319,N/A,40,3
3,N/A,N/A,N/A,314,317,N/A,46,3
2,N/A,N/A,N/A,312,314,N/A,52,3
2,N/A,N/A,N/A,310,312,N/A,58,3
2,N/A,N/A,N/A,308,310,N/A,64,3
3,N/A,N/A,N/A,305,308,N/A,70,3
2,N/A,N/A,N/A,303,305,N/A,75,2
6,N/A,N/A,N/A,297,303,N/A,79,6
3,N/A,N/A,N/A,294,297,N/A,82,3
3,N/A,N/A,N/A,291,294,N/A,87,2
7,N/A,N/A,N/A,284,291,N/A,91,6
5,N/A,N/A,N/A,279,284,N/A,96,5
6,N/A,N/A,N/A,273,279,N/A,102,5
5,N/A,N/A,N/A,268,273,N/A,108,5
3,N/A,N/A,N/A,265,268,N/A,111,2
7,N/A,N/A,N/A,258,265,N/A,115,6
1,N/A,N/A,N/A,257,258,N/A,121,0
6,N/A,N/A,N/A,251,257,N/A,126,5
2,N/A,N/A,N/A,249,251,N/A,129,2
2,N/A,N/A,N/A,247,249,N/A,135,2
5,N/A,N/A,N/A,242,247,N/A,138,5
6,N/A,N/A,N/A,236,242,N/A,144,5
5,N/A,N/A,N/A,231,236,N/A,150,5
6,N/A,N/A,N/A,967,973,N/A,3,5
3,N/A,N/A,N/A,964,967,N/A,8,4
3,N/A,N/A,N/A,961,964,N/A,13,3
2,N/A,N/A,N/A,959,961,N/A,18,2
5,N/A,N/A,N/A,954,959,N/A,21,5
2,N/A,N/A,N/A,952,954,N/A,24,2
2,N/A,N/A,N/A,950,952,N/A,29,1
3,N/A,N/A,N/A,947,950,N/A,32,4
3,N/A,N/A,N/A,944,947,N/A,36,2
7,N/A,N/A,N/A,937,944,N/A,40,6
2,N/A,N/A,N/A,935,937,N/A,46,0
6,N/A,N/A,N/A,929,935,N/A,52,6
2,N/A,N/A,N/A,927,929,N/A,58,0
7,N/A,N/A,N/A,920,927,N/A,64,6
6,N/A,N/A,N/A,914,920,N/A,69,5
3,N/A,N/A,N/A,911,914,N/A,73,3
3,N/A,N/A,N/A,908,911,N/A,79,3
3,N/A,N/A,N/A,905,908,N/A,85,3
2,N/A,N/A,N/A,903,905,N/A,89,1
4,N/A,N/A,N/A,899,903,N/A,92,4
2,N/A,N/A,N/A,897,899,N/A,96,2
1,N/A,N/A,N/A,896,897,N/A,101,1
7,N/A,N/A,N/A,889,896,N/A,106,6
1,N/A,N/A,N/A,888,889,N/A,112,0
2,N/A,N/A,N/A,886,888,N/A,115,3
3,N/A,N/A,N/A,883,886,N/A,120,2
7,N/A,N/A,N/A,876,883,N/A,124,6
3,N/A,N/A,N/A,873,876,N/A,127,3
2,N/A,N/A,N/A,871,873,N/A,133,3
2,N/A,N/A,N/A,869,871,N/A,137,1
1,N/A,N/A,N/A,1642,1643,N/A,4,1
4,N/A,N/A,N/A,1638,1642,N/A,7,4
1,N/A,N/A,N/A,1637,1638,N/A,10,1
6,N/A,N/A,N/A,1631,1637,N/A,14,5
2,N/A,N/A,N/A,1629,1631,N/A,18,3
3,N/A,N/A,N/A,1626,1629,N/A,23,2
2,N/A,N/A,N/A,1624,1626,N/A,28,1
4,N/A,N/A,N/A,1620,1624,N/A,31,4
3,N/A,N/A,N/A,1617,1620,N/A,37,4
3,N/A,N/A,N/A,1614,1617,N/A,42,3
3,N/A,N/A,N/A,1611,1614,N/A,47,2
5,N/A,N/A,N/A,1606,1611,N/A,50,5
6,N/A,N/A,N/A,1600,1606,N/A,56,5
4,N/A,N/A,N/A,1596,1600,N/A,61,4
3,N/A,N/A,N/A,1593,1596,N/A,67,4
2,N/A,N/A,N/A,1591,1593,N/A,71,2
3,N/A,N/A,N/A,1588,1591,N/A,77,2
5,N/A,N/A,N/A,1583,1588,N/A,80,5
5,N/A,N/A,N/A,1578,1583,N/A,86,5
2,N/A,N/A,N/A,1576,1578,N/A,89,2
2,N/A,N/A,N/A,1574,1576,N/A,94,1
5,N/A,N/A,N/A,1569,1574,N/A,98,5
3,N/A,N/A,N/A,1566,1569,N/A,103,4
2,N/A,N/A,N/A,1564,1566,N/A,107,2
6,N/A,N/A,N/A,1558,1564,N/A,110,5
4,N/A,N/A,N/A,1554,1558,N/A,115,4
4,N/A,N/A,N/A,1550,1554,N/A,121,4
3,N/A,N/A,N/A,1547,1550,N/A,125,2
2,N/A,N/A,N/A,1545,1547,N/A,130,1
6,N/A,N/A,N/A,1539,1545,N/A,135,6
2,N/A,N/A,N/A,870,872,N/A,6,3
7,N/A,N/A,N/A,863,870,N/A,9,6
6,N/A,N/A,N/A,857,863,N/A,14,5
3,N/A,N/A,N/A,854,857,N/A,19,4
2,N/A,N/A,N/A,852,854,N/A,24,3
2,N/A,N/A,N/A,850,852,N/A,28,1
6,N/A,N/A,N/A,844,850,N/A,32,5
2,N/A,N/A,N/A,842,844,N/A,36,3
3,N/A,N/A,N/A,839,842,N/A,42,3
2,N/A,N/A,N/A,837,839,N/A,48,3
2,N/A,N/A,N/A,835,837,N/A,52,1
4,N/A,N/A,N/A,831,835,N/A,55,4
3,N/A,N/A,N/A,828,831,N/A,59,2
2,N/A,N/A,N/A,826,828,N/A,64,1
7,N/A,N/A,N/A,819,826,N/A,69,6
6,N/A,N/A,N/A,813,819,N/A,74,5
2,N/A,N/A,N/A,811,813,N/A,78,3
2,N/A,N/A,N/A,809,811,N/A,83,2
6,N/A,N/A,N/A,803,809,N/A,87,6
1,N/A,N/A,N/A,802,803,N/A,93,0
3,N/A,N/A,N/A,799,802,N/A,96,3
1,N/A,N/A,N/A,798,799,N/A,100,1
1,N/A,N/A,N/A,797,798,N/A,106,1
1,N/A,N/A,N/A,796,797,N/A,112,1
3,N/A,N/A,N/A,793,796,N/A,115,4
4,N/A,N/A,N/A,789,793,N/A,121,4
3,N/A,N/A,N/A,786,789,N/A,126,3
2,N/A,N/A,N/A,784,786,N/A,131,2
2,N/A,N/A,N/A,782,784,N/A,137,2
5,N/A,N/A,N/A,777,782,N/A,140,5
6,N/A,N/A,N/A,1026,1032,N/A,5,5
3,N/A,N/A,N/A,1023,1026,N/A,9,3
2,N/A,N/A,N/A,1021,1023,N/A,13,1
6,N/A,N/A,N/A,1015,1021,N/A,17,5
3,N/A,N/A,N/A,1012,1015,N/A,21,3
3,N/A,N/A,N/A,1009,1012,N/A,26,2
7,N/A,N/A,N/A,1002,1009,N/A,30,6
6,N/A,N/A,N/A,996,1002,N/A,35,5
3,N/A,N/A,N/A,993,996,N/A,38,2
1,N/A,N/A,N/A,992,993,N/A,43,1
3,N/A,N/A,N/A,989,992,N/A,46,4
2,N/A,N/A,N/A,987,989,N/A,49,1
5,N/A,N/A,N/A,982,987,N/A,53,5
2,N/A,N/A,N/A,980,982,N/A,56,2
2,N/A,N/A,N/A,978,980,N/A,62,2
5,N/A,N/A,N/A,973,978,N/A,65,5
2,N/A,N/A,N/A,971,973,N/A,69,3
3,N/A,N/A,N/A,968,971,N/A,74,2
2,N/A,N/A,N/A,966,968,N/A,80,2
3,N/A,N/A,N/A,963,966,N/A,86,2
5,N/A,N/A,N/A,958,963,N/A,89,5
3,N/A,N/A,N/A,955,958,N/A,94,4
3,N/A,N/A,N/A,952,955,N/A,100,4
2,N/A,N/A,N/A,950,952,N/A,105,3
2,N/A,N/A,N/A,948,950,N/A,111,3
1,N/A,N/A,N/A,947,948,N/A,115,1
5,N/A,N/A,N/A,942,947,N/A,119,5
5,N/A,N/A,N/A,937,942,N/A,125,5
2,N/A,N/A,N/A,935,937,N/A,129,3
2,N/A,N/A,N/A,933,935,N/A,134,2
2,N/A,N/A,N/A,1721,1723,N/A,6,1
5,N/A,N/A,N/A,1716,1721,N/A,10,5
3,N/A,N/A,N/A,1713,1716,N/A,13,2
6,N/A,N/A,N/A,1707,1713,N/A,16,5
2,N/A,N/A,N/A,1705,1707,N/A,19,2
2,N/A,N/A,N/A,1703,1705,N/A,24,1
1,N/A,N/A,N/A,1702,1703,N/A,30,1
6,N/A,N/A,N/A,1696,1702,N/A,35,6
3,N/A,N/A,N/A,1693,1696,N/A,38,3
3,N/A,N/A,N/A,1690,1693,N/A,43,2
5,N/A,N/A,N/A,1685,1690,N/A,46,5
2,N/A,N/A,N/A,1683,1685,N/A,50,3
2,N/A,N/A,N/A,1681,1683,N/A,54,1
6,N/A,N/A,N/A,1675,1681,N/A,59,6
6,N/A,N/A,N/A,1669,1675,N/A,64,5
3,N/A,N/A,N/A,1666,1669,N/A,68,3
7,N/A,N/A,N/A,1659,1666,N/A,71,6
5,N/A,N/A,N/A,1654,1659,N/A,76,5
5,N/A,N/A,N/A,1649,1654,N/A,82,5
3,N/A,N/A,N/A,1646,1649,N/A,85,2
6,N/A,N/A,N/A,1640,1646,N/A,89,6
3,N/A,N/A,N/A,1637,1640,N/A,93,4
4,N/A,N/A,N/A,1633,1637,N/A,99,4
2,N/A,N/A,N/A,1631,1633,N/A,102,1
4,N/A,N/A,N/A,1627,1631,N/A,105,4
2,N/A,N/A,N/A,1625,1627,N/A,108,1
3,N/A,N/A,N/A,1622,1625,N/A,111,4
3,N/A,N/A,N/A,1619,1622,N/A,116,3
3,N/A,N/A,N/A,1616,1619,N/A,121,2
5,N/A,N/A,N/A,1611,1616,N/A,124,5
7,N/A,N/A,N/A,344,351,N/A,4,6
3,N/A,N/A,N/A,341,344,N/A,8,4
3,N/A,N/A,N/A,338,341,N/A,12,2
2,N/A,N/A,N/A,336,338,N/A,18,2
7,N/A,N/A,N/A,329,336,N/A,22,6
5,N/A,N/A,N/A,324,329,N/A,27,5
6,N/A,N/A,N/A,318,324,N/A,33,5
3,N/A,N/A,N/A,315,318,N/A,36,2
5,N/A,N/A,N/A,310,315,N/A,39,5
4,N/A,N/A,N/A,306,310,N/A,44,4
4,N/A,N/A,N/A,302,306,N/A,50,4
2,N/A,N/A,N/A,300,302,N/A,54,2
6,N/A,N/A,N/A,294,300,N/A,57,5
6,N/A,N/A,N/A,288,294,N/A,63,5
2,N/A,N/A,N/A,286,288,N/A,66,2
2,N/A,N/A,N/A,284,286,N/A,71,1
5,N/A,N/A,N/A,279,284,N/A,75,5
2,N/A,N/A,N/A,277,279,N/A,79,3
3,N/A,N/A,N/A,274,277,N/A,84,2
2,N/A,N/A,N/A,272,274,N/A,90,2
2,N/A,N/A,N/A,270,272,N/A,96,2
5,N/A,N/A,N/A,265,270,N/A,99,5
3,N/A,N/A,N/A,262,265,N/A,103,3
3,N/A,N/A,N/A,259,262,N/A,108,2
5,N/A,N/A,N/A,254,259,N/A,111,5
3,N/A,N/A,N/A,251,254,N/A,116,4
4,N/A,N/A,N/A,247,251,N/A,122,4
3,N/A,N/A,N/A,244,247,N/A,126,2
1,N/A,N/A,N/A,243,244,N/A,131,1
4,N/A,N/A,N/A,239,243,N/A,134,4
5,N/A,N/A,N/A,855,860,N/A,4,5
3,N/A,N/A,N/A,852,855,N/A,9,4
3,N/A,N/A,N/A,849,852,N/A,14,3
3,N/A,N/A,N/A,846,849,N/A,20,3
2,N/A,N/A,N/A,844,846,N/A,24,1
7,N/A,N/A,N/A,837,844,N/A,29,6
2,N/A,N/A,N/A,835,837,N/A,35,0
6,N/A,N/A,N/A,829,835,N/A,41,6
6,N/A,N/A,N/A,823,829,N/A,46,5
3,N/A,N/A,N/A,820,823,N/A,51,4
3,N/A,N/A,N/A,817,820,N/A,56,3
3,N/A,N/A,N/A,814,817,N/A,61,2
7,N/A,N/A,N/A,807,814,N/A,65,6
4,N/A,N/A,N/A,803,807,N/A,69,4
3,N/A,N/A,N/A,800,803,N/A,74,3
6,N/A,N/A,N/A,794,800,N/A,77,6
2,N/A,N/A,N/A,792,794,N/A,80,3
2,N/A,N/A,N/A,790,792,N/A,84,1
3,N/A,N/A,N/A,787,790,N/A,87,4
2,N/A,N/A,N/A,785,787,N/A,91,2
5,N/A,N/A,N/A,780,785,N/A,94,5
2,N/A,N/A,N/A,778,780,N/A,97,2
1,N/A,N/A,N/A,777,778,N/A,102,1
2,N/A,N/A,N/A,775,777,N/A,108,1
3,N/A,N/A,N/A,772,775,N/A,111,4
2,N/A,N/A,N/A,770,772,N/A,115,2
7,N/A,N/A,N/A,763,770,N/A,119,6
3,N/A,N/A,N/A,760,763,N/A,122,3
2,N/A,N/A,N/A,758,760,N/A,127,2
6,N/A,N/A,N/A,752,758,N/A,130,5
3,N/A,N/A,N/A,1345,1348,N/A,3,2
6,N/A,N/A,N/A,1339,1345,N/A,7,6
5,N/A,N/A,N/A,1334,1339,N/A,12,5
6,N/A,N/A,N/A,1328,1334,N/A,18,5
2,N/A,N/A,N/A,1326,1328,N/A,22,3
6,N/A,N/A,N/A,1320,1326,N/A,25,6
6,N/A,N/A,N/A,1314,1320,N/A,30,5
3,N/A,N/A,N/A,1311,1314,N/A,33,2
6,N/A,N/A,N/A,1305,1311,N/A,37,6
2,N/A,N/A,N/A,1303,1305,N/A,40,3
2,N/A,N/A,N/A,1301,1303,N/A,44,1
6,N/A,N/A,N/A,1295,1301,N/A,49,6
2,N/A,N/A,N/A,1293,1295,N/A,52,3
2,N/A,N/A,N/A,1291,1293,N/A,56,1
1,N/A,N/A,N/A,1290,1291,N/A,62,1
4,N/A,N/A,N/A,1286,1290,N/A,65,4
4,N/A,N/A,N/A,1282,1286,N/A,71,4
3,N/A,N/A,N/A,1279,1282,N/A,77,4
2,N/A,N/A,N/A,1277,1279,N/A,82,3
7,N/A,N/A,N/A,1270,1277,N/A,85,6
2,N/A,N/A,N/A,1268,1270,N/A,88,3
1,N/A,N/A,N/A,1267,1268,N/A,92,1
4,N/A,N/A,N/A,1263,1267,N/A,95,4
2,N/A,N/A,N/A,1261,1263,N/A,98,1
1,N/A,N/A,N/A,1260,1261,N/A,104,1
5,N/A,N/A,N/A,1255,1260,N/A,108,5
3,N/A,N/A,N/A,1252,1255,N/A,113,4
3,N/A,N/A,N/A,1249,1252,N/A,117,2
1,N/A,N/A,N/A,1248,1249,N/A,122,1
1,N/A,N/A,N/A,1247,1248,N/A,128,1
2,N/A,N/A,N/A,446,448,N/A,3,1
7,N/A,N/A,N/A,439,446,N/A,8,6
3,N/A,N/A,N/A,436,439,N/A,11,3
1,N/A,N/A,N/A,435,436,N/A,15,1
1,N/A,N/A,N/A,434,435,N/A,21,1
2,N/A,N/A,N/A,432,434,N/A,27,1
7,N/A,N/A,N/A,425,432,N/A,32,6
3,N/A,N/A,N/A,422,425,N/A,35,3
3,N/A,N/A,N/A,419,422,N/A,41,3
1,N/A,N/A,N/A,418,419,N/A,45,1
6,N/A,N/A,N/A,412,418,N/A,50,6
1,N/A,N/A,N/A,411,412,N/A,56,0
3,N/A,N/A,N/A,408,411,N/A,60,4
3,N/A,N/A,N/A,405,408,N/A,65,3
3,N/A,N/A,N/A,402,405,N/A,70,2
3,N/A,N/A,N/A,399,402,N/A,76,2
2,N/A,N/A,N/A,397,399,N/A,82,2
3,N/A,N/A,N/A,394,397,N/A,88,2
1,N/A,N/A,N/A,393,394,N/A,93,1
7,N/A,N/A,N/A,386,393,N/A,98,6
4,N/A,N/A,N/A,382,386,N/A,102,4
2,N/A,N/A,N/A,380,382,N/A,107,3
2,N/A,N/A,N/A,378,380,N/A,113,3
1,N/A,N/A,N/A,377,378,N/A,117,1
4,N/A,N/A,N/A,373,377,N/A,120,4
1,N/A,N/A,N/A,372,373,N/A,123,1
1,N/A,N/A,N/A,371,372,N/A,129,1
6,N/A,N/A,N/A,365,371,N/A,134,6
5,N/A,N/A,N/A,360,365,N/A,139,5
2,N/A,N/A,N/A,358,360,N/A,142,2
2,N/A,N/A,N/A,1914,1916,N/A,5,1
6,N/A,N/A,N/A,1908,1914,N/A,10,6
2,N/A,N/A,N/A,1906,1908,N/A,13,3
2,N/A,N/A,N/A,1904,1906,N/A,18,2
6,N/A,N/A,N/A,1898,1904,N/A,22,6
2,N/A,N/A,N/A,1896,1898,N/A,25,3
3,N/A,N/A,N/A,1893,1896,N/A,31,3
3,N/A,N/A,N/A,1890,1893,N/A,36,2
1,N/A,N/A,N/A,1889,1890,N/A,41,1
2,N/A,N/A,N/A,1887,1889,N/A,47,1
3,N/A,N/A,N/A,1884,1887,N/A,50,4
2,N/A,N/A,N/A,1882,1884,N/A,53,1
6,N/A,N/A,N/A,1876,1882,N/A,58,6
5,N/A,N/A,N/A,1871,1876,N/A,63,5
2,N/A,N/A,N/A,1869,1871,N/A,66,2
3,N/A,N/A,N/A,1866,1869,N/A,72,2
5,N/A,N/A,N/A,1861,1866,N/A,75,5
3,N/A,N/A,N/A,1858,1861,N/A,79,3
1,N/A,N/A,N/A,1857,1858,N/A,83,1
1,N/A,N/A,N/A,1856,1857,N/A,89,1
3,N/A,N/A,N/A,1853,1856,N/A,92,4
3,N/A,N/A,N/A,1850,1853,N/A,96,2
3,N/A,N/A,N/A,1847,1850,N/A,102,2
1,N/A,N/A,N/A,1846,1847,N/A,107,1
3,N/A,N/A,N/A,1843,1846,N/A,110,4
1,N/A,N/A,N/A,1842,1843,N/A,113,1
6,N/A,N/A,N/A,1836,1842,N/A,118,6
1,N/A,N/A,N/A,1835,1836,N/A,124,0
6,N/A,N/A,N/A,1829,1835,N/A,130,6
6,N/A,N/A,N/A,1823,1829,N/A,135,5
2,N/A,N/A,N/A,400,402,N/A,4,3
3,N/A,N/A,N/A,397,400,N/A,10,3
2,N/A,N/A,N/A,395,397,N/A,16,3
3,N/A,N/A,N/A,392,395,N/A,22,3
3,N/A,N/A,N/A,389,392,N/A,27,2
5,N/A,N/A,N/A,384,389,N/A,30,5
3,N/A,N/A,N/A,381,384,N/A,35,4
2,N/A,N/A,N/A,379,381,N/A,40,3
1,N/A,N/A,N/A,378,379,N/A,44,1
6,N/A,N/A,N/A,372,378,N/A,49,6
4,N/A,N/A,N/A,368,372,N/A,53,4
2,N/A,N/A,N/A,366,368,N/A,58,3
2,N/A,N/A,N/A,364,366,N/A,63,2
7,N/A,N/A,N/A,357,364,N/A,67,6
3,N/A,N/A,N/A,354,357,N/A,70,3
2,N/A,N/A,N/A,352,354,N/A,75,2
6,N/A,N/A,N/A,346,352,N/A,78,5
3,N/A,N/A,N/A,343,346,N/A,82,3
2,N/A,N/A,N/A,341,343,N/A,86,1
7,N/A,N/A,N/A,334,341,N/A,91,6
3,N/A,N/A,N/A,331,334,N/A,95,4
2,N/A,N/A,N/A,329,331,N/A,99,2
2,N/A,N/A,N/A,327,329,N/A,105,2
3,N/A,N/A,N/A,324,327,N/A,111,2
2,N/A,N/A,N/A,322,324,N/A,116,1
6,N/A,N/A,N/A,316,322,N/A,121,6
1,N/A,N/A,N/A,315,316,N/A,127,0
6,N/A,N/A,N/A,309,315,N/A,132,5
3,N/A,N/A,N/A,306,309,N/A,136,3
3,N/A,N/A,N/A,303,306,N/A,141,2
3,N/A,N/A,N/A,808,811,N/A,4,2
6,N/A,N/A,N/A,802,808,N/A,8,6
6,N/A,N/A,N/A,796,802,N/A,13,5
3,N/A,N/A,N/A,793,796,N/A,17,3
2,N/A,N/A,N/A,791,793,N/A,21,1
1,N/A,N/A,N/A,790,791,N/A,27,1
3,N/A,N/A,N/A,787,790,N/A,30,4
2,N/A,N/A,N/A,785,787,N/A,33,1
6,N/A,N/A,N/A,779,785,N/A,37,5
6,N/A,N/A,N/A,773,779,N/A,43,5
4,N/A,N/A,N/A,769,773,N/A,48,4
3,N/A,N/A,N/A,766,769,N/A,54,4
2,N/A,N/A,N/A,764,766,N/A,59,3
3,N/A,N/A,N/A,761,764,N/A,64,2
6,N/A,N/A,N/A,755,761,N/A,67,5
3,N/A,N/A,N/A,752,755,N/A,71,3
6,N/A,N/A,N/A,746,752,N/A,74,6
2,N/A,N/A,N/A,744,746,N/A,77,3
3,N/A,N/A,N/A,741,744,N/A,83,3
2,N/A,N/A,N/A,739,741,N/A,87,1
3,N/A,N/A,N/A,736,739,N/A,90,4
3,N/A,N/A,N/A,733,736,N/A,94,2
2,N/A,N/A,N/A,731,733,N/A,99,1
5,N/A,N/A,N/A,726,731,N/A,103,5
3,N/A,N/A,N/A,723,726,N/A,106,2
6,N/A,N/A,N/A,717,723,N/A,109,5
3,N/A,N/A,N/A,714,717,N/A,112,2
7,N/A,N/A,N/A,707,714,N/A,116,6
3,N/A,N/A,N/A,704,707,N/A,120,4
3,N/A,N/A,N/A,701,704,N/A,126,4
6,N/A,N/A,N/A,294,300,N/A,3,6
4,N/A,N/A,N/A,290,294,N/A,7,4
3,N/A,N/A,N/A,287,290,N/A,11,2
1,N/A,N/A,N/A,286,287,N/A,16,1
5,N/A,N/A,N/A,281,286,N/A,20,5
3,N/A,N/A,N/A,278,281,N/A,25,4
3,N/A,N/A,N/A,275,278,N/A,31,4
3,N/A,N/A,N/A,272,275,N/A,37,4
3,N/A,N/A,N/A,269,272,N/A,43,4
3,N/A,N/A,N/A,266,269,N/A,47,2
3,N/A,N/A,N/A,263,266,N/A,53,2
6,N/A,N/A,N/A,257,263,N/A,56,5
3,N/A,N/A,N/A,254,257,N/A,60,3
6,N/A,N/A,N/A,248,254,N/A,63,6
3,N/A,N/A,N/A,245,248,N/A,66,3
3,N/A,N/A,N/A,242,245,N/A,71,2
3,N/A,N/A,N/A,239,242,N/A,77,2
1,N/A,N/A,N/A,238,239,N/A,82,1
1,N/A,N/A,N/A,237,238,N/A,88,1
7,N/A,N/A,N/A,230,237,N/A,93,6
4,N/A,N/A,N/A,226,230,N/A,97,4
1,N/A,N/A,N/A,225,226,N/A,100,1
1,N/A,N/A,N/A,224,225,N/A,106,1
6,N/A,N/A,N/A,218,224,N/A,111,6
6,N/A,N/A,N/A,212,218,N/A,116,5
3,N/A,N/A,N/A,209,212,N/A,121,4
1,N/A,N/A,N/A,208,209,N/A,124,1
6,N/A,N/A,N/A,202,208,N/A,128,5
3,N/A,N/A,N/A,199,202,N/A,133,4
2,N/A,N/A,N/A,197,199,N/A,136,1
2,N/A,N/A,N/A,1394,1396,N/A,6,1
6,N/A,N/A,N/A,1388,1394,N/A,10,5
6,N/A,N/A,N/A,1382,1388,N/A,16,5
4,N/A,N/A,N/A,1378,1382,N/A,21,4
1,N/A,N/A,N/A,1377,1378,N/A,24,1
6,N/A,N/A,N/A,1371,1377,N/A,29,6
2,N/A,N/A,N/A,1369,1371,N/A,35,0
4,N/A,N/A,N/A,1365,1369,N/A,39,4
1,N/A,N/A,N/A,1364,1365,N/A,42,1
1,N/A,N/A,N/A,1363,1364,N/A,48,1
4,N/A,N/A,N/A,1359,1363,N/A,51,4
3,N/A,N/A,N/A,1356,1359,N/A,55,2
3,N/A,N/A,N/A,1353,1356,N/A,61,2
1,N/A,N/A,N/A,1352,1353,N/A,66,1
3,N/A,N/A,N/A,1349,1352,N/A,69,4
2,N/A,N/A,N/A,1347,1349,N/A,74,3
1,N/A,N/A,N/A,1346,1347,N/A,78,1
6,N/A,N/A,N/A,1340,1346,N/A,82,5
2,N/A,N/A,N/A,1338,1340,N/A,86,3
7,N/A,N/A,N/A,1331,1338,N/A,89,6
6,N/A,N/A,N/A,1325,1331,N/A,94,5
3,N/A,N/A,N/A,1322,1325,N/A,98,3
3,N/A,N/A,N/A,1319,1322,N/A,104,3
3,N/A,N/A,N/A,1316,1319,N/A,110,3
2,N/A,N/A,N/A,1314,1316,N/A,116,3
6,N/A,N/A,N/A,1308,1314,N/A,119,6
3,N/A,N/A,N/A,1305,1308,N/A,122,3
3,N/A,N/A,N/A,1302,1305,N/A,128,3
2,N/A,N/A,N/A,1300,1302,N/A,134,3
2,N/A,N/A,N/A,1298,1300,N/A,138,1
3,N/A,N/A,N/A,498,501,N/A,6,4
1,N/A,N/A,N/A,497,498,N/A,9,1
6,N/A,N/A,N/A,491,497,N/A,14,6
6,N/A,N/A,N/A,485,491,N/A,19,5
6,N/A,N/A,N/A,479,485,N/A,25,5
4,N/A,N/A,N/A,475,479,N/A,30,4
2,N/A,N/A,N/A,473,475,N/A,33,1
4,N/A,N/A,N/A,469,473,N/A,36,4
3,N/A,N/A,N/A,466,469,N/A,41,3
2,N/A,N/A,N/A,464,466,N/A,46,2
6,N/A,N/A,N/A,458,464,N/A,50,6
3,N/A,N/A,N/A,455,458,N/A,53,3
7,N/A,N/A,N/A,448,455,N/A,56,6
2,N/A,N/A,N/A,446,448,N/A,59,3
3,N/A,N/A,N/A,443,446,N/A,64,2
5,N/A,N/A,N/A,438,443,N/A,67,5
3,N/A,N/A,N/A,435,438,N/A,70,2
6,N/A,N/A,N/A,429,435,N/A,74,6
2,N/A,N/A,N/A,427,429,N/A,80,0
3,N/A,N/A,N/A,424,427,N/A,84,4
3,N/A,N/A,N/A,421,424,N/A,90,4
3,N/A,N/A,N/A,418,421,N/A,96,4
2,N/A,N/A,N/A,416,418,N/A,101,3
6,N/A,N/A,N/A,410,416,N/A,104,6
2,N/A,N/A,N/A,408,410,N/A,107,3
2,N/A,N/A,N/A,406,408,N/A,111,1
3,N/A,N/A,N/A,403,406,N/A,114,4
1,N/A,N/A,N/A,402,403,N/A,117,1
5,N/A,N/A,N/A,397,402,N/A,121,5
2,N/A,N/A,N/A,395,397,N/A,124,2
5,N/A,N/A,N/A,1271,1276,N/A,3,5
4,N/A,N/A,N/A,1267,1271,N/A,8,4
2,N/A,N/A,N/A,1265,1267,N/A,12,2
2,N/A,N/A,N/A,1263,1265,N/A,18,2
6,N/A,N/A,N/A,1257,1263,N/A,21,5
3,N/A,N/A,N/A,1254,1257,N/A,25,3
6,N/A,N/A,N/A,1248,1254,N/A,28,6
2,N/A,N/A,N/A,1246,1248,N/A,31,3
1,N/A,N/A,N/A,1245,1246,N/A,35,1
4,N/A,N/A,N/A,1241,1245,N/A,38,4
3,N/A,N/A,N/A,1238,1241,N/A,43,3
7,N/A,N/A,N/A,1231,1238,N/A,46,6
3,N/A,N/A,N/A,1228,1231,N/A,49,3
7,N/A,N/A,N/A,1221,1228,N/A,52,6
2,N/A,N/A,N/A,1219,1221,N/A,55,3
7,N/A,N/A,N/A,1212,1219,N/A,58,6
2,N/A,N/A,N/A,1210,1212,N/A,64,0
6,N/A,N/A,N/A,1204,1210,N/A,69,5
3,N/A,N/A,N/A,1201,1204,N/A,72,2
1,N/A,N/A,N/A,1200,1201,N/A,77,1
3,N/A,N/A,N/A,1197,1200,N/A,80,4
2,N/A,N/A,N/A,1195,1197,N/A,85,3
2,N/A,N/A,N/A,1193,1195,N/A,90,2
3,N/A,N/A,N/A,1190,1193,N/A,96,2
1,N/A,N/A,N/A,1189,1190,N/A,101,1
2,N/A,N/A,N/A,1187,1189,N/A,107,1
6,N/A,N/A,N/A,1181,1187,N/A,111,5
6,N/A,N/A,N/A,1175,1181,N/A,117,5
4,N/A,N/A,N/A,1171,1175,N/A,122,4
3,N/A,N/A,N/A,1168,1171,N/A,127,3
3,N/A,N/A,N/A,683,686,N/A,6,2
7,N/A,N/A,N/A,676,683,N/A,10,6
2,N/A,N/A,N/A,674,676,N/A,16,0
4,N/A,N/A,N/A,670,674,N/A,20,4
3,N/A,N/A,N/A,667,670,N/A,25,3
2,N/A,N/A,N/A,665,667,N/A,29,1
7,N/A,N/A,N/A,658,665,N/A,34,6
3,N/A,N/A,N/A,655,658,N/A,37,3
1,N/A,N/A,N/A,654,655,N/A,41,1
5,N/A,N/A,N/A,649,654,N/A,45,5
2,N/A,N/A,N/A,647,649,N/A,48,2
6,N/A,N/A,N/A,641,647,N/A,52,6
2,N/A,N/A,N/A,639,641,N/A,58,0
7,N/A,N/A,N/A,632,639,N/A,64,6
5,N/A,N/A,N/A,627,632,N/A,69,5
3,N/A,N/A,N/A,624,627,N/A,73,3
2,N/A,N/A,N/A,622,624,N/A,77,1
5,N/A,N/A,N/A,617,622,N/A,81,5
3,N/A,N/A,N/A,614,617,N/A,85,3
3,N/A,N/A,N/A,611,614,N/A,91,3
6,N/A,N/A,N/A,605,611,N/A,94,6
4,N/A,N/A,N/A,601,605,N/A,98,4
2,N/A,N/A,N/A,599,601,N/A,102,2
3,N/A,N/A,N/A,596,599,N/A,108,2
6,N/A,N/A,N/A,590,596,N/A,112,6
6,N/A,N/A,N/A,584,590,N/A,117,5
4,N/A,N/A,N/A,580,584,N/A,122,4
2,N/A,N/A,N/A,578,580,N/A,126,2
1,N/A,N/A,N/A,577,578,N/A,131,1
6,N/A,N/A,N/A,571,577,N/A,136,6
6,N/A,N/A,N/A,1918,1924,N/A,3,5
3,N/A,N/A,N/A,1915,1918,N/A,6,2
5,N/A,N/A,N/A,1910,1915,N/A,9,5
4,N/A,N/A,N/A,1906,1910,N/A,14,4
4,N/A,N/A,N/A,1902,1906,N/A,20,4
1,N/A,N/A,N/A,1901,1902,N/A,23,1
4,N/A,N/A,N/A,1897,1901,N/A,26,4
3,N/A,N/A,N/A,1894,1897,N/A,32,4
4,N/A,N/A,N/A,1890,1894,N/A,38,4
3,N/A,N/A,N/A,1887,1890,N/A,44,4
3,N/A,N/A,N/A,1884,1887,N/A,48,2
5,N/A,N/A,N/A,1879,1884,N/A,51,5
3,N/A,N/A,N/A,1876,1879,N/A,54,2
2,N/A,N/A,N/A,1874,1876,N/A,59,1
4,N/A,N/A,N/A,1870,1874,N/A,62,4
3,N/A,N/A,N/A,1867,1870,N/A,66,2
1,N/A,N/A,N/A,1866,1867,N/A,71,1
4,N/A,N/A,N/A,1862,1866,N/A,74,4
2,N/A,N/A,N/A,1860,1862,N/A,77,1
1,N/A,N/A,N/A,1859,1860,N/A,83,1
7,N/A,N/A,N/A,1852,1859,N/A,88,6
6,N/A,N/A,N/A,1846,1852,N/A,93,5
6,N/A,N/A,N/A,1840,1846,N/A,99,5
2,N/A,N/A,N/A,1838,1840,N/A,103,3
6,N/A,N/A,N/A,1832,1838,N/A,106,6
3,N/A,N/A,N/A,1829,1832,N/A,110,4
3,N/A,N/A,N/A,1826,1829,N/A,115,3
2,N/A,N/A,N/A,1824,1826,N/A,120,2
2,N/A,N/A,N/A,1822,1824,N/A,125,1
6,N/A,N/A,N/A,1816,1822,N/A,130,6
6,N/A,N/A,N/A,1063,1069,N/A,3,5
2,N/A,N/A,N/A,1061,1063,N/A,6,2
3,N/A,N/A,N/A,1058,1061,N/A,12,2
5,N/A,N/A,N/A,1053,1058,N/A,15,5
6,N/A,N/A,N/A,1047,1053,N/A,21,5
2,N/A,N/A,N/A,1045,1047,N/A,25,3
7,N/A,N/A,N/A,1038,1045,N/A,28,6
4,N/A,N/A,N/A,1034,1038,N/A,32,4
3,N/A,N/A,N/A,1031,1034,N/A,37,3
1,N/A,N/A,N/A,1030,1031,N/A,41,1
5,N/A,N/A,N/A,1025,1030,N/A,45,5
2,N/A,N/A,N/A,1023,1025,N/A,48,2
5,N/A,N/A,N/A,1018,1023,N/A,51,5
5,N/A,N/A,N/A,1013,1018,N/A,57,5
5,N/A,N/A,N/A,1008,1013,N/A,63,5
3,N/A,N/A,N/A,1005,1008,N/A,67,3
1,N/A,N/A,N/A,1004,1005,N/A,71,1
1,N/A,N/A,N/A,1003,1004,N/A,77,1
7,N/A,N/A,N/A,996,1003,N/A,82,6
5,N/A,N/A,N/A,991,996,N/A,87,5
2,N/A,N/A,N/A,989,991,N/A,90,2
7,N/A,N/A,N/A,982,989,N/A,94,6
2,N/A,N/A,N/A,980,982,N/A,97,3
1,N/A,N/A,N/A,979,980,N/A,101,1
7,N/A,N/A,N/A,972,979,N/A,106,6
2,N/A,N/A,N/A,970,972,N/A,112,0
2,N/A,N/A,N/A,968,970,N/A,115,3
2,N/A,N/A,N/A,966,968,N/A,119,1
5,N/A,N/A,N/A,961,966,N/A,123,5
4,N/A,N/A,N/A,957,961,N/A,128,4
2,N/A,N/A,N/A,750,752,N/A,3,3
2,N/A,N/A,N/A,748,750,N/A,7,1
3,N/A,N/A,N/A,745,748,N/A,10,4
1,N/A,N/A,N/A,744,745,N/A,13,1
6,N/A,N/A,N/A,738,744,N/A,18,6
2,N/A,N/A,N/A,736,738,N/A,24,0
6,N/A,N/A,N/A,730,736,N/A,29,5
4,N/A,N/A,N/A,726,730,N/A,34,4
2,N/A,N/A,N/A,724,726,N/A,38,2
2,N/A,N/A,N/A,722,724,N/A,44,2
3,N/A,N/A,N/A,719,722,N/A,50,2
2,N/A,N/A,N/A,717,719,N/A,56,2
2,N/A,N/A,N/A,715,717,N/A,61,1
7,N/A,N/A,N/A,708,715,N/A,66,6
3,N/A,N/A,N/A,705,708,N/A,69,3
1,N/A,N/A,N/A,704,705,N/A,73,1
6,N/A,N/A,N/A,698,704,N/A,78,6
2,N/A,N/A,N/A,696,698,N/A,84,0
3,N/A,N/A,N/A,693,696,N/A,88,4
3,N/A,N/A,N/A,690,693,N/A,94,4
2,N/A,N/A,N/A,688,690,N/A,98,2
1,N/A,N/A,N/A,687,688,N/A,103,1
2,N/A,N/A,N/A,685,687,N/A,109,1
1,N/A,N/A,N/A,684,685,N/A,115,1
6,N/A,N/A,N/A,678,684,N/A,120,6
6,N/A,N/A,N/A,672,678,N/A,125,5
3,N/A,N/A,N/A,669,672,N/A,130,4
1,N/A,N/A,N/A,668,669,N/A,133,1
5,N/A,N/A,N/A,663,668,N/A,137,5
3,N/A,N/A,N/A,660,663,N/A,140,2
4,N/A,N/A,N/A,569,573,N/A,5,4
2,N/A,N/A,N/A,567,569,N/A,10,3
2,N/A,N/A,N/A,565,567,N/A,15,2
3,N/A,N/A,N/A,562,565,N/A,21,2
6,N/A,N/A,N/A,556,562,N/A,25,6
3,N/A,N/A,N/A,553,556,N/A,28,3
1,N/A,N/A,N/A,552,553,N/A,32,1
6,N/A,N/A,N/A,546,552,N/A,36,5
3,N/A,N/A,N/A,543,546,N/A,41,4
3,N/A,N/A,N/A,540,543,N/A,47,4
4,N/A,N/A,N/A,536,540,N/A,53,4
2,N/A,N/A,N/A,534,536,N/A,58,3
2,N/A,N/A,N/A,532,534,N/A,63,2
2,N/A,N/A,N/A,530,532,N/A,69,2
6,N/A,N/A,N/A,524,530,N/A,72,5
5,N/A,N/A,N/A,519,524,N/A,78,5
5,N/A,N/A,N/A,514,519,N/A,84,5
5,N/A,N/A,N/A,509,514,N/A,90,5
3,N/A,N/A,N/A,506,509,N/A,94,3
2,N/A,N/A,N/A,504,506,N/A,98,1
6,N/A,N/A,N/A,498,504,N/A,102,5
5,N/A,N/A,N/A,493,498,N/A,108,5
3,N/A,N/A,N/A,490,493,N/A,113,4
4,N/A,N/A,N/A,486,490,N/A,119,4
2,N/A,N/A,N/A,484,486,N/A,124,3
2,N/A,N/A,N/A,482,484,N/A,129,2
5,N/A,N/A,N/A,477,482,N/A,132,5
2,N/A,N/A,N/A,475,477,N/A,136,3
7,N/A,N/A,N/A,468,475,N/A,139,6
2,N/A,N/A,N/A,466,468,N/A,145,0
2,N/A,N/A,N/A,1739,1741,N/A,5,2
5,N/A,N/A,N/A,1734,1739,N/A,8,5
6,N/A,N/A,N/A,1728,1734,N/A,14,5
4,N/A,N/A,N/A,1724,1728,N/A,19,4
2,N/A,N/A,N/A,1722,1724,N/A,23,2
1,N/A,N/A,N/A,1721,1722,N/A,28,1
1,N/A,N/A,N/A,1720,1721,N/A,34,1
5,N/A,N/A,N/A,1715,1720,N/A,38,5
5,N/A,N/A,N/A,1710,1715,N/A,44,5
3,N/A,N/A,N/A,1707,1710,N/A,49,4
3,N/A,N/A,N/A,1704,1707,N/A,55,4
3,N/A,N/A,N/A,1701,1704,N/A,59,2
2,N/A,N/A,N/A,1699,1701,N/A,65,2
6,N/A,N/A,N/A,1693,1699,N/A,68,5
2,N/A,N/A,N/A,1691,1693,N/A,72,3
1,N/A,N/A,N/A,1690,1691,N/A,76,1
6,N/A,N/A,N/A,1684,1690,N/A,81,6
5,N/A,N/A,N/A,1679,1684,N/A,86,5
3,N/A,N/A,N/A,1676,1679,N/A,91,4
3,N/A,N/A,N/A,1673,1676,N/A,96,3
2,N/A,N/A,N/A,1671,1673,N/A,101,2
3,N/A,N/A,N/A,1668,1671,N/A,107,2
2,N/A,N/A,N/A,1666,1668,N/A,113,2
7,N/A,N/A,N/A,1659,1666,N/A,117,6
6,N/A,N/A,N/A,1653,1659,N/A,122,5
2,N/A,N/A,N/A,1651,1653,N/A,126,3
7,N/A,N/A,N/A,1644,1651,N/A,129,6
4,N/A,N/A,N/A,1640,1644,N/A,133,4
3,N/A,N/A,N/A,1637,1640,N/A,138,3
3,N/A,N/A,N/A,1634,1637,N/A,144,3
6,N/A,N/A,N/A,1252,1258,N/A,3,5
5,N/A,N/A,N/A,1247,1252,N/A,9,5
6,N/A,N/A,N/A,1241,1247,N/A,15,5
6,N/A,N/A,N/A,1235,1241,N/A,21,5
2,N/A,N/A,N/A,1233,1235,N/A,25,3
2,N/A,N/A,N/A,1231,1233,N/A,30,2
6,N/A,N/A,N/A,1225,1231,N/A,33,5
2,N/A,N/A,N/A,1223,1225,N/A,36,2
7,N/A,N/A,N/A,1216,1223,N/A,40,6
1,N/A,N/A,N/A,1215,1216,N/A,46,0
3,N/A,N/A,N/A,1212,1215,N/A,50,4
2,N/A,N/A,N/A,1210,1212,N/A,54,2
6,N/A,N/A,N/A,1204,1210,N/A,58,6
3,N/A,N/A,N/A,1201,1204,N/A,61,3
7,N/A,N/A,N/A,1194,1201,N/A,64,6
1,N/A,N/A,N/A,1193,1194,N/A,70,0
6,N/A,N/A,N/A,1187,1193,N/A,75,5
5,N/A,N/A,N/A,1182,1187,N/A,81,5
4,N/A,N/A,N/A,1178,1182,N/A,86,4
3,N/A,N/A,N/A,1175,1178,N/A,90,2
7,N/A,N/A,N/A,1168,1175,N/A,94,6
6,N/A,N/A,N/A,1162,1168,N/A,99,5
5,N/A,N/A,N/A,1157,1162,N/A,105,5
2,N/A,N/A,N/A,1155,1157,N/A,108,2
6,N/A,N/A,N/A,1149,1155,N/A,111,5
3,N/A,N/A,N/A,1146,1149,N/A,114,2
6,N/A,N/A,N/A,1140,1146,N/A,117,5
3,N/A,N/A,N/A,1137,1140,N/A,120,2
2,N/A,N/A,N/A,1135,1137,N/A,125,1
6,N/A,N/A,N/A,1129,1135,N/A,130,6
3,N/A,N/A,N/A,1353,1356,N/A,4,2
6,N/A,N/A,N/A,1347,1353,N/A,7,5
5,N/A,N/A,N/A,1342,1347,N/A,13,5
3,N/A,N/A,N/A,1339,1342,N/A,16,2
3,N/A,N/A,N/A,1336,1339,N/A,22,2
3,N/A,N/A,N/A,1333,1336,N/A,28,2
2,N/A,N/A,N/A,1331,1333,N/A,33,1
3,N/A,N/A,N/A,1328,1331,N/A,36,4
1,N/A,N/A,N/A,1327,1328,N/A,39,1
1,N/A,N/A,N/A,1326,1327,N/A,45,1
2,N/A,N/A,N/A,1324,1326,N/A,51,1
7,N/A,N/A,N/A,1317,1324,N/A,56,6
2,N/A,N/A,N/A,1315,1317,N/A,59,3
2,N/A,N/A,N/A,1313,1315,N/A,64,2
2,N/A,N/A,N/A,1311,1313,N/A,70,2
7,N/A,N/A,N/A,1304,1311,N/A,74,6
3,N/A,N/A,N/A,1301,1304,N/A,77,3
2,N/A,N/A,N/A,1299,1301,N/A,82,2
1,N/A,N/A,N/A,1298,1299,N/A,87,1
2,N/A,N/A,N/A,1296,1298,N/A,93,1
6,N/A,N/A,N/A,1290,1296,N/A,98,6
2,N/A,N/A,N/A,1288,1290,N/A,101,3
6,N/A,N/A,N/A,1282,1288,N/A,104,6
5,N/A,N/A,N/A,1277,1282,N/A,109,5
4,N/A,N/A,N/A,1273,1277,N/A,114,4
3,N/A,N/A,N/A,1270,1273,N/A,118,2
6,N/A,N/A,N/A,1264,1270,N/A,121,5
2,N/A,N/A,N/A,1262,1264,N/A,124,2
2,N/A,N/A,N/A,1260,1262,N/A,129,1
7,N/A,N/A,N/A,1253,1260,N/A,134,6
5,N/A,N/A,N/A,1945,1950,N/A,4,5
4,N/A,N/A,N/A,1941,1945,N/A,9,4
4,N/A,N/A,N/A,1937,1941,N/A,15,4
1,N/A,N/A,N/A,1936,1937,N/A,18,1
3,N/A,N/A,N/A,1933,1936,N/A,21,4
2,N/A,N/A,N/A,1931,1933,N/A,24,1
4,N/A,N/A,N/A,1927,1931,N/A,27,4
1,N/A,N/A,N/A,1926,1927,N/A,30,1
5,N/A,N/A,N/A,1921,1926,N/A,34,5
5,N/A,N/A,N/A,1916,1921,N/A,40,5
3,N/A,N/A,N/A,1913,1916,N/A,43,2
2,N/A,N/A,N/A,1911,1913,N/A,49,2
6,N/A,N/A,N/A,1905,1911,N/A,53,6
4,N/A,N/A,N/A,1901,1905,N/A,57,4
2,N/A,N/A,N/A,1899,1901,N/A,61,2
2,N/A,N/A,N/A,1897,1899,N/A,66,1
5,N/A,N/A,N/A,1892,1897,N/A,70,5
3,N/A,N/A,N/A,1889,1892,N/A,74,3
1,N/A,N/A,N/A,1888,1889,N/A,78,1
1,N/A,N/A,N/A,1887,1888,N/A,84,1
5,N/A,N/A,N/A,1882,1887,N/A,88,5
2,N/A,N/A,N/A,1880,1882,N/A,91,2
7,N/A,N/A,N/A,1873,1880,N/A,95,6
2,N/A,N/A,N/A,1871,1873,N/A,98,3
2,N/A,N/A,N/A,1869,1871,N/A,103,2
6,N/A,N/A,N/A,1863,1869,N/A,107,6
1,N/A,N/A,N/A,1862,1863,N/A,113,0
6,N/A,N/A,N/A,1856,1862,N/A,118,5
5,N/A,N/A,N/A,1851,1856,N/A,124,5
4,N/A,N/A,N/A,1847,1851,N/A,129,4
1,N/A,N/A,N/A,1609,1610,N/A,3,1
6,N/A,N/A,N/A,1603,1609,N/A,7,5
3,N/A,N/A,N/A,1600,1603,N/A,12,4
1,N/A,N/A,N/A,1599,1600,N/A,15,1
1,N/A,N/A,N/A,1598,1599,N/A,21,1
6,N/A,N/A,N/A,1592,1598,N/A,25,5
3,N/A,N/A,N/A,1589,1592,N/A,30,4
1,N/A,N/A,N/A,1588,1589,N/A,33,1
7,N/A,N/A,N/A,1581,1588,N/A,38,6
2,N/A,N/A,N/A,1579,1581,N/A,41,3
7,N/A,N/A,N/A,1572,1579,N/A,44,6
3,N/A,N/A,N/A,1569,1572,N/A,48,4
2,N/A,N/A,N/A,1567,1569,N/A,51,1
6,N/A,N/A,N/A,1561,1567,N/A,56,6
3,N/A,N/A,N/A,1558,1561,N/A,60,4
3,N/A,N/A,N/A,1555,1558,N/A,64,2
1,N/A,N/A,N/A,1554,1555,N/A,69,1
1,N/A,N/A,N/A,1553,1554,N/A,75,1
7,N/A,N/A,N/A,1546,1553,N/A,80,6
3,N/A,N/A,N/A,1543,1546,N/A,84,4
1,N/A,N/A,N/A,1542,1543,N/A,87,1
5,N/A,N/A,N/A,1537,1542,N/A,91,5
4,N/A,N/A,N/A,1533,1537,N/A,96,4
2,N/A,N/A,N/A,1531,1533,N/A,100,2
6,N/A,N/A,N/A,1525,1531,N/A,103,5
2,N/A,N/A,N/A,1523,1525,N/A,106,2
2,N/A,N/A,N/A,1521,1523,N/A,111,1
7,N/A,N/A,N/A,1514,1521,N/A,116,6
6,N/A,N/A,N/A,1508,1514,N/A,121,5
3,N/A,N/A,N/A,1505,1508,N/A,124,2
6,N/A,N/A,N/A,1664,1670,N/A,4,5
2,N/A,N/A,N/A,1662,1664,N/A,8,3
2,N/A,N/A,N/A,1660,1662,N/A,13,2
2,N/A,N/A,N/A,1658,1660,N/A,19,2
3,N/A,N/A,N/A,1655,1658,N/A,25,2
2,N/A,N/A,N/A,1653,1655,N/A,31,2
2,N/A,N/A,N/A,1651,1653,N/A,36,1
3,N/A,N/A,N/A,1648,1651,N/A,39,4
2,N/A,N/A,N/A,1646,1648,N/A,43,2
6,N/A,N/A,N/A,1640,1646,N/A,46,5
3,N/A,N/A,N/A,1637,1640,N/A,51,4
2,N/A,N/A,N/A,1635,1637,N/A,55,2
5,N/A,N/A,N/A,1630,1635,N/A,58,5
6,N/A,N/A,N/A,1624,1630,N/A,64,5
3,N/A,N/A,N/A,1621,1624,N/A,67,2
3,N/A,N/A,N/A,1618,1621,N/A,73,2
2,N/A,N/A,N/A,1616,1618,N/A,78,1
1,N/A,N/A,N/A,1615,1616,N/A,84,1
3,N/A,N/A,N/A,1612,1615,N/A,87,4
3,N/A,N/A,N/A,1609,1612,N/A,91,2
2,N/A,N/A,N/A,1607,1609,N/A,96,1
5,N/A,N/A,N/A,1602,1607,N/A,100,5
3,N/A,N/A,N/A,1599,1602,N/A,105,4
2,N/A,N/A,N/A,1597,1599,N/A,109,2
2,N/A,N/A,N/A,1595,1597,N/A,114,1
6,N/A,N/A,N/A,1589,1595,N/A,119,6
2,N/A,N/A,N/A,1587,1589,N/A,122,3
3,N/A,N/A,N/A,1584,1587,N/A,127,2
1,N/A,N/A,N/A,1583,1584,N/A,132,1
2,N/A,N/A,N/A,1581,1583,N/A,138,1
3,N/A,N/A,N/A,1398,1401,N/A,5,2
7,N/A,N/A,N/A,1391,1398,N/A,9,6
2,N/A,N/A,N/A,1389,1391,N/A,15,0
3,N/A,N/A,N/A,1386,1389,N/A,19,4
2,N/A,N/A,N/A,1384,1386,N/A,23,2
2,N/A,N/A,N/A,1382,1384,N/A,29,2
2,N/A,N/A,N/A,1380,1382,N/A,35,2
2,N/A,N/A,N/A,1378,1380,N/A,40,1
1,N/A,N/A,N/A,1377,1378,N/A,46,1
3,N/A,N/A,N/A,1374,1377,N/A,49,4
2,N/A,N/A,N/A,1372,1374,N/A,52,1
6,N/A,N/A,N/A,1366,1372,N/A,57,6
3,N/A,N/A,N/A,1363,1366,N/A,61,4
2,N/A,N/A,N/A,1361,1363,N/A,65,2
2,N/A,N/A,N/A,1359,1361,N/A,71,2
1,N/A,N/A,N/A,1358,1359,N/A,76,1
2,N/A,N/A,N/A,1356,1358,N/A,82,1
1,N/A,N/A,N/A,1355,1356,N/A,88,1
6,N/A,N/A,N/A,1349,1355,N/A,93,6
3,N/A,N/A,N/A,1346,1349,N/A,96,3
6,N/A,N/A,N/A,1340,1346,N/A,99,6
2,N/A,N/A,N/A,1338,1340,N/A,105,0
7,N/A,N/A,N/A,1331,1338,N/A,111,6
2,N/A,N/A,N/A,1329,1331,N/A,117,0
6,N/A,N/A,N/A,1323,1329,N/A,122,5
6,N/A,N/A,N/A,1317,1323,N/A,128,5
3,N/A,N/A,N/A,1314,1317,N/A,132,3
2,N/A,N/A,N/A,1312,1314,N/A,138,3
7,N/A,N/A,N/A,1305,1312,N/A,141,6
6,N/A,N/A,N/A,1299,1305,N/A,146,5
2,N/A,N/A,N/A,1848,1850,N/A,5,3
3,N/A,N/A,N/A,1845,1848,N/A,11,3
2,N/A,N/A,N/A,1843,1845,N/A,16,2
5,N/A,N/A,N/A,1838,1843,N/A,19,5
5,N/A,N/A,N/A,1833,1838,N/A,25,5
3,N/A,N/A,N/A,1830,1833,N/A,28,2
2,N/A,N/A,N/A,1828,1830,N/A,33,1
2,N/A,N/A,N/A,1826,1828,N/A,39,1
5,N/A,N/A,N/A,1821,1826,N/A,43,5
3,N/A,N/A,N/A,1818,1821,N/A,48,4
4,N/A,N/A,N/A,1814,1818,N/A,54,4
1,N/A,N/A,N/A,1813,1814,N/A,57,1
7,N/A,N/A,N/A,1806,1813,N/A,62,6
3,N/A,N/A,N/A,1803,1806,N/A,65,3
6,N/A,N/A,N/A,1797,1803,N/A,68,6
3,N/A,N/A,N/A,1794,1797,N/A,72,4
3,N/A,N/A,N/A,1791,1794,N/A,76,2
2,N/A,N/A,N/A,1789,1791,N/A,82,2
2,N/A,N/A,N/A,1787,1789,N/A,87,1
7,N/A,N/A,N/A,1780,1787,N/A,92,6
3,N/A,N/A,N/A,1777,1780,N/A,95,3
6,N/A,N/A,N/A,1771,1777,N/A,98,6
3,N/A,N/A,N/A,1768,1771,N/A,101,3
3,N/A,N/A,N/A,1765,1768,N/A,107,3
7,N/A,N/A,N/A,1758,1765,N/A,110,6
6,N/A,N/A,N/A,1752,1758,N/A,115,5
4,N/A,N/A,N/A,1748,1752,N/A,120,4
2,N/A,N/A,N/A,1746,1748,N/A,123,1
2,N/A,N/A,N/A,1744,1746,N/A,129,1
6,N/A,N/A,N/A,1738,1744,N/A,133,5
2,N/A,N/A,N/A,1253,1255,N/A,5,2
6,N/A,N/A,N/A,1247,1253,N/A,8,5
3,N/A,N/A,N/A,1244,1247,N/A,11,2
7,N/A,N/A,N/A,1237,1244,N/A,15,6
5,N/A,N/A,N/A,1232,1237,N/A,20,5
2,N/A,N/A,N/A,1230,1232,N/A,23,2
6,N/A,N/A,N/A,1224,1230,N/A,27,6
2,N/A,N/A,N/A,1222,1224,N/A,33,0
6,N/A,N/A,N/A,1216,1222,N/A,38,5
2,N/A,N/A,N/A,1214,1216,N/A,41,2
5,N/A,N/A,N/A,1209,1214,N/A,44,5
3,N/A,N/A,N/A,1206,1209,N/A,48,3
7,N/A,N/A,N/A,1199,1206,N/A,51,6
1,N/A,N/A,N/A,1198,1199,N/A,57,0
4,N/A,N/A,N/A,1194,1198,N/A,61,4
4,N/A,N/A,N/A,1190,1194,N/A,67,4
3,N/A,N/A,N/A,1187,1190,N/A,72,3
3,N/A,N/A,N/A,1184,1187,N/A,78,3
2,N/A,N/A,N/A,1182,1184,N/A,82,1
7,N/A,N/A,N/A,1175,1182,N/A,87,6
2,N/A,N/A,N/A,1173,1175,N/A,90,3
2,N/A,N/A,N/A,1171,1173,N/A,95,2
6,N/A,N/A,N/A,1165,1171,N/A,99,6
5,N/A,N/A,N/A,1160,1165,N/A,104,5
3,N/A,N/A,N/A,1157,1160,N/A,107,2
6,N/A,N/A,N/A,1151,1157,N/A,110,5
4,N/A,N/A,N/A,1147,1151,N/A,115,4
2,N/A,N/A,N/A,1145,1147,N/A,120,3
6,N/A,N/A,N/A,1139,1145,N/A,123,6
4,N/A,N/A,N/A,1135,1139,N/A,127,4
3,N/A,N/A,N/A,1956,1959,N/A,4,2
1,N/A,N/A,N/A,1955,1956,N/A,9,1
6,N/A,N/A,N/A,1949,1955,N/A,14,6
3,N/A,N/A,N/A,1946,1949,N/A,17,3
1,N/A,N/A,N/A,1945,1946,N/A,21,1
6,N/A,N/A,N/A,1939,1945,N/A,26,6
4,N/A,N/A,N/A,1935,1939,N/A,30,4
3,N/A,N/A,N/A,1932,1935,N/A,36,4
2,N/A,N/A,N/A,1930,1932,N/A,40,2
6,N/A,N/A,N/A,1924,1930,N/A,43,5
2,N/A,N/A,N/A,1922,1924,N/A,46,2
5,N/A,N/A,N/A,1917,1922,N/A,49,5
6,N/A,N/A,N/A,1911,1917,N/A,55,5
2,N/A,N/A,N/A,1909,1911,N/A,59,3
7,N/A,N/A,N/A,1902,1909,N/A,62,6
6,N/A,N/A,N/A,1896,1902,N/A,67,5
2,N/A,N/A,N/A,1894,1896,N/A,71,3
7,N/A,N/A,N/A,1887,1894,N/A,74,6
3,N/A,N/A,N/A,1884,1887,N/A,78,4
1,N/A,N/A,N/A,1883,1884,N/A,81,1
6,N/A,N/A,N/A,1877,1883,N/A,86,6
3,N/A,N/A,N/A,1874,1877,N/A,90,4
2,N/A,N/A,N/A,1872,1874,N/A,94,2
6,N/A,N/A,N/A,1866,1872,N/A,98,6
2,N/A,N/A,N/A,1864,1866,N/A,101,3
3,N/A,N/A,N/A,1861,1864,N/A,106,2
7,N/A,N/A,N/A,1854,1861,N/A,110,6
3,N/A,N/A,N/A,1851,1854,N/A,113,3
3,N/A,N/A,N/A,1848,1851,N/A,118,2
7,N/A,N/A,N/A,1841,1848,N/A,122,6
6,N/A,N/A,N/A,1036,1042,N/A,3,6
2,N/A,N/A,N/A,1034,1036,N/A,9,0
7,N/A,N/A,N/A,1027,1034,N/A,15,6
3,N/A,N/A,N/A,1024,1027,N/A,18,3
6,N/A,N/A,N/A,1018,1024,N/A,21,6
1,N/A,N/A,N/A,1017,1018,N/A,27,0
4,N/A,N/A,N/A,1013,1017,N/A,31,4
2,N/A,N/A,N/A,1011,1013,N/A,34,1
6,N/A,N/A,N/A,1005,1011,N/A,38,5
3,N/A,N/A,N/A,1002,1005,N/A,43,4
4,N/A,N/A,N/A,998,1002,N/A,49,4
1,N/A,N/A,N/A,997,998,N/A,52,1
7,N/A,N/A,N/A,990,997,N/A,57,6
2,N/A,N/A,N/A,988,990,N/A,63,0
3,N/A,N/A,N/A,985,988,N/A,67,4
1,N/A,N/A,N/A,984,985,N/A,70,1
7,N/A,N/A,N/A,977,984,N/A,75,6
5,N/A,N/A,N/A,972,977,N/A,80,5
2,N/A,N/A,N/A,970,972,N/A,84,3
2,N/A,N/A,N/A,968,970,N/A,89,2
6,N/A,N/A,N/A,962,968,N/A,92,5
3,N/A,N/A,N/A,959,962,N/A,95,2
5,N/A,N/A,N/A,954,959,N/A,98,5
4,N/A,N/A,N/A,950,954,N/A,103,4
3,N/A,N/A,N/A,947,950,N/A,108,3
1,N/A,N/A,N/A,946,947,N/A,112,1
2,N/A,N/A,N/A,944,946,N/A,118,1
2,N/A,N/A,N/A,942,944,N/A,124,1
4,N/A,N/A,N/A,938,942,N/A,127,4
2,N/A,N/A,N/A,936,938,N/A,132,3
3,N/A,N/A,N/A,839,842,N/A,6,4
4,N/A,N/A,N/A,835,839,N/A,12,4
3,N/A,N/A,N/A,832,835,N/A,16,2
5,N/A,N/A,N/A,827,832,N/A,19,5
3,N/A,N/A,N/A,824,827,N/A,24,4
2,N/A,N/A,N/A,822,824,N/A,28,2
3,N/A,N/A,N/A,819,822,N/A,34,2
6,N/A,N/A,N/A,813,819,N/A,37,5
2,N/A,N/A,N/A,811,813,N/A,41,3
3,N/A,N/A,N/A,808,811,N/A,46,2
3,N/A,N/A,N/A,805,808,N/A,52,2
5,N/A,N/A,N/A,800,805,N/A,55,5
6,N/A,N/A,N/A,794,800,N/A,61,5
5,N/A,N/A,N/A,789,794,N/A,67,5
3,N/A,N/A,N/A,786,789,N/A,72,4
3,N/A,N/A,N/A,783,786,N/A,76,2
6,N/A,N/A,N/A,777,783,N/A,79,5
6,N/A,N/A,N/A,771,777,N/A,85,5
2,N/A,N/A,N/A,769,771,N/A,89,3
7,N/A,N/A,N/A,762,769,N/A,92,6
5,N/A,N/A,N/A,757,762,N/A,97,5
6,N/A,N/A,N/A,751,757,N/A,103,5
4,N/A,N/A,N/A,747,751,N/A,108,4
2,N/A,N/A,N/A,745,747,N/A,113,3
6,N/A,N/A,N/A,739,745,N/A,116,6
5,N/A,N/A,N/A,734,739,N/A,121,5
3,N/A,N/A,N/A,731,734,N/A,124,2
7,N/A,N/A,N/A,724,731,N/A,128,6
1,N/A,N/A,N/A,723,724,N/A,134,0
4,N/A,N/A,N/A,719,723,N/A,138,4
1,N/A,N/A,N/A,780,781,N/A,4,1
2,N/A,N/A,N/A,778,780,N/A,10,1
3,N/A,N/A,N/A,775,778,N/A,13,4
2,N/A,N/A,N/A,773,775,N/A,17,2
1,N/A,N/A,N/A,772,773,N/A,22,1
5,N/A,N/A,N/A,767,772,N/A,26,5
5,N/A,N/A,N/A,762,767,N/A,32,5
5,N/A,N/A,N/A,757,762,N/A,38,5
3,N/A,N/A,N/A,754,757,N/A,42,3
3,N/A,N/A,N/A,751,754,N/A,48,3
2,N/A,N/A,N/A,749,751,N/A,54,3
2,N/A,N/A,N/A,747,749,N/A,59,2
3,N/A,N/A,N/A,744,747,N/A,65,2
6,N/A,N/A,N/A,738,744,N/A,69,6
3,N/A,N/A,N/A,735,738,N/A,72,3
2,N/A,N/A,N/A,733,735,N/A,78,3
2,N/A,N/A,N/A,731,733,N/A,84,3
7,N/A,N/A,N/A,724,731,N/A,87,6
1,N/A,N/A,N/A,723,724,N/A,93,0
7,N/A,N/A,N/A,716,723,N/A,99,6
1,N/A,N/A,N/A,715,716,N/A,105,0
7,N/A,N/A,N/A,708,715,N/A,111,6
3,N/A,N/A,N/A,705,708,N/A,114,3
2,N/A,N/A,N/A,703,705,N/A,118,1
6,N/A,N/A,N/A,697,703,N/A,122,5
3,N/A,N/A,N/A,694,697,N/A,127,4
3,N/A,N/A,N/A,691,694,N/A,133,4
1,N/A,N/A,N/A,690,691,N/A,136,1
7,N/A,N/A,N/A,683,690,N/A,141,6
5,N/A,N/A,N/A,678,683,N/A,146,5
3,N/A,N/A,N/A,1185,1188,N/A,5,3
1,N/A,N/A,N/A,1184,1185,N/A,9,1
7,N/A,N/A,N/A,1177,1184,N/A,14,6
4,N/A,N/A,N/A,1173,1177,N/A,18,4
2,N/A,N/A,N/A,1171,1173,N/A,21,1
1,N/A,N/A,N/A,1170,1171,N/A,27,1
6,N/A,N/A,N/A,1164,1170,N/A,31,5
3,N/A,N/A,N/A,1161,1164,N/A,36,4
4,N/A,N/A,N/A,1157,1161,N/A,42,4
1,N/A,N/A,N/A,1156,1157,N/A,45,1
4,N/A,N/A,N/A,1152,1156,N/A,48,4
3,N/A,N/A,N/A,1149,1152,N/A,54,4
1,N/A,N/A,N/A,1148,1149,N/A,57,1
2,N/A,N/A,N/A,1146,1148,N/A,63,1
6,N/A,N/A,N/A,1140,1146,N/A,68,6
2,N/A,N/A,N/A,1138,1140,N/A,71,3
6,N/A,N/A,N/A,1132,1138,N/A,74,6
3,N/A,N/A,N/A,1129,1132,N/A,78,4
1,N/A,N/A,N/A,1128,1129,N/A,81,1
7,N/A,N/A,N/A,1121,1128,N/A,86,6
5,N/A,N/A,N/A,1116,1121,N/A,91,5
3,N/A,N/A,N/A,1113,1116,N/A,96,4
2,N/A,N/A,N/A,1111,1113,N/A,100,2
2,N/A,N/A,N/A,1109,1111,N/A,105,1
6,N/A,N/A,N/A,1103,1109,N/A,110,6
2,N/A,N/A,N/A,1101,1103,N/A,116,0
5,N/A,N/A,N/A,1096,1101,N/A,121,5
2,N/A,N/A,N/A,1094,1096,N/A,125,3
3,N/A,N/A,N/A,1091,1094,N/A,131,3
3,N/A,N/A,N/A,1088,1091,N/A,137,3
2,N/A,N/A,N/A,1272,1274,N/A,6,3
7,N/A,N/A,N/A,1265,1272,N/A,9,6
1,N/A,N/A,N/A,1264,1265,N/A,15,0
7,N/A,N/A,N/A,1257,1264,N/A,21,6
6,N/A,N/A,N/A,1251,1257,N/A,26,5
5,N/A,N/A,N/A,1246,1251,N/A,32,5
3,N/A,N/A,N/A,1243,1246,N/A,35,2
3,N/A,N/A,N/A,1240,1243,N/A,41,2
2,N/A,N/A,N/A,1238,1240,N/A,47,2
7,N/A,N/A,N/A,1231,1238,N/A,51,6
3,N/A,N/A,N/A,1228,1231,N/A,55,4
3,N/A,N/A,N/A,1225,1228,N/A,59,2
2,N/A,N/A,N/A,1223,1225,N/A,65,2
1,N/A,N/A,N/A,1222,1223,N/A,70,1
5,N/A,N/A,N/A,1217,1222,N/A,74,5
2,N/A,N/A,N/A,1215,1217,N/A,78,3
2,N/A,N/A,N/A,1213,1215,N/A,84,3
2,N/A,N/A,N/A,1211,1213,N/A,89,2
1,N/A,N/A,N/A,1210,1211,N/A,94,1
5,N/A,N/A,N/A,1205,1210,N/A,98,5
3,N/A,N/A,N/A,1202,1205,N/A,101,2
2,N/A,N/A,N/A,1200,1202,N/A,107,2
7,N/A,N/A,N/A,1193,1200,N/A,111,6
1,N/A,N/A,N/A,1192,1193,N/A,117,0
5,N/A,N/A,N/A,1187,1192,N/A,122,5
3,N/A,N/A,N/A,1184,1187,N/A,126,3
3,N/A,N/A,N/A,1181,1184,N/A,132,3
7,N/A,N/A,N/A,1174,1181,N/A,135,6
3,N/A,N/A,N/A,1171,1174,N/A,139,4
2,N/A,N/A,N/A,1169,1171,N/A,142,1
1,N/A,N/A,N/A,646,647,N/A,3,1
3,N/A,N/A,N/A,643,646,N/A,6,4
4,N/A,N/A,N/A,639,643,N/A,12,4
2,N/A,N/A,N/A,637,639,N/A,15,1
6,N/A,N/A,N/A,631,637,N/A,19,5
2,N/A,N/A,N/A,629,631,N/A,23,3
2,N/A,N/A,N/A,627,629,N/A,29,3
2,N/A,N/A,N/A,625,627,N/A,35,3
1,N/A,N/A,N/A,624,625,N/A,39,1
7,N/A,N/A,N/A,617,624,N/A,44,6
3,N/A,N/A,N/A,614,617,N/A,48,4
2,N/A,N/A,N/A,612,614,N/A,51,1
2,N/A,N/A,N/A,610,612,N/A,57,1
7,N/A,N/A,N/A,603,610,N/A,62,6
4,N/A,N/A,N/A,599,603,N/A,66,4
4,N/A,N/A,N/A,595,599,N/A,72,4
3,N/A,N/A,N/A,592,595,N/A,76,2
3,N/A,N/A,N/A,589,592,N/A,82,2
5,N/A,N/A,N/A,584,589,N/A,85,5
2,N/A,N/A,N/A,582,584,N/A,89,3
3,N/A,N/A,N/A,579,582,N/A,95,3
1,N/A,N/A,N/A,578,579,N/A,99,1
5,N/A,N/A,N/A,573,578,N/A,103,5
2,N/A,N/A,N/A,571,573,N/A,107,3
3,N/A,N/A,N/A,568,571,N/A,112,2
6,N/A,N/A,N/A,562,568,N/A,115,5
2,N/A,N/A,N/A,560,562,N/A,118,2
1,N/A,N/A,N/A,559,560,N/A,123,1
7,N/A,N/A,N/A,552,559,N/A,128,6
4,N/A,N/A,N/A,548,552,N/A,132,4
4,N/A,N/A,N/A,459,463,N/A,4,4
2,N/A,N/A,N/A,457,459,N/A,8,2
6,N/A,N/A,N/A,451,457,N/A,12,6
3,N/A,N/A,N/A,448,451,N/A,16,4
2,N/A,N/A,N/A,446,448,N/A,21,3
1,N/A,N/A,N/A,445,446,N/A,25,1
6,N/A,N/A,N/A,439,445,N/A,30,6
2,N/A,N/A,N/A,437,439,N/A,33,3
2,N/A,N/A,N/A,435,437,N/A,37,1
2,N/A,N/A,N/A,433,435,N/A,43,1
6,N/A,N/A,N/A,427,433,N/A,48,6
3,N/A,N/A,N/A,424,427,N/A,51,3
3,N/A,N/A,N/A,421,424,N/A,57,3
2,N/A,N/A,N/A,419,421,N/A,63,3
2,N/A,N/A,N/A,417,419,N/A,68,2
6,N/A,N/A,N/A,411,417,N/A,72,6
2,N/A,N/A,N/A,409,411,N/A,78,0
6,N/A,N/A,N/A,403,409,N/A,83,5
2,N/A,N/A,N/A,401,403,N/A,87,3
7,N/A,N/A,N/A,394,401,N/A,90,6
4,N/A,N/A,N/A,390,394,N/A,94,4
2,N/A,N/A,N/A,388,390,N/A,97,1
3,N/A,N/A,N/A,385,388,N/A,100,4
4,N/A,N/A,N/A,381,385,N/A,106,4
3,N/A,N/A,N/A,378,381,N/A,112,4
2,N/A,N/A,N/A,376,378,N/A,115,1
3,N/A,N/A,N/A,373,376,N/A,118,4
4,N/A,N/A,N/A,369,373,N/A,124,4
3,N/A,N/A,N/A,366,369,N/A,129,3
3,N/A,N/A,N/A,363,366,N/A,135,3
2,N/A,N/A,N/A,1892,1894,N/A,3,2
5,N/A,N/A,N/A,1887,1892,N/A,6,5
3,N/A,N/A,N/A,1884,1887,N/A,11,4
3,N/A,N/A,N/A,1881,1884,N/A,17,4
3,N/A,N/A,N/A,1878,1881,N/A,23,4
4,N/A,N/A,N/A,1874,1878,N/A,29,4
4,N/A,N/A,N/A,1870,1874,N/A,35,4
2,N/A,N/A,N/A,1868,1870,N/A,40,3
3,N/A,N/A,N/A,1865,1868,N/A,45,2
2,N/A,N/A,N/A,1863,1865,N/A,50,1
5,N/A,N/A,N/A,1858,1863,N/A,54,5
2,N/A,N/A,N/A,1856,1858,N/A,58,3
3,N/A,N/A,N/A,1853,1856,N/A,63,2
7,N/A,N/A,N/A,1846,1853,N/A,67,6
6,N/A,N/A,N/A,1840,1846,N/A,72,5
6,N/A,N/A,N/A,1834,1840,N/A,78,5
3,N/A,N/A,N/A,1831,1834,N/A,81,2
1,N/A,N/A,N/A,1830,1831,N/A,86,1
7,N/A,N/A,N/A,1823,1830,N/A,91,6
5,N/A,N/A,N/A,1818,1823,N/A,96,5
3,N/A,N/A,N/A,1815,1818,N/A,99,2
6,N/A,N/A,N/A,1809,1815,N/A,103,6
4,N/A,N/A,N/A,1805,1809,N/A,107,4
3,N/A,N/A,N/A,1802,1805,N/A,112,3
2,N/A,N/A,N/A,1800,1802,N/A,118,3
1,N/A,N/A,N/A,1799,1800,N/A,122,1
2,N/A,N/A,N/A,1797,1799,N/A,128,1
4,N/A,N/A,N/A,1793,1797,N/A,131,4
3,N/A,N/A,N/A,1790,1793,N/A,136,3
2,N/A,N/A,N/A,1788,1790,N/A,141,2
6,N/A,N/A,N/A,1921,1927,N/A,6,5
3,N/A,N/A,N/A,1918,1921,N/A,11,4
3,N/A,N/A,N/A,1915,1918,N/A,17,4
3,N/A,N/A,N/A,1912,1915,N/A,23,4
3,N/A,N/A,N/A,1909,1912,N/A,29,4
2,N/A,N/A,N/A,1907,1909,N/A,34,3
3,N/A,N/A,N/A,1904,1907,N/A,39,2
2,N/A,N/A,N/A,1902,1904,N/A,44,1
3,N/A,N/A,N/A,1899,1902,N/A,47,4
3,N/A,N/A,N/A,1896,1899,N/A,52,3
3,N/A,N/A,N/A,1893,1896,N/A,57,2
6,N/A,N/A,N/A,1887,1893,N/A,61,6
4,N/A,N/A,N/A,1883,1887,N/A,65,4
2,N/A,N/A,N/A,1881,1883,N/A,68,1
7,N/A,N/A,N/A,1874,1881,N/A,73,6
2,N/A,N/A,N/A,1872,1874,N/A,79,0
2,N/A,N/A,N/A,1870,1872,N/A,82,3
2,N/A,N/A,N/A,1868,1870,N/A,86,1
4,N/A,N/A,N/A,1864,1868,N/A,89,4
3,N/A,N/A,N/A,1861,1864,N/A,94,3
2,N/A,N/A,N/A,1859,1861,N/A,98,1
2,N/A,N/A,N/A,1857,1859,N/A,104,1
3,N/A,N/A,N/A,1854,1857,N/A,107,4
3,N/A,N/A,N/A,1851,1854,N/A,113,4
2,N/A,N/A,N/A,1849,1851,N/A,117,2
3,N/A,N/A,N/A,1846,1849,N/A,123,2
2,N/A,N/A,N/A,1844,1846,N/A,128,1
6,N/A,N/A,N/A,1838,1844,N/A,133,6
6,N/A,N/A,N/A,1832,1838,N/A,138,5
3,N/A,N/A,N/A,1829,1832,N/A,141,2
4,N/A,N/A,N/A,572,576,N/A,3,4
2,N/A,N/A,N/A,570,572,N/A,6,1
3,N/A,N/A,N/A,567,570,N/A,9,4
2,N/A,N/A,N/A,565,567,N/A,12,1
6,N/A,N/A,N/A,559,565,N/A,17,6
2,N/A,N/A,N/A,557,559,N/A,23,0
6,N/A,N/A,N/A,551,557,N/A,28,5
4,N/A,N/A,N/A,547,551,N/A,33,4
3,N/A,N/A,N/A,544,547,N/A,39,4
2,N/A,N/A,N/A,542,544,N/A,42,1
6,N/A,N/A,N/A,536,542,N/A,46,5
6,N/A,N/A,N/A,530,536,N/A,52,5
4,N/A,N/A,N/A,526,530,N/A,57,4
2,N/A,N/A,N/A,524,526,N/A,62,3
2,N/A,N/A,N/A,522,524,N/A,68,3
2,N/A,N/A,N/A,520,522,N/A,72,1
7,N/A,N/A,N/A,513,520,N/A,77,6
5,N/A,N/A,N/A,508,513,N/A,82,5
3,N/A,N/A,N/A,505,508,N/A,86,3
7,N/A,N/A,N/A,498,505,N/A,89,6
2,N/A,N/A,N/A,496,498,N/A,92,3
3,N/A,N/A,N/A,493,496,N/A,97,2
7,N/A,N/A,N/A,486,493,N/A,101,6
1,N/A,N/A,N/A,485,486,N/A,107,0
5,N/A,N/A,N/A,480,485,N/A,112,5
5,N/A,N/A,N/A,475,480,N/A,118,5
2,N/A,N/A,N/A,473,475,N/A,122,3
6,N/A,N/A,N/A,467,473,N/A,125,6
3,N/A,N/A,N/A,464,467,N/A,128,3
3,N/A,N/A,N/A,461,464,N/A,134,3
3,N/A,N/A,N/A,1788,1791,N/A,5,2
2,N/A,N/A,N/A,1786,1788,N/A,11,2
3,N/A,N/A,N/A,1783,1786,N/A,17,2
5,N/A,N/A,N/A,1778,1783,N/A,20,5
5,N/A,N/A,N/A,1773,1778,N/A,26,5
3,N/A,N/A,N/A,1770,1773,N/A,29,2
3,N/A,N/A,N/A,1767,1770,N/A,35,2
5,N/A,N/A,N/A,1762,1767,N/A,38,5
3,N/A,N/A,N/A,1759,1762,N/A,43,4
3,N/A,N/A,N/A,1756,1759,N/A,48,3
6,N/A,N/A,N/A,1750,1756,N/A,51,6
2,N/A,N/A,N/A,1748,1750,N/A,54,3
1,N/A,N/A,N/A,1747,1748,N/A,58,1
6,N/A,N/A,N/A,1741,1747,N/A,62,5
2,N/A,N/A,N/A,1739,1741,N/A,66,3
7,N/A,N/A,N/A,1732,1739,N/A,69,6
2,N/A,N/A,N/A,1730,1732,N/A,75,0
3,N/A,N/A,N/A,1727,1730,N/A,78,3
7,N/A,N/A,N/A,1720,1727,N/A,81,6
5,N/A,N/A,N/A,1715,1720,N/A,86,5
3,N/A,N/A,N/A,1712,1715,N/A,90,3
2,N/A,N/A,N/A,1710,1712,N/A,96,3
7,N/A,N/A,N/A,1703,1710,N/A,99,6
6,N/A,N/A,N/A,1697,1703,N/A,104,5
2,N/A,N/A,N/A,1695,1697,N/A,108,3
2,N/A,N/A,N/A,1693,1695,N/A,112,1
2,N/A,N/A,N/A,1691,1693,N/A,118,1
6,N/A,N/A,N/A,1685,1691,N/A,122,5
5,N/A,N/A,N/A,1680,1685,N/A,128,5
6,N/A,N/A,N/A,1674,1680,N/A,134,5
3,N/A,N/A,N/A,1648,1651,N/A,3,2
1,N/A,N/A,N/A,1647,1648,N/A,8,1
1,N/A,N/A,N/A,1646,1647,N/A,14,1
7,N/A,N/A,N/A,1639,1646,N/A,19,6
1,N/A,N/A,N/A,1638,1639,N/A,25,0
6,N/A,N/A,N/A,1632,1638,N/A,31,6
3,N/A,N/A,N/A,1629,1632,N/A,35,4
4,N/A,N/A,N/A,1625,1629,N/A,41,4
3,N/A,N/A,N/A,1622,1625,N/A,45,2
2,N/A,N/A,N/A,1620,1622,N/A,50,1
7,N/A,N/A,N/A,1613,1620,N/A,55,6
2,N/A,N/A,N/A,1611,1613,N/A,61,0
4,N/A,N/A,N/A,1607,1611,N/A,65,4
2,N/A,N/A,N/A,1605,1607,N/A,68,1
4,N/A,N/A,N/A,1601,1605,N/A,71,4
2,N/A,N/A,N/A,1599,1601,N/A,76,3
2,N/A,N/A,N/A,1597,1599,N/A,80,1
6,N/A,N/A,N/A,1591,1597,N/A,85,6
2,N/A,N/A,N/A,1589,1591,N/A,88,3
1,N/A,N/A,N/A,1588,1589,N/A,92,1
6,N/A,N/A,N/A,1582,1588,N/A,96,5
2,N/A,N/A,N/A,1580,1582,N/A,100,3
6,N/A,N/A,N/A,1574,1580,N/A,103,6
3,N/A,N/A,N/A,1571,1574,N/A,107,4
3,N/A,N/A,N/A,1568,1571,N/A,111,2
2,N/A,N/A,N/A,1566,1568,N/A,116,1
6,N/A,N/A,N/A,1560,1566,N/A,120,5
3,N/A,N/A,N/A,1557,1560,N/A,124,3
2,N/A,N/A,N/A,1555,1557,N/A,129,2
6,N/A,N/A,N/A,1549,1555,N/A,133,6
7,N/A,N/A,N/A,678,685,N/A,4,6
2,N/A,N/A,N/A,676,678,N/A,10,0
2,N/A,N/A,N/A,674,676,N/A,13,3
3,N/A,N/A,N/A,671,674,N/A,18,2
6,N/A,N/A,N/A,665,671,N/A,22,6
2,N/A,N/A,N/A,663,665,N/A,25,3
2,N/A,N/A,N/A,661,663,N/A,29,1
3,N/A,N/A,N/A,658,661,N/A,32,4
3,N/A,N/A,N/A,655,658,N/A,36,2
6,N/A,N/A,N/A,649,655,N/A,40,6
2,N/A,N/A,N/A,647,649,N/A,43,3
3,N/A,N/A,N/A,644,647,N/A,49,3
3,N/A,N/A,N/A,641,644,N/A,54,2
2,N/A,N/A,N/A,639,641,N/A,59,1
7,N/A,N/A,N/A,632,639,N/A,64,6
6,N/A,N/A,N/A,626,632,N/A,69,5
2,N/A,N/A,N/A,624,626,N/A,72,2
1,N/A,N/A,N/A,623,624,N/A,77,1
2,N/A,N/A,N/A,621,623,N/A,83,1
2,N/A,N/A,N/A,619,621,N/A,89,1
4,N/A,N/A,N/A,615,619,N/A,92,4
4,N/A,N/A,N/A,611,615,N/A,98,4
3,N/A,N/A,N/A,608,611,N/A,104,4
1,N/A,N/A,N/A,607,608,N/A,107,1
6,N/A,N/A,N/A,601,607,N/A,112,6
2,N/A,N/A,N/A,599,601,N/A,118,0
5,N/A,N/A,N/A,594,599,N/A,123,5
2,N/A,N/A,N/A,592,594,N/A,127,3
6,N/A,N/A,N/A,586,592,N/A,130,6
6,N/A,N/A,N/A,580,586,N/A,135,5
6,N/A,N/A,N/A,693,699,N/A,4,5
3,N/A,N/A,N/A,690,693,N/A,9,4
2,N/A,N/A,N/A,688,690,N/A,12,1
6,N/A,N/A,N/A,682,688,N/A,16,5
3,N/A,N/A,N/A,679,682,N/A,21,4
3,N/A,N/A,N/A,676,679,N/A,25,2
2,N/A,N/A,N/A,674,676,N/A,31,2
6,N/A,N/A,N/A,668,674,N/A,35,6
2,N/A,N/A,N/A,666,668,N/A,38,3
2,N/A,N/A,N/A,664,666,N/A,42,1
3,N/A,N/A,N/A,661,664,N/A,45,4
2,N/A,N/A,N/A,659,661,N/A,48,1
7,N/A,N/A,N/A,652,659,N/A,53,6
2,N/A,N/A,N/A,650,652,N/A,59,0
7,N/A,N/A,N/A,643,650,N/A,65,6
2,N/A,N/A,N/A,641,643,N/A,71,0
6,N/A,N/A,N/A,635,641,N/A,76,5
3,N/A,N/A,N/A,632,635,N/A,79,2
2,N/A,N/A,N/A,630,632,N/A,85,2
1,N/A,N/A,N/A,629,630,N/A,90,1
2,N/A,N/A,N/A,627,629,N/A,96,1
7,N/A,N/A,N/A,620,627,N/A,101,6
3,N/A,N/A,N/A,617,620,N/A,105,4
2,N/A,N/A,N/A,615,617,N/A,109,2
2,N/A,N/A,N/A,613,615,N/A,114,1
3,N/A,N/A,N/A,610,613,N/A,117,4
3,N/A,N/A,N/A,607,610,N/A,121,2
3,N/A,N/A,N/A,604,607,N/A,127,2
1,N/A,N/A,N/A,603,604,N/A,132,1
3,N/A,N/A,N/A,600,603,N/A,135,4
2,N/A,N/A,N/A,656,658,N/A,6,3
2,N/A,N/A,N/A,654,656,N/A,12,3
7,N/A,N/A,N/A,647,654,N/A,15,6
3,N/A,N/A,N/A,644,647,N/A,18,3
1,N/A,N/A,N/A,643,644,N/A,22,1
2,N/A,N/A,N/A,641,643,N/A,28,1
2,N/A,N/A,N/A,639,641,N/A,34,1
1,N/A,N/A,N/A,638,639,N/A,40,1
6,N/A,N/A,N/A,632,638,N/A,45,6
5,N/A,N/A,N/A,627,632,N/A,50,5
5,N/A,N/A,N/A,622,627,N/A,56,5
5,N/A,N/A,N/A,617,622,N/A,62,5
4,N/A,N/A,N/A,613,617,N/A,67,4
2,N/A,N/A,N/A,611,613,N/A,71,2
6,N/A,N/A,N/A,605,611,N/A,75,6
2,N/A,N/A,N/A,603,605,N/A,78,3
3,N/A,N/A,N/A,600,603,N/A,83,2
5,N/A,N/A,N/A,595,600,N/A,86,5
3,N/A,N/A,N/A,592,595,N/A,89,2
2,N/A,N/A,N/A,590,592,N/A,94,1
3,N/A,N/A,N/A,587,590,N/A,97,4
3,N/A,N/A,N/A,584,587,N/A,101,2
5,N/A,N/A,N/A,579,584,N/A,104,5
3,N/A,N/A,N/A,576,579,N/A,109,4
2,N/A,N/A,N/A,574,576,N/A,113,2
2,N/A,N/A,N/A,572,574,N/A,119,2
2,N/A,N/A,N/A,570,572,N/A,125,2
6,N/A,N/A,N/A,564,570,N/A,129,6
4,N/A,N/A,N/A,560,564,N/A,133,4
1,N/A,N/A,N/A,559,560,N/A,136,1
2,N/A,N/A,N/A,1877,1879,N/A,4,2
1,N/A,N/A,N/A,1876,1877,N/A,9,1
4,N/A,N/A,N/A,1872,1876,N/A,12,4
3,N/A,N/A,N/A,1869,1872,N/A,18,4
2,N/A,N/A,N/A,1867,1869,N/A,23,3
2,N/A,N/A,N/A,1865,1867,N/A,27,1
4,N/A,N/A,N/A,1861,1865,N/A,30,4
3,N/A,N/A,N/A,1858,1861,N/A,35,3
3,N/A,N/A,N/A,1855,1858,N/A,40,2
5,N/A,N/A,N/A,1850,1855,N/A,43,5
3,N/A,N/A,N/A,1847,1850,N/A,48,4
4,N/A,N/A,N/A,1843,1847,N/A,54,4
2,N/A,N/A,N/A,1841,1843,N/A,57,1
2,N/A,N/A,N/A,1839,1841,N/A,63,1
6,N/A,N/A,N/A,1833,1839,N/A,67,5
6,N/A,N/A,N/A,1827,1833,N/A,73,5
2,N/A,N/A,N/A,1825,1827,N/A,77,3
3,N/A,N/A,N/A,1822,1825,N/A,82,2
3,N/A,N/A,N/A,1819,1822,N/A,88,2
3,N/A,N/A,N/A,1816,1819,N/A,94,2
6,N/A,N/A,N/A,1810,1816,N/A,98,6
1,N/A,N/A,N/A,1809,1810,N/A,104,0
2,N/A,N/A,N/A,1807,1809,N/A,107,3
1,N/A,N/A,N/A,1806,1807,N/A,111,1
1,N/A,N/A,N/A,1805,1806,N/A,117,1
4,N/A,N/A,N/A,1801,1805,N/A,120,4
2,N/A,N/A,N/A,1799,1801,N/A,125,3
7,N/A,N/A,N/A,1792,1799,N/A,128,6
6,N/A,N/A,N/A,1786,1792,N/A,133,5
4,N/A,N/A,N/A,1782,1786,N/A,138,4
1,N/A,N/A,N/A,1455,1456,N/A,4,1
3,N/A,N/A,N/A,1452,1455,N/A,7,4
2,N/A,N/A,N/A,1450,1452,N/A,10,1
6,N/A,N/A,N/A,1444,1450,N/A,14,5
6,N/A,N/A,N/A,1438,1444,N/A,20,5
2,N/A,N/A,N/A,1436,1438,N/A,23,2
2,N/A,N/A,N/A,1434,1436,N/A,29,2
6,N/A,N/A,N/A,1428,1434,N/A,33,6
2,N/A,N/A,N/A,1426,1428,N/A,36,3
2,N/A,N/A,N/A,1424,1426,N/A,40,1
5,N/A,N/A,N/A,1419,1424,N/A,44,5
4,N/A,N/A,N/A,1415,1419,N/A,49,4
2,N/A,N/A,N/A,1413,1415,N/A,52,1
4,N/A,N/A,N/A,1409,1413,N/A,55,4
2,N/A,N/A,N/A,1407,1409,N/A,58,1
6,N/A,N/A,N/A,1401,1407,N/A,62,5
2,N/A,N/A,N/A,1399,1401,N/A,66,3
2,N/A,N/A,N/A,1397,1399,N/A,72,3
7,N/A,N/A,N/A,1390,1397,N/A,75,6
2,N/A,N/A,N/A,1388,1390,N/A,81,0
4,N/A,N/A,N/A,1384,1388,N/A,85,4
4,N/A,N/A,N/A,1380,1384,N/A,91,4
2,N/A,N/A,N/A,1378,1380,N/A,94,1
5,N/A,N/A,N/A,1373,1378,N/A,98,5
2,N/A,N/A,N/A,1371,1373,N/A,102,3
7,N/A,N/A,N/A,1364,1371,N/A,105,6
2,N/A,N/A,N/A,1362,1364,N/A,111,0
5,N/A,N/A,N/A,1357,1362,N/A,116,5
2,N/A,N/A,N/A,1355,1357,N/A,120,3
2,N/A,N/A,N/A,1353,1355,N/A,126,3
4,N/A,N/A,N/A,386,390,N/A,3,4
1,N/A,N/A,N/A,385,386,N/A,6,1
1,N/A,N/A,N/A,384,385,N/A,12,1
5,N/A,N/A,N/A,379,384,N/A,16,5
3,N/A,N/A,N/A,376,379,N/A,21,4
2,N/A,N/A,N/A,374,376,N/A,26,3
6,N/A,N/A,N/A,368,374,N/A,29,6
2,N/A,N/A,N/A,366,368,N/A,32,3
3,N/A,N/A,N/A,363,366,N/A,37,2
3,N/A,N/A,N/A,360,363,N/A,43,2
6,N/A,N/A,N/A,354,360,N/A,46,5
3,N/A,N/A,N/A,351,354,N/A,49,2
7,N/A,N/A,N/A,344,351,N/A,53,6
6,N/A,N/A,N/A,338,344,N/A,58,5
3,N/A,N/A,N/A,335,338,N/A,62,3
7,N/A,N/A,N/A,328,335,N/A,65,6
3,N/A,N/A,N/A,325,328,N/A,68,3
6,N/A,N/A,N/A,319,325,N/A,71,6
3,N/A,N/A,N/A,316,319,N/A,75,4
1,N/A,N/A,N/A,315,316,N/A,78,1
4,N/A,N/A,N/A,311,315,N/A,81,4
4,N/A,N/A,N/A,307,311,N/A,87,4
3,N/A,N/A,N/A,304,307,N/A,91,2
6,N/A,N/A,N/A,298,304,N/A,94,5
3,N/A,N/A,N/A,295,298,N/A,97,2
6,N/A,N/A,N/A,289,295,N/A,100,5
2,N/A,N/A,N/A,287,289,N/A,103,2
3,N/A,N/A,N/A,284,287,N/A,109,2
2,N/A,N/A,N/A,282,284,N/A,115,2
2,N/A,N/A,N/A,280,282,N/A,120,1
6,N/A,N/A,N/A,1171,1177,N/A,4,5
2,N/A,N/A,N/A,1169,1171,N/A,8,3
3,N/A,N/A,N/A,1166,1169,N/A,13,2
2,N/A,N/A,N/A,1164,1166,N/A,19,2
6,N/A,N/A,N/A,1158,1164,N/A,23,6
3,N/A,N/A,N/A,1155,1158,N/A,27,4
3,N/A,N/A,N/A,1152,1155,N/A,31,2
6,N/A,N/A,N/A,1146,1152,N/A,34,5
3,N/A,N/A,N/A,1143,1146,N/A,38,3
3,N/A,N/A,N/A,1140,1143,N/A,43,2
1,N/A,N/A,N/A,1139,1140,N/A,48,1
4,N/A,N/A,N/A,1135,1139,N/A,51,4
3,N/A,N/A,N/A,1132,1135,N/A,57,4
4,N/A,N/A,N/A,1128,1132,N/A,63,4
3,N/A,N/A,N/A,1125,1128,N/A,69,4
3,N/A,N/A,N/A,1122,1125,N/A,75,4
2,N/A,N/A,N/A,1120,1122,N/A,79,2
5,N/A,N/A,N/A,1115,1120,N/A,82,5
6,N/A,N/A,N/A,1109,1115,N/A,88,5
5,N/A,N/A,N/A,1104,1109,N/A,94,5
2,N/A,N/A,N/A,1102,1104,N/A,97,2
2,N/A,N/A,N/A,1100,1102,N/A,102,1
1,N/A,N/A,N/A,1099,1100,N/A,108,1
6,N/A,N/A,N/A,1093,1099,N/A,112,5
2,N/A,N/A,N/A,1091,1093,N/A,115,2
1,N/A,N/A,N/A,1090,1091,N/A,120,1
7,N/A,N/A,N/A,1083,1090,N/A,125,6
1,N/A,N/A,N/A,1082,1083,N/A,131,0
3,N/A,N/A,N/A,1079,1082,N/A,135,4
4,N/A,N/A,N/A,1075,1079,N/A,141,4
2,N/A,N/A,N/A,1201,1203,N/A,3,2
6,N/A,N/A,N/A,1195,1201,N/A,7,6
1,N/A,N/A,N/A,1194,1195,N/A,13,0
4,N/A,N/A,N/A,1190,1194,N/A,17,4
4,N/A,N/A,N/A,1186,1190,N/A,23,4
4,N/A,N/A,N/A,1182,1186,N/A,29,4
4,N/A,N/A,N/A,1178,1182,N/A,35,4
3,N/A,N/A,N/A,1175,1178,N/A,39,2
1,N/A,N/A,N/A,1174,1175,N/A,44,1
5,N/A,N/A,N/A,1169,1174,N/A,48,5
4,N/A,N/A,N/A,1165,1169,N/A,53,4
2,N/A,N/A,N/A,1163,1165,N/A,58,3
6,N/A,N/A,N/A,1157,1163,N/A,61,6
3,N/A,N/A,N/A,1154,1157,N/A,65,4
1,N/A,N/A,N/A,1153,1154,N/A,68,1
2,N/A,N/A,N/A,1151,1153,N/A,74,1
4,N/A,N/A,N/A,1147,1151,N/A,77,4
2,N/A,N/A,N/A,1145,1147,N/A,82,3
3,N/A,N/A,N/A,1142,1145,N/A,88,3
6,N/A,N/A,N/A,1136,1142,N/A,91,6
5,N/A,N/A,N/A,1131,1136,N/A,96,5
4,N/A,N/A,N/A,1127,1131,N/A,101,4
2,N/A,N/A,N/A,1125,1127,N/A,104,1
6,N/A,N/A,N/A,1119,1125,N/A,108,5
3,N/A,N/A,N/A,1116,1119,N/A,113,4
2,N/A,N/A,N/A,1114,1116,N/A,117,2
2,N/A,N/A,N/A,1112,1114,N/A,123,2
6,N/A,N/A,N/A,1106,1112,N/A,127,6
2,N/A,N/A,N/A,1104,1106,N/A,130,3
1,N/A,N/A,N/A,1103,1104,N/A,134,1
6,N/A,N/A,N/A,1780,1786,N/A,5,6
4,N/A,N/A,N/A,1776,1780,N/A,9,4
2,N/A,N/A,N/A,1774,1776,N/A,14,3
3,N/A,N/A,N/A,1771,1774,N/A,19,2
3,N/A,N/A,N/A,1768,1771,N/A,25,2
6,N/A,N/A,N/A,1762,1768,N/A,29,6
2,N/A,N/A,N/A,1760,1762,N/A,32,3
1,N/A,N/A,N/A,1759,1760,N/A,36,1
1,N/A,N/A,N/A,1758,1759,N/A,42,1
6,N/A,N/A,N/A,1752,1758,N/A,47,6
2,N/A,N/A,N/A,1750,1752,N/A,53,0
5,N/A,N/A,N/A,1745,1750,N/A,58,5
2,N/A,N/A,N/A,1743,1745,N/A,62,3
7,N/A,N/A,N/A,1736,1743,N/A,65,6
2,N/A,N/A,N/A,1734,1736,N/A,71,0
2,N/A,N/A,N/A,1732,1734,N/A,74,3
2,N/A,N/A,N/A,1730,1732,N/A,78,1
6,N/A,N/A,N/A,1724,1730,N/A,82,5
3,N/A,N/A,N/A,1721,1724,N/A,87,4
1,N/A,N/A,N/A,1720,1721,N/A,90,1
4,N/A,N/A,N/A,1716,1720,N/A,93,4
3,N/A,N/A,N/A,1713,1716,N/A,97,2
3,N/A,N/A,N/A,1710,1713,N/A,103,2
6,N/A,N/A,N/A,1704,1710,N/A,106,5
3,N/A,N/A,N/A,1701,1704,N/A,110,3
2,N/A,N/A,N/A,1699,1701,N/A,114,1
5,N/A,N/A,N/A,1694,1699,N/A,118,5
5,N/A,N/A,N/A,1689,1694,N/A,124,5
3,N/A,N/A,N/A,1686,1689,N/A,127,2
2,N/A,N/A,N/A,1684,1686,N/A,133,2
4,N/A,N/A,N/A,1635,1639,N/A,3,4
2,N/A,N/A,N/A,1633,1635,N/A,8,3
3,N/A,N/A,N/A,1630,1633,N/A,14,3
3,N/A,N/A,N/A,1627,1630,N/A,19,2
2,N/A,N/A,N/A,1625,1627,N/A,24,1
6,N/A,N/A,N/A,1619,1625,N/A,29,6
5,N/A,N/A,N/A,1614,1619,N/A,34,5
3,N/A,N/A,N/A,1611,1614,N/A,38,3
6,N/A,N/A,N/A,1605,1611,N/A,41,6
4,N/A,N/A,N/A,1601,1605,N/A,45,4
2,N/A,N/A,N/A,1599,1601,N/A,48,1
6,N/A,N/A,N/A,1593,1599,N/A,52,5
5,N/A,N/A,N/A,1588,1593,N/A,58,5
5,N/A,N/A,N/A,1583,1588,N/A,64,5
6,N/A,N/A,N/A,1577,1583,N/A,70,5
2,N/A,N/A,N/A,1575,1577,N/A,73,2
6,N/A,N/A,N/A,1569,1575,N/A,77,6
3,N/A,N/A,N/A,1566,1569,N/A,80,3
2,N/A,N/A,N/A,1564,1566,N/A,85,2
1,N/A,N/A,N/A,1563,1564,N/A,90,1
2,N/A,N/A,N/A,1561,1563,N/A,96,1
3,N/A,N/A,N/A,1558,1561,N/A,99,4
2,N/A,N/A,N/A,1556,1558,N/A,103,2
2,N/A,N/A,N/A,1554,1556,N/A,108,1
6,N/A,N/A,N/A,1548,1554,N/A,112,5
3,N/A,N/A,N/A,1545,1548,N/A,115,2
7,N/A,N/A,N/A,1538,1545,N/A,119,6
2,N/A,N/A,N/A,1536,1538,N/A,125,0
6,N/A,N/A,N/A,1530,1536,N/A,130,5
3,N/A,N/A,N/A,1527,1530,N/A,134,3
5,N/A,N/A,N/A,1010,1015,N/A,4,5
5,N/A,N/A,N/A,1005,1010,N/A,10,5
3,N/A,N/A,N/A,1002,1005,N/A,13,2
7,N/A,N/A,N/A,995,1002,N/A,17,6
5,N/A,N/A,N/A,990,995,N/A,22,5
6,N/A,N/A,N/A,984,990,N/A,28,5
2,N/A,N/A,N/A,982,984,N/A,31,2
6,N/A,N/A,N/A,976,982,N/A,35,6
4,N/A,N/A,N/A,972,976,N/A,39,4
4,N/A,N/A,N/A,968,972,N/A,45,4
3,N/A,N/A,N/A,965,968,N/A,49,2
1,N/A,N/A,N/A,964,965,N/A,54,1
6,N/A,N/A,N/A,958,964,N/A,59,6
2,N/A,N/A,N/A,956,958,N/A,62,3
3,N/A,N/A,N/A,953,956,N/A,68,3
2,N/A,N/A,N/A,951,953,N/A,73,2
3,N/A,N/A,N/A,948,951,N/A,79,2
7,N/A,N/A,N/A,941,948,N/A,83,6
3,N/A,N/A,N/A,938,941,N/A,86,3
2,N/A,N/A,N/A,936,938,N/A,91,2
2,N/A,N/A,N/A,934,936,N/A,97,2
7,N/A,N/A,N/A,927,934,N/A,101,6
3,N/A,N/A,N/A,924,927,N/A,105,4
3,N/A,N/A,N/A,921,924,N/A,110,3
3,N/A,N/A,N/A,918,921,N/A,116,3
7,N/A,N/A,N/A,911,918,N/A,119,6
2,N/A,N/A,N/A,909,911,N/A,125,0
6,N/A,N/A,N/A,903,909,N/A,131,6
1,N/A,N/A,N/A,902,903,N/A,137,0
3,N/A,N/A,N/A,899,902,N/A,141,4
2,N/A,N/A,N/A,444,446,N/A,5,1
4,N/A,N/A,N/A,440,444,N/A,8,4
3,N/A,N/A,N/A,437,440,N/A,12,2
5,N/A,N/A,N/A,432,437,N/A,15,5
5,N/A,N/A,N/A,427,432,N/A,21,5
6,N/A,N/A,N/A,421,427,N/A,27,5
5,N/A,N/A,N/A,416,421,N/A,33,5
4,N/A,N/A,N/A,412,416,N/A,38,4
4,N/A,N/A,N/A,408,412,N/A,44,4
2,N/A,N/A,N/A,406,408,N/A,48,2
2,N/A,N/A,N/A,404,406,N/A,53,1
6,N/A,N/A,N/A,398,404,N/A,58,6
3,N/A,N/A,N/A,395,398,N/A,61,3
2,N/A,N/A,N/A,393,395,N/A,66,2
5,N/A,N/A,N/A,388,393,N/A,69,5
4,N/A,N/A,N/A,384,388,N/A,74,4
2,N/A,N/A,N/A,382,384,N/A,78,2
2,N/A,N/A,N/A,380,382,N/A,84,2
3,N/A,N/A,N/A,377,380,N/A,90,2
2,N/A,N/A,N/A,375,377,N/A,95,1
4,N/A,N/A,N/A,371,375,N/A,98,4
3,N/A,N/A,N/A,368,371,N/A,104,4
2,N/A,N/A,N/A,366,368,N/A,107,1
4,N/A,N/A,N/A,362,366,N/A,110,4
3,N/A,N/A,N/A,359,362,N/A,114,2
6,N/A,N/A,N/A,353,359,N/A,118,6
3,N/A,N/A,N/A,350,353,N/A,122,4
1,N/A,N/A,N/A,349,350,N/A,125,1
2,N/A,N/A,N/A,347,349,N/A,131,1
7,N/A,N/A,N/A,340,347,N/A,136,6
7,N/A,N/A,N/A,1197,1204,N/A,3,6
3,N/A,N/A,N/A,1194,1197,N/A,6,3
6,N/A,N/A,N/A,1188,1194,N/A,9,6
2,N/A,N/A,N/A,1186,1188,N/A,15,0
7,N/A,N/A,N/A,1179,1186,N/A,21,6
4,N/A,N/A,N/A,1175,1179,N/A,25,4
3,N/A,N/A,N/A,1172,1175,N/A,30,3
2,N/A,N/A,N/A,1170,1172,N/A,35,2
1,N/A,N/A,N/A,1169,1170,N/A,40,1
2,N/A,N/A,N/A,1167,1169,N/A,46,1
5,N/A,N/A,N/A,1162,1167,N/A,50,5
3,N/A,N/A,N/A,1159,1162,N/A,53,2
3,N/A,N/A,N/A,1156,1159,N/A,59,2
2,N/A,N/A,N/A,1154,1156,N/A,65,2
6,N/A,N/A,N/A,1148,1154,N/A,68,5
6,N/A,N/A,N/A,1142,1148,N/A,74,5
3,N/A,N/A,N/A,1139,1142,N/A,79,4
3,N/A,N/A,N/A,1136,1139,N/A,84,3
1,N/A,N/A,N/A,1135,1136,N/A,88,1
4,N/A,N/A,N/A,1131,1135,N/A,91,4
2,N/A,N/A,N/A,1129,1131,N/A,95,2
3,N/A,N/A,N/A,1126,1129,N/A,101,2
6,N/A,N/A,N/A,1120,1126,N/A,105,6
2,N/A,N/A,N/A,1118,1120,N/A,108,3
7,N/A,N/A,N/A,1111,1118,N/A,111,6
6,N/A,N/A,N/A,1105,1111,N/A,116,5
3,N/A,N/A,N/A,1102,1105,N/A,120,3
2,N/A,N/A,N/A,1100,1102,N/A,124,1
6,N/A,N/A,N/A,1094,1100,N/A,129,6
2,N/A,N/A,N/A,1092,1094,N/A,135,0
7,N/A,N/A,N/A,1550,1557,N/A,4,6
1,N/A,N/A,N/A,1549,1550,N/A,10,0
3,N/A,N/A,N/A,1546,1549,N/A,14,4
2,N/A,N/A,N/A,1544,1546,N/A,18,2
6,N/A,N/A,N/A,1538,1544,N/A,21,5
2,N/A,N/A,N/A,1536,1538,N/A,25,3
3,N/A,N/A,N/A,1533,1536,N/A,31,3
2,N/A,N/A,N/A,1531,1533,N/A,35,1
5,N/A,N/A,N/A,1526,1531,N/A,39,5
3,N/A,N/A,N/A,1523,1526,N/A,42,2
2,N/A,N/A,N/A,1521,1523,N/A,48,2
2,N/A,N/A,N/A,1519,1521,N/A,54,2
6,N/A,N/A,N/A,1513,1519,N/A,57,5
4,N/A,N/A,N/A,1509,1513,N/A,62,4
4,N/A,N/A,N/A,1505,1509,N/A,68,4
3,N/A,N/A,N/A,1502,1505,N/A,74,4
2,N/A,N/A,N/A,1500,1502,N/A,79,3
2,N/A,N/A,N/A,1498,1500,N/A,84,2
6,N/A,N/A,N/A,1492,1498,N/A,87,5
6,N/A,N/A,N/A,1486,1492,N/A,93,5
3,N/A,N/A,N/A,1483,1486,N/A,97,3
7,N/A,N/A,N/A,1476,1483,N/A,100,6
6,N/A,N/A,N/A,1470,1476,N/A,105,5
4,N/A,N/A,N/A,1466,1470,N/A,110,4
4,N/A,N/A,N/A,1462,1466,N/A,116,4
3,N/A,N/A,N/A,1459,1462,N/A,120,2
6,N/A,N/A,N/A,1453,1459,N/A,124,6
2,N/A,N/A,N/A,1451,1453,N/A,130,0
2,N/A,N/A,N/A,1449,1451,N/A,133,3
6,N/A,N/A,N/A,1443,1449,N/A,136,6
5,N/A,N/A,N/A,1574,1579,N/A,5,5
2,N/A,N/A,N/A,1572,1574,N/A,8,2
6,N/A,N/A,N/A,1566,1572,N/A,11,5
2,N/A,N/A,N/A,1564,1566,N/A,15,3
2,N/A,N/A,N/A,1562,1564,N/A,21,3
1,N/A,N/A,N/A,1561,1562,N/A,25,1
6,N/A,N/A,N/A,1555,1561,N/A,30,6
5,N/A,N/A,N/A,1550,1555,N/A,35,5
3,N/A,N/A,N/A,1547,1550,N/A,39,3
2,N/A,N/A,N/A,1545,1547,N/A,44,2
6,N/A,N/A,N/A,1539,1545,N/A,48,6
2,N/A,N/A,N/A,1537,1539,N/A,54,0
6,N/A,N/A,N/A,1531,1537,N/A,60,6
3,N/A,N/A,N/A,1528,1531,N/A,63,3
6,N/A,N/A,N/A,1522,1528,N/A,66,6
5,N/A,N/A,N/A,1517,1522,N/A,71,5
2,N/A,N/A,N/A,1515,1517,N/A,75,3
3,N/A,N/A,N/A,1512,1515,N/A,80,2
7,N/A,N/A,N/A,1505,1512,N/A,84,6
1,N/A,N/A,N/A,1504,1505,N/A,90,0
7,N/A,N/A,N/A,1497,1504,N/A,96,6
5,N/A,N/A,N/A,1492,1497,N/A,101,5
3,N/A,N/A,N/A,1489,1492,N/A,104,2
6,N/A,N/A,N/A,1483,1489,N/A,107,5
3,N/A,N/A,N/A,1480,1483,N/A,110,2
3,N/A,N/A,N/A,1477,1480,N/A,116,2
3,N/A,N/A,N/A,1474,1477,N/A,122,2
1,N/A,N/A,N/A,1473,1474,N/A,127,1
6,N/A,N/A,N/A,1467,1473,N/A,132,6
1,N/A,N/A,N/A,1466,1467,N/A,138,0
6,N/A,N/A,N/A,1199,1205,N/A,4,5
6,N/A,N/A,N/A,1193,1199,N/A,10,5
2,N/A,N/A,N/A,1191,1193,N/A,14,3
6,N/A,N/A,N/A,1185,1191,N/A,17,6
3,N/A,N/A,N/A,1182,1185,N/A,20,3
2,N/A,N/A,N/A,1180,1182,N/A,25,2
3,N/A,N/A,N/A,1177,1180,N/A,31,2
5,N/A,N/A,N/A,1172,1177,N/A,34,5
5,N/A,N/A,N/A,1167,1172,N/A,40,5
4,N/A,N/A,N/A,1163,1167,N/A,45,4
3,N/A,N/A,N/A,1160,1163,N/A,50,3
7,N/A,N/A,N/A,1153,1160,N/A,53,6
6,N/A,N/A,N/A,1147,1153,N/A,58,5
3,N/A,N/A,N/A,1144,1147,N/A,61,2
3,N/A,N/A,N/A,1141,1144,N/A,67,2
7,N/A,N/A,N/A,1134,1141,N/A,71,6
3,N/A,N/A,N/A,1131,1134,N/A,74,3
3,N/A,N/A,N/A,1128,1131,N/A,80,3
3,N/A,N/A,N/A,1125,1128,N/A,86,3
3,N/A,N/A,N/A,1122,1125,N/A,91,2
3,N/A,N/A,N/A,1119,1122,N/A,97,2
1,N/A,N/A,N/A,1118,1119,N/A,102,1
4,N/A,N/A,N/A,1114,1118,N/A,105,4
2,N/A,N/A,N/A,1112,1114,N/A,108,1
3,N/A,N/A,N/A,1109,1112,N/A,111,4
4,N/A,N/A,N/A,1105,1109,N/A,117,4
3,N/A,N/A,N/A,1102,1105,N/A,121,2
1,N/A,N/A,N/A,1101,1102,N/A,126,1
6,N/A,N/A,N/A,1095,1101,N/A,130,5
3,N/A,N/A,N/A,1092,1095,N/A,133,2
3,N/A,N/A,N/A,1667,1670,N/A,6,4
2,N/A,N/A,N/A,1665,1667,N/A,10,2
6,N/A,N/A,N/A,1659,1665,N/A,14,6
6,N/A,N/A,N/A,1653,1659,N/A,19,5
5,N/A,N/A,N/A,1648,1653,N/A,25,5
3,N/A,N/A,N/A,1645,1648,N/A,28,2
7,N/A,N/A,N/A,1638,1645,N/A,32,6
2,N/A,N/A,N/A,1636,1638,N/A,35,3
2,N/A,N/A,N/A,1634,1636,N/A,40,2
7,N/A,N/A,N/A,1627,1634,N/A,44,6
2,N/A,N/A,N/A,1625,1627,N/A,50,0
5,N/A,N/A,N/A,1620,1625,N/A,55,5
3,N/A,N/A,N/A,1617,1620,N/A,60,4
2,N/A,N/A,N/A,1615,1617,N/A,63,1
6,N/A,N/A,N/A,1609,1615,N/A,68,6
2,N/A,N/A,N/A,1607,1609,N/A,74,0
6,N/A,N/A,N/A,1601,1607,N/A,79,5
3,N/A,N/A,N/A,1598,1601,N/A,84,4
2,N/A,N/A,N/A,1596,1598,N/A,89,3
7,N/A,N/A,N/A,1589,1596,N/A,92,6
5,N/A,N/A,N/A,1584,1589,N/A,97,5
2,N/A,N/A,N/A,1582,1584,N/A,100,2
2,N/A,N/A,N/A,1580,1582,N/A,106,2
1,N/A,N/A,N/A,1579,1580,N/A,111,1
7,N/A,N/A,N/A,1572,1579,N/A,116,6
5,N/A,N/A,N/A,1567,1572,N/A,121,5
4,N/A,N/A,N/A,1563,1567,N/A,126,4
2,N/A,N/A,N/A,1561,1563,N/A,129,1
6,N/A,N/A,N/A,1555,1561,N/A,133,5
2,N/A,N/A,N/A,1553,1555,N/A,137,3
2,N/A,N/A,N/A,1369,1371,N/A,5,3
2,N/A,N/A,N/A,1367,1369,N/A,9,1
6,N/A,N/A,N/A,1361,1367,N/A,14,6
3,N/A,N/A,N/A,1358,1361,N/A,18,4
3,N/A,N/A,N/A,1355,1358,N/A,24,4
2,N/A,N/A,N/A,1353,1355,N/A,29,3
3,N/A,N/A,N/A,1350,1353,N/A,34,2
2,N/A,N/A,N/A,1348,1350,N/A,40,2
2,N/A,N/A,N/A,1346,1348,N/A,45,1
1,N/A,N/A,N/A,1345,1346,N/A,51,1
2,N/A,N/A,N/A,1343,1345,N/A,57,1
6,N/A,N/A,N/A,1337,1343,N/A,61,5
5,N/A,N/A,N/A,1332,1337,N/A,67,5
3,N/A,N/A,N/A,1329,1332,N/A,70,2
6,N/A,N/A,N/A,1323,1329,N/A,73,5
3,N/A,N/A,N/A,1320,1323,N/A,77,3
3,N/A,N/A,N/A,1317,1320,N/A,83,3
3,N/A,N/A,N/A,1314,1317,N/A,89,3
6,N/A,N/A,N/A,1308,1314,N/A,92,6
5,N/A,N/A,N/A,1303,1308,N/A,97,5
2,N/A,N/A,N/A,1301,1303,N/A,101,3
3,N/A,N/A,N/A,1298,1301,N/A,106,2
6,N/A,N/A,N/A,1292,1298,N/A,110,6
2,N/A,N/A,N/A,1290,1292,N/A,116,0
5,N/A,N/A,N/A,1285,1290,N/A,121,5
3,N/A,N/A,N/A,1282,1285,N/A,125,3
7,N/A,N/A,N/A,1275,1282,N/A,128,6
2,N/A,N/A,N/A,1273,1275,N/A,134,0
5,N/A,N/A,N/A,1268,1273,N/A,139,5
5,N/A,N/A,N/A,1263,1268,N/A,145,5
2,N/A,N/A,N/A,1749,1751,N/A,5,3
7,N/A,N/A,N/A,1742,1749,N/A,8,6
3,N/A,N/A,N/A,1739,1742,N/A,12,4
3,N/A,N/A,N/A,1736,1739,N/A,17,3
3,N/A,N/A,N/A,1733,1736,N/A,22,2
6,N/A,N/A,N/A,1727,1733,N/A,25,5
4,N/A,N/A,N/A,1723,1727,N/A,30,4
3,N/A,N/A,N/A,1720,1723,N/A,35,3
2,N/A,N/A,N/A,1718,1720,N/A,41,3
2,N/A,N/A,N/A,1716,1718,N/A,45,1
1,N/A,N/A,N/A,1715,1716,N/A,51,1
4,N/A,N/A,N/A,1711,1715,N/A,54,4
3,N/A,N/A,N/A,1708,1711,N/A,60,4
2,N/A,N/A,N/A,1706,1708,N/A,63,1
6,N/A,N/A,N/A,1700,1706,N/A,67,5
3,N/A,N/A,N/A,1697,1700,N/A,71,3
7,N/A,N/A,N/A,1690,1697,N/A,74,6
3,N/A,N/A,N/A,1687,1690,N/A,78,4
3,N/A,N/A,N/A,1684,1687,N/A,82,2
1,N/A,N/A,N/A,1683,1684,N/A,87,1
1,N/A,N/A,N/A,1682,1683,N/A,93,1
5,N/A,N/A,N/A,1677,1682,N/A,97,5
3,N/A,N/A,N/A,1674,1677,N/A,101,3
2,N/A,N/A,N/A,1672,1674,N/A,105,1
4,N/A,N/A,N/A,1668,1672,N/A,108,4
2,N/A,N/A,N/A,1666,1668,N/A,112,2
6,N/A,N/A,N/A,1660,1666,N/A,115,5
6,N/A,N/A,N/A,1654,1660,N/A,121,5
3,N/A,N/A,N/A,1651,1654,N/A,125,3
6,N/A,N/A,N/A,1645,1651,N/A,128,6
3,N/A,N/A,N/A,439,442,N/A,6,3
2,N/A,N/A,N/A,437,439,N/A,11,2
3,N/A,N/A,N/A,434,437,N/A,17,2
7,N/A,N/A,N/A,427,434,N/A,21,6
3,N/A,N/A,N/A,424,427,N/A,25,4
3,N/A,N/A,N/A,421,424,N/A,30,3
3,N/A,N/A,N/A,418,421,N/A,35,2
6,N/A,N/A,N/A,412,418,N/A,38,5
2,N/A,N/A,N/A,410,412,N/A,41,2
6,N/A,N/A,N/A,404,410,N/A,45,6
3,N/A,N/A,N/A,401,404,N/A,49,4
2,N/A,N/A,N/A,399,401,N/A,54,3
3,N/A,N/A,N/A,396,399,N/A,60,3
7,N/A,N/A,N/A,389,396,N/A,63,6
2,N/A,N/A,N/A,387,389,N/A,66,3
3,N/A,N/A,N/A,384,387,N/A,71,2
3,N/A,N/A,N/A,381,384,N/A,77,2
2,N/A,N/A,N/A,379,381,N/A,82,1
2,N/A,N/A,N/A,377,379,N/A,88,1
4,N/A,N/A,N/A,373,377,N/A,91,4
2,N/A,N/A,N/A,371,373,N/A,96,3
2,N/A,N/A,N/A,369,371,N/A,102,3
7,N/A,N/A,N/A,362,369,N/A,105,6
5,N/A,N/A,N/A,357,362,N/A,110,5
4,N/A,N/A,N/A,353,357,N/A,115,4
2,N/A,N/A,N/A,351,353,N/A,120,3
2,N/A,N/A,N/A,349,351,N/A,125,2
2,N/A,N/A,N/A,347,349,N/A,130,1
4,N/A,N/A,N/A,343,347,N/A,133,4
3,N/A,N/A,N/A,340,343,N/A,137,2
2,N/A,N/A,N/A,1466,1468,N/A,4,2
1,N/A,N/A,N/A,1465,1466,N/A,9,1
2,N/A,N/A,N/A,1463,1465,N/A,15,1
6,N/A,N/A,N/A,1457,1463,N/A,20,6
2,N/A,N/A,N/A,1455,1457,N/A,26,0
3,N/A,N/A,N/A,1452,1455,N/A,30,4
1,N/A,N/A,N/A,1451,1452,N/A,33,1
6,N/A,N/A,N/A,1445,1451,N/A,37,5
3,N/A,N/A,N/A,1442,1445,N/A,41,3
2,N/A,N/A,N/A,1440,1442,N/A,45,1
5,N/A,N/A,N/A,1435,1440,N/A,49,5
4,N/A,N/A,N/A,1431,1435,N/A,54,4
3,N/A,N/A,N/A,1428,1431,N/A,59,3
1,N/A,N/A,N/A,1427,1428,N/A,63,1
5,N/A,N/A,N/A,1422,1427,N/A,67,5
2,N/A,N/A,N/A,1420,1422,N/A,70,2
1,N/A,N/A,N/A,1419,1420,N/A,75,1
3,N/A,N/A,N/A,1416,1419,N/A,78,4
4,N/A,N/A,N/A,1412,1416,N/A,84,4
3,N/A,N/A,N/A,1409,1412,N/A,88,2
1,N/A,N/A,N/A,1408,1409,N/A,93,1
4,N/A,N/A,N/A,1404,1408,N/A,96,4
4,N/A,N/A,N/A,1400,1404,N/A,102,4
3,N/A,N/A,N/A,1397,1400,N/A,106,2
2,N/A,N/A,N/A,1395,1397,N/A,111,1
1,N/A,N/A,N/A,1394,1395,N/A,117,1
6,N/A,N/A,N/A,1388,1394,N/A,121,5
5,N/A,N/A,N/A,1383,1388,N/A,127,5
3,N/A,N/A,N/A,1380,1383,N/A,132,4
2,N/A,N/A,N/A,1378,1380,N/A,137,3
1,N/A,N/A,N/A,743,744,N/A,6,1
6,N/A,N/A,N/A,737,743,N/A,11,6
2,N/A,N/A,N/A,735,737,N/A,14,3
6,N/A,N/A,N/A,729,735,N/A,17,6
2,N/A,N/A,N/A,727,729,N/A,20,3
6,N/A,N/A,N/A,721,727,N/A,23,6
4,N/A,N/A,N/A,717,721,N/A,27,4
3,N/A,N/A,N/A,714,717,N/A,32,3
6,N/A,N/A,N/A,708,714,N/A,35,6
5,N/A,N/A,N/A,703,708,N/A,40,5
2,N/A,N/A,N/A,701,703,N/A,43,2
3,N/A,N/A,N/A,698,701,N/A,49,2
3,N/A,N/A,N/A,695,698,N/A,55,2
6,N/A,N/A,N/A,689,695,N/A,59,6
2,N/A,N/A,N/A,687,689,N/A,62,3
2,N/A,N/A,N/A,685,687,N/A,67,2
6,N/A,N/A,N/A,679,685,N/A,71,6
3,N/A,N/A,N/A,676,679,N/A,74,3
2,N/A,N/A,N/A,674,676,N/A,80,3
2,N/A,N/A,N/A,672,674,N/A,84,1
2,N/A,N/A,N/A,670,672,N/A,90,1
5,N/A,N/A,N/A,665,670,N/A,94,5
3,N/A,N/A,N/A,662,665,N/A,98,3
7,N/A,N/A,N/A,655,662,N/A,101,6
4,N/A,N/A,N/A,651,655,N/A,105,4
2,N/A,N/A,N/A,649,651,N/A,108,1
5,N/A,N/A,N/A,644,649,N/A,112,5
3,N/A,N/A,N/A,641,644,N/A,116,3
2,N/A,N/A,N/A,639,641,N/A,122,3
2,N/A,N/A,N/A,637,639,N/A,128,3
3,N/A,N/A,N/A,810,813,N/A,3,4
3,N/A,N/A,N/A,807,810,N/A,9,4
1,N/A,N/A,N/A,806,807,N/A,12,1
1,N/A,N/A,N/A,805,806,N/A,18,1
7,N/A,N/A,N/A,798,805,N/A,23,6
2,N/A,N/A,N/A,796,798,N/A,26,3
1,N/A,N/A,N/A,795,796,N/A,30,1
3,N/A,N/A,N/A,792,795,N/A,33,4
2,N/A,N/A,N/A,790,792,N/A,37,2
5,N/A,N/A,N/A,785,790,N/A,40,5
6,N/A,N/A,N/A,779,785,N/A,46,5
5,N/A,N/A,N/A,774,779,N/A,52,5
2,N/A,N/A,N/A,772,774,N/A,56,3
2,N/A,N/A,N/A,770,772,N/A,61,2
2,N/A,N/A,N/A,768,770,N/A,66,1
4,N/A,N/A,N/A,764,768,N/A,69,4
2,N/A,N/A,N/A,762,764,N/A,74,3
3,N/A,N/A,N/A,759,762,N/A,80,3
6,N/A,N/A,N/A,753,759,N/A,83,6
2,N/A,N/A,N/A,751,753,N/A,86,3
2,N/A,N/A,N/A,749,751,N/A,90,1
2,N/A,N/A,N/A,747,749,N/A,96,1
1,N/A,N/A,N/A,746,747,N/A,102,1
6,N/A,N/A,N/A,740,746,N/A,107,6
3,N/A,N/A,N/A,737,740,N/A,110,3
2,N/A,N/A,N/A,735,737,N/A,116,3
6,N/A,N/A,N/A,729,735,N/A,119,6
1,N/A,N/A,N/A,728,729,N/A,125,0
4,N/A,N/A,N/A,724,728,N/A,129,4
4,N/A,N/A,N/A,720,724,N/A,135,4
3,N/A,N/A,N/A,1019,1022,N/A,4,4
1,N/A,N/A,N/A,1018,1019,N/A,7,1
1,N/A,N/A,N/A,1017,1018,N/A,13,1
6,N/A,N/A,N/A,1011,1017,N/A,18,6
3,N/A,N/A,N/A,1008,1011,N/A,22,4
3,N/A,N/A,N/A,1005,1008,N/A,28,4
1,N/A,N/A,N/A,1004,1005,N/A,31,1
1,N/A,N/A,N/A,1003,1004,N/A,37,1
6,N/A,N/A,N/A,997,1003,N/A,42,6
3,N/A,N/A,N/A,994,997,N/A,45,3
3,N/A,N/A,N/A,991,994,N/A,50,2
6,N/A,N/A,N/A,985,991,N/A,53,5
2,N/A,N/A,N/A,983,985,N/A,57,3
6,N/A,N/A,N/A,977,983,N/A,60,6
2,N/A,N/A,N/A,975,977,N/A,66,0
2,N/A,N/A,N/A,973,975,N/A,69,3
2,N/A,N/A,N/A,971,973,N/A,75,3
7,N/A,N/A,N/A,964,971,N/A,78,6
3,N/A,N/A,N/A,961,964,N/A,81,3
2,N/A,N/A,N/A,959,961,N/A,87,3
3,N/A,N/A,N/A,956,959,N/A,92,2
6,N/A,N/A,N/A,950,956,N/A,95,5
3,N/A,N/A,N/A,947,950,N/A,98,2
7,N/A,N/A,N/A,940,947,N/A,102,6
2,N/A,N/A,N/A,938,940,N/A,108,0
4,N/A,N/A,N/A,934,938,N/A,112,4
3,N/A,N/A,N/A,931,934,N/A,117,3
2,N/A,N/A,N/A,929,931,N/A,122,2
2,N/A,N/A,N/A,927,929,N/A,127,1
6,N/A,N/A,N/A,921,927,N/A,132,6
4,N/A,N/A,N/A,548,552,N/A,5,4
2,N/A,N/A,N/A,546,548,N/A,9,2
2,N/A,N/A,N/A,544,546,N/A,14,1
1,N/A,N/A,N/A,543,544,N/A,20,1
4,N/A,N/A,N/A,539,543,N/A,23,4
3,N/A,N/A,N/A,536,539,N/A,27,2
5,N/A,N/A,N/A,531,536,N/A,30,5
3,N/A,N/A,N/A,528,531,N/A,33,2
2,N/A,N/A,N/A,526,528,N/A,39,2
5,N/A,N/A,N/A,521,526,N/A,42,5
5,N/A,N/A,N/A,516,521,N/A,48,5
5,N/A,N/A,N/A,511,516,N/A,54,5
2,N/A,N/A,N/A,509,511,N/A,57,2
2,N/A,N/A,N/A,507,509,N/A,62,1
3,N/A,N/A,N/A,504,507,N/A,65,4
3,N/A,N/A,N/A,501,504,N/A,69,2
2,N/A,N/A,N/A,499,501,N/A,75,2
6,N/A,N/A,N/A,493,499,N/A,79,6
2,N/A,N/A,N/A,491,493,N/A,82,3
2,N/A,N/A,N/A,489,491,N/A,86,1
5,N/A,N/A,N/A,484,489,N/A,90,5
4,N/A,N/A,N/A,480,484,N/A,95,4
3,N/A,N/A,N/A,477,480,N/A,99,2
1,N/A,N/A,N/A,476,477,N/A,104,1
2,N/A,N/A,N/A,474,476,N/A,110,1
6,N/A,N/A,N/A,468,474,N/A,115,6
3,N/A,N/A,N/A,465,468,N/A,118,3
1,N/A,N/A,N/A,464,465,N/A,122,1
6,N/A,N/A,N/A,458,464,N/A,126,5
6,N/A,N/A,N/A,452,458,N/A,132,5
6,N/A,N/A,N/A,962,968,N/A,6,5
2,N/A,N/A,N/A,960,962,N/A,10,3
1,N/A,N/A,N/A,959,960,N/A,14,1
4,N/A,N/A,N/A,955,959,N/A,17,4
2,N/A,N/A,N/A,953,955,N/A,20,1
2,N/A,N/A,N/A,951,953,N/A,26,1
3,N/A,N/A,N/A,948,951,N/A,29,4
2,N/A,N/A,N/A,946,948,N/A,32,1
2,N/A,N/A,N/A,944,946,N/A,38,1
6,N/A,N/A,N/A,938,944,N/A,42,5
3,N/A,N/A,N/A,935,938,N/A,46,3
2,N/A,N/A,N/A,933,935,N/A,50,1
2,N/A,N/A,N/A,931,933,N/A,56,1
4,N/A,N/A,N/A,927,931,N/A,59,4
2,N/A,N/A,N/A,925,927,N/A,63,2
6,N/A,N/A,N/A,919,925,N/A,66,5
6,N/A,N/A,N/A,913,919,N/A,72,5
5,N/A,N/A,N/A,908,913,N/A,78,5
6,N/A,N/A,N/A,902,908,N/A,84,5
4,N/A,N/A,N/A,898,902,N/A,89,4
3,N/A,N/A,N/A,895,898,N/A,95,4
3,N/A,N/A,N/A,892,895,N/A,99,2
7,N/A,N/A,N/A,885,892,N/A,103,6
3,N/A,N/A,N/A,882,885,N/A,107,4
2,N/A,N/A,N/A,880,882,N/A,111,2
1,N/A,N/A,N/A,879,880,N/A,116,1
5,N/A,N/A,N/A,874,879,N/A,120,5
2,N/A,N/A,N/A,872,874,N/A,124,3
6,N/A,N/A,N/A,866,872,N/A,127,6
5,N/A,N/A,N/A,861,866,N/A,132,5
3,N/A,N/A,N/A,1848,1851,N/A,5,4
2,N/A,N/A,N/A,1846,1848,N/A,9,2
5,N/A,N/A,N/A,1841,1846,N/A,12,5
6,N/A,N/A,N/A,1835,1841,N/A,18,5
3,N/A,N/A,N/A,1832,1835,N/A,21,2
6,N/A,N/A,N/A,1826,1832,N/A,24,5
2,N/A,N/A,N/A,1824,1826,N/A,28,3
6,N/A,N/A,N/A,1818,1824,N/A,31,6
6,N/A,N/A,N/A,1812,1818,N/A,36,5
2,N/A,N/A,N/A,1810,1812,N/A,40,3
2,N/A,N/A,N/A,1808,1810,N/A,46,3
2,N/A,N/A,N/A,1806,1808,N/A,50,1
1,N/A,N/A,N/A,1805,1806,N/A,56,1
3,N/A,N/A,N/A,1802,1805,N/A,59,4
2,N/A,N/A,N/A,1800,1802,N/A,64,3
1,N/A,N/A,N/A,1799,1800,N/A,68,1
2,N/A,N/A,N/A,1797,1799,N/A,74,1
6,N/A,N/A,N/A,1791,1797,N/A,79,6
1,N/A,N/A,N/A,1790,1791,N/A,85,0
3,N/A,N/A,N/A,1787,1790,N/A,89,4
2,N/A,N/A,N/A,1785,1787,N/A,93,2
7,N/A,N/A,N/A,1778,1785,N/A,97,6
5,N/A,N/A,N/A,1773,1778,N/A,102,5
3,N/A,N/A,N/A,1770,1773,N/A,105,2
3,N/A,N/A,N/A,1767,1770,N/A,111,2
1,N/A,N/A,N/A,1766,1767,N/A,116,1
4,N/A,N/A,N/A,1762,1766,N/A,119,4
2,N/A,N/A,N/A,1760,1762,N/A,122,1
2,N/A,N/A,N/A,1758,1760,N/A,128,1
6,N/A,N/A,N/A,1752,1758,N/A,133,6
1,N/A,N/A,N/A,368,369,N/A,6,1
6,N/A,N/A,N/A,362,368,N/A,10,5
3,N/A,N/A,N/A,359,362,N/A,13,2
2,N/A,N/A,N/A,357,359,N/A,19,2
1,N/A,N/A,N/A,356,357,N/A,24,1
4,N/A,N/A,N/A,352,356,N/A,27,4
1,N/A,N/A,N/A,351,352,N/A,30,1
3,N/A,N/A,N/A,348,351,N/A,33,4
3,N/A,N/A,N/A,345,348,N/A,39,4
4,N/A,N/A,N/A,341,345,N/A,45,4
1,N/A,N/A,N/A,340,341,N/A,48,1
6,N/A,N/A,N/A,334,340,N/A,52,5
3,N/A,N/A,N/A,331,334,N/A,55,2
6,N/A,N/A,N/A,325,331,N/A,59,6
5,N/A,N/A,N/A,320,325,N/A,64,5
3,N/A,N/A,N/A,317,320,N/A,69,4
2,N/A,N/A,N/A,315,317,N/A,74,3
2,N/A,N/A,N/A,313,315,N/A,79,2
6,N/A,N/A,N/A,307,313,N/A,82,5
2,N/A,N/A,N/A,305,307,N/A,85,2
6,N/A,N/A,N/A,299,305,N/A,89,6
6,N/A,N/A,N/A,293,299,N/A,94,5
4,N/A,N/A,N/A,289,293,N/A,99,4
2,N/A,N/A,N/A,287,289,N/A,102,1
7,N/A,N/A,N/A,280,287,N/A,107,6
5,N/A,N/A,N/A,275,280,N/A,112,5
5,N/A,N/A,N/A,270,275,N/A,118,5
2,N/A,N/A,N/A,268,270,N/A,121,2
2,N/A,N/A,N/A,266,268,N/A,126,1
2,N/A,N/A,N/A,264,266,N/A,132,1
5,N/A,N/A,N/A,1784,1789,N/A,4,5
4,N/A,N/A,N/A,1780,1784,N/A,9,4
4,N/A,N/A,N/A,1776,1780,N/A,15,4
2,N/A,N/A,N/A,1774,1776,N/A,20,3
2,N/A,N/A,N/A,1772,1774,N/A,26,3
7,N/A,N/A,N/A,1765,1772,N/A,29,6
5,N/A,N/A,N/A,1760,1765,N/A,34,5
4,N/A,N/A,N/A,1756,1760,N/A,39,4
4,N/A,N/A,N/A,1752,1756,N/A,45,4
3,N/A,N/A,N/A,1749,1752,N/A,50,3
2,N/A,N/A,N/A,1747,1749,N/A,55,2
5,N/A,N/A,N/A,1742,1747,N/A,58,5
3,N/A,N/A,N/A,1739,1742,N/A,63,4
3,N/A,N/A,N/A,1736,1739,N/A,67,2
7,N/A,N/A,N/A,1729,1736,N/A,71,6
5,N/A,N/A,N/A,1724,1729,N/A,76,5
3,N/A,N/A,N/A,1721,1724,N/A,79,2
6,N/A,N/A,N/A,1715,1721,N/A,83,6
3,N/A,N/A,N/A,1712,1715,N/A,87,4
1,N/A,N/A,N/A,1711,1712,N/A,90,1
6,N/A,N/A,N/A,1705,1711,N/A,95,6
6,N/A,N/A,N/A,1699,1705,N/A,100,5
5,N/A,N/A,N/A,1694,1699,N/A,106,5
3,N/A,N/A,N/A,1691,1694,N/A,110,3
2,N/A,N/A,N/A,1689,1691,N/A,116,3
3,N/A,N/A,N/A,1686,1689,N/A,121,2
3,N/A,N/A,N/A,1683,1686,N/A,127,2
7,N/A,N/A,N/A,1676,1683,N/A,131,6
1,N/A,N/A,N/A,1675,1676,N/A,137,0
5,N/A,N/A,N/A,1670,1675,N/A,142,5
5,N/A,N/A,N/A,1750,1755,N/A,5,5
5,N/A,N/A,N/A,1745,1750,N/A,11,5
3,N/A,N/A,N/A,1742,1745,N/A,16,4
3,N/A,N/A,N/A,1739,1742,N/A,21,3
3,N/A,N/A,N/A,1736,1739,N/A,27,3
2,N/A,N/A,N/A,1734,1736,N/A,32,2
1,N/A,N/A,N/A,1733,1734,N/A,37,1
3,N/A,N/A,N/A,1730,1733,N/A,40,4
1,N/A,N/A,N/A,1729,1730,N/A,43,1
4,N/A,N/A,N/A,1725,1729,N/A,46,4
2,N/A,N/A,N/A,1723,1725,N/A,51,3
2,N/A,N/A,N/A,1721,1723,N/A,55,1
7,N/A,N/A,N/A,1714,1721,N/A,60,6
4,N/A,N/A,N/A,1710,1714,N/A,64,4
2,N/A,N/A,N/A,1708,1710,N/A,67,1
1,N/A,N/A,N/A,1707,1708,N/A,73,1
2,N/A,N/A,N/A,1705,1707,N/A,79,1
5,N/A,N/A,N/A,1700,1705,N/A,83,5
2,N/A,N/A,N/A,1698,1700,N/A,86,2
6,N/A,N/A,N/A,1692,1698,N/A,89,5
3,N/A,N/A,N/A,1689,1692,N/A,94,4
2,N/A,N/A,N/A,1687,1689,N/A,97,1
6,N/A,N/A,N/A,1681,1687,N/A,102,6
2,N/A,N/A,N/A,1679,1681,N/A,108,0
7,N/A,N/A,N/A,1672,1679,N/A,114,6
5,N/A,N/A,N/A,1667,1672,N/A,119,5
4,N/A,N/A,N/A,1663,1667,N/A,124,4
3,N/A,N/A,N/A,1660,1663,N/A,129,3
1,N/A,N/A,N/A,1659,1660,N/A,133,1
3,N/A,N/A,N/A,1656,1659,N/A,136,4
6,N/A,N/A,N/A,299,305,N/A,6,6
2,N/A,N/A,N/A,297,299,N/A,12,0
3,N/A,N/A,N/A,294,297,N/A,16,4
2,N/A,N/A,N/A,292,294,N/A,19,1
1,N/A,N/A,N/A,291,292,N/A,25,1
6,N/A,N/A,N/A,285,291,N/A,30,6
3,N/A,N/A,N/A,282,285,N/A,34,4
2,N/A,N/A,N/A,280,282,N/A,38,2
2,N/A,N/A,N/A,278,280,N/A,44,2
2,N/A,N/A,N/A,276,278,N/A,49,1
2,N/A,N/A,N/A,274,276,N/A,55,1
5,N/A,N/A,N/A,269,274,N/A,59,5
2,N/A,N/A,N/A,267,269,N/A,62,2
2,N/A,N/A,N/A,265,267,N/A,67,1
1,N/A,N/A,N/A,264,265,N/A,73,1
2,N/A,N/A,N/A,262,264,N/A,79,1
6,N/A,N/A,N/A,256,262,N/A,83,5
2,N/A,N/A,N/A,254,256,N/A,87,3
2,N/A,N/A,N/A,252,254,N/A,91,1
4,N/A,N/A,N/A,248,252,N/A,94,4
2,N/A,N/A,N/A,246,248,N/A,99,3
2,N/A,N/A,N/A,244,246,N/A,103,1
5,N/A,N/A,N/A,239,244,N/A,107,5
3,N/A,N/A,N/A,236,239,N/A,111,3
2,N/A,N/A,N/A,234,236,N/A,117,3
2,N/A,N/A,N/A,232,234,N/A,123,3
1,N/A,N/A,N/A,231,232,N/A,127,1
2,N/A,N/A,N/A,229,231,N/A,133,1
1,N/A,N/A,N/A,228,229,N/A,139,1
6,N/A,N/A,N/A,222,228,N/A,143,5
1,N/A,N/A,N/A,1773,1774,N/A,3,1
4,N/A,N/A,N/A,1769,1773,N/A,6,4
2,N/A,N/A,N/A,1767,1769,N/A,9,1
6,N/A,N/A,N/A,1761,1767,N/A,14,6
3,N/A,N/A,N/A,1758,1761,N/A,18,4
2,N/A,N/A,N/A,1756,1758,N/A,21,1
6,N/A,N/A,N/A,1750,1756,N/A,26,6
4,N/A,N/A,N/A,1746,1750,N/A,30,4
3,N/A,N/A,N/A,1743,1746,N/A,35,3
3,N/A,N/A,N/A,1740,1743,N/A,41,3
2,N/A,N/A,N/A,1738,1740,N/A,47,3
1,N/A,N/A,N/A,1737,1738,N/A,51,1
4,N/A,N/A,N/A,1733,1737,N/A,54,4
4,N/A,N/A,N/A,1729,1733,N/A,60,4
2,N/A,N/A,N/A,1727,1729,N/A,65,3
3,N/A,N/A,N/A,1724,1727,N/A,71,3
3,N/A,N/A,N/A,1721,1724,N/A,77,3
3,N/A,N/A,N/A,1718,1721,N/A,83,3
3,N/A,N/A,N/A,1715,1718,N/A,89,3
1,N/A,N/A,N/A,1714,1715,N/A,93,1
6,N/A,N/A,N/A,1708,1714,N/A,98,6
6,N/A,N/A,N/A,1702,1708,N/A,103,5
3,N/A,N/A,N/A,1699,1702,N/A,106,2
1,N/A,N/A,N/A,1698,1699,N/A,111,1
6,N/A,N/A,N/A,1692,1698,N/A,115,5
3,N/A,N/A,N/A,1689,1692,N/A,120,4
2,N/A,N/A,N/A,1687,1689,N/A,123,1
6,N/A,N/A,N/A,1681,1687,N/A,128,6
4,N/A,N/A,N/A,1677,1681,N/A,132,4
2,N/A,N/A,N/A,1675,1677,N/A,137,3
1,N/A,N/A,N/A,1507,1508,N/A,6,1
5,N/A,N/A,N/A,1502,1507,N/A,10,5
3,N/A,N/A,N/A,1499,1502,N/A,13,2
5,N/A,N/A,N/A,1494,1499,N/A,16,5
6,N/A,N/A,N/A,1488,1494,N/A,22,5
5,N/A,N/A,N/A,1483,1488,N/A,28,5
2,N/A,N/A,N/A,1481,1483,N/A,31,2
1,N/A,N/A,N/A,1480,1481,N/A,36,1
7,N/A,N/A,N/A,1473,1480,N/A,41,6
6,N/A,N/A,N/A,1467,1473,N/A,46,5
2,N/A,N/A,N/A,1465,1467,N/A,50,3
6,N/A,N/A,N/A,1459,1465,N/A,53,6
5,N/A,N/A,N/A,1454,1459,N/A,58,5
5,N/A,N/A,N/A,1449,1454,N/A,64,5
2,N/A,N/A,N/A,1447,1449,N/A,67,2
6,N/A,N/A,N/A,1441,1447,N/A,70,5
3,N/A,N/A,N/A,1438,1441,N/A,73,2
6,N/A,N/A,N/A,1432,1438,N/A,77,6
3,N/A,N/A,N/A,1429,1432,N/A,81,4
1,N/A,N/A,N/A,1428,1429,N/A,84,1
1,N/A,N/A,N/A,1427,1428,N/A,90,1
6,N/A,N/A,N/A,1421,1427,N/A,94,5
4,N/A,N/A,N/A,1417,1421,N/A,99,4
2,N/A,N/A,N/A,1415,1417,N/A,102,1
1,N/A,N/A,N/A,1414,1415,N/A,108,1
6,N/A,N/A,N/A,1408,1414,N/A,112,5
4,N/A,N/A,N/A,1404,1408,N/A,117,4
3,N/A,N/A,N/A,1401,1404,N/A,121,2
2,N/A,N/A,N/A,1399,1401,N/A,126,1
3,N/A,N/A,N/A,1396,1399,N/A,129,4
5,N/A,N/A,N/A,1768,1773,N/A,5,5
3,N/A,N/A,N/A,1765,1768,N/A,8,2
7,N/A,N/A,N/A,1758,1765,N/A,12,6
3,N/A,N/A,N/A,1755,1758,N/A,15,3
3,N/A,N/A,N/A,1752,1755,N/A,21,3
1,N/A,N/A,N/A,1751,1752,N/A,25,1
7,N/A,N/A,N/A,1744,1751,N/A,30,6
5,N/A,N/A,N/A,1739,1744,N/A,35,5
6,N/A,N/A,N/A,1733,1739,N/A,41,5
5,N/A,N/A,N/A,1728,1733,N/A,47,5
2,N/A,N/A,N/A,1726,1728,N/A,51,3
1,N/A,N/A,N/A,1725,1726,N/A,55,1
5,N/A,N/A,N/A,1720,1725,N/A,59,5
2,N/A,N/A,N/A,1718,1720,N/A,62,2
6,N/A,N/A,N/A,1712,1718,N/A,65,5
2,N/A,N/A,N/A,1710,1712,N/A,69,3
2,N/A,N/A,N/A,1708,1710,N/A,73,1
5,N/A,N/A,N/A,1703,1708,N/A,77,5
3,N/A,N/A,N/A,1700,1703,N/A,80,2
5,N/A,N/A,N/A,1695,1700,N/A,83,5
2,N/A,N/A,N/A,1693,1695,N/A,86,2
2,N/A,N/A,N/A,1691,1693,N/A,92,2
2,N/A,N/A,N/A,1689,1691,N/A,98,2
6,N/A,N/A,N/A,1683,1689,N/A,101,5
2,N/A,N/A,N/A,1681,1683,N/A,105,3
6,N/A,N/A,N/A,1675,1681,N/A,108,6
5,N/A,N/A,N/A,1670,1675,N/A,113,5
2,N/A,N/A,N/A,1668,1670,N/A,117,3
3,N/A,N/A,N/A,1665,1668,N/A,122,2
2,N/A,N/A,N/A,1663,1665,N/A,127,1
4,N/A,N/A,N/A,757,761,N/A,3,4
2,N/A,N/A,N/A,755,757,N/A,6,1
5,N/A,N/A,N/A,750,755,N/A,10,5
3,N/A,N/A,N/A,747,750,N/A,14,3
7,N/A,N/A,N/A,740,747,N/A,17,6
2,N/A,N/A,N/A,738,740,N/A,23,0
6,N/A,N/A,N/A,732,738,N/A,29,6
1,N/A,N/A,N/A,731,732,N/A,35,0
3,N/A,N/A,N/A,728,731,N/A,39,4
2,N/A,N/A,N/A,726,728,N/A,43,2
3,N/A,N/A,N/A,723,726,N/A,49,2
6,N/A,N/A,N/A,717,723,N/A,53,6
3,N/A,N/A,N/A,714,717,N/A,57,4
3,N/A,N/A,N/A,711,714,N/A,62,3
1,N/A,N/A,N/A,710,711,N/A,66,1
6,N/A,N/A,N/A,704,710,N/A,70,5
3,N/A,N/A,N/A,701,704,N/A,73,2
1,N/A,N/A,N/A,700,701,N/A,78,1
6,N/A,N/A,N/A,694,700,N/A,82,5
3,N/A,N/A,N/A,691,694,N/A,87,4
3,N/A,N/A,N/A,688,691,N/A,91,2
2,N/A,N/A,N/A,686,688,N/A,97,2
2,N/A,N/A,N/A,684,686,N/A,103,2
2,N/A,N/A,N/A,682,684,N/A,108,1
6,N/A,N/A,N/A,676,682,N/A,112,5
2,N/A,N/A,N/A,674,676,N/A,116,3
3,N/A,N/A,N/A,671,674,N/A,121,2
2,N/A,N/A,N/A,669,671,N/A,127,2
1,N/A,N/A,N/A,668,669,N/A,132,1
6,N/A,N/A,N/A,662,668,N/A,136,5
3,N/A,N/A,N/A,1843,1846,N/A,3,4
3,N/A,N/A,N/A,1840,1843,N/A,9,4
2,N/A,N/A,N/A,1838,1840,N/A,12,1
6,N/A,N/A,N/A,1832,1838,N/A,17,6
2,N/A,N/A,N/A,1830,1832,N/A,20,3
2,N/A,N/A,N/A,1828,1830,N/A,26,3
6,N/A,N/A,N/A,1822,1828,N/A,29,6
3,N/A,N/A,N/A,1819,1822,N/A,32,3
7,N/A,N/A,N/A,1812,1819,N/A,35,6
2,N/A,N/A,N/A,1810,1812,N/A,41,0
7,N/A,N/A,N/A,1803,1810,N/A,47,6
6,N/A,N/A,N/A,1797,1803,N/A,52,5
5,N/A,N/A,N/A,1792,1797,N/A,58,5
3,N/A,N/A,N/A,1789,1792,N/A,62,3
2,N/A,N/A,N/A,1787,1789,N/A,68,3
6,N/A,N/A,N/A,1781,1787,N/A,71,6
5,N/A,N/A,N/A,1776,1781,N/A,76,5
6,N/A,N/A,N/A,1770,1776,N/A,82,5
5,N/A,N/A,N/A,1765,1770,N/A,88,5
4,N/A,N/A,N/A,1761,1765,N/A,93,4
3,N/A,N/A,N/A,1758,1761,N/A,97,2
6,N/A,N/A,N/A,1752,1758,N/A,101,6
6,N/A,N/A,N/A,1746,1752,N/A,106,5
3,N/A,N/A,N/A,1743,1746,N/A,111,4
4,N/A,N/A,N/A,1739,1743,N/A,117,4
3,N/A,N/A,N/A,1736,1739,N/A,123,4
4,N/A,N/A,N/A,1732,1736,N/A,129,4
2,N/A,N/A,N/A,1730,1732,N/A,134,3
2,N/A,N/A,N/A,1728,1730,N/A,138,1
7,N/A,N/A,N/A,1721,1728,N/A,143,6
2,N/A,N/A,N/A,1923,1925,N/A,6,2
7,N/A,N/A,N/A,1916,1923,N/A,10,6
1,N/A,N/A,N/A,1915,1916,N/A,16,0
7,N/A,N/A,N/A,1908,1915,N/A,22,6
6,N/A,N/A,N/A,1902,1908,N/A,27,5
2,N/A,N/A,N/A,1900,1902,N/A,30,2
1,N/A,N/A,N/A,1899,1900,N/A,35,1
2,N/A,N/A,N/A,1897,1899,N/A,41,1
4,N/A,N/A,N/A,1893,1897,N/A,44,4
4,N/A,N/A,N/A,1889,1893,N/A,50,4
3,N/A,N/A,N/A,1886,1889,N/A,54,2
2,N/A,N/A,N/A,1884,1886,N/A,59,1
2,N/A,N/A,N/A,1882,1884,N/A,65,1
1,N/A,N/A,N/A,1881,1882,N/A,71,1
1,N/A,N/A,N/A,1880,1881,N/A,77,1
5,N/A,N/A,N/A,1875,1880,N/A,81,5
3,N/A,N/A,N/A,1872,1875,N/A,85,3
2,N/A,N/A,N/A,1870,1872,N/A,90,2
5,N/A,N/A,N/A,1865,1870,N/A,93,5
2,N/A,N/A,N/A,1863,1865,N/A,96,2
1,N/A,N/A,N/A,1862,1863,N/A,101,1
2,N/A,N/A,N/A,1860,1862,N/A,107,1
1,N/A,N/A,N/A,1859,1860,N/A,113,1
2,N/A,N/A,N/A,1857,1859,N/A,119,1
5,N/A,N/A,N/A,1852,1857,N/A,123,5
6,N/A,N/A,N/A,1846,1852,N/A,129,5
3,N/A,N/A,N/A,1843,1846,N/A,133,3
2,N/A,N/A,N/A,1841,1843,N/A,139,3
6,N/A,N/A,N/A,1835,1841,N/A,142,6
2,N/A,N/A,N/A,1833,1835,N/A,145,3
2,N/A,N/A,N/A,1417,1419,N/A,4,2
3,N/A,N/A,N/A,1414,1417,N/A,10,2
2,N/A,N/A,N/A,1412,1414,N/A,16,2
2,N/A,N/A,N/A,1410,1412,N/A,21,1
1,N/A,N/A,N/A,1409,1410,N/A,27,1
2,N/A,N/A,N/A,1407,1409,N/A,33,1
6,N/A,N/A,N/A,1401,1407,N/A,37,5
2,N/A,N/A,N/A,1399,1401,N/A,41,3
3,N/A,N/A,N/A,1396,1399,N/A,47,3
2,N/A,N/A,N/A,1394,1396,N/A,53,3
6,N/A,N/A,N/A,1388,1394,N/A,56,6
1,N/A,N/A,N/A,1387,1388,N/A,62,0
2,N/A,N/A,N/A,1385,1387,N/A,65,3
1,N/A,N/A,N/A,1384,1385,N/A,69,1
3,N/A,N/A,N/A,1381,1384,N/A,72,4
3,N/A,N/A,N/A,1378,1381,N/A,77,3
3,N/A,N/A,N/A,1375,1378,N/A,82,2
2,N/A,N/A,N/A,1373,1375,N/A,87,1
6,N/A,N/A,N/A,1367,1373,N/A,92,6
3,N/A,N/A,N/A,1364,1367,N/A,96,4
2,N/A,N/A,N/A,1362,1364,N/A,100,2
1,N/A,N/A,N/A,1361,1362,N/A,105,1
7,N/A,N/A,N/A,1354,1361,N/A,110,6
3,N/A,N/A,N/A,1351,1354,N/A,113,3
3,N/A,N/A,N/A,1348,1351,N/A,118,2
2,N/A,N/A,N/A,1346,1348,N/A,124,2
3,N/A,N/A,N/A,1343,1346,N/A,130,2
7,N/A,N/A,N/A,1336,1343,N/A,134,6
2,N/A,N/A,N/A,1334,1336,N/A,140,0
6,N/A,N/A,N/A,1328,1334,N/A,146,6
5,N/A,N/A,N/A,831,836,N/A,5,5
4,N/A,N/A,N/A,827,831,N/A,10,4
2,N/A,N/A,N/A,825,827,N/A,15,3
6,N/A,N/A,N/A,819,825,N/A,18,6
4,N/A,N/A,N/A,815,819,N/A,22,4
3,N/A,N/A,N/A,812,815,N/A,27,3
2,N/A,N/A,N/A,810,812,N/A,33,3
3,N/A,N/A,N/A,807,810,N/A,39,3
7,N/A,N/A,N/A,800,807,N/A,42,6
3,N/A,N/A,N/A,797,800,N/A,45,3
1,N/A,N/A,N/A,796,797,N/A,49,1
4,N/A,N/A,N/A,792,796,N/A,52,4
1,N/A,N/A,N/A,791,792,N/A,55,1
5,N/A,N/A,N/A,786,791,N/A,59,5
2,N/A,N/A,N/A,784,786,N/A,62,2
2,N/A,N/A,N/A,782,784,N/A,68,2
1,N/A,N/A,N/A,781,782,N/A,73,1
4,N/A,N/A,N/A,777,781,N/A,76,4
3,N/A,N/A,N/A,774,777,N/A,80,2
7,N/A,N/A,N/A,767,774,N/A,84,6
3,N/A,N/A,N/A,764,767,N/A,87,3
7,N/A,N/A,N/A,757,764,N/A,90,6
3,N/A,N/A,N/A,754,757,N/A,94,4
2,N/A,N/A,N/A,752,754,N/A,98,2
2,N/A,N/A,N/A,750,752,N/A,104,2
6,N/A,N/A,N/A,744,750,N/A,108,6
2,N/A,N/A,N/A,742,744,N/A,111,3
3,N/A,N/A,N/A,739,742,N/A,116,2
2,N/A,N/A,N/A,737,739,N/A,122,2
6,N/A,N/A,N/A,731,737,N/A,125,5
2,N/A,N/A,N/A,1440,1442,N/A,3,2
1,N/A,N/A,N/A,1439,1440,N/A,8,1
7,N/A,N/A,N/A,1432,1439,N/A,13,6
3,N/A,N/A,N/A,1429,1432,N/A,16,3
2,N/A,N/A,N/A,1427,1429,N/A,20,1
2,N/A,N/A,N/A,1425,1427,N/A,26,1
5,N/A,N/A,N/A,1420,1425,N/A,30,5
2,N/A,N/A,N/A,1418,1420,N/A,33,2
3,N/A,N/A,N/A,1415,1418,N/A,39,2
6,N/A,N/A,N/A,1409,1415,N/A,43,6
4,N/A,N/A,N/A,1405,1409,N/A,47,4
2,N/A,N/A,N/A,1403,1405,N/A,51,2
5,N/A,N/A,N/A,1398,1403,N/A,54,5
2,N/A,N/A,N/A,1396,1398,N/A,58,3
3,N/A,N/A,N/A,1393,1396,N/A,63,2
2,N/A,N/A,N/A,1391,1393,N/A,68,1
6,N/A,N/A,N/A,1385,1391,N/A,72,5
4,N/A,N/A,N/A,1381,1385,N/A,77,4
2,N/A,N/A,N/A,1379,1381,N/A,82,3
7,N/A,N/A,N/A,1372,1379,N/A,85,6
1,N/A,N/A,N/A,1371,1372,N/A,91,0
4,N/A,N/A,N/A,1367,1371,N/A,95,4
1,N/A,N/A,N/A,1366,1367,N/A,98,1
4,N/A,N/A,N/A,1362,1366,N/A,101,4
2,N/A,N/A,N/A,1360,1362,N/A,104,1
6,N/A,N/A,N/A,1354,1360,N/A,108,5
3,N/A,N/A,N/A,1351,1354,N/A,112,3
2,N/A,N/A,N/A,1349,1351,N/A,118,3
2,N/A,N/A,N/A,1347,1349,N/A,124,3
3,N/A,N/A,N/A,1344,1347,N/A,129,2
3,N/A,N/A,N/A,1189,1192,N/A,6,3
2,N/A,N/A,N/A,1187,1189,N/A,10,1
5,N/A,N/A,N/A,1182,1187,N/A,14,5
4,N/A,N/A,N/A,1178,1182,N/A,19,4
3,N/A,N/A,N/A,1175,1178,N/A,24,3
1,N/A,N/A,N/A,1174,1175,N/A,28,1
4,N/A,N/A,N/A,1170,1174,N/A,31,4
4,N/A,N/A,N/A,1166,1170,N/A,37,4
3,N/A,N/A,N/A,1163,1166,N/A,42,3
2,N/A,N/A,N/A,1161,1163,N/A,47,2
1,N/A,N/A,N/A,1160,1161,N/A,52,1
7,N/A,N/A,N/A,1153,1160,N/A,57,6
5,N/A,N/A,N/A,1148,1153,N/A,62,5
6,N/A,N/A,N/A,1142,1148,N/A,68,5
5,N/A,N/A,N/A,1137,1142,N/A,74,5
2,N/A,N/A,N/A,1135,1137,N/A,78,3
7,N/A,N/A,N/A,1128,1135,N/A,81,6
1,N/A,N/A,N/A,1127,1128,N/A,87,0
5,N/A,N/A,N/A,1122,1127,N/A,92,5
2,N/A,N/A,N/A,1120,1122,N/A,96,3
2,N/A,N/A,N/A,1118,1120,N/A,102,3
7,N/A,N/A,N/A,1111,1118,N/A,105,6
5,N/A,N/A,N/A,1106,1111,N/A,110,5
3,N/A,N/A,N/A,1103,1106,N/A,114,3
3,N/A,N/A,N/A,1100,1103,N/A,120,3
2,N/A,N/A,N/A,1098,1100,N/A,124,1
3,N/A,N/A,N/A,1095,1098,N/A,127,4
2,N/A,N/A,N/A,1093,1095,N/A,132,3
7,N/A,N/A,N/A,1086,1093,N/A,135,6
2,N/A,N/A,N/A,1084,1086,N/A,141,0
3,N/A,N/A,N/A,628,631,N/A,5,4
3,N/A,N/A,N/A,625,628,N/A,11,4
1,N/A,N/A,N/A,624,625,N/A,14,1
7,N/A,N/A,N/A,617,624,N/A,19,6
1,N/A,N/A,N/A,616,617,N/A,25,0
6,N/A,N/A,N/A,610,616,N/A,31,6
2,N/A,N/A,N/A,608,610,N/A,34,3
6,N/A,N/A,N/A,602,608,N/A,37,6
3,N/A,N/A,N/A,599,602,N/A,41,4
2,N/A,N/A,N/A,597,599,N/A,44,1
6,N/A,N/A,N/A,591,597,N/A,48,5
4,N/A,N/A,N/A,587,591,N/A,53,4
2,N/A,N/A,N/A,585,587,N/A,56,1
5,N/A,N/A,N/A,580,585,N/A,60,5
2,N/A,N/A,N/A,578,580,N/A,63,2
2,N/A,N/A,N/A,576,578,N/A,68,1
3,N/A,N/A,N/A,573,576,N/A,71,4
3,N/A,N/A,N/A,570,573,N/A,75,2
7,N/A,N/A,N/A,563,570,N/A,79,6
6,N/A,N/A,N/A,557,563,N/A,84,5
4,N/A,N/A,N/A,553,557,N/A,89,4
2,N/A,N/A,N/A,551,553,N/A,92,1
3,N/A,N/A,N/A,548,551,N/A,95,4
1,N/A,N/A,N/A,547,548,N/A,98,1
5,N/A,N/A,N/A,542,547,N/A,102,5
3,N/A,N/A,N/A,539,542,N/A,107,4
4,N/A,N/A,N/A,535,539,N/A,113,4
2,N/A,N/A,N/A,533,535,N/A,116,1
1,N/A,N/A,N/A,532,533,N/A,122,1
7,N/A,N/A,N/A,525,532,N/A,127,6
6,N/A,N/A,N/A,831,837,N/A,4,5
2,N/A,N/A,N/A,829,831,N/A,8,3
2,N/A,N/A,N/A,827,829,N/A,12,1
7,N/A,N/A,N/A,820,827,N/A,17,6
2,N/A,N/A,N/A,818,820,N/A,20,3
1,N/A,N/A,N/A,817,818,N/A,24,1
7,N/A,N/A,N/A,810,817,N/A,29,6
1,N/A,N/A,N/A,809,810,N/A,35,0
4,N/A,N/A,N/A,805,809,N/A,39,4
2,N/A,N/A,N/A,803,805,N/A,42,1
4,N/A,N/A,N/A,799,803,N/A,45,4
2,N/A,N/A,N/A,797,799,N/A,48,1
1,N/A,N/A,N/A,796,797,N/A,54,1
4,N/A,N/A,N/A,792,796,N/A,57,4
3,N/A,N/A,N/A,789,792,N/A,61,2
2,N/A,N/A,N/A,787,789,N/A,67,2
6,N/A,N/A,N/A,781,787,N/A,71,6
3,N/A,N/A,N/A,778,781,N/A,74,3
2,N/A,N/A,N/A,776,778,N/A,78,1
7,N/A,N/A,N/A,769,776,N/A,83,6
3,N/A,N/A,N/A,766,769,N/A,87,4
2,N/A,N/A,N/A,764,766,N/A,92,3
3,N/A,N/A,N/A,761,764,N/A,97,2
2,N/A,N/A,N/A,759,761,N/A,102,1
7,N/A,N/A,N/A,752,759,N/A,107,6
2,N/A,N/A,N/A,750,752,N/A,113,0
3,N/A,N/A,N/A,747,750,N/A,116,3
7,N/A,N/A,N/A,740,747,N/A,119,6
3,N/A,N/A,N/A,737,740,N/A,123,4
3,N/A,N/A,N/A,734,737,N/A,128,3
3,N/A,N/A,N/A,379,382,N/A,5,4
3,N/A,N/A,N/A,376,379,N/A,9,2
2,N/A,N/A,N/A,374,376,N/A,14,1
3,N/A,N/A,N/A,371,374,N/A,17,4
2,N/A,N/A,N/A,369,371,N/A,20,1
4,N/A,N/A,N/A,365,369,N/A,23,4
4,N/A,N/A,N/A,361,365,N/A,29,4
3,N/A,N/A,N/A,358,361,N/A,35,4
4,N/A,N/A,N/A,354,358,N/A,41,4
3,N/A,N/A,N/A,351,354,N/A,47,4
1,N/A,N/A,N/A,350,351,N/A,50,1
6,N/A,N/A,N/A,344,350,N/A,55,6
2,N/A,N/A,N/A,342,344,N/A,58,3
2,N/A,N/A,N/A,340,342,N/A,63,2
6,N/A,N/A,N/A,334,340,N/A,66,5
6,N/A,N/A,N/A,328,334,N/A,72,5
2,N/A,N/A,N/A,326,328,N/A,76,3
2,N/A,N/A,N/A,324,326,N/A,80,1
6,N/A,N/A,N/A,318,324,N/A,84,5
5,N/A,N/A,N/A,313,318,N/A,90,5
2,N/A,N/A,N/A,311,313,N/A,94,3
3,N/A,N/A,N/A,308,311,N/A,100,3
6,N/A,N/A,N/A,302,308,N/A,103,6
1,N/A,N/A,N/A,301,302,N/A,109,0
3,N/A,N/A,N/A,298,301,N/A,112,3
7,N/A,N/A,N/A,291,298,N/A,115,6
6,N/A,N/A,N/A,285,291,N/A,120,5
2,N/A,N/A,N/A,283,285,N/A,123,2
7,N/A,N/A,N/A,276,283,N/A,127,6
2,N/A,N/A,N/A,274,276,N/A,130,3
2,N/A,N/A,N/A,1516,1518,N/A,3,3
2,N/A,N/A,N/A,1514,1516,N/A,7,1
4,N/A,N/A,N/A,1510,1514,N/A,10,4
2,N/A,N/A,N/A,1508,1510,N/A,15,3
7,N/A,N/A,N/A,1501,1508,N/A,18,6
2,N/A,N/A,N/A,1499,1501,N/A,21,3
2,N/A,N/A,N/A,1497,1499,N/A,26,2
2,N/A,N/A,N/A,1495,1497,N/A,31,1
7,N/A,N/A,N/A,1488,1495,N/A,36,6
3,N/A,N/A,N/A,1485,1488,N/A,40,4
2,N/A,N/A,N/A,1483,1485,N/A,45,3
2,N/A,N/A,N/A,1481,1483,N/A,49,1
7,N/A,N/A,N/A,1474,1481,N/A,54,6
2,N/A,N/A,N/A,1472,1474,N/A,57,3
2,N/A,N/A,N/A,1470,1472,N/A,62,2
6,N/A,N/A,N/A,1464,1470,N/A,66,6
2,N/A,N/A,N/A,1462,1464,N/A,72,0
3,N/A,N/A,N/A,1459,1462,N/A,76,4
3,N/A,N/A,N/A,1456,1459,N/A,80,2
2,N/A,N/A,N/A,1454,1456,N/A,86,2
2,N/A,N/A,N/A,1452,1454,N/A,92,2
3,N/A,N/A,N/A,1449,1452,N/A,98,2
1,N/A,N/A,N/A,1448,1449,N/A,103,1
7,N/A,N/A,N/A,1441,1448,N/A,108,6
5,N/A,N/A,N/A,1436,1441,N/A,113,5
5,N/A,N/A,N/A,1431,1436,N/A,119,5
3,N/A,N/A,N/A,1428,1431,N/A,124,4
2,N/A,N/A,N/A,1426,1428,N/A,129,3
3,N/A,N/A,N/A,1423,1426,N/A,134,2
2,N/A,N/A,N/A,1421,1423,N/A,139,1
2,N/A,N/A,N/A,1472,1474,N/A,3,1
5,N/A,N/A,N/A,1467,1472,N/A,7,5
6,N/A,N/A,N/A,1461,1467,N/A,13,5
3,N/A,N/A,N/A,1458,1461,N/A,17,3
3,N/A,N/A,N/A,1455,1458,N/A,22,2
3,N/A,N/A,N/A,1452,1455,N/A,28,2
6,N/A,N/A,N/A,1446,1452,N/A,32,6
4,N/A,N/A,N/A,1442,1446,N/A,36,4
2,N/A,N/A,N/A,1440,1442,N/A,39,1
6,N/A,N/A,N/A,1434,1440,N/A,44,6
2,N/A,N/A,N/A,1432,1434,N/A,50,0
3,N/A,N/A,N/A,1429,1432,N/A,54,4
1,N/A,N/A,N/A,1428,1429,N/A,57,1
4,N/A,N/A,N/A,1424,1428,N/A,60,4
3,N/A,N/A,N/A,1421,1424,N/A,66,4
3,N/A,N/A,N/A,1418,1421,N/A,70,2
7,N/A,N/A,N/A,1411,1418,N/A,74,6
1,N/A,N/A,N/A,1410,1411,N/A,80,0
6,N/A,N/A,N/A,1404,1410,N/A,86,6
5,N/A,N/A,N/A,1399,1404,N/A,91,5
5,N/A,N/A,N/A,1394,1399,N/A,97,5
2,N/A,N/A,N/A,1392,1394,N/A,101,3
7,N/A,N/A,N/A,1385,1392,N/A,104,6
3,N/A,N/A,N/A,1382,1385,N/A,108,4
2,N/A,N/A,N/A,1380,1382,N/A,112,2
6,N/A,N/A,N/A,1374,1380,N/A,115,5
3,N/A,N/A,N/A,1371,1374,N/A,119,3
6,N/A,N/A,N/A,1365,1371,N/A,122,6
6,N/A,N/A,N/A,1359,1365,N/A,127,5
5,N/A,N/A,N/A,1354,1359,N/A,133,5
3,N/A,N/A,N/A,332,335,N/A,6,3
6,N/A,N/A,N/A,326,332,N/A,9,6
6,N/A,N/A,N/A,320,326,N/A,14,5
2,N/A,N/A,N/A,318,320,N/A,17,2
6,N/A,N/A,N/A,312,318,N/A,21,6
3,N/A,N/A,N/A,309,312,N/A,25,4
3,N/A,N/A,N/A,306,309,N/A,30,3
3,N/A,N/A,N/A,303,306,N/A,36,3
3,N/A,N/A,N/A,300,303,N/A,41,2
2,N/A,N/A,N/A,298,300,N/A,46,1
4,N/A,N/A,N/A,294,298,N/A,49,4
3,N/A,N/A,N/A,291,294,N/A,54,3
2,N/A,N/A,N/A,289,291,N/A,58,1
7,N/A,N/A,N/A,282,289,N/A,63,6
3,N/A,N/A,N/A,279,282,N/A,66,3
7,N/A,N/A,N/A,272,279,N/A,69,6
5,N/A,N/A,N/A,267,272,N/A,74,5
2,N/A,N/A,N/A,265,267,N/A,77,2
2,N/A,N/A,N/A,263,265,N/A,82,1
7,N/A,N/A,N/A,256,263,N/A,87,6
3,N/A,N/A,N/A,253,256,N/A,90,3
3,N/A,N/A,N/A,250,253,N/A,96,3
1,N/A,N/A,N/A,249,250,N/A,100,1
6,N/A,N/A,N/A,243,249,N/A,105,6
2,N/A,N/A,N/A,241,243,N/A,108,3
1,N/A,N/A,N/A,240,241,N/A,112,1
7,N/A,N/A,N/A,233,240,N/A,117,6
1,N/A,N/A,N/A,232,233,N/A,123,0
3,N/A,N/A,N/A,229,232,N/A,127,4
2,N/A,N/A,N/A,227,229,N/A,131,2
1,N/A,N/A,N/A,991,992,N/A,5,1
1,N/A,N/A,N/A,990,991,N/A,11,1
2,N/A,N/A,N/A,988,990,N/A,17,1
1,N/A,N/A,N/A,987,988,N/A,23,1
4,N/A,N/A,N/A,983,987,N/A,26,4
2,N/A,N/A,N/A,981,983,N/A,31,3
6,N/A,N/A,N/A,975,981,N/A,34,6
2,N/A,N/A,N/A,973,975,N/A,37,3
1,N/A,N/A,N/A,972,973,N/A,41,1
3,N/A,N/A,N/A,969,972,N/A,44,4
2,N/A,N/A,N/A,967,969,N/A,48,2
6,N/A,N/A,N/A,961,967,N/A,51,5
5,N/A,N/A,N/A,956,961,N/A,57,5
4,N/A,N/A,N/A,952,956,N/A,62,4
3,N/A,N/A,N/A,949,952,N/A,68,4
2,N/A,N/A,N/A,947,949,N/A,71,1
6,N/A,N/A,N/A,941,947,N/A,76,6
3,N/A,N/A,N/A,938,941,N/A,79,3
3,N/A,N/A,N/A,935,938,N/A,85,3
3,N/A,N/A,N/A,932,935,N/A,91,3
2,N/A,N/A,N/A,930,932,N/A,96,2
6,N/A,N/A,N/A,924,930,N/A,99,5
6,N/A,N/A,N/A,918,924,N/A,105,5
5,N/A,N/A,N/A,913,918,N/A,111,5
2,N/A,N/A,N/A,911,913,N/A,115,3
2,N/A,N/A,N/A,909,911,N/A,120,2
7,N/A,N/A,N/A,902,909,N/A,124,6
6,N/A,N/A,N/A,896,902,N/A,129,5
2,N/A,N/A,N/A,894,896,N/A,133,3
2,N/A,N/A,N/A,892,894,N/A,137,1
3,N/A,N/A,N/A,1779,1782,N/A,5,4
2,N/A,N/A,N/A,1777,1779,N/A,10,3
7,N/A,N/A,N/A,1770,1777,N/A,13,6
3,N/A,N/A,N/A,1767,1770,N/A,16,3
2,N/A,N/A,N/A,1765,1767,N/A,21,2
5,N/A,N/A,N/A,1760,1765,N/A,24,5
3,N/A,N/A,N/A,1757,1760,N/A,29,4
3,N/A,N/A,N/A,1754,1757,N/A,35,4
1,N/A,N/A,N/A,1753,1754,N/A,38,1
4,N/A,N/A,N/A,1749,1753,N/A,41,4
2,N/A,N/A,N/A,1747,1749,N/A,44,1
6,N/A,N/A,N/A,1741,1747,N/A,48,5
2,N/A,N/A,N/A,1739,1741,N/A,51,2
7,N/A,N/A,N/A,1732,1739,N/A,55,6
3,N/A,N/A,N/A,1729,1732,N/A,59,4
3,N/A,N/A,N/A,1726,1729,N/A,64,3
2,N/A,N/A,N/A,1724,1726,N/A,68,1
3,N/A,N/A,N/A,1721,1724,N/A,71,4
2,N/A,N/A,N/A,1719,1721,N/A,74,1
6,N/A,N/A,N/A,1713,1719,N/A,78,5
2,N/A,N/A,N/A,1711,1713,N/A,81,2
2,N/A,N/A,N/A,1709,1711,N/A,87,2
6,N/A,N/A,N/A,1703,1709,N/A,91,6
4,N/A,N/A,N/A,1699,1703,N/A,95,4
3,N/A,N/A,N/A,1696,1699,N/A,100,3
3,N/A,N/A,N/A,1693,1696,N/A,106,3
3,N/A,N/A,N/A,1690,1693,N/A,112,3
2,N/A,N/A,N/A,1688,1690,N/A,118,3
7,N/A,N/A,N/A,1681,1688,N/A,121,6
5,N/A,N/A,N/A,1676,1681,N/A,126,5
3,N/A,N/A,N/A,449,452,N/A,3,2
7,N/A,N/A,N/A,442,449,N/A,7,6
3,N/A,N/A,N/A,439,442,N/A,10,3
7,N/A,N/A,N/A,432,439,N/A,13,6
6,N/A,N/A,N/A,426,432,N/A,18,5
5,N/A,N/A,N/A,421,426,N/A,24,5
3,N/A,N/A,N/A,418,421,N/A,29,4
3,N/A,N/A,N/A,415,418,N/A,33,2
6,N/A,N/A,N/A,409,415,N/A,37,6
4,N/A,N/A,N/A,405,409,N/A,41,4
4,N/A,N/A,N/A,401,405,N/A,47,4
2,N/A,N/A,N/A,399,401,N/A,50,1
3,N/A,N/A,N/A,396,399,N/A,53,4
3,N/A,N/A,N/A,393,396,N/A,58,3
6,N/A,N/A,N/A,387,393,N/A,61,6
6,N/A,N/A,N/A,381,387,N/A,66,5
4,N/A,N/A,N/A,377,381,N/A,71,4
3,N/A,N/A,N/A,374,377,N/A,75,2
6,N/A,N/A,N/A,368,374,N/A,78,5
5,N/A,N/A,N/A,363,368,N/A,84,5
2,N/A,N/A,N/A,361,363,N/A,87,2
5,N/A,N/A,N/A,356,361,N/A,90,5
3,N/A,N/A,N/A,353,356,N/A,94,3
2,N/A,N/A,N/A,351,353,N/A,98,1
7,N/A,N/A,N/A,344,351,N/A,103,6
4,N/A,N/A,N/A,340,344,N/A,107,4
2,N/A,N/A,N/A,338,340,N/A,112,3
2,N/A,N/A,N/A,336,338,N/A,118,3
3,N/A,N/A,N/A,333,336,N/A,124,3
1,N/A,N/A,N/A,332,333,N/A,128,1
5,N/A,N/A,N/A,593,598,N/A,6,5
2,N/A,N/A,N/A,591,593,N/A,10,3
7,N/A,N/A,N/A,584,591,N/A,13,6
3,N/A,N/A,N/A,581,584,N/A,16,3
3,N/A,N/A,N/A,578,581,N/A,22,3
2,N/A,N/A,N/A,576,578,N/A,26,1
3,N/A,N/A,N/A,573,576,N/A,29,4
4,N/A,N/A,N/A,569,573,N/A,35,4
1,N/A,N/A,N/A,568,569,N/A,38,1
6,N/A,N/A,N/A,562,568,N/A,42,5
5,N/A,N/A,N/A,557,562,N/A,48,5
2,N/A,N/A,N/A,555,557,N/A,52,3
1,N/A,N/A,N/A,554,555,N/A,56,1
7,N/A,N/A,N/A,547,554,N/A,61,6
1,N/A,N/A,N/A,546,547,N/A,67,0
4,N/A,N/A,N/A,542,546,N/A,71,4
1,N/A,N/A,N/A,541,542,N/A,74,1
6,N/A,N/A,N/A,535,541,N/A,78,5
5,N/A,N/A,N/A,530,535,N/A,84,5
3,N/A,N/A,N/A,527,530,N/A,87,2
2,N/A,N/A,N/A,525,527,N/A,92,1
3,N/A,N/A,N/A,522,525,N/A,95,4
2,N/A,N/A,N/A,520,522,N/A,100,3
3,N/A,N/A,N/A,517,520,N/A,105,2
3,N/A,N/A,N/A,514,517,N/A,111,2
2,N/A,N/A,N/A,512,514,N/A,117,2
6,N/A,N/A,N/A,506,512,N/A,121,6
3,N/A,N/A,N/A,503,506,N/A,124,3
2,N/A,N/A,N/A,501,503,N/A,128,1
6,N/A,N/A,N/A,495,501,N/A,133,6
2,N/A,N/A,N/A,1002,1004,N/A,5,3
3,N/A,N/A,N/A,999,1002,N/A,11,3
3,N/A,N/A,N/A,996,999,N/A,16,2
6,N/A,N/A,N/A,990,996,N/A,20,6
1,N/A,N/A,N/A,989,990,N/A,26,0
3,N/A,N/A,N/A,986,989,N/A,29,3
3,N/A,N/A,N/A,983,986,N/A,35,3
1,N/A,N/A,N/A,982,983,N/A,39,1
3,N/A,N/A,N/A,979,982,N/A,42,4
2,N/A,N/A,N/A,977,979,N/A,45,1
4,N/A,N/A,N/A,973,977,N/A,48,4
3,N/A,N/A,N/A,970,973,N/A,53,3
3,N/A,N/A,N/A,967,970,N/A,58,2
5,N/A,N/A,N/A,962,967,N/A,61,5
4,N/A,N/A,N/A,958,962,N/A,66,4
2,N/A,N/A,N/A,956,958,N/A,70,2
6,N/A,N/A,N/A,950,956,N/A,74,6
3,N/A,N/A,N/A,947,950,N/A,77,3
1,N/A,N/A,N/A,946,947,N/A,81,1
6,N/A,N/A,N/A,940,946,N/A,85,5
3,N/A,N/A,N/A,937,940,N/A,88,2
3,N/A,N/A,N/A,934,937,N/A,94,2
7,N/A,N/A,N/A,927,934,N/A,98,6
1,N/A,N/A,N/A,926,927,N/A,104,0
7,N/A,N/A,N/A,919,926,N/A,110,6
2,N/A,N/A,N/A,917,919,N/A,113,3
3,N/A,N/A,N/A,914,917,N/A,119,3
2,N/A,N/A,N/A,912,914,N/A,125,3
2,N/A,N/A,N/A,910,912,N/A,129,1
6,N/A,N/A,N/A,904,910,N/A,133,5
3,N/A,N/A,N/A,1157,1160,N/A,5,4
2,N/A,N/A,N/A,1155,1157,N/A,9,2
5,N/A,N/A,N/A,1150,1155,N/A,12,5
3,N/A,N/A,N/A,1147,1150,N/A,16,3
2,N/A,N/A,N/A,1145,1147,N/A,22,3
2,N/A,N/A,N/A,1143,1145,N/A,27,2
5,N/A,N/A,N/A,1138,1143,N/A,30,5
4,N/A,N/A,N/A,1134,1138,N/A,35,4
2,N/A,N/A,N/A,1132,1134,N/A,40,3
2,N/A,N/A,N/A,1130,1132,N/A,46,3
6,N/A,N/A,N/A,1124,1130,N/A,49,6
4,N/A,N/A,N/A,1120,1124,N/A,53,4
2,N/A,N/A,N/A,1118,1120,N/A,57,2
7,N/A,N/A,N/A,1111,1118,N/A,61,6
6,N/A,N/A,N/A,1105,1111,N/A,66,5
2,N/A,N/A,N/A,1103,1105,N/A,70,3
3,N/A,N/A,N/A,1100,1103,N/A,76,3
3,N/A,N/A,N/A,1097,1100,N/A,81,2
1,N/A,N/A,N/A,1096,1097,N/A,86,1
4,N/A,N/A,N/A,1092,1096,N/A,89,4
1,N/A,N/A,N/A,1091,1092,N/A,92,1
6,N/A,N/A,N/A,1085,1091,N/A,97,6
1,N/A,N/A,N/A,1084,1085,N/A,103,0
3,N/A,N/A,N/A,1081,1084,N/A,107,4
3,N/A,N/A,N/A,1078,1081,N/A,112,3
7,N/A,N/A,N/A,1071,1078,N/A,115,6
6,N/A,N/A,N/A,1065,1071,N/A,120,5
3,N/A,N/A,N/A,1062,1065,N/A,125,4
3,N/A,N/A,N/A,1059,1062,N/A,131,4
3,N/A,N/A,N/A,1056,1059,N/A,135,2
2,N/A,N/A,N/A,590,592,N/A,4,1
2,N/A,N/A,N/A,588,590,N/A,10,1
5,N/A,N/A,N/A,583,588,N/A,14,5
3,N/A,N/A,N/A,580,583,N/A,18,3
1,N/A,N/A,N/A,579,580,N/A,22,1
4,N/A,N/A,N/A,575,579,N/A,25,4
2,N/A,N/A,N/A,573,575,N/A,28,1
2,N/A,N/A,N/A,571,573,N/A,34,1
2,N/A,N/A,N/A,569,571,N/A,40,1
1,N/A,N/A,N/A,568,569,N/A,46,1
6,N/A,N/A,N/A,562,568,N/A,50,5
3,N/A,N/A,N/A,559,562,N/A,54,3
3,N/A,N/A,N/A,556,559,N/A,60,3
2,N/A,N/A,N/A,554,556,N/A,65,2
2,N/A,N/A,N/A,552,554,N/A,70,1
1,N/A,N/A,N/A,551,552,N/A,76,1
4,N/A,N/A,N/A,547,551,N/A,79,4
3,N/A,N/A,N/A,544,547,N/A,84,3
2,N/A,N/A,N/A,542,544,N/A,89,2
3,N/A,N/A,N/A,539,542,N/A,95,2
2,N/A,N/A,N/A,537,539,N/A,101,2
5,N/A,N/A,N/A,532,537,N/A,104,5
4,N/A,N/A,N/A,528,532,N/A,109,4
3,N/A,N/A,N/A,525,528,N/A,114,3
3,N/A,N/A,N/A,522,525,N/A,120,3
3,N/A,N/A,N/A,519,522,N/A,125,2
6,N/A,N/A,N/A,513,519,N/A,128,5
3,N/A,N/A,N/A,510,513,N/A,131,2
5,N/A,N/A,N/A,505,510,N/A,134,5
2,N/A,N/A,N/A,503,505,N/A,137,2
6,N/A,N/A,N/A,1865,1871,N/A,5,5
2,N/A,N/A,N/A,1863,1865,N/A,9,3
1,N/A,N/A,N/A,1862,1863,N/A,13,1
1,N/A,N/A,N/A,1861,1862,N/A,19,1
3,N/A,N/A,N/A,1858,1861,N/A,22,4
4,N/A,N/A,N/A,1854,1858,N/A,28,4
4,N/A,N/A,N/A,1850,1854,N/A,34,4
1,N/A,N/A,N/A,1849,1850,N/A,37,1
6,N/A,N/A,N/A,1843,1849,N/A,42,6
3,N/A,N/A,N/A,1840,1843,N/A,45,3
2,N/A,N/A,N/A,1838,1840,N/A,49,1
3,N/A,N/A,N/A,1835,1838,N/A,52,4
2,N/A,N/A,N/A,1833,1835,N/A,57,3
2,N/A,N/A,N/A,1831,1833,N/A,63,3
6,N/A,N/A,N/A,1825,1831,N/A,66,6
2,N/A,N/A,N/A,1823,1825,N/A,72,0
6,N/A,N/A,N/A,1817,1823,N/A,77,5
5,N/A,N/A,N/A,1812,1817,N/A,83,5
4,N/A,N/A,N/A,1808,1812,N/A,88,4
3,N/A,N/A,N/A,1805,1808,N/A,94,4
1,N/A,N/A,N/A,1804,1805,N/A,97,1
1,N/A,N/A,N/A,1803,1804,N/A,103,1
3,N/A,N/A,N/A,1800,1803,N/A,106,4
3,N/A,N/A,N/A,1797,1800,N/A,110,2
6,N/A,N/A,N/A,1791,1797,N/A,113,5
5,N/A,N/A,N/A,1786,1791,N/A,119,5
3,N/A,N/A,N/A,1783,1786,N/A,122,2
3,N/A,N/A,N/A,1780,1783,N/A,128,2
2,N/A,N/A,N/A,1778,1780,N/A,134,2
6,N/A,N/A,N/A,1772,1778,N/A,138,6
6,N/A,N/A,N/A,686,692,N/A,4,5
2,N/A,N/A,N/A,684,686,N/A,8,3
2,N/A,N/A,N/A,682,684,N/A,14,3
3,N/A,N/A,N/A,679,682,N/A,20,3
2,N/A,N/A,N/A,677,679,N/A,25,2
5,N/A,N/A,N/A,672,677,N/A,28,5
2,N/A,N/A,N/A,670,672,N/A,32,3
1,N/A,N/A,N/A,669,670,N/A,36,1
3,N/A,N/A,N/A,666,669,N/A,39,4
3,N/A,N/A,N/A,663,666,N/A,44,3
3,N/A,N/A,N/A,660,663,N/A,49,2
1,N/A,N/A,N/A,659,660,N/A,54,1
4,N/A,N/A,N/A,655,659,N/A,57,4
2,N/A,N/A,N/A,653,655,N/A,62,3
2,N/A,N/A,N/A,651,653,N/A,67,2
6,N/A,N/A,N/A,645,651,N/A,71,6
2,N/A,N/A,N/A,643,645,N/A,74,3
6,N/A,N/A,N/A,637,643,N/A,77,6
1,N/A,N/A,N/A,636,637,N/A,83,0
3,N/A,N/A,N/A,633,636,N/A,86,3
6,N/A,N/A,N/A,627,633,N/A,89,6
3,N/A,N/A,N/A,624,627,N/A,93,4
2,N/A,N/A,N/A,622,624,N/A,98,3
2,N/A,N/A,N/A,620,622,N/A,104,3
2,N/A,N/A,N/A,618,620,N/A,108,1
6,N/A,N/A,N/A,612,618,N/A,113,6
2,N/A,N/A,N/A,610,612,N/A,119,0
3,N/A,N/A,N/A,607,610,N/A,122,3
2,N/A,N/A,N/A,605,607,N/A,128,3
2,N/A,N/A,N/A,603,605,N/A,133,2
6,N/A,N/A,N/A,803,809,N/A,5,5
5,N/A,N/A,N/A,798,803,N/A,11,5
3,N/A,N/A,N/A,795,798,N/A,14,2
3,N/A,N/A,N/A,792,795,N/A,20,2
5,N/A,N/A,N/A,787,792,N/A,23,5
3,N/A,N/A,N/A,784,787,N/A,26,2
3,N/A,N/A,N/A,781,784,N/A,32,2
2,N/A,N/A,N/A,779,781,N/A,38,2
6,N/A,N/A,N/A,773,779,N/A,42,6
1,N/A,N/A,N/A,772,773,N/A,48,0
2,N/A,N/A,N/A,770,772,N/A,51,3
7,N/A,N/A,N/A,763,770,N/A,54,6
3,N/A,N/A,N/A,760,763,N/A,58,4
2,N/A,N/A,N/A,758,760,N/A,61,1
4,N/A,N/A,N/A,754,758,N/A,64,4
3,N/A,N/A,N/A,751,754,N/A,70,4
1,N/A,N/A,N/A,750,751,N/A,73,1
5,N/A,N/A,N/A,745,750,N/A,77,5
6,N/A,N/A,N/A,739,745,N/A,83,5
6,N/A,N/A,N/A,733,739,N/A,89,5
3,N/A,N/A,N/A,730,733,N/A,92,2
1,N/A,N/A,N/A,729,730,N/A,97,1
7,N/A,N/A,N/A,722,729,N/A,102,6
6,N/A,N/A,N/A,716,722,N/A,107,5
2,N/A,N/A,N/A,714,716,N/A,110,2
6,N/A,N/A,N/A,708,714,N/A,114,6
3,N/A,N/A,N/A,705,708,N/A,117,3
3,N/A,N/A,N/A,702,705,N/A,122,2
5,N/A,N/A,N/A,697,702,N/A,125,5
2,N/A,N/A,N/A,695,697,N/A,128,2
2,N/A,N/A,N/A,1805,1807,N/A,3,3
2,N/A,N/A,N/A,1803,1805,N/A,9,3
1,N/A,N/A,N/A,1802,1803,N/A,13,1
6,N/A,N/A,N/A,1796,1802,N/A,17,5
6,N/A,N/A,N/A,1790,1796,N/A,23,5
4,N/A,N/A,N/A,1786,1790,N/A,28,4
3,N/A,N/A,N/A,1783,1786,N/A,32,2
5,N/A,N/A,N/A,1778,1783,N/A,35,5
2,N/A,N/A,N/A,1776,1778,N/A,38,2
3,N/A,N/A,N/A,1773,1776,N/A,44,2
6,N/A,N/A,N/A,1767,1773,N/A,47,5
2,N/A,N/A,N/A,1765,1767,N/A,51,3
1,N/A,N/A,N/A,1764,1765,N/A,55,1
5,N/A,N/A,N/A,1759,1764,N/A,59,5
2,N/A,N/A,N/A,1757,1759,N/A,62,2
1,N/A,N/A,N/A,1756,1757,N/A,67,1
3,N/A,N/A,N/A,1753,1756,N/A,70,4
2,N/A,N/A,N/A,1751,1753,N/A,74,2
6,N/A,N/A,N/A,1745,1751,N/A,78,6
3,N/A,N/A,N/A,1742,1745,N/A,81,3
3,N/A,N/A,N/A,1739,1742,N/A,87,3
2,N/A,N/A,N/A,1737,1739,N/A,91,1
1,N/A,N/A,N/A,1736,1737,N/A,97,1
6,N/A,N/A,N/A,1730,1736,N/A,102,6
3,N/A,N/A,N/A,1727,1730,N/A,106,4
2,N/A,N/A,N/A,1725,1727,N/A,109,1
3,N/A,N/A,N/A,1722,1725,N/A,112,4
4,N/A,N/A,N/A,1718,1722,N/A,118,4
3,N/A,N/A,N/A,1715,1718,N/A,122,2
3,N/A,N/A,N/A,1712,1715,N/A,128,2
3,N/A,N/A,N/A,1402,1405,N/A,6,2
6,N/A,N/A,N/A,1396,1402,N/A,9,5
2,N/A,N/A,N/A,1394,1396,N/A,13,3
2,N/A,N/A,N/A,1392,1394,N/A,18,2
7,N/A,N/A,N/A,1385,1392,N/A,22,6
3,N/A,N/A,N/A,1382,1385,N/A,25,3
1,N/A,N/A,N/A,1381,1382,N/A,29,1
7,N/A,N/A,N/A,1374,1381,N/A,34,6
6,N/A,N/A,N/A,1368,1374,N/A,39,5
3,N/A,N/A,N/A,1365,1368,N/A,42,2
3,N/A,N/A,N/A,1362,1365,N/A,48,2
7,N/A,N/A,N/A,1355,1362,N/A,52,6
6,N/A,N/A,N/A,1349,1355,N/A,57,5
6,N/A,N/A,N/A,1343,1349,N/A,63,5
6,N/A,N/A,N/A,1337,1343,N/A,69,5
2,N/A,N/A,N/A,1335,1337,N/A,72,2
7,N/A,N/A,N/A,1328,1335,N/A,76,6
3,N/A,N/A,N/A,1325,1328,N/A,79,3
2,N/A,N/A,N/A,1323,1325,N/A,85,3
6,N/A,N/A,N/A,1317,1323,N/A,88,6
4,N/A,N/A,N/A,1313,1317,N/A,92,4
1,N/A,N/A,N/A,1312,1313,N/A,95,1
5,N/A,N/A,N/A,1307,1312,N/A,99,5
3,N/A,N/A,N/A,1304,1307,N/A,103,3
7,N/A,N/A,N/A,1297,1304,N/A,106,6
6,N/A,N/A,N/A,1291,1297,N/A,111,5
5,N/A,N/A,N/A,1286,1291,N/A,117,5
2,N/A,N/A,N/A,1284,1286,N/A,120,2
2,N/A,N/A,N/A,1282,1284,N/A,126,2
2,N/A,N/A,N/A,1280,1282,N/A,131,1
3,N/A,N/A,N/A,1394,1397,N/A,3,4
2,N/A,N/A,N/A,1392,1394,N/A,8,3
7,N/A,N/A,N/A,1385,1392,N/A,11,6
2,N/A,N/A,N/A,1383,1385,N/A,14,3
3,N/A,N/A,N/A,1380,1383,N/A,19,2
3,N/A,N/A,N/A,1377,1380,N/A,25,2
7,N/A,N/A,N/A,1370,1377,N/A,29,6
3,N/A,N/A,N/A,1367,1370,N/A,32,3
2,N/A,N/A,N/A,1365,1367,N/A,37,2
2,N/A,N/A,N/A,1363,1365,N/A,43,2
7,N/A,N/A,N/A,1356,1363,N/A,47,6
3,N/A,N/A,N/A,1353,1356,N/A,51,4
2,N/A,N/A,N/A,1351,1353,N/A,55,2
6,N/A,N/A,N/A,1345,1351,N/A,59,6
5,N/A,N/A,N/A,1340,1345,N/A,64,5
5,N/A,N/A,N/A,1335,1340,N/A,70,5
3,N/A,N/A,N/A,1332,1335,N/A,75,4
1,N/A,N/A,N/A,1331,1332,N/A,78,1
2,N/A,N/A,N/A,1329,1331,N/A,84,1
5,N/A,N/A,N/A,1324,1329,N/A,88,5
2,N/A,N/A,N/A,1322,1324,N/A,91,2
6,N/A,N/A,N/A,1316,1322,N/A,94,5
2,N/A,N/A,N/A,1314,1316,N/A,97,2
2,N/A,N/A,N/A,1312,1314,N/A,102,1
3,N/A,N/A,N/A,1309,1312,N/A,105,4
3,N/A,N/A,N/A,1306,1309,N/A,111,4
1,N/A,N/A,N/A,1305,1306,N/A,114,1
2,N/A,N/A,N/A,1303,1305,N/A,120,1
5,N/A,N/A,N/A,1298,1303,N/A,124,5
3,N/A,N/A,N/A,1295,1298,N/A,129,4
6,N/A,N/A,N/A,1784,1790,N/A,6,5
2,N/A,N/A,N/A,1782,1784,N/A,9,2
3,N/A,N/A,N/A,1779,1782,N/A,15,2
6,N/A,N/A,N/A,1773,1779,N/A,19,6
4,N/A,N/A,N/A,1769,1773,N/A,23,4
2,N/A,N/A,N/A,1767,1769,N/A,26,1
2,N/A,N/A,N/A,1765,1767,N/A,32,1
1,N/A,N/A,N/A,1764,1765,N/A,38,1
4,N/A,N/A,N/A,1760,1764,N/A,41,4
3,N/A,N/A,N/A,1757,1760,N/A,47,4
2,N/A,N/A,N/A,1755,1757,N/A,52,3
2,N/A,N/A,N/A,1753,1755,N/A,58,3
2,N/A,N/A,N/A,1751,1753,N/A,62,1
5,N/A,N/A,N/A,1746,1751,N/A,66,5
5,N/A,N/A,N/A,1741,1746,N/A,72,5
4,N/A,N/A,N/A,1737,1741,N/A,77,4
3,N/A,N/A,N/A,1734,1737,N/A,83,4
2,N/A,N/A,N/A,1732,1734,N/A,88,3
6,N/A,N/A,N/A,1726,1732,N/A,91,6
2,N/A,N/A,N/A,1724,1726,N/A,97,0
2,N/A,N/A,N/A,1722,1724,N/A,100,3
6,N/A,N/A,N/A,1716,1722,N/A,103,6
2,N/A,N/A,N/A,1714,1716,N/A,106,3
1,N/A,N/A,N/A,1713,1714,N/A,110,1
2,N/A,N/A,N/A,1711,1713,N/A,116,1
6,N/A,N/A,N/A,1705,1711,N/A,121,6
6,N/A,N/A,N/A,1699,1705,N/A,126,5
5,N/A,N/A,N/A,1694,1699,N/A,132,5
2,N/A,N/A,N/A,1692,1694,N/A,136,3
6,N/A,N/A,N/A,1686,1692,N/A,139,6
7,N/A,N/A,N/A,1275,1282,N/A,6,6
5,N/A,N/A,N/A,1270,1275,N/A,11,5
6,N/A,N/A,N/A,1264,1270,N/A,17,5
2,N/A,N/A,N/A,1262,1264,N/A,21,3
2,N/A,N/A,N/A,1260,1262,N/A,25,1
1,N/A,N/A,N/A,1259,1260,N/A,31,1
6,N/A,N/A,N/A,1253,1259,N/A,36,6
1,N/A,N/A,N/A,1252,1253,N/A,42,0
6,N/A,N/A,N/A,1246,1252,N/A,48,6
5,N/A,N/A,N/A,1241,1246,N/A,53,5
3,N/A,N/A,N/A,1238,1241,N/A,58,4
1,N/A,N/A,N/A,1237,1238,N/A,61,1
6,N/A,N/A,N/A,1231,1237,N/A,66,6
1,N/A,N/A,N/A,1230,1231,N/A,72,0
3,N/A,N/A,N/A,1227,1230,N/A,76,4
1,N/A,N/A,N/A,1226,1227,N/A,79,1
7,N/A,N/A,N/A,1219,1226,N/A,84,6
1,N/A,N/A,N/A,1218,1219,N/A,90,0
4,N/A,N/A,N/A,1214,1218,N/A,94,4
1,N/A,N/A,N/A,1213,1214,N/A,97,1
6,N/A,N/A,N/A,1207,1213,N/A,101,5
6,N/A,N/A,N/A,1201,1207,N/A,107,5
3,N/A,N/A,N/A,1198,1201,N/A,112,4
3,N/A,N/A,N/A,1195,1198,N/A,117,3
2,N/A,N/A,N/A,1193,1195,N/A,122,2
3,N/A,N/A,N/A,1190,1193,N/A,128,2
5,N/A,N/A,N/A,1185,1190,N/A,131,5
3,N/A,N/A,N/A,1182,1185,N/A,135,3
2,N/A,N/A,N/A,1180,1182,N/A,139,1
5,N/A,N/A,N/A,1175,1180,N/A,143,5
1,N/A,N/A,N/A,1867,1868,N/A,3,1
4,N/A,N/A,N/A,1863,1867,N/A,6,4
2,N/A,N/A,N/A,1861,1863,N/A,11,3
3,N/A,N/A,N/A,1858,1861,N/A,16,2
2,N/A,N/A,N/A,1856,1858,N/A,22,2
6,N/A,N/A,N/A,1850,1856,N/A,25,5
6,N/A,N/A,N/A,1844,1850,N/A,31,5
6,N/A,N/A,N/A,1838,1844,N/A,37,5
5,N/A,N/A,N/A,1833,1838,N/A,43,5
2,N/A,N/A,N/A,1831,1833,N/A,46,2
5,N/A,N/A,N/A,1826,1831,N/A,49,5
5,N/A,N/A,N/A,1821,1826,N/A,55,5
3,N/A,N/A,N/A,1818,1821,N/A,58,2
1,N/A,N/A,N/A,1817,1818,N/A,63,1
1,N/A,N/A,N/A,1816,1817,N/A,69,1
3,N/A,N/A,N/A,1813,1816,N/A,72,4
2,N/A,N/A,N/A,1811,1813,N/A,76,2
6,N/A,N/A,N/A,1805,1811,N/A,80,6
3,N/A,N/A,N/A,1802,1805,N/A,83,3
2,N/A,N/A,N/A,1800,1802,N/A,89,3
7,N/A,N/A,N/A,1793,1800,N/A,92,6
2,N/A,N/A,N/A,1791,1793,N/A,98,0
6,N/A,N/A,N/A,1785,1791,N/A,104,6
3,N/A,N/A,N/A,1782,1785,N/A,108,4
2,N/A,N/A,N/A,1780,1782,N/A,113,3
3,N/A,N/A,N/A,1777,1780,N/A,119,3
7,N/A,N/A,N/A,1770,1777,N/A,122,6
1,N/A,N/A,N/A,1769,1770,N/A,128,0
5,N/A,N/A,N/A,1764,1769,N/A,133,5
3,N/A,N/A,N/A,1761,1764,N/A,137,3
3,N/A,N/A,N/A,925,928,N/A,4,4
3,N/A,N/A,N/A,922,925,N/A,10,4
3,N/A,N/A,N/A,919,922,N/A,15,3
2,N/A,N/A,N/A,917,919,N/A,21,3
3,N/A,N/A,N/A,914,917,N/A,26,2
7,N/A,N/A,N/A,907,914,N/A,30,6
6,N/A,N/A,N/A,901,907,N/A,35,5
3,N/A,N/A,N/A,898,901,N/A,40,4
2,N/A,N/A,N/A,896,898,N/A,44,2
6,N/A,N/A,N/A,890,896,N/A,47,5
2,N/A,N/A,N/A,888,890,N/A,50,2
7,N/A,N/A,N/A,881,888,N/A,54,6
2,N/A,N/A,N/A,879,881,N/A,60,0
6,N/A,N/A,N/A,873,879,N/A,65,5
4,N/A,N/A,N/A,869,873,N/A,70,4
3,N/A,N/A,N/A,866,869,N/A,75,3
2,N/A,N/A,N/A,864,866,N/A,80,2
3,N/A,N/A,N/A,861,864,N/A,86,2
2,N/A,N/A,N/A,859,861,N/A,91,1
3,N/A,N/A,N/A,856,859,N/A,94,4
2,N/A,N/A,N/A,854,856,N/A,99,3
2,N/A,N/A,N/A,852,854,N/A,105,3
7,N/A,N/A,N/A,845,852,N/A,108,6
2,N/A,N/A,N/A,843,845,N/A,114,0
3,N/A,N/A,N/A,840,843,N/A,117,3
1,N/A,N/A,N/A,839,840,N/A,121,1
6,N/A,N/A,N/A,833,839,N/A,126,6
4,N/A,N/A,N/A,829,833,N/A,130,4
3,N/A,N/A,N/A,826,829,N/A,134,2
6,N/A,N/A,N/A,820,826,N/A,137,5
3,N/A,N/A,N/A,1060,1063,N/A,5,3
3,N/A,N/A,N/A,1057,1060,N/A,11,3
2,N/A,N/A,N/A,1055,1057,N/A,16,2
6,N/A,N/A,N/A,1049,1055,N/A,20,6
2,N/A,N/A,N/A,1047,1049,N/A,26,0
3,N/A,N/A,N/A,1044,1047,N/A,29,3
3,N/A,N/A,N/A,1041,1044,N/A,35,3
7,N/A,N/A,N/A,1034,1041,N/A,38,6
3,N/A,N/A,N/A,1031,1034,N/A,41,3
2,N/A,N/A,N/A,1029,1031,N/A,47,3
2,N/A,N/A,N/A,1027,1029,N/A,53,3
6,N/A,N/A,N/A,1021,1027,N/A,56,6
4,N/A,N/A,N/A,1017,1021,N/A,60,4
1,N/A,N/A,N/A,1016,1017,N/A,63,1
6,N/A,N/A,N/A,1010,1016,N/A,68,6
1,N/A,N/A,N/A,1009,1010,N/A,74,0
6,N/A,N/A,N/A,1003,1009,N/A,79,5
3,N/A,N/A,N/A,1000,1003,N/A,82,2
1,N/A,N/A,N/A,999,1000,N/A,87,1
2,N/A,N/A,N/A,997,999,N/A,93,1
7,N/A,N/A,N/A,990,997,N/A,98,6
2,N/A,N/A,N/A,988,990,N/A,101,3
7,N/A,N/A,N/A,981,988,N/A,104,6
5,N/A,N/A,N/A,976,981,N/A,109,5
5,N/A,N/A,N/A,971,976,N/A,115,5
3,N/A,N/A,N/A,968,971,N/A,120,4
2,N/A,N/A,N/A,966,968,N/A,124,2
3,N/A,N/A,N/A,963,966,N/A,130,2
2,N/A,N/A,N/A,961,963,N/A,135,1
7,N/A,N/A,N/A,954,961,N/A,140,6
1,N/A,N/A,N/A,670,671,N/A,5,1
2,N/A,N/A,N/A,668,670,N/A,11,1
4,N/A,N/A,N/A,664,668,N/A,14,4
3,N/A,N/A,N/A,661,664,N/A,20,4
1,N/A,N/A,N/A,660,661,N/A,23,1
2,N/A,N/A,N/A,658,660,N/A,29,1
7,N/A,N/A,N/A,651,658,N/A,34,6
6,N/A,N/A,N/A,645,651,N/A,39,5
3,N/A,N/A,N/A,642,645,N/A,43,3
3,N/A,N/A,N/A,639,642,N/A,48,2
7,N/A,N/A,N/A,632,639,N/A,52,6
3,N/A,N/A,N/A,629,632,N/A,56,4
1,N/A,N/A,N/A,628,629,N/A,59,1
7,N/A,N/A,N/A,621,628,N/A,64,6
3,N/A,N/A,N/A,618,621,N/A,67,3
3,N/A,N/A,N/A,615,618,N/A,73,3
6,N/A,N/A,N/A,609,615,N/A,76,6
2,N/A,N/A,N/A,607,609,N/A,82,0
6,N/A,N/A,N/A,601,607,N/A,87,5
2,N/A,N/A,N/A,599,601,N/A,91,3
1,N/A,N/A,N/A,598,599,N/A,95,1
4,N/A,N/A,N/A,594,598,N/A,98,4
3,N/A,N/A,N/A,591,594,N/A,103,3
2,N/A,N/A,N/A,589,591,N/A,107,1
3,N/A,N/A,N/A,586,589,N/A,110,4
3,N/A,N/A,N/A,583,586,N/A,114,2
1,N/A,N/A,N/A,582,583,N/A,119,1
6,N/A,N/A,N/A,576,582,N/A,123,5
2,N/A,N/A,N/A,574,576,N/A,127,3
3,N/A,N/A,N/A,571,574,N/A,133,3
2,N/A,N/A,N/A,665,667,N/A,6,2
3,N/A,N/A,N/A,662,665,N/A,12,2
3,N/A,N/A,N/A,659,662,N/A,18,2
1,N/A,N/A,N/A,658,659,N/A,23,1
5,N/A,N/A,N/A,653,658,N/A,27,5
3,N/A,N/A,N/A,650,653,N/A,32,4
2,N/A,N/A,N/A,648,650,N/A,37,3
3,N/A,N/A,N/A,645,648,N/A,42,2
3,N/A,N/A,N/A,642,645,N/A,48,2
2,N/A,N/A,N/A,640,642,N/A,53,1
1,N/A,N/A,N/A,639,640,N/A,59,1
3,N/A,N/A,N/A,636,639,N/A,62,4
3,N/A,N/A,N/A,633,636,N/A,68,4
1,N/A,N/A,N/A,632,633,N/A,71,1
1,N/A,N/A,N/A,631,632,N/A,77,1
5,N/A,N/A,N/A,626,631,N/A,81,5
3,N/A,N/A,N/A,623,626,N/A,85,3
2,N/A,N/A,N/A,621,623,N/A,89,1
7,N/A,N/A,N/A,614,621,N/A,94,6
2,N/A,N/A,N/A,612,614,N/A,100,0
2,N/A,N/A,N/A,610,612,N/A,103,3
7,N/A,N/A,N/A,603,610,N/A,106,6
3,N/A,N/A,N/A,600,603,N/A,109,3
3,N/A,N/A,N/A,597,600,N/A,114,2
3,N/A,N/A,N/A,594,597,N/A,120,2
2,N/A,N/A,N/A,592,594,N/A,126,2
3,N/A,N/A,N/A,589,592,N/A,132,2
2,N/A,N/A,N/A,587,589,N/A,137,1
6,N/A,N/A,N/A,581,587,N/A,142,6
2,N/A,N/A,N/A,579,581,N/A,148,0
6,N/A,N/A,N/A,1957,1963,N/A,6,6
3,N/A,N/A,N/A,1954,1957,N/A,10,4
3,N/A,N/A,N/A,1951,1954,N/A,14,2
2,N/A,N/A,N/A,1949,1951,N/A,19,1
5,N/A,N/A,N/A,1944,1949,N/A,23,5
3,N/A,N/A,N/A,1941,1944,N/A,28,4
2,N/A,N/A,N/A,1939,1941,N/A,31,1
3,N/A,N/A,N/A,1936,1939,N/A,34,4
3,N/A,N/A,N/A,1933,1936,N/A,39,3
2,N/A,N/A,N/A,1931,1933,N/A,43,1
5,N/A,N/A,N/A,1926,1931,N/A,47,5
5,N/A,N/A,N/A,1921,1926,N/A,53,5
2,N/A,N/A,N/A,1919,1921,N/A,57,3
2,N/A,N/A,N/A,1917,1919,N/A,63,3
2,N/A,N/A,N/A,1915,1917,N/A,69,3
2,N/A,N/A,N/A,1913,1915,N/A,74,2
1,N/A,N/A,N/A,1912,1913,N/A,79,1
5,N/A,N/A,N/A,1907,1912,N/A,83,5
3,N/A,N/A,N/A,1904,1907,N/A,87,3
7,N/A,N/A,N/A,1897,1904,N/A,90,6
5,N/A,N/A,N/A,1892,1897,N/A,95,5
2,N/A,N/A,N/A,1890,1892,N/A,99,3
3,N/A,N/A,N/A,1887,1890,N/A,104,2
2,N/A,N/A,N/A,1885,1887,N/A,109,1
3,N/A,N/A,N/A,1882,1885,N/A,112,4
2,N/A,N/A,N/A,1880,1882,N/A,115,1
2,N/A,N/A,N/A,1878,1880,N/A,121,1
5,N/A,N/A,N/A,1873,1878,N/A,125,5
2,N/A,N/A,N/A,1871,1873,N/A,128,2
2,N/A,N/A,N/A,1869,1871,N/A,134,2
3,N/A,N/A,N/A,1753,1756,N/A,3,3
3,N/A,N/A,N/A,1750,1753,N/A,8,2
7,N/A,N/A,N/A,1743,1750,N/A,12,6
2,N/A,N/A,N/A,1741,1743,N/A,18,0
3,N/A,N/A,N/A,1738,1741,N/A,21,3
7,N/A,N/A,N/A,1731,1738,N/A,24,6
3,N/A,N/A,N/A,1728,1731,N/A,28,4
3,N/A,N/A,N/A,1725,1728,N/A,33,3
3,N/A,N/A,N/A,1722,1725,N/A,39,3
2,N/A,N/A,N/A,1720,1722,N/A,44,2
6,N/A,N/A,N/A,1714,1720,N/A,48,6
3,N/A,N/A,N/A,1711,1714,N/A,52,4
4,N/A,N/A,N/A,1707,1711,N/A,58,4
1,N/A,N/A,N/A,1706,1707,N/A,61,1
5,N/A,N/A,N/A,1701,1706,N/A,65,5
4,N/A,N/A,N/A,1697,1701,N/A,70,4
3,N/A,N/A,N/A,1694,1697,N/A,76,4
3,N/A,N/A,N/A,1691,1694,N/A,82,4
2,N/A,N/A,N/A,1689,1691,N/A,86,2
6,N/A,N/A,N/A,1683,1689,N/A,90,6
4,N/A,N/A,N/A,1679,1683,N/A,94,4
3,N/A,N/A,N/A,1676,1679,N/A,100,4
2,N/A,N/A,N/A,1674,1676,N/A,104,2
6,N/A,N/A,N/A,1668,1674,N/A,107,5
3,N/A,N/A,N/A,1665,1668,N/A,112,4
3,N/A,N/A,N/A,1662,1665,N/A,116,2
3,N/A,N/A,N/A,1659,1662,N/A,122,2
2,N/A,N/A,N/A,1657,1659,N/A,128,2
3,N/A,N/A,N/A,1654,1657,N/A,134,2
1,N/A,N/A,N/A,1653,1654,N/A,139,1
3,N/A,N/A,N/A,1616,1619,N/A,5,2
6,N/A,N/A,N/A,1610,1616,N/A,8,5
2,N/A,N/A,N/A,1608,1610,N/A,11,2
2,N/A,N/A,N/A,1606,1608,N/A,17,2
6,N/A,N/A,N/A,1600,1606,N/A,20,5
3,N/A,N/A,N/A,1597,1600,N/A,23,2
2,N/A,N/A,N/A,1595,1597,N/A,28,1
7,N/A,N/A,N/A,1588,1595,N/A,33,6
2,N/A,N/A,N/A,1586,1588,N/A,39,0
6,N/A,N/A,N/A,1580,1586,N/A,45,6
6,N/A,N/A,N/A,1574,1580,N/A,50,5
3,N/A,N/A,N/A,1571,1574,N/A,55,4
2,N/A,N/A,N/A,1569,1571,N/A,60,3
6,N/A,N/A,N/A,1563,1569,N/A,63,6
2,N/A,N/A,N/A,1561,1563,N/A,66,3
3,N/A,N/A,N/A,1558,1561,N/A,72,3
3,N/A,N/A,N/A,1555,1558,N/A,77,2
6,N/A,N/A,N/A,1549,1555,N/A,80,5
2,N/A,N/A,N/A,1547,1549,N/A,84,3
7,N/A,N/A,N/A,1540,1547,N/A,87,6
1,N/A,N/A,N/A,1539,1540,N/A,93,0
6,N/A,N/A,N/A,1533,1539,N/A,99,6
4,N/A,N/A,N/A,1529,1533,N/A,103,4
2,N/A,N/A,N/A,1527,1529,N/A,106,1
3,N/A,N/A,N/A,1524,1527,N/A,109,4
4,N/A,N/A,N/A,1520,1524,N/A,115,4
4,N/A,N/A,N/A,1516,1520,N/A,121,4
3,N/A,N/A,N/A,1513,1516,N/A,125,2
6,N/A,N/A,N/A,1507,1513,N/A,128,5
6,N/A,N/A,N/A,1501,1507,N/A,134,5
3,N/A,N/A,N/A,1632,1635,N/A,5,4
3,N/A,N/A,N/A,1629,1632,N/A,9,2
6,N/A,N/A,N/A,1623,1629,N/A,12,5
3,N/A,N/A,N/A,1620,1623,N/A,17,4
2,N/A,N/A,N/A,1618,1620,N/A,22,3
3,N/A,N/A,N/A,1615,1618,N/A,28,3
2,N/A,N/A,N/A,1613,1615,N/A,32,1
7,N/A,N/A,N/A,1606,1613,N/A,37,6
1,N/A,N/A,N/A,1605,1606,N/A,43,0
7,N/A,N/A,N/A,1598,1605,N/A,49,6
1,N/A,N/A,N/A,1597,1598,N/A,55,0
6,N/A,N/A,N/A,1591,1597,N/A,61,6
6,N/A,N/A,N/A,1585,1591,N/A,66,5
3,N/A,N/A,N/A,1582,1585,N/A,70,3
3,N/A,N/A,N/A,1579,1582,N/A,76,3
6,N/A,N/A,N/A,1573,1579,N/A,79,6
5,N/A,N/A,N/A,1568,1573,N/A,84,5
3,N/A,N/A,N/A,1565,1568,N/A,88,3
2,N/A,N/A,N/A,1563,1565,N/A,92,1
4,N/A,N/A,N/A,1559,1563,N/A,95,4
2,N/A,N/A,N/A,1557,1559,N/A,99,2
1,N/A,N/A,N/A,1556,1557,N/A,104,1
1,N/A,N/A,N/A,1555,1556,N/A,110,1
6,N/A,N/A,N/A,1549,1555,N/A,114,5
6,N/A,N/A,N/A,1543,1549,N/A,120,5
3,N/A,N/A,N/A,1540,1543,N/A,124,3
2,N/A,N/A,N/A,1538,1540,N/A,128,1
3,N/A,N/A,N/A,1535,1538,N/A,131,4
1,N/A,N/A,N/A,1534,1535,N/A,134,1
7,N/A,N/A,N/A,1527,1534,N/A,139,6
3,N/A,N/A,N/A,1543,1546,N/A,5,2
5,N/A,N/A,N/A,1538,1543,N/A,8,5
2,N/A,N/A,N/A,1536,1538,N/A,11,2
5,N/A,N/A,N/A,1531,1536,N/A,14,5
3,N/A,N/A,N/A,1528,1531,N/A,17,2
7,N/A,N/A,N/A,1521,1528,N/A,21,6
4,N/A,N/A,N/A,1517,1521,N/A,25,4
2,N/A,N/A,N/A,1515,1517,N/A,29,2
2,N/A,N/A,N/A,1513,1515,N/A,35,2
2,N/A,N/A,N/A,1511,1513,N/A,41,2
7,N/A,N/A,N/A,1504,1511,N/A,45,6
3,N/A,N/A,N/A,1501,1504,N/A,49,4
3,N/A,N/A,N/A,1498,1501,N/A,53,2
2,N/A,N/A,N/A,1496,1498,N/A,59,2
2,N/A,N/A,N/A,1494,1496,N/A,64,1
2,N/A,N/A,N/A,1492,1494,N/A,70,1
6,N/A,N/A,N/A,1486,1492,N/A,75,6
4,N/A,N/A,N/A,1482,1486,N/A,79,4
3,N/A,N/A,N/A,1479,1482,N/A,85,4
2,N/A,N/A,N/A,1477,1479,N/A,90,3
3,N/A,N/A,N/A,1474,1477,N/A,96,3
2,N/A,N/A,N/A,1472,1474,N/A,100,1
3,N/A,N/A,N/A,1469,1472,N/A,103,4
4,N/A,N/A,N/A,1465,1469,N/A,109,4
2,N/A,N/A,N/A,1463,1465,N/A,112,1
4,N/A,N/A,N/A,1459,1463,N/A,115,4
2,N/A,N/A,N/A,1457,1459,N/A,119,2
5,N/A,N/A,N/A,1452,1457,N/A,122,5
4,N/A,N/A,N/A,1448,1452,N/A,127,4
2,N/A,N/A,N/A,1446,1448,N/A,131,2
3,N/A,N/A,N/A,1174,1177,N/A,6,2
7,N/A,N/A,N/A,1167,1174,N/A,10,6
2,N/A,N/A,N/A,1165,1167,N/A,16,0
3,N/A,N/A,N/A,1162,1165,N/A,20,4
2,N/A,N/A,N/A,1160,1162,N/A,24,2
6,N/A,N/A,N/A,1154,1160,N/A,28,6
3,N/A,N/A,N/A,1151,1154,N/A,31,3
3,N/A,N/A,N/A,1148,1151,N/A,37,3
2,N/A,N/A,N/A,1146,1148,N/A,41,1
7,N/A,N/A,N/A,1139,1146,N/A,46,6
5,N/A,N/A,N/A,1134,1139,N/A,51,5
6,N/A,N/A,N/A,1128,1134,N/A,57,5
4,N/A,N/A,N/A,1124,1128,N/A,62,4
2,N/A,N/A,N/A,1122,1124,N/A,66,2
1,N/A,N/A,N/A,1121,1122,N/A,71,1
7,N/A,N/A,N/A,1114,1121,N/A,76,6
5,N/A,N/A,N/A,1109,1114,N/A,81,5
2,N/A,N/A,N/A,1107,1109,N/A,85,3
2,N/A,N/A,N/A,1105,1107,N/A,91,3
3,N/A,N/A,N/A,1102,1105,N/A,96,2
7,N/A,N/A,N/A,1095,1102,N/A,100,6
3,N/A,N/A,N/A,1092,1095,N/A,104,4
2,N/A,N/A,N/A,1090,1092,N/A,108,2
3,N/A,N/A,N/A,1087,1090,N/A,114,2
6,N/A,N/A,N/A,1081,1087,N/A,117,5
4,N/A,N/A,N/A,1077,1081,N/A,122,4
1,N/A,N/A,N/A,1076,1077,N/A,125,1
6,N/A,N/A,N/A,1070,1076,N/A,129,5
3,N/A,N/A,N/A,1067,1070,N/A,134,4
3,N/A,N/A,N/A,1064,1067,N/A,140,4
6,N/A,N/A,N/A,453,459,N/A,4,5
3,N/A,N/A,N/A,450,453,N/A,7,2
7,N/A,N/A,N/A,443,450,N/A,11,6
3,N/A,N/A,N/A,440,443,N/A,15,4
4,N/A,N/A,N/A,436,440,N/A,21,4
2,N/A,N/A,N/A,434,436,N/A,24,1
6,N/A,N/A,N/A,428,434,N/A,29,6
3,N/A,N/A,N/A,425,428,N/A,32,3
3,N/A,N/A,N/A,422,425,N/A,37,2
1,N/A,N/A,N/A,421,422,N/A,42,1
6,N/A,N/A,N/A,415,421,N/A,46,5
3,N/A,N/A,N/A,412,415,N/A,50,3
6,N/A,N/A,N/A,406,412,N/A,53,6
3,N/A,N/A,N/A,403,406,N/A,57,4
2,N/A,N/A,N/A,401,403,N/A,60,1
2,N/A,N/A,N/A,399,401,N/A,66,1
6,N/A,N/A,N/A,393,399,N/A,70,5
4,N/A,N/A,N/A,389,393,N/A,75,4
1,N/A,N/A,N/A,388,389,N/A,78,1
3,N/A,N/A,N/A,385,388,N/A,81,4
3,N/A,N/A,N/A,382,385,N/A,87,4
3,N/A,N/A,N/A,379,382,N/A,91,2
3,N/A,N/A,N/A,376,379,N/A,97,2
7,N/A,N/A,N/A,369,376,N/A,101,6
6,N/A,N/A,N/A,363,369,N/A,106,5
4,N/A,N/A,N/A,359,363,N/A,111,4
2,N/A,N/A,N/A,357,359,N/A,116,3
6,N/A,N/A,N/A,351,357,N/A,119,6
5,N/A,N/A,N/A,346,351,N/A,124,5
2,N/A,N/A,N/A,344,346,N/A,127,2
6,N/A,N/A,N/A,1981,1987,N/A,5,5
4,N/A,N/A,N/A,1977,1981,N/A,10,4
3,N/A,N/A,N/A,1974,1977,N/A,15,3
7,N/A,N/A,N/A,1967,1974,N/A,18,6
3,N/A,N/A,N/A,1964,1967,N/A,21,3
2,N/A,N/A,N/A,1962,1964,N/A,26,2
5,N/A,N/A,N/A,1957,1962,N/A,29,5
5,N/A,N/A,N/A,1952,1957,N/A,35,5
3,N/A,N/A,N/A,1949,1952,N/A,38,2
6,N/A,N/A,N/A,1943,1949,N/A,41,5
3,N/A,N/A,N/A,1940,1943,N/A,45,3
2,N/A,N/A,N/A,1938,1940,N/A,51,3
3,N/A,N/A,N/A,1935,1938,N/A,56,2
6,N/A,N/A,N/A,1929,1935,N/A,60,6
1,N/A,N/A,N/A,1928,1929,N/A,66,0
3,N/A,N/A,N/A,1925,1928,N/A,70,4
2,N/A,N/A,N/A,1923,1925,N/A,74,2
7,N/A,N/A,N/A,1916,1923,N/A,78,6
2,N/A,N/A,N/A,1914,1916,N/A,81,3
7,N/A,N/A,N/A,1907,1914,N/A,84,6
2,N/A,N/A,N/A,1905,1907,N/A,90,0
3,N/A,N/A,N/A,1902,1905,N/A,94,4
2,N/A,N/A,N/A,1900,1902,N/A,97,1
2,N/A,N/A,N/A,1898,1900,N/A,103,1
6,N/A,N/A,N/A,1892,1898,N/A,107,5
4,N/A,N/A,N/A,1888,1892,N/A,112,4
3,N/A,N/A,N/A,1885,1888,N/A,118,4
2,N/A,N/A,N/A,1883,1885,N/A,123,3
1,N/A,N/A,N/A,1882,1883,N/A,127,1
7,N/A,N/A,N/A,1875,1882,N/A,132,6
3,N/A,N/A,N/A,336,339,N/A,6,2
6,N/A,N/A,N/A,330,336,N/A,9,5
2,N/A,N/A,N/A,328,330,N/A,12,2
2,N/A,N/A,N/A,326,328,N/A,17,1
4,N/A,N/A,N/A,322,326,N/A,20,4
2,N/A,N/A,N/A,320,322,N/A,25,3
3,N/A,N/A,N/A,317,320,N/A,31,3
3,N/A,N/A,N/A,314,317,N/A,36,2
7,N/A,N/A,N/A,307,314,N/A,40,6
3,N/A,N/A,N/A,304,307,N/A,43,3
3,N/A,N/A,N/A,301,304,N/A,48,2
6,N/A,N/A,N/A,295,301,N/A,52,6
2,N/A,N/A,N/A,293,295,N/A,58,0
6,N/A,N/A,N/A,287,293,N/A,63,5
6,N/A,N/A,N/A,281,287,N/A,69,5
3,N/A,N/A,N/A,278,281,N/A,73,3
2,N/A,N/A,N/A,276,278,N/A,79,3
2,N/A,N/A,N/A,274,276,N/A,85,3
1,N/A,N/A,N/A,273,274,N/A,89,1
4,N/A,N/A,N/A,269,273,N/A,92,4
3,N/A,N/A,N/A,266,269,N/A,98,4
2,N/A,N/A,N/A,264,266,N/A,102,2
2,N/A,N/A,N/A,262,264,N/A,107,1
4,N/A,N/A,N/A,258,262,N/A,110,4
3,N/A,N/A,N/A,255,258,N/A,114,2
6,N/A,N/A,N/A,249,255,N/A,117,5
3,N/A,N/A,N/A,246,249,N/A,120,2
5,N/A,N/A,N/A,241,246,N/A,123,5
2,N/A,N/A,N/A,239,241,N/A,126,2
5,N/A,N/A,N/A,234,239,N/A,129,5
6,N/A,N/A,N/A,1367,1373,N/A,6,5
2,N/A,N/A,N/A,1365,1367,N/A,10,3
2,N/A,N/A,N/A,1363,1365,N/A,16,3
3,N/A,N/A,N/A,1360,1363,N/A,22,3
1,N/A,N/A,N/A,1359,1360,N/A,26,1
2,N/A,N/A,N/A,1357,1359,N/A,32,1
6,N/A,N/A,N/A,1351,1357,N/A,36,5
2,N/A,N/A,N/A,1349,1351,N/A,40,3
2,N/A,N/A,N/A,1347,1349,N/A,45,2
1,N/A,N/A,N/A,1346,1347,N/A,50,1
2,N/A,N/A,N/A,1344,1346,N/A,56,1
1,N/A,N/A,N/A,1343,1344,N/A,62,1
1,N/A,N/A,N/A,1342,1343,N/A,68,1
3,N/A,N/A,N/A,1339,1342,N/A,71,4
3,N/A,N/A,N/A,1336,1339,N/A,75,2
2,N/A,N/A,N/A,1334,1336,N/A,81,2
6,N/A,N/A,N/A,1328,1334,N/A,84,5
3,N/A,N/A,N/A,1325,1328,N/A,89,4
2,N/A,N/A,N/A,1323,1325,N/A,93,2
6,N/A,N/A,N/A,1317,1323,N/A,96,5
6,N/A,N/A,N/A,1311,1317,N/A,102,5
6,N/A,N/A,N/A,1305,1311,N/A,108,5
3,N/A,N/A,N/A,1302,1305,N/A,112,3
2,N/A,N/A,N/A,1300,1302,N/A,116,1
1,N/A,N/A,N/A,1299,1300,N/A,122,1
1,N/A,N/A,N/A,1298,1299,N/A,128,1
6,N/A,N/A,N/A,1292,1298,N/A,133,6
5,N/A,N/A,N/A,1287,1292,N/A,138,5
2,N/A,N/A,N/A,1285,1287,N/A,142,3
3,N/A,N/A,N/A,1282,1285,N/A,148,3
6,N/A,N/A,N/A,1344,1350,N/A,6,6
3,N/A,N/A,N/A,1341,1344,N/A,10,4
2,N/A,N/A,N/A,1339,1341,N/A,15,3
3,N/A,N/A,N/A,1336,1339,N/A,21,3
3,N/A,N/A,N/A,1333,1336,N/A,26,2
6,N/A,N/A,N/A,1327,1333,N/A,29,5
2,N/A,N/A,N/A,1325,1327,N/A,32,2
1,N/A,N/A,N/A,1324,1325,N/A,37,1
1,N/A,N/A,N/A,1323,1324,N/A,43,1
6,N/A,N/A,N/A,1317,1323,N/A,48,6
2,N/A,N/A,N/A,1315,1317,N/A,51,3
3,N/A,N/A,N/A,1312,1315,N/A,57,3
6,N/A,N/A,N/A,1306,1312,N/A,60,6
3,N/A,N/A,N/A,1303,1306,N/A,64,4
3,N/A,N/A,N/A,1300,1303,N/A,69,3
1,N/A,N/A,N/A,1299,1300,N/A,73,1
1,N/A,N/A,N/A,1298,1299,N/A,79,1
4,N/A,N/A,N/A,1294,1298,N/A,82,4
3,N/A,N/A,N/A,1291,1294,N/A,86,2
2,N/A,N/A,N/A,1289,1291,N/A,92,2
7,N/A,N/A,N/A,1282,1289,N/A,96,6
5,N/A,N/A,N/A,1277,1282,N/A,101,5
3,N/A,N/A,N/A,1274,1277,N/A,104,2
6,N/A,N/A,N/A,1268,1274,N/A,108,6
1,N/A,N/A,N/A,1267,1268,N/A,114,0
2,N/A,N/A,N/A,1265,1267,N/A,117,3
7,N/A,N/A,N/A,1258,1265,N/A,120,6
3,N/A,N/A,N/A,1255,1258,N/A,123,3
2,N/A,N/A,N/A,1253,1255,N/A,127,1
7,N/A,N/A,N/A,1246,1253,N/A,132,6
6,N/A,N/A,N/A,800,806,N/A,4,6
6,N/A,N/A,N/A,794,800,N/A,9,5
2,N/A,N/A,N/A,792,794,N/A,12,2
7,N/A,N/A,N/A,785,792,N/A,16,6
3,N/A,N/A,N/A,782,785,N/A,19,3
1,N/A,N/A,N/A,781,782,N/A,23,1
4,N/A,N/A,N/A,777,781,N/A,26,4
2,N/A,N/A,N/A,775,777,N/A,31,3
2,N/A,N/A,N/A,773,775,N/A,35,1
4,N/A,N/A,N/A,769,773,N/A,38,4
2,N/A,N/A,N/A,767,769,N/A,43,3
3,N/A,N/A,N/A,764,767,N/A,49,3
3,N/A,N/A,N/A,761,764,N/A,55,3
2,N/A,N/A,N/A,759,761,N/A,59,1
2,N/A,N/A,N/A,757,759,N/A,65,1
3,N/A,N/A,N/A,754,757,N/A,68,4
2,N/A,N/A,N/A,752,754,N/A,71,1
6,N/A,N/A,N/A,746,752,N/A,76,6
2,N/A,N/A,N/A,744,746,N/A,82,0
7,N/A,N/A,N/A,737,744,N/A,88,6
6,N/A,N/A,N/A,731,737,N/A,93,5
4,N/A,N/A,N/A,727,731,N/A,98,4
2,N/A,N/A,N/A,725,727,N/A,101,1
7,N/A,N/A,N/A,718,725,N/A,106,6
5,N/A,N/A,N/A,713,718,N/A,111,5
3,N/A,N/A,N/A,710,713,N/A,114,2
5,N/A,N/A,N/A,705,710,N/A,117,5
3,N/A,N/A,N/A,702,705,N/A,120,2
2,N/A,N/A,N/A,700,702,N/A,126,2
5,N/A,N/A,N/A,695,700,N/A,129,5
3,N/A,N/A,N/A,1577,1580,N/A,5,2
6,N/A,N/A,N/A,1571,1577,N/A,8,5
2,N/A,N/A,N/A,1569,1571,N/A,11,2
6,N/A,N/A,N/A,1563,1569,N/A,15,6
2,N/A,N/A,N/A,1561,1563,N/A,18,3
6,N/A,N/A,N/A,1555,1561,N/A,21,6
3,N/A,N/A,N/A,1552,1555,N/A,24,3
6,N/A,N/A,N/A,1546,1552,N/A,27,6
3,N/A,N/A,N/A,1543,1546,N/A,30,3
1,N/A,N/A,N/A,1542,1543,N/A,34,1
3,N/A,N/A,N/A,1539,1542,N/A,37,4
3,N/A,N/A,N/A,1536,1539,N/A,42,3
3,N/A,N/A,N/A,1533,1536,N/A,47,2
6,N/A,N/A,N/A,1527,1533,N/A,50,5
2,N/A,N/A,N/A,1525,1527,N/A,54,3
2,N/A,N/A,N/A,1523,1525,N/A,60,3
1,N/A,N/A,N/A,1522,1523,N/A,64,1
3,N/A,N/A,N/A,1519,1522,N/A,67,4
3,N/A,N/A,N/A,1516,1519,N/A,72,3
3,N/A,N/A,N/A,1513,1516,N/A,78,3
7,N/A,N/A,N/A,1506,1513,N/A,81,6
3,N/A,N/A,N/A,1503,1506,N/A,85,4
3,N/A,N/A,N/A,1500,1503,N/A,89,2
5,N/A,N/A,N/A,1495,1500,N/A,92,5
3,N/A,N/A,N/A,1492,1495,N/A,96,3
2,N/A,N/A,N/A,1490,1492,N/A,102,3
6,N/A,N/A,N/A,1484,1490,N/A,105,6
6,N/A,N/A,N/A,1478,1484,N/A,110,5
3,N/A,N/A,N/A,1475,1478,N/A,113,2
3,N/A,N/A,N/A,1472,1475,N/A,119,2
4,N/A,N/A,N/A,1013,1017,N/A,5,4
4,N/A,N/A,N/A,1009,1013,N/A,11,4
2,N/A,N/A,N/A,1007,1009,N/A,15,2
6,N/A,N/A,N/A,1001,1007,N/A,18,5
2,N/A,N/A,N/A,999,1001,N/A,21,2
7,N/A,N/A,N/A,992,999,N/A,25,6
4,N/A,N/A,N/A,988,992,N/A,29,4
3,N/A,N/A,N/A,985,988,N/A,35,4
3,N/A,N/A,N/A,982,985,N/A,41,4
4,N/A,N/A,N/A,978,982,N/A,47,4
4,N/A,N/A,N/A,974,978,N/A,53,4
2,N/A,N/A,N/A,972,974,N/A,57,2
1,N/A,N/A,N/A,971,972,N/A,62,1
7,N/A,N/A,N/A,964,971,N/A,67,6
2,N/A,N/A,N/A,962,964,N/A,73,0
6,N/A,N/A,N/A,956,962,N/A,79,6
6,N/A,N/A,N/A,950,956,N/A,84,5
3,N/A,N/A,N/A,947,950,N/A,89,4
2,N/A,N/A,N/A,945,947,N/A,94,3
7,N/A,N/A,N/A,938,945,N/A,97,6
3,N/A,N/A,N/A,935,938,N/A,101,4
3,N/A,N/A,N/A,932,935,N/A,106,3
2,N/A,N/A,N/A,930,932,N/A,112,3
2,N/A,N/A,N/A,928,930,N/A,116,1
7,N/A,N/A,N/A,921,928,N/A,121,6
1,N/A,N/A,N/A,920,921,N/A,127,0
6,N/A,N/A,N/A,914,920,N/A,133,6
2,N/A,N/A,N/A,912,914,N/A,136,3
2,N/A,N/A,N/A,910,912,N/A,142,3
3,N/A,N/A,N/A,907,910,N/A,147,2
2,N/A,N/A,N/A,1342,1344,N/A,4,1
7,N/A,N/A,N/A,1335,1342,N/A,9,6
4,N/A,N/A,N/A,1331,1335,N/A,13,4
3,N/A,N/A,N/A,1328,1331,N/A,17,2
7,N/A,N/A,N/A,1321,1328,N/A,21,6
2,N/A,N/A,N/A,1319,1321,N/A,24,3
1,N/A,N/A,N/A,1318,1319,N/A,28,1
1,N/A,N/A,N/A,1317,1318,N/A,34,1
6,N/A,N/A,N/A,1311,1317,N/A,39,6
2,N/A,N/A,N/A,1309,1311,N/A,45,0
2,N/A,N/A,N/A,1307,1309,N/A,48,3
6,N/A,N/A,N/A,1301,1307,N/A,51,6
1,N/A,N/A,N/A,1300,1301,N/A,57,0
3,N/A,N/A,N/A,1297,1300,N/A,60,3
3,N/A,N/A,N/A,1294,1297,N/A,66,3
7,N/A,N/A,N/A,1287,1294,N/A,69,6
1,N/A,N/A,N/A,1286,1287,N/A,75,0
2,N/A,N/A,N/A,1284,1286,N/A,78,3
6,N/A,N/A,N/A,1278,1284,N/A,81,6
4,N/A,N/A,N/A,1274,1278,N/A,85,4
1,N/A,N/A,N/A,1273,1274,N/A,88,1
4,N/A,N/A,N/A,1269,1273,N/A,91,4
1,N/A,N/A,N/A,1268,1269,N/A,94,1
6,N/A,N/A,N/A,1262,1268,N/A,99,6
6,N/A,N/A,N/A,1256,1262,N/A,104,5
6,N/A,N/A,N/A,1250,1256,N/A,110,5
5,N/A,N/A,N/A,1245,1250,N/A,116,5
6,N/A,N/A,N/A,1239,1245,N/A,122,5
3,N/A,N/A,N/A,1236,1239,N/A,126,3
3,N/A,N/A,N/A,1233,1236,N/A,132,3
7,N/A,N/A,N/A,1262,1269,N/A,4,6
3,N/A,N/A,N/A,1259,1262,N/A,8,4
2,N/A,N/A,N/A,1257,1259,N/A,12,2
1,N/A,N/A,N/A,1256,1257,N/A,17,1
6,N/A,N/A,N/A,1250,1256,N/A,21,5
5,N/A,N/A,N/A,1245,1250,N/A,27,5
6,N/A,N/A,N/A,1239,1245,N/A,33,5
5,N/A,N/A,N/A,1234,1239,N/A,39,5
2,N/A,N/A,N/A,1232,1234,N/A,42,2
2,N/A,N/A,N/A,1230,1232,N/A,47,1
1,N/A,N/A,N/A,1229,1230,N/A,53,1
5,N/A,N/A,N/A,1224,1229,N/A,57,5
4,N/A,N/A,N/A,1220,1224,N/A,62,4
2,N/A,N/A,N/A,1218,1220,N/A,65,1
4,N/A,N/A,N/A,1214,1218,N/A,68,4
2,N/A,N/A,N/A,1212,1214,N/A,73,3
2,N/A,N/A,N/A,1210,1212,N/A,78,2
6,N/A,N/A,N/A,1204,1210,N/A,82,6
3,N/A,N/A,N/A,1201,1204,N/A,86,4
1,N/A,N/A,N/A,1200,1201,N/A,89,1
6,N/A,N/A,N/A,1194,1200,N/A,94,6
6,N/A,N/A,N/A,1188,1194,N/A,99,5
2,N/A,N/A,N/A,1186,1188,N/A,102,2
3,N/A,N/A,N/A,1183,1186,N/A,108,2
6,N/A,N/A,N/A,1177,1183,N/A,111,5
5,N/A,N/A,N/A,1172,1177,N/A,117,5
4,N/A,N/A,N/A,1168,1172,N/A,122,4
2,N/A,N/A,N/A,1166,1168,N/A,127,3
2,N/A,N/A,N/A,1164,1166,N/A,133,3
7,N/A,N/A,N/A,1157,1164,N/A,136,6
7,N/A,N/A,N/A,1332,1339,N/A,6,6
1,N/A,N/A,N/A,1331,1332,N/A,12,0
3,N/A,N/A,N/A,1328,1331,N/A,15,3
3,N/A,N/A,N/A,1325,1328,N/A,20,2
6,N/A,N/A,N/A,1319,1325,N/A,23,5
4,N/A,N/A,N/A,1315,1319,N/A,28,4
4,N/A,N/A,N/A,1311,1315,N/A,34,4
3,N/A,N/A,N/A,1308,1311,N/A,38,2
5,N/A,N/A,N/A,1303,1308,N/A,41,5
6,N/A,N/A,N/A,1297,1303,N/A,47,5
3,N/A,N/A,N/A,1294,1297,N/A,51,3
2,N/A,N/A,N/A,1292,1294,N/A,55,1
2,N/A,N/A,N/A,1290,1292,N/A,61,1
1,N/A,N/A,N/A,1289,1290,N/A,67,1
6,N/A,N/A,N/A,1283,1289,N/A,72,6
3,N/A,N/A,N/A,1280,1283,N/A,76,4
3,N/A,N/A,N/A,1277,1280,N/A,82,4
3,N/A,N/A,N/A,1274,1277,N/A,86,2
1,N/A,N/A,N/A,1273,1274,N/A,91,1
7,N/A,N/A,N/A,1266,1273,N/A,96,6
4,N/A,N/A,N/A,1262,1266,N/A,100,4
2,N/A,N/A,N/A,1260,1262,N/A,104,2
1,N/A,N/A,N/A,1259,1260,N/A,109,1
6,N/A,N/A,N/A,1253,1259,N/A,114,6
3,N/A,N/A,N/A,1250,1253,N/A,117,3
2,N/A,N/A,N/A,1248,1250,N/A,123,3
1,N/A,N/A,N/A,1247,1248,N/A,127,1
2,N/A,N/A,N/A,1245,1247,N/A,133,1
2,N/A,N/A,N/A,1243,1245,N/A,139,1
6,N/A,N/A,N/A,1237,1243,N/A,144,6
1,N/A,N/A,N/A,1004,1005,N/A,6,1
6,N/A,N/A,N/A,998,1004,N/A,11,6
6,N/A,N/A,N/A,992,998,N/A,16,5
3,N/A,N/A,N/A,989,992,N/A,19,2
2,N/A,N/A,N/A,987,989,N/A,24,1
2,N/A,N/A,N/A,985,987,N/A,30,1
6,N/A,N/A,N/A,979,985,N/A,34,5
4,N/A,N/A,N/A,975,979,N/A,39,4
2,N/A,N/A,N/A,973,975,N/A,42,1
5,N/A,N/A,N/A,968,973,N/A,46,5
3,N/A,N/A,N/A,965,968,N/A,49,2
6,N/A,N/A,N/A,959,965,N/A,52,5
3,N/A,N/A,N/A,956,959,N/A,55,2
1,N/A,N/A,N/A,955,956,N/A,60,1
5,N/A,N/A,N/A,950,955,N/A,64,5
2,N/A,N/A,N/A,948,950,N/A,67,2
2,N/A,N/A,N/A,946,948,N/A,73,2
7,N/A,N/A,N/A,939,946,N/A,77,6
2,N/A,N/A,N/A,937,939,N/A,83,0
2,N/A,N/A,N/A,935,937,N/A,86,3
7,N/A,N/A,N/A,928,935,N/A,89,6
3,N/A,N/A,N/A,925,928,N/A,93,4
2,N/A,N/A,N/A,923,925,N/A,98,3
2,N/A,N/A,N/A,921,923,N/A,103,2
6,N/A,N/A,N/A,915,921,N/A,107,6
6,N/A,N/A,N/A,909,915,N/A,112,5
3,N/A,N/A,N/A,906,909,N/A,117,4
3,N/A,N/A,N/A,903,906,N/A,123,4
1,N/A,N/A,N/A,902,903,N/A,126,1
7,N/A,N/A,N/A,895,902,N/A,131,6
6,N/A,N/A,N/A,1608,1614,N/A,6,5
6,N/A,N/A,N/A,1602,1608,N/A,12,5
3,N/A,N/A,N/A,1599,1602,N/A,17,4
3,N/A,N/A,N/A,1596,1599,N/A,21,2
3,N/A,N/A,N/A,1593,1596,N/A,27,2
2,N/A,N/A,N/A,1591,1593,N/A,32,1
4,N/A,N/A,N/A,1587,1591,N/A,35,4
2,N/A,N/A,N/A,1585,1587,N/A,38,1
2,N/A,N/A,N/A,1583,1585,N/A,44,1
5,N/A,N/A,N/A,1578,1583,N/A,48,5
3,N/A,N/A,N/A,1575,1578,N/A,52,3
6,N/A,N/A,N/A,1569,1575,N/A,55,6
5,N/A,N/A,N/A,1564,1569,N/A,60,5
3,N/A,N/A,N/A,1561,1564,N/A,65,4
3,N/A,N/A,N/A,1558,1561,N/A,71,4
2,N/A,N/A,N/A,1556,1558,N/A,74,1
2,N/A,N/A,N/A,1554,1556,N/A,80,1
1,N/A,N/A,N/A,1553,1554,N/A,86,1
4,N/A,N/A,N/A,1549,1553,N/A,89,4
3,N/A,N/A,N/A,1546,1549,N/A,94,3
2,N/A,N/A,N/A,1544,1546,N/A,100,3
6,N/A,N/A,N/A,1538,1544,N/A,103,6
6,N/A,N/A,N/A,1532,1538,N/A,108,5
2,N/A,N/A,N/A,1530,1532,N/A,111,2
6,N/A,N/A,N/A,1524,1530,N/A,114,5
5,N/A,N/A,N/A,1519,1524,N/A,120,5
3,N/A,N/A,N/A,1516,1519,N/A,125,4
3,N/A,N/A,N/A,1513,1516,N/A,130,3
2,N/A,N/A,N/A,1511,1513,N/A,135,2
5,N/A,N/A,N/A,1506,1511,N/A,138,5
4,N/A,N/A,N/A,849,853,N/A,6,4
2,N/A,N/A,N/A,847,849,N/A,10,2
7,N/A,N/A,N/A,840,847,N/A,14,6
2,N/A,N/A,N/A,838,840,N/A,17,3
2,N/A,N/A,N/A,836,838,N/A,22,2
5,N/A,N/A,N/A,831,836,N/A,25,5
5,N/A,N/A,N/A,826,831,N/A,31,5
3,N/A,N/A,N/A,823,826,N/A,34,2
3,N/A,N/A,N/A,820,823,N/A,40,2
2,N/A,N/A,N/A,818,820,N/A,45,1
7,N/A,N/A,N/A,811,818,N/A,50,6
1,N/A,N/A,N/A,810,811,N/A,56,0
3,N/A,N/A,N/A,807,810,N/A,59,3
3,N/A,N/A,N/A,804,807,N/A,64,2
1,N/A,N/A,N/A,803,804,N/A,69,1
5,N/A,N/A,N/A,798,803,N/A,73,5
4,N/A,N/A,N/A,794,798,N/A,78,4
2,N/A,N/A,N/A,792,794,N/A,83,3
1,N/A,N/A,N/A,791,792,N/A,87,1
5,N/A,N/A,N/A,786,791,N/A,91,5
3,N/A,N/A,N/A,783,786,N/A,96,4
1,N/A,N/A,N/A,782,783,N/A,99,1
6,N/A,N/A,N/A,776,782,N/A,103,5
3,N/A,N/A,N/A,773,776,N/A,108,4
3,N/A,N/A,N/A,770,773,N/A,114,4
4,N/A,N/A,N/A,766,770,N/A,120,4
2,N/A,N/A,N/A,764,766,N/A,124,2
5,N/A,N/A,N/A,759,764,N/A,127,5
3,N/A,N/A,N/A,756,759,N/A,131,3
7,N/A,N/A,N/A,749,756,N/A,134,6
1,N/A,N/A,N/A,471,472,N/A,4,1
1,N/A,N/A,N/A,470,471,N/A,10,1
5,N/A,N/A,N/A,465,470,N/A,14,5
2,N/A,N/A,N/A,463,465,N/A,17,2
3,N/A,N/A,N/A,460,463,N/A,23,2
1,N/A,N/A,N/A,459,460,N/A,28,1
3,N/A,N/A,N/A,456,459,N/A,31,4
2,N/A,N/A,N/A,454,456,N/A,35,2
6,N/A,N/A,N/A,448,454,N/A,39,6
2,N/A,N/A,N/A,446,448,N/A,42,3
1,N/A,N/A,N/A,445,446,N/A,46,1
1,N/A,N/A,N/A,444,445,N/A,52,1
7,N/A,N/A,N/A,437,444,N/A,57,6
3,N/A,N/A,N/A,434,437,N/A,60,3
2,N/A,N/A,N/A,432,434,N/A,66,3
3,N/A,N/A,N/A,429,432,N/A,71,2
6,N/A,N/A,N/A,423,429,N/A,74,5
3,N/A,N/A,N/A,420,423,N/A,79,4
2,N/A,N/A,N/A,418,420,N/A,82,1
7,N/A,N/A,N/A,411,418,N/A,87,6
6,N/A,N/A,N/A,405,411,N/A,92,5
4,N/A,N/A,N/A,401,405,N/A,97,4
3,N/A,N/A,N/A,398,401,N/A,103,4
2,N/A,N/A,N/A,396,398,N/A,108,3
2,N/A,N/A,N/A,394,396,N/A,113,2
1,N/A,N/A,N/A,393,394,N/A,118,1
5,N/A,N/A,N/A,388,393,N/A,122,5
4,N/A,N/A,N/A,384,388,N/A,127,4
1,N/A,N/A,N/A,383,384,N/A,130,1
3,N/A,N/A,N/A,380,383,N/A,133,4
3,N/A,N/A,N/A,828,831,N/A,4,4
4,N/A,N/A,N/A,824,828,N/A,10,4
2,N/A,N/A,N/A,822,824,N/A,13,1
3,N/A,N/A,N/A,819,822,N/A,16,4
4,N/A,N/A,N/A,815,819,N/A,22,4
4,N/A,N/A,N/A,811,815,N/A,28,4
1,N/A,N/A,N/A,810,811,N/A,31,1
6,N/A,N/A,N/A,804,810,N/A,35,5
2,N/A,N/A,N/A,802,804,N/A,38,2
6,N/A,N/A,N/A,796,802,N/A,42,6
4,N/A,N/A,N/A,792,796,N/A,46,4
2,N/A,N/A,N/A,790,792,N/A,49,1
4,N/A,N/A,N/A,786,790,N/A,52,4
4,N/A,N/A,N/A,782,786,N/A,58,4
2,N/A,N/A,N/A,780,782,N/A,62,2
2,N/A,N/A,N/A,778,780,N/A,67,1
2,N/A,N/A,N/A,776,778,N/A,73,1
6,N/A,N/A,N/A,770,776,N/A,77,5
4,N/A,N/A,N/A,766,770,N/A,82,4
3,N/A,N/A,N/A,763,766,N/A,87,3
2,N/A,N/A,N/A,761,763,N/A,93,3
2,N/A,N/A,N/A,759,761,N/A,97,1
2,N/A,N/A,N/A,757,759,N/A,103,1
5,N/A,N/A,N/A,752,757,N/A,107,5
6,N/A,N/A,N/A,746,752,N/A,113,5
5,N/A,N/A,N/A,741,746,N/A,119,5
2,N/A,N/A,N/A,739,741,N/A,123,3
2,N/A,N/A,N/A,737,739,N/A,129,3
2,N/A,N/A,N/A,735,737,N/A,134,2
1,N/A,N/A,N/A,734,735,N/A,139,1
2,N/A,N/A,N/A,979,981,N/A,6,1
1,N/A,N/A,N/A,978,979,N/A,12,1
4,N/A,N/A,N/A,974,978,N/A,15,4
3,N/A,N/A,N/A,971,974,N/A,21,4
3,N/A,N/A,N/A,968,971,N/A,26,3
1,N/A,N/A,N/A,967,968,N/A,30,1
4,N/A,N/A,N/A,963,967,N/A,33,4
4,N/A,N/A,N/A,959,963,N/A,39,4
4,N/A,N/A,N/A,955,959,N/A,45,4
3,N/A,N/A,N/A,952,955,N/A,51,4
2,N/A,N/A,N/A,950,952,N/A,55,2
2,N/A,N/A,N/A,948,950,N/A,61,2
3,N/A,N/A,N/A,945,948,N/A,67,2
1,N/A,N/A,N/A,944,945,N/A,72,1
4,N/A,N/A,N/A,940,944,N/A,75,4
2,N/A,N/A,N/A,938,940,N/A,78,1
1,N/A,N/A,N/A,937,938,N/A,84,1
2,N/A,N/A,N/A,935,937,N/A,90,1
4,N/A,N/A,N/A,931,935,N/A,93,4
2,N/A,N/A,N/A,929,931,N/A,97,2
2,N/A,N/A,N/A,927,929,N/A,102,1
6,N/A,N/A,N/A,921,927,N/A,107,6
3,N/A,N/A,N/A,918,921,N/A,111,4
2,N/A,N/A,N/A,916,918,N/A,115,2
2,N/A,N/A,N/A,914,916,N/A,121,2
7,N/A,N/A,N/A,907,914,N/A,125,6
5,N/A,N/A,N/A,902,907,N/A,130,5
3,N/A,N/A,N/A,899,902,N/A,133,2
7,N/A,N/A,N/A,892,899,N/A,137,6
1,N/A,N/A,N/A,891,892,N/A,143,0
3,N/A,N/A,N/A,1651,1654,N/A,5,3
2,N/A,N/A,N/A,1649,1651,N/A,9,1
6,N/A,N/A,N/A,1643,1649,N/A,14,6
6,N/A,N/A,N/A,1637,1643,N/A,19,5
4,N/A,N/A,N/A,1633,1637,N/A,24,4
1,N/A,N/A,N/A,1632,1633,N/A,27,1
6,N/A,N/A,N/A,1626,1632,N/A,32,6
3,N/A,N/A,N/A,1623,1626,N/A,36,4
1,N/A,N/A,N/A,1622,1623,N/A,39,1
7,N/A,N/A,N/A,1615,1622,N/A,44,6
2,N/A,N/A,N/A,1613,1615,N/A,50,0
2,N/A,N/A,N/A,1611,1613,N/A,53,3
1,N/A,N/A,N/A,1610,1611,N/A,57,1
6,N/A,N/A,N/A,1604,1610,N/A,61,5
2,N/A,N/A,N/A,1602,1604,N/A,64,2
7,N/A,N/A,N/A,1595,1602,N/A,68,6
1,N/A,N/A,N/A,1594,1595,N/A,74,0
5,N/A,N/A,N/A,1589,1594,N/A,79,5
3,N/A,N/A,N/A,1586,1589,N/A,84,4
2,N/A,N/A,N/A,1584,1586,N/A,88,2
3,N/A,N/A,N/A,1581,1584,N/A,94,2
6,N/A,N/A,N/A,1575,1581,N/A,97,5
6,N/A,N/A,N/A,1569,1575,N/A,103,5
3,N/A,N/A,N/A,1566,1569,N/A,106,2
6,N/A,N/A,N/A,1560,1566,N/A,110,6
3,N/A,N/A,N/A,1557,1560,N/A,114,4
3,N/A,N/A,N/A,1554,1557,N/A,119,3
3,N/A,N/A,N/A,1551,1554,N/A,124,2
3,N/A,N/A,N/A,1548,1551,N/A,130,2
5,N/A,N/A,N/A,1543,1548,N/A,133,5
7,N/A,N/A,N/A,1932,1939,N/A,5,6
3,N/A,N/A,N/A,1929,1932,N/A,8,3
2,N/A,N/A,N/A,1927,1929,N/A,13,2
6,N/A,N/A,N/A,1921,1927,N/A,16,5
3,N/A,N/A,N/A,1918,1921,N/A,20,3
1,N/A,N/A,N/A,1917,1918,N/A,24,1
1,N/A,N/A,N/A,1916,1917,N/A,30,1
2,N/A,N/A,N/A,1914,1916,N/A,36,1
4,N/A,N/A,N/A,1910,1914,N/A,39,4
2,N/A,N/A,N/A,1908,1910,N/A,43,2
6,N/A,N/A,N/A,1902,1908,N/A,46,5
2,N/A,N/A,N/A,1900,1902,N/A,50,3
2,N/A,N/A,N/A,1898,1900,N/A,55,2
1,N/A,N/A,N/A,1897,1898,N/A,60,1
6,N/A,N/A,N/A,1891,1897,N/A,65,6
1,N/A,N/A,N/A,1890,1891,N/A,71,0
2,N/A,N/A,N/A,1888,1890,N/A,74,3
6,N/A,N/A,N/A,1882,1888,N/A,77,6
6,N/A,N/A,N/A,1876,1882,N/A,82,5
2,N/A,N/A,N/A,1874,1876,N/A,85,2
1,N/A,N/A,N/A,1873,1874,N/A,90,1
5,N/A,N/A,N/A,1868,1873,N/A,94,5
4,N/A,N/A,N/A,1864,1868,N/A,99,4
2,N/A,N/A,N/A,1862,1864,N/A,102,1
1,N/A,N/A,N/A,1861,1862,N/A,108,1
3,N/A,N/A,N/A,1858,1861,N/A,111,4
2,N/A,N/A,N/A,1856,1858,N/A,114,1
3,N/A,N/A,N/A,1853,1856,N/A,117,4
3,N/A,N/A,N/A,1850,1853,N/A,123,4
2,N/A,N/A,N/A,1848,1850,N/A,128,3
6,N/A,N/A,N/A,1497,1503,N/A,6,5
6,N/A,N/A,N/A,1491,1497,N/A,12,5
6,N/A,N/A,N/A,1485,1491,N/A,18,5
6,N/A,N/A,N/A,1479,1485,N/A,24,5
3,N/A,N/A,N/A,1476,1479,N/A,27,2
2,N/A,N/A,N/A,1474,1476,N/A,33,2
1,N/A,N/A,N/A,1473,1474,N/A,38,1
4,N/A,N/A,N/A,1469,1473,N/A,41,4
4,N/A,N/A,N/A,1465,1469,N/A,47,4
3,N/A,N/A,N/A,1462,1465,N/A,51,2
1,N/A,N/A,N/A,1461,1462,N/A,56,1
6,N/A,N/A,N/A,1455,1461,N/A,61,6
3,N/A,N/A,N/A,1452,1455,N/A,65,4
2,N/A,N/A,N/A,1450,1452,N/A,70,3
3,N/A,N/A,N/A,1447,1450,N/A,76,3
2,N/A,N/A,N/A,1445,1447,N/A,80,1
6,N/A,N/A,N/A,1439,1445,N/A,85,6
4,N/A,N/A,N/A,1435,1439,N/A,89,4
2,N/A,N/A,N/A,1433,1435,N/A,93,2
1,N/A,N/A,N/A,1432,1433,N/A,98,1
7,N/A,N/A,N/A,1425,1432,N/A,103,6
4,N/A,N/A,N/A,1421,1425,N/A,107,4
3,N/A,N/A,N/A,1418,1421,N/A,113,4
3,N/A,N/A,N/A,1415,1418,N/A,119,4
2,N/A,N/A,N/A,1413,1415,N/A,123,2
2,N/A,N/A,N/A,1411,1413,N/A,129,2
7,N/A,N/A,N/A,1404,1411,N/A,133,6
2,N/A,N/A,N/A,1402,1404,N/A,136,3
2,N/A,N/A,N/A,1400,1402,N/A,141,2
2,N/A,N/A,N/A,1398,1400,N/A,146,1
2,N/A,N/A,N/A,1436,1438,N/A,3,2
6,N/A,N/A,N/A,1430,1436,N/A,7,6
2,N/A,N/A,N/A,1428,1430,N/A,13,0
4,N/A,N/A,N/A,1424,1428,N/A,17,4
3,N/A,N/A,N/A,1421,1424,N/A,23,4
2,N/A,N/A,N/A,1419,1421,N/A,28,3
2,N/A,N/A,N/A,1417,1419,N/A,33,2
2,N/A,N/A,N/A,1415,1417,N/A,39,2
5,N/A,N/A,N/A,1410,1415,N/A,42,5
3,N/A,N/A,N/A,1407,1410,N/A,46,3
6,N/A,N/A,N/A,1401,1407,N/A,49,6
1,N/A,N/A,N/A,1400,1401,N/A,55,0
2,N/A,N/A,N/A,1398,1400,N/A,58,3
2,N/A,N/A,N/A,1396,1398,N/A,62,1
4,N/A,N/A,N/A,1392,1396,N/A,65,4
3,N/A,N/A,N/A,1389,1392,N/A,70,3
2,N/A,N/A,N/A,1387,1389,N/A,74,1
5,N/A,N/A,N/A,1382,1387,N/A,78,5
4,N/A,N/A,N/A,1378,1382,N/A,83,4
2,N/A,N/A,N/A,1376,1378,N/A,88,3
7,N/A,N/A,N/A,1369,1376,N/A,91,6
5,N/A,N/A,N/A,1364,1369,N/A,96,5
2,N/A,N/A,N/A,1362,1364,N/A,100,3
6,N/A,N/A,N/A,1356,1362,N/A,103,6
4,N/A,N/A,N/A,1352,1356,N/A,107,4
2,N/A,N/A,N/A,1350,1352,N/A,112,3
1,N/A,N/A,N/A,1349,1350,N/A,116,1
4,N/A,N/A,N/A,1345,1349,N/A,119,4
3,N/A,N/A,N/A,1342,1345,N/A,125,4
3,N/A,N/A,N/A,1339,1342,N/A,131,4
3,N/A,N/A,N/A,1357,1360,N/A,5,2
6,N/A,N/A,N/A,1351,1357,N/A,8,5
2,N/A,N/A,N/A,1349,1351,N/A,11,2
2,N/A,N/A,N/A,1347,1349,N/A,16,1
6,N/A,N/A,N/A,1341,1347,N/A,21,6
6,N/A,N/A,N/A,1335,1341,N/A,26,5
3,N/A,N/A,N/A,1332,1335,N/A,29,2
5,N/A,N/A,N/A,1327,1332,N/A,32,5
3,N/A,N/A,N/A,1324,1327,N/A,35,2
2,N/A,N/A,N/A,1322,1324,N/A,40,1
4,N/A,N/A,N/A,1318,1322,N/A,43,4
2,N/A,N/A,N/A,1316,1318,N/A,48,3
2,N/A,N/A,N/A,1314,1316,N/A,54,3
2,N/A,N/A,N/A,1312,1314,N/A,59,2
6,N/A,N/A,N/A,1306,1312,N/A,62,5
3,N/A,N/A,N/A,1303,1306,N/A,66,3
2,N/A,N/A,N/A,1301,1303,N/A,71,2
5,N/A,N/A,N/A,1296,1301,N/A,74,5
3,N/A,N/A,N/A,1293,1296,N/A,78,3
3,N/A,N/A,N/A,1290,1293,N/A,83,2
2,N/A,N/A,N/A,1288,1290,N/A,88,1
6,N/A,N/A,N/A,1282,1288,N/A,93,6
5,N/A,N/A,N/A,1277,1282,N/A,98,5
5,N/A,N/A,N/A,1272,1277,N/A,104,5
2,N/A,N/A,N/A,1270,1272,N/A,107,2
1,N/A,N/A,N/A,1269,1270,N/A,112,1
6,N/A,N/A,N/A,1263,1269,N/A,116,5
3,N/A,N/A,N/A,1260,1263,N/A,119,2
5,N/A,N/A,N/A,1255,1260,N/A,122,5
6,N/A,N/A,N/A,1249,1255,N/A,128,5
3,N/A,N/A,N/A,576,579,N/A,3,4
2,N/A,N/A,N/A,574,576,N/A,6,1
2,N/A,N/A,N/A,572,574,N/A,12,1
2,N/A,N/A,N/A,570,572,N/A,18,1
1,N/A,N/A,N/A,569,570,N/A,24,1
6,N/A,N/A,N/A,563,569,N/A,28,5
4,N/A,N/A,N/A,559,563,N/A,33,4
2,N/A,N/A,N/A,557,559,N/A,37,2
3,N/A,N/A,N/A,554,557,N/A,43,2
7,N/A,N/A,N/A,547,554,N/A,47,6
3,N/A,N/A,N/A,544,547,N/A,50,3
2,N/A,N/A,N/A,542,544,N/A,54,1
2,N/A,N/A,N/A,540,542,N/A,60,1
6,N/A,N/A,N/A,534,540,N/A,65,6
3,N/A,N/A,N/A,531,534,N/A,69,4
3,N/A,N/A,N/A,528,531,N/A,73,2
7,N/A,N/A,N/A,521,528,N/A,77,6
2,N/A,N/A,N/A,519,521,N/A,83,0
3,N/A,N/A,N/A,516,519,N/A,86,3
2,N/A,N/A,N/A,514,516,N/A,92,3
6,N/A,N/A,N/A,508,514,N/A,95,6
2,N/A,N/A,N/A,506,508,N/A,101,0
3,N/A,N/A,N/A,503,506,N/A,104,3
2,N/A,N/A,N/A,501,503,N/A,110,3
7,N/A,N/A,N/A,494,501,N/A,113,6
2,N/A,N/A,N/A,492,494,N/A,116,3
2,N/A,N/A,N/A,490,492,N/A,122,3
1,N/A,N/A,N/A,489,490,N/A,126,1
5,N/A,N/A,N/A,484,489,N/A,130,5
4,N/A,N/A,N/A,480,484,N/A,135,4
6,N/A,N/A,N/A,1357,1363,N/A,4,6
6,N/A,N/A,N/A,1351,1357,N/A,9,5
3,N/A,N/A,N/A,1348,1351,N/A,14,4
3,N/A,N/A,N/A,1345,1348,N/A,20,4
2,N/A,N/A,N/A,1343,1345,N/A,25,3
3,N/A,N/A,N/A,1340,1343,N/A,30,2
6,N/A,N/A,N/A,1334,1340,N/A,34,6
4,N/A,N/A,N/A,1330,1334,N/A,38,4
4,N/A,N/A,N/A,1326,1330,N/A,44,4
1,N/A,N/A,N/A,1325,1326,N/A,47,1
6,N/A,N/A,N/A,1319,1325,N/A,52,6
4,N/A,N/A,N/A,1315,1319,N/A,56,4
4,N/A,N/A,N/A,1311,1315,N/A,62,4
4,N/A,N/A,N/A,1307,1311,N/A,68,4
3,N/A,N/A,N/A,1304,1307,N/A,74,4
1,N/A,N/A,N/A,1303,1304,N/A,77,1
7,N/A,N/A,N/A,1296,1303,N/A,82,6
2,N/A,N/A,N/A,1294,1296,N/A,85,3
2,N/A,N/A,N/A,1292,1294,N/A,89,1
4,N/A,N/A,N/A,1288,1292,N/A,92,4
2,N/A,N/A,N/A,1286,1288,N/A,96,2
6,N/A,N/A,N/A,1280,1286,N/A,99,5
4,N/A,N/A,N/A,1276,1280,N/A,104,4
1,N/A,N/A,N/A,1275,1276,N/A,107,1
5,N/A,N/A,N/A,1270,1275,N/A,111,5
5,N/A,N/A,N/A,1265,1270,N/A,117,5
4,N/A,N/A,N/A,1261,1265,N/A,122,4
4,N/A,N/A,N/A,1257,1261,N/A,128,4
3,N/A,N/A,N/A,1254,1257,N/A,134,4
2,N/A,N/A,N/A,1252,1254,N/A,137,1
6,N/A,N/A,N/A,344,350,N/A,6,6
2,N/A,N/A,N/A,342,344,N/A,12,0
3,N/A,N/A,N/A,339,342,N/A,15,3
3,N/A,N/A,N/A,336,339,N/A,21,3
2,N/A,N/A,N/A,334,336,N/A,25,1
2,N/A,N/A,N/A,332,334,N/A,31,1
6,N/A,N/A,N/A,326,332,N/A,35,5
2,N/A,N/A,N/A,324,326,N/A,39,3
7,N/A,N/A,N/A,317,324,N/A,42,6
5,N/A,N/A,N/A,312,317,N/A,47,5
3,N/A,N/A,N/A,309,312,N/A,51,3
2,N/A,N/A,N/A,307,309,N/A,56,2
5,N/A,N/A,N/A,302,307,N/A,59,5
2,N/A,N/A,N/A,300,302,N/A,62,2
6,N/A,N/A,N/A,294,300,N/A,66,6
4,N/A,N/A,N/A,290,294,N/A,70,4
1,N/A,N/A,N/A,289,290,N/A,73,1
7,N/A,N/A,N/A,282,289,N/A,78,6
5,N/A,N/A,N/A,277,282,N/A,83,5
4,N/A,N/A,N/A,273,277,N/A,88,4
3,N/A,N/A,N/A,270,273,N/A,92,2
7,N/A,N/A,N/A,263,270,N/A,96,6
6,N/A,N/A,N/A,257,263,N/A,101,5
3,N/A,N/A,N/A,254,257,N/A,106,4
1,N/A,N/A,N/A,253,254,N/A,109,1
3,N/A,N/A,N/A,250,253,N/A,112,4
2,N/A,N/A,N/A,248,250,N/A,116,2
2,N/A,N/A,N/A,246,248,N/A,122,2
2,N/A,N/A,N/A,244,246,N/A,128,2
2,N/A,N/A,N/A,242,244,N/A,134,2
4,N/A,N/A,N/A,1757,1761,N/A,5,4
4,N/A,N/A,N/A,1753,1757,N/A,11,4
2,N/A,N/A,N/A,1751,1753,N/A,16,3
2,N/A,N/A,N/A,1749,1751,N/A,20,1
6,N/A,N/A,N/A,1743,1749,N/A,25,6
5,N/A,N/A,N/A,1738,1743,N/A,30,5
2,N/A,N/A,N/A,1736,1738,N/A,34,3
2,N/A,N/A,N/A,1734,1736,N/A,39,2
7,N/A,N/A,N/A,1727,1734,N/A,43,6
2,N/A,N/A,N/A,1725,1727,N/A,46,3
1,N/A,N/A,N/A,1724,1725,N/A,50,1
1,N/A,N/A,N/A,1723,1724,N/A,56,1
7,N/A,N/A,N/A,1716,1723,N/A,61,6
2,N/A,N/A,N/A,1714,1716,N/A,64,3
3,N/A,N/A,N/A,1711,1714,N/A,69,2
2,N/A,N/A,N/A,1709,1711,N/A,74,1
1,N/A,N/A,N/A,1708,1709,N/A,80,1
1,N/A,N/A,N/A,1707,1708,N/A,86,1
7,N/A,N/A,N/A,1700,1707,N/A,91,6
4,N/A,N/A,N/A,1696,1700,N/A,95,4
2,N/A,N/A,N/A,1694,1696,N/A,98,1
3,N/A,N/A,N/A,1691,1694,N/A,101,4
2,N/A,N/A,N/A,1689,1691,N/A,106,3
2,N/A,N/A,N/A,1687,1689,N/A,111,2
6,N/A,N/A,N/A,1681,1687,N/A,114,5
4,N/A,N/A,N/A,1677,1681,N/A,119,4
2,N/A,N/A,N/A,1675,1677,N/A,124,3
2,N/A,N/A,N/A,1673,1675,N/A,130,3
7,N/A,N/A,N/A,1666,1673,N/A,133,6
3,N/A,N/A,N/A,1663,1666,N/A,136,3
7,N/A,N/A,N/A,997,1004,N/A,3,6
2,N/A,N/A,N/A,995,997,N/A,9,0
5,N/A,N/A,N/A,990,995,N/A,14,5
2,N/A,N/A,N/A,988,990,N/A,17,2
2,N/A,N/A,N/A,986,988,N/A,22,1
4,N/A,N/A,N/A,982,986,N/A,25,4
3,N/A,N/A,N/A,979,982,N/A,31,4
3,N/A,N/A,N/A,976,979,N/A,37,4
4,N/A,N/A,N/A,972,976,N/A,43,4
3,N/A,N/A,N/A,969,972,N/A,48,3
6,N/A,N/A,N/A,963,969,N/A,51,6
2,N/A,N/A,N/A,961,963,N/A,57,0
6,N/A,N/A,N/A,955,961,N/A,62,5
3,N/A,N/A,N/A,952,955,N/A,66,3
2,N/A,N/A,N/A,950,952,N/A,71,2
6,N/A,N/A,N/A,944,950,N/A,74,5
2,N/A,N/A,N/A,942,944,N/A,78,3
7,N/A,N/A,N/A,935,942,N/A,81,6
4,N/A,N/A,N/A,931,935,N/A,85,4
2,N/A,N/A,N/A,929,931,N/A,89,2
3,N/A,N/A,N/A,926,929,N/A,95,2
6,N/A,N/A,N/A,920,926,N/A,98,5
2,N/A,N/A,N/A,918,920,N/A,102,3
6,N/A,N/A,N/A,912,918,N/A,105,6
2,N/A,N/A,N/A,910,912,N/A,111,0
6,N/A,N/A,N/A,904,910,N/A,116,5
3,N/A,N/A,N/A,901,904,N/A,121,4
1,N/A,N/A,N/A,900,901,N/A,124,1
3,N/A,N/A,N/A,897,900,N/A,127,4
1,N/A,N/A,N/A,896,897,N/A,130,1
7,N/A,N/A,N/A,1299,1306,N/A,4,6
3,N/A,N/A,N/A,1296,1299,N/A,7,3
1,N/A,N/A,N/A,1295,1296,N/A,11,1
2,N/A,N/A,N/A,1293,1295,N/A,17,1
5,N/A,N/A,N/A,1288,1293,N/A,21,5
2,N/A,N/A,N/A,1286,1288,N/A,25,3
3,N/A,N/A,N/A,1283,1286,N/A,31,3
2,N/A,N/A,N/A,1281,1283,N/A,37,3
2,N/A,N/A,N/A,1279,1281,N/A,41,1
1,N/A,N/A,N/A,1278,1279,N/A,47,1
7,N/A,N/A,N/A,1271,1278,N/A,52,6
3,N/A,N/A,N/A,1268,1271,N/A,56,4
1,N/A,N/A,N/A,1267,1268,N/A,59,1
7,N/A,N/A,N/A,1260,1267,N/A,64,6
3,N/A,N/A,N/A,1257,1260,N/A,67,3
2,N/A,N/A,N/A,1255,1257,N/A,73,3
1,N/A,N/A,N/A,1254,1255,N/A,77,1
6,N/A,N/A,N/A,1248,1254,N/A,81,5
5,N/A,N/A,N/A,1243,1248,N/A,87,5
6,N/A,N/A,N/A,1237,1243,N/A,93,5
3,N/A,N/A,N/A,1234,1237,N/A,96,2
6,N/A,N/A,N/A,1228,1234,N/A,100,6
2,N/A,N/A,N/A,1226,1228,N/A,103,3
3,N/A,N/A,N/A,1223,1226,N/A,109,3
2,N/A,N/A,N/A,1221,1223,N/A,113,1
3,N/A,N/A,N/A,1218,1221,N/A,116,4
2,N/A,N/A,N/A,1216,1218,N/A,119,1
4,N/A,N/A,N/A,1212,1216,N/A,122,4
3,N/A,N/A,N/A,1209,1212,N/A,126,2
7,N/A,N/A,N/A,1202,1209,N/A,130,6
2,N/A,N/A,N/A,1892,1894,N/A,4,2
2,N/A,N/A,N/A,1890,1892,N/A,10,2
7,N/A,N/A,N/A,1883,1890,N/A,14,6
2,N/A,N/A,N/A,1881,1883,N/A,20,0
5,N/A,N/A,N/A,1876,1881,N/A,25,5
2,N/A,N/A,N/A,1874,1876,N/A,29,3
6,N/A,N/A,N/A,1868,1874,N/A,32,6
2,N/A,N/A,N/A,1866,1868,N/A,35,3
6,N/A,N/A,N/A,1860,1866,N/A,38,6
3,N/A,N/A,N/A,1857,1860,N/A,41,3
1,N/A,N/A,N/A,1856,1857,N/A,45,1
5,N/A,N/A,N/A,1851,1856,N/A,49,5
3,N/A,N/A,N/A,1848,1851,N/A,54,4
3,N/A,N/A,N/A,1845,1848,N/A,58,2
6,N/A,N/A,N/A,1839,1845,N/A,61,5
6,N/A,N/A,N/A,1833,1839,N/A,67,5
3,N/A,N/A,N/A,1830,1833,N/A,70,2
5,N/A,N/A,N/A,1825,1830,N/A,73,5
2,N/A,N/A,N/A,1823,1825,N/A,77,3
2,N/A,N/A,N/A,1821,1823,N/A,83,3
2,N/A,N/A,N/A,1819,1821,N/A,87,1
5,N/A,N/A,N/A,1814,1819,N/A,91,5
2,N/A,N/A,N/A,1812,1814,N/A,95,3
2,N/A,N/A,N/A,1810,1812,N/A,99,1
3,N/A,N/A,N/A,1807,1810,N/A,102,4
2,N/A,N/A,N/A,1805,1807,N/A,105,1
1,N/A,N/A,N/A,1804,1805,N/A,111,1
5,N/A,N/A,N/A,1799,1804,N/A,115,5
2,N/A,N/A,N/A,1797,1799,N/A,119,3
3,N/A,N/A,N/A,1794,1797,N/A,124,2
6,N/A,N/A,N/A,634,640,N/A,3,6
1,N/A,N/A,N/A,633,634,N/A,9,0
5,N/A,N/A,N/A,628,633,N/A,14,5
5,N/A,N/A,N/A,623,628,N/A,20,5
4,N/A,N/A,N/A,619,623,N/A,25,4
3,N/A,N/A,N/A,616,619,N/A,29,2
6,N/A,N/A,N/A,610,616,N/A,33,6
5,N/A,N/A,N/A,605,610,N/A,38,5
5,N/A,N/A,N/A,600,605,N/A,44,5
2,N/A,N/A,N/A,598,600,N/A,48,3
3,N/A,N/A,N/A,595,598,N/A,54,3
2,N/A,N/A,N/A,593,595,N/A,60,3
1,N/A,N/A,N/A,592,593,N/A,64,1
6,N/A,N/A,N/A,586,592,N/A,68,5
4,N/A,N/A,N/A,582,586,N/A,73,4
3,N/A,N/A,N/A,579,582,N/A,77,2
7,N/A,N/A,N/A,572,579,N/A,81,6
2,N/A,N/A,N/A,570,572,N/A,87,0
3,N/A,N/A,N/A,567,570,N/A,90,3
2,N/A,N/A,N/A,565,567,N/A,96,3
3,N/A,N/A,N/A,562,565,N/A,101,2
6,N/A,N/A,N/A,556,562,N/A,104,5
3,N/A,N/A,N/A,553,556,N/A,107,2
2,N/A,N/A,N/A,551,553,N/A,112,1
3,N/A,N/A,N/A,548,551,N/A,115,4
2,N/A,N/A,N/A,546,548,N/A,119,2
2,N/A,N/A,N/A,544,546,N/A,124,1
6,N/A,N/A,N/A,538,544,N/A,129,6
6,N/A,N/A,N/A,532,538,N/A,134,5
2,N/A,N/A,N/A,530,532,N/A,137,2
6,N/A,N/A,N/A,964,970,N/A,3,5
3,N/A,N/A,N/A,961,964,N/A,7,3
2,N/A,N/A,N/A,959,961,N/A,11,1
6,N/A,N/A,N/A,953,959,N/A,15,5
3,N/A,N/A,N/A,950,953,N/A,19,3
2,N/A,N/A,N/A,948,950,N/A,24,2
5,N/A,N/A,N/A,943,948,N/A,27,5
3,N/A,N/A,N/A,940,943,N/A,31,3
2,N/A,N/A,N/A,938,940,N/A,37,3
6,N/A,N/A,N/A,932,938,N/A,40,6
3,N/A,N/A,N/A,929,932,N/A,43,3
7,N/A,N/A,N/A,922,929,N/A,46,6
4,N/A,N/A,N/A,918,922,N/A,50,4
4,N/A,N/A,N/A,914,918,N/A,56,4
3,N/A,N/A,N/A,911,914,N/A,60,2
2,N/A,N/A,N/A,909,911,N/A,66,2
3,N/A,N/A,N/A,906,909,N/A,72,2
2,N/A,N/A,N/A,904,906,N/A,77,1
4,N/A,N/A,N/A,900,904,N/A,80,4
3,N/A,N/A,N/A,897,900,N/A,85,3
2,N/A,N/A,N/A,895,897,N/A,91,3
7,N/A,N/A,N/A,888,895,N/A,94,6
5,N/A,N/A,N/A,883,888,N/A,99,5
6,N/A,N/A,N/A,877,883,N/A,105,5
5,N/A,N/A,N/A,872,877,N/A,111,5
5,N/A,N/A,N/A,867,872,N/A,117,5
6,N/A,N/A,N/A,861,867,N/A,123,5
4,N/A,N/A,N/A,857,861,N/A,128,4
3,N/A,N/A,N/A,854,857,N/A,133,3
3,N/A,N/A,N/A,851,854,N/A,139,3
3,N/A,N/A,N/A,1538,1541,N/A,4,3
3,N/A,N/A,N/A,1535,1538,N/A,10,3
6,N/A,N/A,N/A,1529,1535,N/A,13,6
3,N/A,N/A,N/A,1526,1529,N/A,16,3
1,N/A,N/A,N/A,1525,1526,N/A,20,1
6,N/A,N/A,N/A,1519,1525,N/A,24,5
4,N/A,N/A,N/A,1515,1519,N/A,29,4
2,N/A,N/A,N/A,1513,1515,N/A,34,3
3,N/A,N/A,N/A,1510,1513,N/A,39,2
2,N/A,N/A,N/A,1508,1510,N/A,45,2
1,N/A,N/A,N/A,1507,1508,N/A,50,1
3,N/A,N/A,N/A,1504,1507,N/A,53,4
1,N/A,N/A,N/A,1503,1504,N/A,56,1
7,N/A,N/A,N/A,1496,1503,N/A,61,6
3,N/A,N/A,N/A,1493,1496,N/A,65,4
2,N/A,N/A,N/A,1491,1493,N/A,70,3
3,N/A,N/A,N/A,1488,1491,N/A,75,2
2,N/A,N/A,N/A,1486,1488,N/A,80,1
6,N/A,N/A,N/A,1480,1486,N/A,85,6
2,N/A,N/A,N/A,1478,1480,N/A,91,0
3,N/A,N/A,N/A,1475,1478,N/A,95,4
3,N/A,N/A,N/A,1472,1475,N/A,100,3
6,N/A,N/A,N/A,1466,1472,N/A,103,6
5,N/A,N/A,N/A,1461,1466,N/A,108,5
3,N/A,N/A,N/A,1458,1461,N/A,112,3
2,N/A,N/A,N/A,1456,1458,N/A,117,2
6,N/A,N/A,N/A,1450,1456,N/A,120,5
4,N/A,N/A,N/A,1446,1450,N/A,125,4
2,N/A,N/A,N/A,1444,1446,N/A,128,1
6,N/A,N/A,N/A,1438,1444,N/A,133,6
1,N/A,N/A,N/A,1631,1632,N/A,5,1
7,N/A,N/A,N/A,1624,1631,N/A,10,6
5,N/A,N/A,N/A,1619,1624,N/A,15,5
3,N/A,N/A,N/A,1616,1619,N/A,20,4
3,N/A,N/A,N/A,1613,1616,N/A,24,2
2,N/A,N/A,N/A,1611,1613,N/A,29,1
7,N/A,N/A,N/A,1604,1611,N/A,34,6
3,N/A,N/A,N/A,1601,1604,N/A,37,3
3,N/A,N/A,N/A,1598,1601,N/A,43,3
2,N/A,N/A,N/A,1596,1598,N/A,48,2
6,N/A,N/A,N/A,1590,1596,N/A,51,5
5,N/A,N/A,N/A,1585,1590,N/A,57,5
3,N/A,N/A,N/A,1582,1585,N/A,61,3
2,N/A,N/A,N/A,1580,1582,N/A,65,1
4,N/A,N/A,N/A,1576,1580,N/A,68,4
3,N/A,N/A,N/A,1573,1576,N/A,73,3
3,N/A,N/A,N/A,1570,1573,N/A,78,2
3,N/A,N/A,N/A,1567,1570,N/A,84,2
3,N/A,N/A,N/A,1564,1567,N/A,90,2
5,N/A,N/A,N/A,1559,1564,N/A,93,5
3,N/A,N/A,N/A,1556,1559,N/A,97,3
3,N/A,N/A,N/A,1553,1556,N/A,102,2
2,N/A,N/A,N/A,1551,1553,N/A,107,1
3,N/A,N/A,N/A,1548,1551,N/A,110,4
2,N/A,N/A,N/A,1546,1548,N/A,113,1
4,N/A,N/A,N/A,1542,1546,N/A,116,4
3,N/A,N/A,N/A,1539,1542,N/A,120,2
5,N/A,N/A,N/A,1534,1539,N/A,123,5
2,N/A,N/A,N/A,1532,1534,N/A,127,3
1,N/A,N/A,N/A,1531,1532,N/A,131,1
1,N/A,N/A,N/A,956,957,N/A,5,1
5,N/A,N/A,N/A,951,956,N/A,9,5
3,N/A,N/A,N/A,948,951,N/A,13,3
2,N/A,N/A,N/A,946,948,N/A,19,3
3,N/A,N/A,N/A,943,946,N/A,24,2
5,N/A,N/A,N/A,938,943,N/A,27,5
2,N/A,N/A,N/A,936,938,N/A,30,2
7,N/A,N/A,N/A,929,936,N/A,34,6
3,N/A,N/A,N/A,926,929,N/A,37,3
3,N/A,N/A,N/A,923,926,N/A,42,2
5,N/A,N/A,N/A,918,923,N/A,45,5
6,N/A,N/A,N/A,912,918,N/A,51,5
3,N/A,N/A,N/A,909,912,N/A,56,4
1,N/A,N/A,N/A,908,909,N/A,59,1
4,N/A,N/A,N/A,904,908,N/A,62,4
4,N/A,N/A,N/A,900,904,N/A,68,4
2,N/A,N/A,N/A,898,900,N/A,71,1
4,N/A,N/A,N/A,894,898,N/A,74,4
3,N/A,N/A,N/A,891,894,N/A,80,4
2,N/A,N/A,N/A,889,891,N/A,85,3
2,N/A,N/A,N/A,887,889,N/A,91,3
3,N/A,N/A,N/A,884,887,N/A,96,2
2,N/A,N/A,N/A,882,884,N/A,102,2
6,N/A,N/A,N/A,876,882,N/A,106,6
4,N/A,N/A,N/A,872,876,N/A,110,4
2,N/A,N/A,N/A,870,872,N/A,113,1
3,N/A,N/A,N/A,867,870,N/A,116,4
2,N/A,N/A,N/A,865,867,N/A,121,3
3,N/A,N/A,N/A,862,865,N/A,126,2
3,N/A,N/A,N/A,859,862,N/A,132,2
3,N/A,N/A,N/A,1388,1391,N/A,5,3
2,N/A,N/A,N/A,1386,1388,N/A,9,1
7,N/A,N/A,N/A,1379,1386,N/A,14,6
3,N/A,N/A,N/A,1376,1379,N/A,17,3
2,N/A,N/A,N/A,1374,1376,N/A,23,3
6,N/A,N/A,N/A,1368,1374,N/A,26,6
3,N/A,N/A,N/A,1365,1368,N/A,29,3
3,N/A,N/A,N/A,1362,1365,N/A,35,3
7,N/A,N/A,N/A,1355,1362,N/A,38,6
1,N/A,N/A,N/A,1354,1355,N/A,44,0
3,N/A,N/A,N/A,1351,1354,N/A,47,3
2,N/A,N/A,N/A,1349,1351,N/A,53,3
2,N/A,N/A,N/A,1347,1349,N/A,59,3
6,N/A,N/A,N/A,1341,1347,N/A,62,6
5,N/A,N/A,N/A,1336,1341,N/A,67,5
4,N/A,N/A,N/A,1332,1336,N/A,72,4
4,N/A,N/A,N/A,1328,1332,N/A,78,4
3,N/A,N/A,N/A,1325,1328,N/A,84,4
2,N/A,N/A,N/A,1323,1325,N/A,89,3
6,N/A,N/A,N/A,1317,1323,N/A,92,6
3,N/A,N/A,N/A,1314,1317,N/A,95,3
2,N/A,N/A,N/A,1312,1314,N/A,101,3
6,N/A,N/A,N/A,1306,1312,N/A,104,6
2,N/A,N/A,N/A,1304,1306,N/A,110,0
5,N/A,N/A,N/A,1299,1304,N/A,115,5
3,N/A,N/A,N/A,1296,1299,N/A,118,2
7,N/A,N/A,N/A,1289,1296,N/A,122,6
2,N/A,N/A,N/A,1287,1289,N/A,128,0
4,N/A,N/A,N/A,1283,1287,N/A,132,4
3,N/A,N/A,N/A,1280,1283,N/A,137,3
2,N/A,N/A,N/A,1795,1797,N/A,5,3
3,N/A,N/A,N/A,1792,1795,N/A,11,3
1,N/A,N/A,N/A,1791,1792,N/A,15,1
6,N/A,N/A,N/A,1785,1791,N/A,19,5
3,N/A,N/A,N/A,1782,1785,N/A,24,4
2,N/A,N/A,N/A,1780,1782,N/A,27,1
2,N/A,N/A,N/A,1778,1780,N/A,33,1
2,N/A,N/A,N/A,1776,1778,N/A,39,1
5,N/A,N/A,N/A,1771,1776,N/A,43,5
3,N/A,N/A,N/A,1768,1771,N/A,47,3
2,N/A,N/A,N/A,1766,1768,N/A,52,2
2,N/A,N/A,N/A,1764,1766,N/A,58,2
2,N/A,N/A,N/A,1762,1764,N/A,64,2
1,N/A,N/A,N/A,1761,1762,N/A,69,1
6,N/A,N/A,N/A,1755,1761,N/A,73,5
2,N/A,N/A,N/A,1753,1755,N/A,77,3
2,N/A,N/A,N/A,1751,1753,N/A,82,2
2,N/A,N/A,N/A,1749,1751,N/A,88,2
2,N/A,N/A,N/A,1747,1749,N/A,93,1
1,N/A,N/A,N/A,1746,1747,N/A,99,1
6,N/A,N/A,N/A,1740,1746,N/A,103,5
3,N/A,N/A,N/A,1737,1740,N/A,107,3
7,N/A,N/A,N/A,1730,1737,N/A,110,6
4,N/A,N/A,N/A,1726,1730,N/A,114,4
2,N/A,N/A,N/A,1724,1726,N/A,118,2
3,N/A,N/A,N/A,1721,1724,N/A,124,2
3,N/A,N/A,N/A,1718,1721,N/A,130,2
2,N/A,N/A,N/A,1716,1718,N/A,136,2
2,N/A,N/A,N/A,1714,1716,N/A,141,1
2,N/A,N/A,N/A,1712,1714,N/A,147,1
6,N/A,N/A,N/A,1406,1412,N/A,5,6
5,N/A,N/A,N/A,1401,1406,N/A,10,5
3,N/A,N/A,N/A,1398,1401,N/A,15,4
4,N/A,N/A,N/A,1394,1398,N/A,21,4
2,N/A,N/A,N/A,1392,1394,N/A,24,1
1,N/A,N/A,N/A,1391,1392,N/A,30,1
1,N/A,N/A,N/A,1390,1391,N/A,36,1
4,N/A,N/A,N/A,1386,1390,N/A,39,4
1,N/A,N/A,N/A,1385,1386,N/A,42,1
4,N/A,N/A,N/A,1381,1385,N/A,45,4
1,N/A,N/A,N/A,1380,1381,N/A,48,1
1,N/A,N/A,N/A,1379,1380,N/A,54,1
2,N/A,N/A,N/A,1377,1379,N/A,60,1
6,N/A,N/A,N/A,1371,1377,N/A,65,6
3,N/A,N/A,N/A,1368,1371,N/A,69,4
4,N/A,N/A,N/A,1364,1368,N/A,75,4
2,N/A,N/A,N/A,1362,1364,N/A,79,2
1,N/A,N/A,N/A,1361,1362,N/A,84,1
5,N/A,N/A,N/A,1356,1361,N/A,88,5
3,N/A,N/A,N/A,1353,1356,N/A,91,2
2,N/A,N/A,N/A,1351,1353,N/A,96,1
2,N/A,N/A,N/A,1349,1351,N/A,102,1
3,N/A,N/A,N/A,1346,1349,N/A,105,4
2,N/A,N/A,N/A,1344,1346,N/A,110,3
3,N/A,N/A,N/A,1341,1344,N/A,116,3
3,N/A,N/A,N/A,1338,1341,N/A,122,3
2,N/A,N/A,N/A,1336,1338,N/A,126,1
6,N/A,N/A,N/A,1330,1336,N/A,130,5
2,N/A,N/A,N/A,1328,1330,N/A,133,2
5,N/A,N/A,N/A,1323,1328,N/A,136,5
2,N/A,N/A,N/A,1414,1416,N/A,6,3
7,N/A,N/A,N/A,1407,1414,N/A,9,6
4,N/A,N/A,N/A,1403,1407,N/A,13,4
3,N/A,N/A,N/A,1400,1403,N/A,18,3
3,N/A,N/A,N/A,1397,1400,N/A,24,3
3,N/A,N/A,N/A,1394,1397,N/A,30,3
3,N/A,N/A,N/A,1391,1394,N/A,35,2
3,N/A,N/A,N/A,1388,1391,N/A,41,2
6,N/A,N/A,N/A,1382,1388,N/A,45,6
5,N/A,N/A,N/A,1377,1382,N/A,50,5
3,N/A,N/A,N/A,1374,1377,N/A,53,2
2,N/A,N/A,N/A,1372,1374,N/A,58,1
3,N/A,N/A,N/A,1369,1372,N/A,61,4
2,N/A,N/A,N/A,1367,1369,N/A,66,3
2,N/A,N/A,N/A,1365,1367,N/A,71,2
2,N/A,N/A,N/A,1363,1365,N/A,76,1
3,N/A,N/A,N/A,1360,1363,N/A,79,4
3,N/A,N/A,N/A,1357,1360,N/A,83,2
1,N/A,N/A,N/A,1356,1357,N/A,88,1
1,N/A,N/A,N/A,1355,1356,N/A,94,1
6,N/A,N/A,N/A,1349,1355,N/A,99,6
2,N/A,N/A,N/A,1347,1349,N/A,102,3
3,N/A,N/A,N/A,1344,1347,N/A,108,3
7,N/A,N/A,N/A,1337,1344,N/A,111,6
3,N/A,N/A,N/A,1334,1337,N/A,114,3
2,N/A,N/A,N/A,1332,1334,N/A,118,1
7,N/A,N/A,N/A,1325,1332,N/A,123,6
3,N/A,N/A,N/A,1322,1325,N/A,126,3
7,N/A,N/A,N/A,1315,1322,N/A,129,6
4,N/A,N/A,N/A,1311,1315,N/A,133,4
2,N/A,N/A,N/A,1308,1310,N/A,6,1
6,N/A,N/A,N/A,1302,1308,N/A,11,6
2,N/A,N/A,N/A,1300,1302,N/A,14,3
1,N/A,N/A,N/A,1299,1300,N/A,18,1
3,N/A,N/A,N/A,1296,1299,N/A,21,4
2,N/A,N/A,N/A,1294,1296,N/A,26,3
6,N/A,N/A,N/A,1288,1294,N/A,29,6
4,N/A,N/A,N/A,1284,1288,N/A,33,4
3,N/A,N/A,N/A,1281,1284,N/A,39,4
4,N/A,N/A,N/A,1277,1281,N/A,45,4
1,N/A,N/A,N/A,1276,1277,N/A,48,1
6,N/A,N/A,N/A,1270,1276,N/A,52,5
3,N/A,N/A,N/A,1267,1270,N/A,55,2
6,N/A,N/A,N/A,1261,1267,N/A,58,5
3,N/A,N/A,N/A,1258,1261,N/A,63,4
4,N/A,N/A,N/A,1254,1258,N/A,69,4
3,N/A,N/A,N/A,1251,1254,N/A,73,2
6,N/A,N/A,N/A,1245,1251,N/A,77,6
4,N/A,N/A,N/A,1241,1245,N/A,81,4
3,N/A,N/A,N/A,1238,1241,N/A,86,3
3,N/A,N/A,N/A,1235,1238,N/A,92,3
2,N/A,N/A,N/A,1233,1235,N/A,98,3
3,N/A,N/A,N/A,1230,1233,N/A,103,2
3,N/A,N/A,N/A,1227,1230,N/A,109,2
1,N/A,N/A,N/A,1226,1227,N/A,114,1
4,N/A,N/A,N/A,1222,1226,N/A,117,4
3,N/A,N/A,N/A,1219,1222,N/A,123,4
3,N/A,N/A,N/A,1216,1219,N/A,129,4
2,N/A,N/A,N/A,1214,1216,N/A,133,2
1,N/A,N/A,N/A,1213,1214,N/A,138,1
2,N/A,N/A,N/A,1500,1502,N/A,4,3
6,N/A,N/A,N/A,1494,1500,N/A,7,6
5,N/A,N/A,N/A,1489,1494,N/A,12,5
6,N/A,N/A,N/A,1483,1489,N/A,18,5
6,N/A,N/A,N/A,1477,1483,N/A,24,5
3,N/A,N/A,N/A,1474,1477,N/A,28,3
3,N/A,N/A,N/A,1471,1474,N/A,34,3
2,N/A,N/A,N/A,1469,1471,N/A,38,1
2,N/A,N/A,N/A,1467,1469,N/A,44,1
1,N/A,N/A,N/A,1466,1467,N/A,50,1
2,N/A,N/A,N/A,1464,1466,N/A,56,1
4,N/A,N/A,N/A,1460,1464,N/A,59,4
2,N/A,N/A,N/A,1458,1460,N/A,62,1
6,N/A,N/A,N/A,1452,1458,N/A,66,5
6,N/A,N/A,N/A,1446,1452,N/A,72,5
4,N/A,N/A,N/A,1442,1446,N/A,77,4
3,N/A,N/A,N/A,1439,1442,N/A,82,3
7,N/A,N/A,N/A,1432,1439,N/A,85,6
2,N/A,N/A,N/A,1430,1432,N/A,88,3
2,N/A,N/A,N/A,1428,1430,N/A,92,1
6,N/A,N/A,N/A,1422,1428,N/A,97,6
4,N/A,N/A,N/A,1418,1422,N/A,101,4
2,N/A,N/A,N/A,1416,1418,N/A,105,2
2,N/A,N/A,N/A,1414,1416,N/A,110,1
2,N/A,N/A,N/A,1412,1414,N/A,116,1
4,N/A,N/A,N/A,1408,1412,N/A,119,4
3,N/A,N/A,N/A,1405,1408,N/A,124,3
1,N/A,N/A,N/A,1404,1405,N/A,128,1
3,N/A,N/A,N/A,1401,1404,N/A,131,4
2,N/A,N/A,N/A,1399,1401,N/A,134,1
3,N/A,N/A,N/A,693,696,N/A,6,2
2,N/A,N/A,N/A,691,693,N/A,11,1
3,N/A,N/A,N/A,688,691,N/A,14,4
4,N/A,N/A,N/A,684,688,N/A,20,4
2,N/A,N/A,N/A,682,684,N/A,23,1
2,N/A,N/A,N/A,680,682,N/A,29,1
2,N/A,N/A,N/A,678,680,N/A,35,1
6,N/A,N/A,N/A,672,678,N/A,40,6
6,N/A,N/A,N/A,666,672,N/A,45,5
5,N/A,N/A,N/A,661,666,N/A,51,5
3,N/A,N/A,N/A,658,661,N/A,56,4
2,N/A,N/A,N/A,656,658,N/A,59,1
6,N/A,N/A,N/A,650,656,N/A,64,6
3,N/A,N/A,N/A,647,650,N/A,67,3
6,N/A,N/A,N/A,641,647,N/A,70,6
2,N/A,N/A,N/A,639,641,N/A,73,3
6,N/A,N/A,N/A,633,639,N/A,76,6
3,N/A,N/A,N/A,630,633,N/A,79,3
3,N/A,N/A,N/A,627,630,N/A,84,2
5,N/A,N/A,N/A,622,627,N/A,87,5
3,N/A,N/A,N/A,619,622,N/A,91,3
2,N/A,N/A,N/A,617,619,N/A,96,2
3,N/A,N/A,N/A,614,617,N/A,102,2
6,N/A,N/A,N/A,608,614,N/A,105,5
3,N/A,N/A,N/A,605,608,N/A,108,2
2,N/A,N/A,N/A,603,605,N/A,113,1
6,N/A,N/A,N/A,597,603,N/A,117,5
3,N/A,N/A,N/A,594,597,N/A,121,3
2,N/A,N/A,N/A,592,594,N/A,125,1
7,N/A,N/A,N/A,585,592,N/A,130,6
3,N/A,N/A,N/A,1659,1662,N/A,4,4
2,N/A,N/A,N/A,1657,1659,N/A,9,3
6,N/A,N/A,N/A,1651,1657,N/A,12,6
5,N/A,N/A,N/A,1646,1651,N/A,17,5
3,N/A,N/A,N/A,1643,1646,N/A,21,3
3,N/A,N/A,N/A,1640,1643,N/A,27,3
2,N/A,N/A,N/A,1638,1640,N/A,32,2
3,N/A,N/A,N/A,1635,1638,N/A,38,2
6,N/A,N/A,N/A,1629,1635,N/A,41,5
6,N/A,N/A,N/A,1623,1629,N/A,47,5
2,N/A,N/A,N/A,1621,1623,N/A,50,2
6,N/A,N/A,N/A,1615,1621,N/A,53,5
3,N/A,N/A,N/A,1612,1615,N/A,57,3
7,N/A,N/A,N/A,1605,1612,N/A,60,6
5,N/A,N/A,N/A,1600,1605,N/A,65,5
2,N/A,N/A,N/A,1598,1600,N/A,68,2
6,N/A,N/A,N/A,1592,1598,N/A,72,6
3,N/A,N/A,N/A,1589,1592,N/A,75,3
2,N/A,N/A,N/A,1587,1589,N/A,80,2
5,N/A,N/A,N/A,1582,1587,N/A,83,5
2,N/A,N/A,N/A,1580,1582,N/A,86,2
6,N/A,N/A,N/A,1574,1580,N/A,90,6
2,N/A,N/A,N/A,1572,1574,N/A,93,3
3,N/A,N/A,N/A,1569,1572,N/A,99,3
3,N/A,N/A,N/A,1566,1569,N/A,104,2
7,N/A,N/A,N/A,1559,1566,N/A,108,6
1,N/A,N/A,N/A,1558,1559,N/A,114,0
6,N/A,N/A,N/A,1552,1558,N/A,120,6
2,N/A,N/A,N/A,1550,1552,N/A,126,0
7,N/A,N/A,N/A,1543,1550,N/A,132,6
1,N/A,N/A,N/A,741,742,N/A,4,1
2,N/A,N/A,N/A,739,741,N/A,10,1
4,N/A,N/A,N/A,735,739,N/A,13,4
2,N/A,N/A,N/A,733,735,N/A,18,3
3,N/A,N/A,N/A,730,733,N/A,23,2
2,N/A,N/A,N/A,728,730,N/A,29,2
6,N/A,N/A,N/A,722,728,N/A,33,6
4,N/A,N/A,N/A,718,722,N/A,37,4
3,N/A,N/A,N/A,715,718,N/A,42,3
7,N/A,N/A,N/A,708,715,N/A,45,6
1,N/A,N/A,N/A,707,708,N/A,51,0
4,N/A,N/A,N/A,703,707,N/A,55,4
3,N/A,N/A,N/A,700,703,N/A,60,3
2,N/A,N/A,N/A,698,700,N/A,65,2
7,N/A,N/A,N/A,691,698,N/A,69,6
5,N/A,N/A,N/A,686,691,N/A,74,5
6,N/A,N/A,N/A,680,686,N/A,80,5
5,N/A,N/A,N/A,675,680,N/A,86,5
2,N/A,N/A,N/A,673,675,N/A,90,3
7,N/A,N/A,N/A,666,673,N/A,93,6
2,N/A,N/A,N/A,664,666,N/A,96,3
6,N/A,N/A,N/A,658,664,N/A,99,6
3,N/A,N/A,N/A,655,658,N/A,103,4
3,N/A,N/A,N/A,652,655,N/A,108,3
6,N/A,N/A,N/A,646,652,N/A,111,6
5,N/A,N/A,N/A,641,646,N/A,116,5
4,N/A,N/A,N/A,637,641,N/A,121,4
3,N/A,N/A,N/A,634,637,N/A,127,4
1,N/A,N/A,N/A,633,634,N/A,130,1
7,N/A,N/A,N/A,626,633,N/A,135,6
4,N/A,N/A,N/A,477,481,N/A,4,4
2,N/A,N/A,N/A,475,477,N/A,7,1
6,N/A,N/A,N/A,469,475,N/A,12,6
5,N/A,N/A,N/A,464,469,N/A,17,5
4,N/A,N/A,N/A,460,464,N/A,22,4
1,N/A,N/A,N/A,459,460,N/A,25,1
7,N/A,N/A,N/A,452,459,N/A,30,6
2,N/A,N/A,N/A,450,452,N/A,33,3
7,N/A,N/A,N/A,443,450,N/A,36,6
3,N/A,N/A,N/A,440,443,N/A,40,4
2,N/A,N/A,N/A,438,440,N/A,45,3
1,N/A,N/A,N/A,437,438,N/A,49,1
5,N/A,N/A,N/A,432,437,N/A,53,5
2,N/A,N/A,N/A,430,432,N/A,57,3
2,N/A,N/A,N/A,428,430,N/A,61,1
3,N/A,N/A,N/A,425,428,N/A,64,4
1,N/A,N/A,N/A,424,425,N/A,67,1
5,N/A,N/A,N/A,419,424,N/A,71,5
3,N/A,N/A,N/A,416,419,N/A,75,3
3,N/A,N/A,N/A,413,416,N/A,80,2
6,N/A,N/A,N/A,407,413,N/A,84,6
1,N/A,N/A,N/A,406,407,N/A,90,0
6,N/A,N/A,N/A,400,406,N/A,95,5
3,N/A,N/A,N/A,397,400,N/A,98,2
7,N/A,N/A,N/A,390,397,N/A,102,6
2,N/A,N/A,N/A,388,390,N/A,105,3
2,N/A,N/A,N/A,386,388,N/A,109,1
4,N/A,N/A,N/A,382,386,N/A,112,4
3,N/A,N/A,N/A,379,382,N/A,116,2
2,N/A,N/A,N/A,377,379,N/A,121,1
2,N/A,N/A,N/A,982,984,N/A,3,1
4,N/A,N/A,N/A,978,982,N/A,6,4
2,N/A,N/A,N/A,976,978,N/A,9,1
1,N/A,N/A,N/A,975,976,N/A,15,1
4,N/A,N/A,N/A,971,975,N/A,18,4
3,N/A,N/A,N/A,968,971,N/A,24,4
2,N/A,N/A,N/A,966,968,N/A,28,2
2,N/A,N/A,N/A,964,966,N/A,34,2
5,N/A,N/A,N/A,959,964,N/A,37,5
2,N/A,N/A,N/A,957,959,N/A,41,3
3,N/A,N/A,N/A,954,957,N/A,46,2
3,N/A,N/A,N/A,951,954,N/A,52,2
7,N/A,N/A,N/A,944,951,N/A,56,6
1,N/A,N/A,N/A,943,944,N/A,62,0
3,N/A,N/A,N/A,940,943,N/A,65,3
2,N/A,N/A,N/A,938,940,N/A,71,3
1,N/A,N/A,N/A,937,938,N/A,75,1
6,N/A,N/A,N/A,931,937,N/A,79,5
3,N/A,N/A,N/A,928,931,N/A,84,4
3,N/A,N/A,N/A,925,928,N/A,90,4
4,N/A,N/A,N/A,921,925,N/A,96,4
4,N/A,N/A,N/A,917,921,N/A,102,4
4,N/A,N/A,N/A,913,917,N/A,108,4
3,N/A,N/A,N/A,910,913,N/A,114,4
3,N/A,N/A,N/A,907,910,N/A,118,2
2,N/A,N/A,N/A,905,907,N/A,124,2
2,N/A,N/A,N/A,903,905,N/A,130,2
5,N/A,N/A,N/A,898,903,N/A,133,5
2,N/A,N/A,N/A,896,898,N/A,137,3
1,N/A,N/A,N/A,895,896,N/A,141,1
6,N/A,N/A,N/A,1562,1568,N/A,5,6
5,N/A,N/A,N/A,1557,1562,N/A,10,5
2,N/A,N/A,N/A,1555,1557,N/A,13,2
2,N/A,N/A,N/A,1553,1555,N/A,18,1
2,N/A,N/A,N/A,1551,1553,N/A,24,1
6,N/A,N/A,N/A,1545,1551,N/A,29,6
2,N/A,N/A,N/A,1543,1545,N/A,35,0
7,N/A,N/A,N/A,1536,1543,N/A,41,6
4,N/A,N/A,N/A,1532,1536,N/A,45,4
2,N/A,N/A,N/A,1530,1532,N/A,49,2
2,N/A,N/A,N/A,1528,1530,N/A,55,2
1,N/A,N/A,N/A,1527,1528,N/A,60,1
4,N/A,N/A,N/A,1523,1527,N/A,63,4
3,N/A,N/A,N/A,1520,1523,N/A,69,4
3,N/A,N/A,N/A,1517,1520,N/A,73,2
2,N/A,N/A,N/A,1515,1517,N/A,79,2
6,N/A,N/A,N/A,1509,1515,N/A,82,5
2,N/A,N/A,N/A,1507,1509,N/A,86,3
3,N/A,N/A,N/A,1504,1507,N/A,92,3
1,N/A,N/A,N/A,1503,1504,N/A,96,1
6,N/A,N/A,N/A,1497,1503,N/A,101,6
4,N/A,N/A,N/A,1493,1497,N/A,105,4
2,N/A,N/A,N/A,1491,1493,N/A,108,1
5,N/A,N/A,N/A,1486,1491,N/A,112,5
3,N/A,N/A,N/A,1483,1486,N/A,116,3
6,N/A,N/A,N/A,1477,1483,N/A,119,6
3,N/A,N/A,N/A,1474,1477,N/A,123,4
2,N/A,N/A,N/A,1472,1474,N/A,128,3
3,N/A,N/A,N/A,1469,1472,N/A,134,3
1,N/A,N/A,N/A,1468,1469,N/A,138,1
6,N/A,N/A,N/A,1783,1789,N/A,6,6
6,N/A,N/A,N/A,1777,1783,N/A,11,5
2,N/A,N/A,N/A,1775,1777,N/A,15,3
3,N/A,N/A,N/A,1772,1775,N/A,20,2
1,N/A,N/A,N/A,1771,1772,N/A,25,1
2,N/A,N/A,N/A,1769,1771,N/A,31,1
5,N/A,N/A,N/A,1764,1769,N/A,35,5
2,N/A,N/A,N/A,1762,1764,N/A,38,2
5,N/A,N/A,N/A,1757,1762,N/A,41,5
5,N/A,N/A,N/A,1752,1757,N/A,47,5
2,N/A,N/A,N/A,1750,1752,N/A,50,2
3,N/A,N/A,N/A,1747,1750,N/A,56,2
3,N/A,N/A,N/A,1744,1747,N/A,62,2
3,N/A,N/A,N/A,1741,1744,N/A,68,2
1,N/A,N/A,N/A,1740,1741,N/A,73,1
7,N/A,N/A,N/A,1733,1740,N/A,78,6
6,N/A,N/A,N/A,1727,1733,N/A,83,5
2,N/A,N/A,N/A,1725,1727,N/A,86,2
3,N/A,N/A,N/A,1722,1725,N/A,92,2
7,N/A,N/A,N/A,1715,1722,N/A,96,6
4,N/A,N/A,N/A,1711,1715,N/A,100,4
3,N/A,N/A,N/A,1708,1711,N/A,104,2
3,N/A,N/A,N/A,1705,1708,N/A,110,2
1,N/A,N/A,N/A,1704,1705,N/A,115,1
3,N/A,N/A,N/A,1701,1704,N/A,118,4
3,N/A,N/A,N/A,1698,1701,N/A,123,3
1,N/A,N/A,N/A,1697,1698,N/A,127,1
2,N/A,N/A,N/A,1695,1697,N/A,133,1
7,N/A,N/A,N/A,1688,1695,N/A,138,6
1,N/A,N/A,N/A,1687,1688,N/A,144,0
7,N/A,N/A,N/A,326,333,N/A,5,6
1,N/A,N/A,N/A,325,326,N/A,11,0
3,N/A,N/A,N/A,322,325,N/A,14,3
3,N/A,N/A,N/A,319,322,N/A,19,2
3,N/A,N/A,N/A,316,319,N/A,25,2
3,N/A,N/A,N/A,313,316,N/A,31,2
3,N/A,N/A,N/A,310,313,N/A,37,2
5,N/A,N/A,N/A,305,310,N/A,40,5
3,N/A,N/A,N/A,302,305,N/A,43,2
5,N/A,N/A,N/A,297,302,N/A,46,5
2,N/A,N/A,N/A,295,297,N/A,50,3
1,N/A,N/A,N/A,294,295,N/A,54,1
3,N/A,N/A,N/A,291,294,N/A,57,4
1,N/A,N/A,N/A,290,291,N/A,60,1
2,N/A,N/A,N/A,288,290,N/A,66,1
6,N/A,N/A,N/A,282,288,N/A,70,5
5,N/A,N/A,N/A,277,282,N/A,76,5
3,N/A,N/A,N/A,274,277,N/A,79,2
2,N/A,N/A,N/A,272,274,N/A,84,1
1,N/A,N/A,N/A,271,272,N/A,90,1
2,N/A,N/A,N/A,269,271,N/A,96,1
7,N/A,N/A,N/A,262,269,N/A,101,6
2,N/A,N/A,N/A,260,262,N/A,104,3
7,N/A,N/A,N/A,253,260,N/A,107,6
2,N/A,N/A,N/A,251,253,N/A,113,0
3,N/A,N/A,N/A,248,251,N/A,117,4
3,N/A,N/A,N/A,245,248,N/A,122,3
1,N/A,N/A,N/A,244,245,N/A,126,1
7,N/A,N/A,N/A,237,244,N/A,131,6
6,N/A,N/A,N/A,231,237,N/A,136,5
6,N/A,N/A,N/A,1835,1841,N/A,6,5
3,N/A,N/A,N/A,1832,1835,N/A,9,2
7,N/A,N/A,N/A,1825,1832,N/A,13,6
6,N/A,N/A,N/A,1819,1825,N/A,18,5
6,N/A,N/A,N/A,1813,1819,N/A,24,5
2,N/A,N/A,N/A,1811,1813,N/A,28,3
2,N/A,N/A,N/A,1809,1811,N/A,34,3
7,N/A,N/A,N/A,1802,1809,N/A,37,6
2,N/A,N/A,N/A,1800,1802,N/A,40,3
2,N/A,N/A,N/A,1798,1800,N/A,45,2
6,N/A,N/A,N/A,1792,1798,N/A,49,6
1,N/A,N/A,N/A,1791,1792,N/A,55,0
3,N/A,N/A,N/A,1788,1791,N/A,58,3
3,N/A,N/A,N/A,1785,1788,N/A,63,2
3,N/A,N/A,N/A,1782,1785,N/A,69,2
7,N/A,N/A,N/A,1775,1782,N/A,73,6
5,N/A,N/A,N/A,1770,1775,N/A,78,5
2,N/A,N/A,N/A,1768,1770,N/A,82,3
2,N/A,N/A,N/A,1766,1768,N/A,88,3
3,N/A,N/A,N/A,1763,1766,N/A,94,3
2,N/A,N/A,N/A,1761,1763,N/A,100,3
3,N/A,N/A,N/A,1758,1761,N/A,106,3
3,N/A,N/A,N/A,1755,1758,N/A,112,3
3,N/A,N/A,N/A,1752,1755,N/A,118,3
1,N/A,N/A,N/A,1751,1752,N/A,122,1
7,N/A,N/A,N/A,1744,1751,N/A,127,6
2,N/A,N/A,N/A,1742,1744,N/A,133,0
7,N/A,N/A,N/A,1735,1742,N/A,139,6
3,N/A,N/A,N/A,1732,1735,N/A,143,4
2,N/A,N/A,N/A,1730,1732,N/A,146,1
3,N/A,N/A,N/A,1857,1860,N/A,3,4
3,N/A,N/A,N/A,1854,1857,N/A,8,3
2,N/A,N/A,N/A,1852,1854,N/A,13,2
2,N/A,N/A,N/A,1850,1852,N/A,18,1
4,N/A,N/A,N/A,1846,1850,N/A,21,4
3,N/A,N/A,N/A,1843,1846,N/A,27,4
2,N/A,N/A,N/A,1841,1843,N/A,32,3
7,N/A,N/A,N/A,1834,1841,N/A,35,6
3,N/A,N/A,N/A,1831,1834,N/A,38,3
2,N/A,N/A,N/A,1829,1831,N/A,42,1
7,N/A,N/A,N/A,1822,1829,N/A,47,6
1,N/A,N/A,N/A,1821,1822,N/A,53,0
5,N/A,N/A,N/A,1816,1821,N/A,58,5
2,N/A,N/A,N/A,1814,1816,N/A,62,3
2,N/A,N/A,N/A,1812,1814,N/A,66,1
2,N/A,N/A,N/A,1810,1812,N/A,72,1
3,N/A,N/A,N/A,1807,1810,N/A,75,4
3,N/A,N/A,N/A,1804,1807,N/A,81,4
3,N/A,N/A,N/A,1801,1804,N/A,85,2
2,N/A,N/A,N/A,1799,1801,N/A,91,2
2,N/A,N/A,N/A,1797,1799,N/A,97,2
6,N/A,N/A,N/A,1791,1797,N/A,101,6
2,N/A,N/A,N/A,1789,1791,N/A,107,0
7,N/A,N/A,N/A,1782,1789,N/A,113,6
1,N/A,N/A,N/A,1781,1782,N/A,119,0
2,N/A,N/A,N/A,1779,1781,N/A,122,3
2,N/A,N/A,N/A,1777,1779,N/A,128,3
2,N/A,N/A,N/A,1775,1777,N/A,132,1
2,N/A,N/A,N/A,1773,1775,N/A,138,1
1,N/A,N/A,N/A,1772,1773,N/A,144,1
3,N/A,N/A,N/A,302,305,N/A,4,3
2,N/A,N/A,N/A,300,302,N/A,8,1
1,N/A,N/A,N/A,299,300,N/A,14,1
1,N/A,N/A,N/A,298,299,N/A,20,1
6,N/A,N/A,N/A,292,298,N/A,25,6
1,N/A,N/A,N/A,291,292,N/A,31,0
6,N/A,N/A,N/A,285,291,N/A,36,5
5,N/A,N/A,N/A,280,285,N/A,42,5
3,N/A,N/A,N/A,277,280,N/A,47,4
2,N/A,N/A,N/A,275,277,N/A,52,3
2,N/A,N/A,N/A,273,275,N/A,57,2
7,N/A,N/A,N/A,266,273,N/A,61,6
2,N/A,N/A,N/A,264,266,N/A,64,3
3,N/A,N/A,N/A,261,264,N/A,69,2
6,N/A,N/A,N/A,255,261,N/A,73,6
4,N/A,N/A,N/A,251,255,N/A,77,4
2,N/A,N/A,N/A,249,251,N/A,80,1
4,N/A,N/A,N/A,245,249,N/A,83,4
1,N/A,N/A,N/A,244,245,N/A,86,1
6,N/A,N/A,N/A,238,244,N/A,91,6
3,N/A,N/A,N/A,235,238,N/A,95,4
3,N/A,N/A,N/A,232,235,N/A,101,4
4,N/A,N/A,N/A,228,232,N/A,107,4
3,N/A,N/A,N/A,225,228,N/A,112,3
7,N/A,N/A,N/A,218,225,N/A,115,6
3,N/A,N/A,N/A,215,218,N/A,118,3
6,N/A,N/A,N/A,209,215,N/A,121,6
3,N/A,N/A,N/A,206,209,N/A,124,3
6,N/A,N/A,N/A,200,206,N/A,127,6
2,N/A,N/A,N/A,198,200,N/A,130,3
2,N/A,N/A,N/A,1866,1868,N/A,5,1
7,N/A,N/A,N/A,1859,1866,N/A,10,6
3,N/A,N/A,N/A,1856,1859,N/A,13,3
3,N/A,N/A,N/A,1853,1856,N/A,19,3
1,N/A,N/A,N/A,1852,1853,N/A,23,1
1,N/A,N/A,N/A,1851,1852,N/A,29,1
4,N/A,N/A,N/A,1847,1851,N/A,32,4
3,N/A,N/A,N/A,1844,1847,N/A,38,4
2,N/A,N/A,N/A,1842,1844,N/A,41,1
6,N/A,N/A,N/A,1836,1842,N/A,46,6
3,N/A,N/A,N/A,1833,1836,N/A,49,3
2,N/A,N/A,N/A,1831,1833,N/A,53,1
1,N/A,N/A,N/A,1830,1831,N/A,59,1
1,N/A,N/A,N/A,1829,1830,N/A,65,1
7,N/A,N/A,N/A,1822,1829,N/A,70,6
6,N/A,N/A,N/A,1816,1822,N/A,75,5
4,N/A,N/A,N/A,1812,1816,N/A,80,4
2,N/A,N/A,N/A,1810,1812,N/A,85,3
2,N/A,N/A,N/A,1808,1810,N/A,89,1
6,N/A,N/A,N/A,1802,1808,N/A,93,5
2,N/A,N/A,N/A,1800,1802,N/A,96,2
2,N/A,N/A,N/A,1798,1800,N/A,101,1
1,N/A,N/A,N/A,1797,1798,N/A,107,1
4,N/A,N/A,N/A,1793,1797,N/A,110,4
3,N/A,N/A,N/A,1790,1793,N/A,115,3
6,N/A,N/A,N/A,1784,1790,N/A,118,6
3,N/A,N/A,N/A,1781,1784,N/A,121,3
7,N/A,N/A,N/A,1774,1781,N/A,124,6
3,N/A,N/A,N/A,1771,1774,N/A,128,4
1,N/A,N/A,N/A,1770,1771,N/A,131,1
2,N/A,N/A,N/A,1939,1941,N/A,5,3
3,N/A,N/A,N/A,1936,1939,N/A,10,2
6,N/A,N/A,N/A,1930,1936,N/A,14,6
2,N/A,N/A,N/A,1928,1930,N/A,20,0
5,N/A,N/A,N/A,1923,1928,N/A,25,5
3,N/A,N/A,N/A,1920,1923,N/A,28,2
5,N/A,N/A,N/A,1915,1920,N/A,31,5
2,N/A,N/A,N/A,1913,1915,N/A,34,2
6,N/A,N/A,N/A,1907,1913,N/A,38,6
2,N/A,N/A,N/A,1905,1907,N/A,44,0
6,N/A,N/A,N/A,1899,1905,N/A,49,5
2,N/A,N/A,N/A,1897,1899,N/A,53,3
2,N/A,N/A,N/A,1895,1897,N/A,57,1
3,N/A,N/A,N/A,1892,1895,N/A,60,4
4,N/A,N/A,N/A,1888,1892,N/A,66,4
3,N/A,N/A,N/A,1885,1888,N/A,71,3
1,N/A,N/A,N/A,1884,1885,N/A,75,1
1,N/A,N/A,N/A,1883,1884,N/A,81,1
5,N/A,N/A,N/A,1878,1883,N/A,85,5
3,N/A,N/A,N/A,1875,1878,N/A,90,4
2,N/A,N/A,N/A,1873,1875,N/A,94,2
2,N/A,N/A,N/A,1871,1873,N/A,99,1
5,N/A,N/A,N/A,1866,1871,N/A,103,5
3,N/A,N/A,N/A,1863,1866,N/A,106,2
6,N/A,N/A,N/A,1857,1863,N/A,110,6
2,N/A,N/A,N/A,1855,1857,N/A,116,0
5,N/A,N/A,N/A,1850,1855,N/A,121,5
3,N/A,N/A,N/A,1847,1850,N/A,125,3
7,N/A,N/A,N/A,1840,1847,N/A,128,6
4,N/A,N/A,N/A,1836,1840,N/A,132,4
2,N/A,N/A,N/A,344,346,N/A,6,2
2,N/A,N/A,N/A,342,344,N/A,11,1
1,N/A,N/A,N/A,341,342,N/A,17,1
6,N/A,N/A,N/A,335,341,N/A,22,6
2,N/A,N/A,N/A,333,335,N/A,28,0
6,N/A,N/A,N/A,327,333,N/A,33,5
4,N/A,N/A,N/A,323,327,N/A,38,4
3,N/A,N/A,N/A,320,323,N/A,43,3
6,N/A,N/A,N/A,314,320,N/A,46,6
6,N/A,N/A,N/A,308,314,N/A,51,5
2,N/A,N/A,N/A,306,308,N/A,55,3
1,N/A,N/A,N/A,305,306,N/A,59,1
5,N/A,N/A,N/A,300,305,N/A,63,5
4,N/A,N/A,N/A,296,300,N/A,68,4
3,N/A,N/A,N/A,293,296,N/A,74,4
2,N/A,N/A,N/A,291,293,N/A,77,1
1,N/A,N/A,N/A,290,291,N/A,83,1
6,N/A,N/A,N/A,284,290,N/A,87,5
2,N/A,N/A,N/A,282,284,N/A,91,3
2,N/A,N/A,N/A,280,282,N/A,96,2
1,N/A,N/A,N/A,279,280,N/A,101,1
4,N/A,N/A,N/A,275,279,N/A,104,4
3,N/A,N/A,N/A,272,275,N/A,110,4
3,N/A,N/A,N/A,269,272,N/A,116,4
4,N/A,N/A,N/A,265,269,N/A,122,4
3,N/A,N/A,N/A,262,265,N/A,126,2
6,N/A,N/A,N/A,256,262,N/A,130,6
5,N/A,N/A,N/A,251,256,N/A,135,5
5,N/A,N/A,N/A,246,251,N/A,141,5
2,N/A,N/A,N/A,244,246,N/A,145,3
7,N/A,N/A,N/A,746,753,N/A,3,6
5,N/A,N/A,N/A,741,746,N/A,8,5
5,N/A,N/A,N/A,736,741,N/A,14,5
2,N/A,N/A,N/A,734,736,N/A,18,3
7,N/A,N/A,N/A,727,734,N/A,21,6
3,N/A,N/A,N/A,724,727,N/A,24,3
3,N/A,N/A,N/A,721,724,N/A,29,2
7,N/A,N/A,N/A,714,721,N/A,33,6
3,N/A,N/A,N/A,711,714,N/A,37,4
4,N/A,N/A,N/A,707,711,N/A,43,4
3,N/A,N/A,N/A,704,707,N/A,49,4
2,N/A,N/A,N/A,702,704,N/A,52,1
6,N/A,N/A,N/A,696,702,N/A,57,6
3,N/A,N/A,N/A,693,696,N/A,61,4
1,N/A,N/A,N/A,692,693,N/A,64,1
3,N/A,N/A,N/A,689,692,N/A,67,4
3,N/A,N/A,N/A,686,689,N/A,71,2
6,N/A,N/A,N/A,680,686,N/A,75,6
1,N/A,N/A,N/A,679,680,N/A,81,0
5,N/A,N/A,N/A,674,679,N/A,86,5
3,N/A,N/A,N/A,671,674,N/A,89,2
2,N/A,N/A,N/A,669,671,N/A,95,2
5,N/A,N/A,N/A,664,669,N/A,98,5
3,N/A,N/A,N/A,661,664,N/A,102,3
6,N/A,N/A,N/A,655,661,N/A,105,6
3,N/A,N/A,N/A,652,655,N/A,108,3
2,N/A,N/A,N/A,650,652,N/A,112,1
1,N/A,N/A,N/A,649,650,N/A,118,1
4,N/A,N/A,N/A,645,649,N/A,121,4
3,N/A,N/A,N/A,642,645,N/A,127,4
3,N/A,N/A,N/A,1785,1788,N/A,4,3
2,N/A,N/A,N/A,1783,1785,N/A,10,3
1,N/A,N/A,N/A,1782,1783,N/A,14,1
2,N/A,N/A,N/A,1780,1782,N/A,20,1
6,N/A,N/A,N/A,1774,1780,N/A,25,6
6,N/A,N/A,N/A,1768,1774,N/A,30,5
2,N/A,N/A,N/A,1766,1768,N/A,34,3
2,N/A,N/A,N/A,1764,1766,N/A,40,3
7,N/A,N/A,N/A,1757,1764,N/A,43,6
3,N/A,N/A,N/A,1754,1757,N/A,47,4
3,N/A,N/A,N/A,1751,1754,N/A,52,3
1,N/A,N/A,N/A,1750,1751,N/A,56,1
6,N/A,N/A,N/A,1744,1750,N/A,61,6
4,N/A,N/A,N/A,1740,1744,N/A,65,4
3,N/A,N/A,N/A,1737,1740,N/A,70,3
2,N/A,N/A,N/A,1735,1737,N/A,74,1
1,N/A,N/A,N/A,1734,1735,N/A,80,1
3,N/A,N/A,N/A,1731,1734,N/A,83,4
4,N/A,N/A,N/A,1727,1731,N/A,89,4
3,N/A,N/A,N/A,1724,1727,N/A,94,3
1,N/A,N/A,N/A,1723,1724,N/A,98,1
1,N/A,N/A,N/A,1722,1723,N/A,104,1
3,N/A,N/A,N/A,1719,1722,N/A,107,4
2,N/A,N/A,N/A,1717,1719,N/A,111,2
7,N/A,N/A,N/A,1710,1717,N/A,115,6
1,N/A,N/A,N/A,1709,1710,N/A,121,0
5,N/A,N/A,N/A,1704,1709,N/A,126,5
5,N/A,N/A,N/A,1699,1704,N/A,132,5
2,N/A,N/A,N/A,1697,1699,N/A,135,2
5,N/A,N/A,N/A,1692,1697,N/A,138,5
2,N/A,N/A,N/A,1311,1313,N/A,5,1
5,N/A,N/A,N/A,1306,1311,N/A,9,5
3,N/A,N/A,N/A,1303,1306,N/A,14,4
2,N/A,N/A,N/A,1301,1303,N/A,18,2
5,N/A,N/A,N/A,1296,1301,N/A,21,5
3,N/A,N/A,N/A,1293,1296,N/A,26,4
2,N/A,N/A,N/A,1291,1293,N/A,31,3
1,N/A,N/A,N/A,1290,1291,N/A,35,1
5,N/A,N/A,N/A,1285,1290,N/A,39,5
2,N/A,N/A,N/A,1283,1285,N/A,42,2
6,N/A,N/A,N/A,1277,1283,N/A,46,6
2,N/A,N/A,N/A,1275,1277,N/A,52,0
5,N/A,N/A,N/A,1270,1275,N/A,57,5
3,N/A,N/A,N/A,1267,1270,N/A,60,2
7,N/A,N/A,N/A,1260,1267,N/A,64,6
6,N/A,N/A,N/A,1254,1260,N/A,69,5
3,N/A,N/A,N/A,1251,1254,N/A,74,4
2,N/A,N/A,N/A,1249,1251,N/A,78,2
2,N/A,N/A,N/A,1247,1249,N/A,83,1
5,N/A,N/A,N/A,1242,1247,N/A,87,5
2,N/A,N/A,N/A,1240,1242,N/A,90,2
2,N/A,N/A,N/A,1238,1240,N/A,95,1
3,N/A,N/A,N/A,1235,1238,N/A,98,4
3,N/A,N/A,N/A,1232,1235,N/A,102,2
1,N/A,N/A,N/A,1231,1232,N/A,107,1
5,N/A,N/A,N/A,1226,1231,N/A,111,5
4,N/A,N/A,N/A,1222,1226,N/A,116,4
3,N/A,N/A,N/A,1219,1222,N/A,122,4
2,N/A,N/A,N/A,1217,1219,N/A,127,3
2,N/A,N/A,N/A,1215,1217,N/A,131,1
3,N/A,N/A,N/A,1363,1366,N/A,3,4
3,N/A,N/A,N/A,1360,1363,N/A,8,3
7,N/A,N/A,N/A,1353,1360,N/A,11,6
6,N/A,N/A,N/A,1347,1353,N/A,16,5
2,N/A,N/A,N/A,1345,1347,N/A,19,2
3,N/A,N/A,N/A,1342,1345,N/A,25,2
7,N/A,N/A,N/A,1335,1342,N/A,29,6
3,N/A,N/A,N/A,1332,1335,N/A,32,3
2,N/A,N/A,N/A,1330,1332,N/A,38,3
3,N/A,N/A,N/A,1327,1330,N/A,44,3
2,N/A,N/A,N/A,1325,1327,N/A,50,3
7,N/A,N/A,N/A,1318,1325,N/A,53,6
1,N/A,N/A,N/A,1317,1318,N/A,59,0
7,N/A,N/A,N/A,1310,1317,N/A,65,6
4,N/A,N/A,N/A,1306,1310,N/A,69,4
2,N/A,N/A,N/A,1304,1306,N/A,73,2
7,N/A,N/A,N/A,1297,1304,N/A,77,6
3,N/A,N/A,N/A,1294,1297,N/A,81,4
2,N/A,N/A,N/A,1292,1294,N/A,85,2
7,N/A,N/A,N/A,1285,1292,N/A,89,6
5,N/A,N/A,N/A,1280,1285,N/A,94,5
4,N/A,N/A,N/A,1276,1280,N/A,99,4
2,N/A,N/A,N/A,1274,1276,N/A,102,1
6,N/A,N/A,N/A,1268,1274,N/A,106,5
3,N/A,N/A,N/A,1265,1268,N/A,110,3
3,N/A,N/A,N/A,1262,1265,N/A,115,2
6,N/A,N/A,N/A,1256,1262,N/A,118,5
2,N/A,N/A,N/A,1254,1256,N/A,122,3
3,N/A,N/A,N/A,1251,1254,N/A,127,2
7,N/A,N/A,N/A,1244,1251,N/A,131,6
2,N/A,N/A,N/A,1236,1238,N/A,3,3
3,N/A,N/A,N/A,1233,1236,N/A,9,3
7,N/A,N/A,N/A,1226,1233,N/A,12,6
3,N/A,N/A,N/A,1223,1226,N/A,16,4
3,N/A,N/A,N/A,1220,1223,N/A,20,2
6,N/A,N/A,N/A,1214,1220,N/A,23,5
3,N/A,N/A,N/A,1211,1214,N/A,27,3
1,N/A,N/A,N/A,1210,1211,N/A,31,1
1,N/A,N/A,N/A,1209,1210,N/A,37,1
7,N/A,N/A,N/A,1202,1209,N/A,42,6
3,N/A,N/A,N/A,1199,1202,N/A,45,3
2,N/A,N/A,N/A,1197,1199,N/A,49,1
5,N/A,N/A,N/A,1192,1197,N/A,53,5
6,N/A,N/A,N/A,1186,1192,N/A,59,5
6,N/A,N/A,N/A,1180,1186,N/A,65,5
3,N/A,N/A,N/A,1177,1180,N/A,68,2
3,N/A,N/A,N/A,1174,1177,N/A,74,2
6,N/A,N/A,N/A,1168,1174,N/A,77,5
4,N/A,N/A,N/A,1164,1168,N/A,82,4
3,N/A,N/A,N/A,1161,1164,N/A,86,2
3,N/A,N/A,N/A,1158,1161,N/A,92,2
1,N/A,N/A,N/A,1157,1158,N/A,97,1
6,N/A,N/A,N/A,1151,1157,N/A,102,6
1,N/A,N/A,N/A,1150,1151,N/A,108,0
5,N/A,N/A,N/A,1145,1150,N/A,113,5
3,N/A,N/A,N/A,1142,1145,N/A,116,2
6,N/A,N/A,N/A,1136,1142,N/A,120,6
3,N/A,N/A,N/A,1133,1136,N/A,124,4
4,N/A,N/A,N/A,1129,1133,N/A,130,4
3,N/A,N/A,N/A,1126,1129,N/A,136,4
2,N/A,N/A,N/A,1384,1386,N/A,6,2
7,N/A,N/A,N/A,1377,1384,N/A,10,6
2,N/A,N/A,N/A,1375,1377,N/A,16,0
7,N/A,N/A,N/A,1368,1375,N/A,22,6
1,N/A,N/A,N/A,1367,1368,N/A,28,0
3,N/A,N/A,N/A,1364,1367,N/A,31,3
2,N/A,N/A,N/A,1362,1364,N/A,37,3
2,N/A,N/A,N/A,1360,1362,N/A,41,1
7,N/A,N/A,N/A,1353,1360,N/A,46,6
3,N/A,N/A,N/A,1350,1353,N/A,50,4
2,N/A,N/A,N/A,1348,1350,N/A,55,3
3,N/A,N/A,N/A,1345,1348,N/A,61,3
2,N/A,N/A,N/A,1343,1345,N/A,66,2
6,N/A,N/A,N/A,1337,1343,N/A,69,5
3,N/A,N/A,N/A,1334,1337,N/A,72,2
5,N/A,N/A,N/A,1329,1334,N/A,75,5
5,N/A,N/A,N/A,1324,1329,N/A,81,5
5,N/A,N/A,N/A,1319,1324,N/A,87,5
6,N/A,N/A,N/A,1313,1319,N/A,93,5
2,N/A,N/A,N/A,1311,1313,N/A,96,2
6,N/A,N/A,N/A,1305,1311,N/A,99,5
4,N/A,N/A,N/A,1301,1305,N/A,104,4
3,N/A,N/A,N/A,1298,1301,N/A,110,4
2,N/A,N/A,N/A,1296,1298,N/A,113,1
3,N/A,N/A,N/A,1293,1296,N/A,116,4
1,N/A,N/A,N/A,1292,1293,N/A,119,1
3,N/A,N/A,N/A,1289,1292,N/A,122,4
4,N/A,N/A,N/A,1285,1289,N/A,128,4
2,N/A,N/A,N/A,1283,1285,N/A,131,1
5,N/A,N/A,N/A,1278,1283,N/A,135,5
7,N/A,N/A,N/A,899,906,N/A,6,6
2,N/A,N/A,N/A,897,899,N/A,9,3
3,N/A,N/A,N/A,894,897,N/A,14,2
6,N/A,N/A,N/A,888,894,N/A,17,5
3,N/A,N/A,N/A,885,888,N/A,20,2
6,N/A,N/A,N/A,879,885,N/A,24,6
2,N/A,N/A,N/A,877,879,N/A,27,3
2,N/A,N/A,N/A,875,877,N/A,32,2
6,N/A,N/A,N/A,869,875,N/A,36,6
6,N/A,N/A,N/A,863,869,N/A,41,5
4,N/A,N/A,N/A,859,863,N/A,46,4
3,N/A,N/A,N/A,856,859,N/A,52,4
2,N/A,N/A,N/A,854,856,N/A,57,3
3,N/A,N/A,N/A,851,854,N/A,63,3
2,N/A,N/A,N/A,849,851,N/A,68,2
6,N/A,N/A,N/A,843,849,N/A,71,5
6,N/A,N/A,N/A,837,843,N/A,77,5
4,N/A,N/A,N/A,833,837,N/A,82,4
3,N/A,N/A,N/A,830,833,N/A,88,4
1,N/A,N/A,N/A,829,830,N/A,91,1
1,N/A,N/A,N/A,828,829,N/A,97,1
3,N/A,N/A,N/A,825,828,N/A,100,4
3,N/A,N/A,N/A,822,825,N/A,104,2
6,N/A,N/A,N/A,816,822,N/A,107,5
2,N/A,N/A,N/A,814,816,N/A,111,3
3,N/A,N/A,N/A,811,814,N/A,117,3
2,N/A,N/A,N/A,809,811,N/A,122,2
1,N/A,N/A,N/A,808,809,N/A,127,1
7,N/A,N/A,N/A,801,808,N/A,132,6
4,N/A,N/A,N/A,797,801,N/A,136,4
3,N/A,N/A,N/A,955,958,N/A,4,3
2,N/A,N/A,N/A,953,955,N/A,9,2
6,N/A,N/A,N/A,947,953,N/A,12,5
3,N/A,N/A,N/A,944,947,N/A,15,2
1,N/A,N/A,N/A,943,944,N/A,20,1
6,N/A,N/A,N/A,937,943,N/A,25,6
2,N/A,N/A,N/A,935,937,N/A,31,0
5,N/A,N/A,N/A,930,935,N/A,36,5
2,N/A,N/A,N/A,928,930,N/A,39,2
1,N/A,N/A,N/A,927,928,N/A,44,1
7,N/A,N/A,N/A,920,927,N/A,49,6
6,N/A,N/A,N/A,914,920,N/A,54,5
3,N/A,N/A,N/A,911,914,N/A,57,2
3,N/A,N/A,N/A,908,911,N/A,63,2
2,N/A,N/A,N/A,906,908,N/A,69,2
2,N/A,N/A,N/A,904,906,N/A,74,1
1,N/A,N/A,N/A,903,904,N/A,80,1
7,N/A,N/A,N/A,896,903,N/A,85,6
2,N/A,N/A,N/A,894,896,N/A,88,3
1,N/A,N/A,N/A,893,894,N/A,92,1
5,N/A,N/A,N/A,888,893,N/A,96,5
3,N/A,N/A,N/A,885,888,N/A,99,2
3,N/A,N/A,N/A,882,885,N/A,105,2
1,N/A,N/A,N/A,881,882,N/A,110,1
6,N/A,N/A,N/A,875,881,N/A,114,5
3,N/A,N/A,N/A,872,875,N/A,119,4
4,N/A,N/A,N/A,868,872,N/A,125,4
2,N/A,N/A,N/A,866,868,N/A,130,3
1,N/A,N/A,N/A,865,866,N/A,134,1
5,N/A,N/A,N/A,860,865,N/A,138,5
3,N/A,N/A,N/A,1005,1008,N/A,3,2
7,N/A,N/A,N/A,998,1005,N/A,7,6
3,N/A,N/A,N/A,995,998,N/A,11,4
3,N/A,N/A,N/A,992,995,N/A,17,4
2,N/A,N/A,N/A,990,992,N/A,20,1
2,N/A,N/A,N/A,988,990,N/A,26,1
1,N/A,N/A,N/A,987,988,N/A,32,1
7,N/A,N/A,N/A,980,987,N/A,37,6
6,N/A,N/A,N/A,974,980,N/A,42,5
3,N/A,N/A,N/A,971,974,N/A,45,2
6,N/A,N/A,N/A,965,971,N/A,48,5
3,N/A,N/A,N/A,962,965,N/A,51,2
6,N/A,N/A,N/A,956,962,N/A,55,6
2,N/A,N/A,N/A,954,956,N/A,61,0
6,N/A,N/A,N/A,948,954,N/A,66,5
3,N/A,N/A,N/A,945,948,N/A,71,4
2,N/A,N/A,N/A,943,945,N/A,74,1
6,N/A,N/A,N/A,937,943,N/A,79,6
3,N/A,N/A,N/A,934,937,N/A,83,4
4,N/A,N/A,N/A,930,934,N/A,89,4
1,N/A,N/A,N/A,929,930,N/A,92,1
4,N/A,N/A,N/A,925,929,N/A,95,4
2,N/A,N/A,N/A,923,925,N/A,99,2
3,N/A,N/A,N/A,920,923,N/A,105,2
7,N/A,N/A,N/A,913,920,N/A,109,6
5,N/A,N/A,N/A,908,913,N/A,114,5
3,N/A,N/A,N/A,905,908,N/A,119,4
1,N/A,N/A,N/A,904,905,N/A,122,1
5,N/A,N/A,N/A,899,904,N/A,126,5
5,N/A,N/A,N/A,894,899,N/A,132,5
6,N/A,N/A,N/A,1902,1908,N/A,6,5
3,N/A,N/A,N/A,1899,1902,N/A,9,2
3,N/A,N/A,N/A,1896,1899,N/A,15,2
5,N/A,N/A,N/A,1891,1896,N/A,18,5
5,N/A,N/A,N/A,1886,1891,N/A,24,5
3,N/A,N/A,N/A,1883,1886,N/A,27,2
1,N/A,N/A,N/A,1882,1883,N/A,32,1
6,N/A,N/A,N/A,1876,1882,N/A,36,5
6,N/A,N/A,N/A,1870,1876,N/A,42,5
6,N/A,N/A,N/A,1864,1870,N/A,48,5
6,N/A,N/A,N/A,1858,1864,N/A,54,5
2,N/A,N/A,N/A,1856,1858,N/A,57,2
3,N/A,N/A,N/A,1853,1856,N/A,63,2
2,N/A,N/A,N/A,1851,1853,N/A,69,2
2,N/A,N/A,N/A,1849,1851,N/A,74,1
6,N/A,N/A,N/A,1843,1849,N/A,78,5
6,N/A,N/A,N/A,1837,1843,N/A,84,5
6,N/A,N/A,N/A,1831,1837,N/A,90,5
2,N/A,N/A,N/A,1829,1831,N/A,93,2
6,N/A,N/A,N/A,1823,1829,N/A,97,6
4,N/A,N/A,N/A,1819,1823,N/A,101,4
3,N/A,N/A,N/A,1816,1819,N/A,107,4
3,N/A,N/A,N/A,1813,1816,N/A,111,2
5,N/A,N/A,N/A,1808,1813,N/A,114,5
4,N/A,N/A,N/A,1804,1808,N/A,119,4
3,N/A,N/A,N/A,1801,1804,N/A,125,4
3,N/A,N/A,N/A,1798,1801,N/A,129,2
2,N/A,N/A,N/A,1796,1798,N/A,134,1
3,N/A,N/A,N/A,1793,1796,N/A,137,4
3,N/A,N/A,N/A,1790,1793,N/A,141,2
6,N/A,N/A,N/A,1104,1110,N/A,6,5
3,N/A,N/A,N/A,1101,1104,N/A,9,2
5,N/A,N/A,N/A,1096,1101,N/A,12,5
3,N/A,N/A,N/A,1093,1096,N/A,16,3
2,N/A,N/A,N/A,1091,1093,N/A,22,3
2,N/A,N/A,N/A,1089,1091,N/A,28,3
1,N/A,N/A,N/A,1088,1089,N/A,32,1
5,N/A,N/A,N/A,1083,1088,N/A,36,5
2,N/A,N/A,N/A,1081,1083,N/A,39,2
3,N/A,N/A,N/A,1078,1081,N/A,45,2
1,N/A,N/A,N/A,1077,1078,N/A,50,1
5,N/A,N/A,N/A,1072,1077,N/A,54,5
3,N/A,N/A,N/A,1069,1072,N/A,57,2
5,N/A,N/A,N/A,1064,1069,N/A,60,5
2,N/A,N/A,N/A,1062,1064,N/A,64,3
6,N/A,N/A,N/A,1056,1062,N/A,67,6
3,N/A,N/A,N/A,1053,1056,N/A,71,4
2,N/A,N/A,N/A,1051,1053,N/A,74,1
6,N/A,N/A,N/A,1045,1051,N/A,78,5
3,N/A,N/A,N/A,1042,1045,N/A,81,2
3,N/A,N/A,N/A,1039,1042,N/A,87,2
2,N/A,N/A,N/A,1037,1039,N/A,93,2
6,N/A,N/A,N/A,1031,1037,N/A,97,6
3,N/A,N/A,N/A,1028,1031,N/A,100,3
3,N/A,N/A,N/A,1025,1028,N/A,106,3
2,N/A,N/A,N/A,1023,1025,N/A,111,2
2,N/A,N/A,N/A,1021,1023,N/A,117,2
6,N/A,N/A,N/A,1015,1021,N/A,120,5
3,N/A,N/A,N/A,1012,1015,N/A,123,2
7,N/A,N/A,N/A,1005,1012,N/A,127,6
3,N/A,N/A,N/A,832,835,N/A,5,2
7,N/A,N/A,N/A,825,832,N/A,9,6
3,N/A,N/A,N/A,822,825,N/A,13,4
3,N/A,N/A,N/A,819,822,N/A,18,3
2,N/A,N/A,N/A,817,819,N/A,22,1
5,N/A,N/A,N/A,812,817,N/A,26,5
3,N/A,N/A,N/A,809,812,N/A,31,4
1,N/A,N/A,N/A,808,809,N/A,34,1
2,N/A,N/A,N/A,806,808,N/A,40,1
3,N/A,N/A,N/A,803,806,N/A,43,4
3,N/A,N/A,N/A,800,803,N/A,48,3
2,N/A,N/A,N/A,798,800,N/A,53,2
6,N/A,N/A,N/A,792,798,N/A,57,6
3,N/A,N/A,N/A,789,792,N/A,60,3
2,N/A,N/A,N/A,787,789,N/A,66,3
1,N/A,N/A,N/A,786,787,N/A,70,1
5,N/A,N/A,N/A,781,786,N/A,74,5
3,N/A,N/A,N/A,778,781,N/A,77,2
7,N/A,N/A,N/A,771,778,N/A,81,6
5,N/A,N/A,N/A,766,771,N/A,86,5
2,N/A,N/A,N/A,764,766,N/A,90,3
3,N/A,N/A,N/A,761,764,N/A,96,3
2,N/A,N/A,N/A,759,761,N/A,102,3
3,N/A,N/A,N/A,756,759,N/A,107,2
5,N/A,N/A,N/A,751,756,N/A,110,5
3,N/A,N/A,N/A,748,751,N/A,113,2
3,N/A,N/A,N/A,745,748,N/A,119,2
2,N/A,N/A,N/A,743,745,N/A,124,1
1,N/A,N/A,N/A,742,743,N/A,130,1
6,N/A,N/A,N/A,736,742,N/A,134,5
1,N/A,N/A,N/A,1586,1587,N/A,5,1
5,N/A,N/A,N/A,1581,1586,N/A,9,5
2,N/A,N/A,N/A,1579,1581,N/A,12,2
2,N/A,N/A,N/A,1577,1579,N/A,17,1
6,N/A,N/A,N/A,1571,1577,N/A,21,5
3,N/A,N/A,N/A,1568,1571,N/A,24,2
2,N/A,N/A,N/A,1566,1568,N/A,30,2
7,N/A,N/A,N/A,1559,1566,N/A,34,6
3,N/A,N/A,N/A,1556,1559,N/A,38,4
3,N/A,N/A,N/A,1553,1556,N/A,44,4
3,N/A,N/A,N/A,1550,1553,N/A,50,4
3,N/A,N/A,N/A,1547,1550,N/A,54,2
1,N/A,N/A,N/A,1546,1547,N/A,59,1
3,N/A,N/A,N/A,1543,1546,N/A,62,4
2,N/A,N/A,N/A,1541,1543,N/A,65,1
2,N/A,N/A,N/A,1539,1541,N/A,71,1
3,N/A,N/A,N/A,1536,1539,N/A,74,4
2,N/A,N/A,N/A,1534,1536,N/A,78,2
3,N/A,N/A,N/A,1531,1534,N/A,84,2
2,N/A,N/A,N/A,1529,1531,N/A,90,2
1,N/A,N/A,N/A,1528,1529,N/A,95,1
6,N/A,N/A,N/A,1522,1528,N/A,100,6
6,N/A,N/A,N/A,1516,1522,N/A,105,5
2,N/A,N/A,N/A,1514,1516,N/A,109,3
6,N/A,N/A,N/A,1508,1514,N/A,112,6
1,N/A,N/A,N/A,1507,1508,N/A,118,0
5,N/A,N/A,N/A,1502,1507,N/A,123,5
6,N/A,N/A,N/A,1496,1502,N/A,129,5
3,N/A,N/A,N/A,1493,1496,N/A,134,4
2,N/A,N/A,N/A,1491,1493,N/A,138,2
1,N/A,N/A,N/A,1188,1189,N/A,5,1
7,N/A,N/A,N/A,1181,1188,N/A,10,6
2,N/A,N/A,N/A,1179,1181,N/A,16,0
3,N/A,N/A,N/A,1176,1179,N/A,20,4
2,N/A,N/A,N/A,1174,1176,N/A,24,2
6,N/A,N/A,N/A,1168,1174,N/A,28,6
2,N/A,N/A,N/A,1166,1168,N/A,31,3
2,N/A,N/A,N/A,1164,1166,N/A,37,3
2,N/A,N/A,N/A,1162,1164,N/A,43,3
6,N/A,N/A,N/A,1156,1162,N/A,46,6
5,N/A,N/A,N/A,1151,1156,N/A,51,5
6,N/A,N/A,N/A,1145,1151,N/A,57,5
3,N/A,N/A,N/A,1142,1145,N/A,60,2
6,N/A,N/A,N/A,1136,1142,N/A,64,6
3,N/A,N/A,N/A,1133,1136,N/A,67,3
7,N/A,N/A,N/A,1126,1133,N/A,70,6
2,N/A,N/A,N/A,1124,1126,N/A,73,3
2,N/A,N/A,N/A,1122,1124,N/A,79,3
2,N/A,N/A,N/A,1120,1122,N/A,85,3
6,N/A,N/A,N/A,1114,1120,N/A,88,6
1,N/A,N/A,N/A,1113,1114,N/A,94,0
6,N/A,N/A,N/A,1107,1113,N/A,100,6
1,N/A,N/A,N/A,1106,1107,N/A,106,0
3,N/A,N/A,N/A,1103,1106,N/A,109,3
6,N/A,N/A,N/A,1097,1103,N/A,112,6
3,N/A,N/A,N/A,1094,1097,N/A,115,3
3,N/A,N/A,N/A,1091,1094,N/A,120,2
6,N/A,N/A,N/A,1085,1091,N/A,124,6
5,N/A,N/A,N/A,1080,1085,N/A,129,5
5,N/A,N/A,N/A,1075,1080,N/A,135,5
1,N/A,N/A,N/A,425,426,N/A,4,1
6,N/A,N/A,N/A,419,425,N/A,9,6
2,N/A,N/A,N/A,417,419,N/A,15,0
3,N/A,N/A,N/A,414,417,N/A,18,3
3,N/A,N/A,N/A,411,414,N/A,24,3
2,N/A,N/A,N/A,409,411,N/A,28,1
3,N/A,N/A,N/A,406,409,N/A,31,4
2,N/A,N/A,N/A,404,406,N/A,36,3
3,N/A,N/A,N/A,401,404,N/A,42,3
1,N/A,N/A,N/A,400,401,N/A,46,1
6,N/A,N/A,N/A,394,400,N/A,51,6
2,N/A,N/A,N/A,392,394,N/A,54,3
2,N/A,N/A,N/A,390,392,N/A,60,3
7,N/A,N/A,N/A,383,390,N/A,63,6
6,N/A,N/A,N/A,377,383,N/A,68,5
2,N/A,N/A,N/A,375,377,N/A,72,3
7,N/A,N/A,N/A,368,375,N/A,75,6
1,N/A,N/A,N/A,367,368,N/A,81,0
7,N/A,N/A,N/A,360,367,N/A,87,6
4,N/A,N/A,N/A,356,360,N/A,91,4
3,N/A,N/A,N/A,353,356,N/A,96,3
7,N/A,N/A,N/A,346,353,N/A,99,6
6,N/A,N/A,N/A,340,346,N/A,104,5
3,N/A,N/A,N/A,337,340,N/A,109,4
4,N/A,N/A,N/A,333,337,N/A,115,4
4,N/A,N/A,N/A,329,333,N/A,121,4
3,N/A,N/A,N/A,326,329,N/A,126,3
6,N/A,N/A,N/A,320,326,N/A,129,6
5,N/A,N/A,N/A,315,320,N/A,134,5
3,N/A,N/A,N/A,312,315,N/A,138,3
7,N/A,N/A,N/A,1747,1754,N/A,4,6
6,N/A,N/A,N/A,1741,1747,N/A,9,5
3,N/A,N/A,N/A,1738,1741,N/A,14,4
3,N/A,N/A,N/A,1735,1738,N/A,20,4
3,N/A,N/A,N/A,1732,1735,N/A,24,2
7,N/A,N/A,N/A,1725,1732,N/A,28,6
3,N/A,N/A,N/A,1722,1725,N/A,31,3
7,N/A,N/A,N/A,1715,1722,N/A,34,6
4,N/A,N/A,N/A,1711,1715,N/A,38,4
2,N/A,N/A,N/A,1709,1711,N/A,41,1
3,N/A,N/A,N/A,1706,1709,N/A,44,4
4,N/A,N/A,N/A,1702,1706,N/A,50,4
1,N/A,N/A,N/A,1701,1702,N/A,53,1
1,N/A,N/A,N/A,1700,1701,N/A,59,1
1,N/A,N/A,N/A,1699,1700,N/A,65,1
6,N/A,N/A,N/A,1693,1699,N/A,69,5
3,N/A,N/A,N/A,1690,1693,N/A,74,4
3,N/A,N/A,N/A,1687,1690,N/A,79,3
3,N/A,N/A,N/A,1684,1687,N/A,85,3
6,N/A,N/A,N/A,1678,1684,N/A,88,6
2,N/A,N/A,N/A,1676,1678,N/A,94,0
7,N/A,N/A,N/A,1669,1676,N/A,100,6
6,N/A,N/A,N/A,1663,1669,N/A,105,5
3,N/A,N/A,N/A,1660,1663,N/A,110,4
3,N/A,N/A,N/A,1657,1660,N/A,116,4
2,N/A,N/A,N/A,1655,1657,N/A,119,1
7,N/A,N/A,N/A,1648,1655,N/A,124,6
2,N/A,N/A,N/A,1646,1648,N/A,130,0
5,N/A,N/A,N/A,1641,1646,N/A,135,5
2,N/A,N/A,N/A,1639,1641,N/A,139,3
6,N/A,N/A,N/A,1556,1562,N/A,4,6
4,N/A,N/A,N/A,1552,1556,N/A,8,4
2,N/A,N/A,N/A,1550,1552,N/A,13,3
1,N/A,N/A,N/A,1549,1550,N/A,17,1
3,N/A,N/A,N/A,1546,1549,N/A,20,4
3,N/A,N/A,N/A,1543,1546,N/A,24,2
1,N/A,N/A,N/A,1542,1543,N/A,29,1
6,N/A,N/A,N/A,1536,1542,N/A,33,5
4,N/A,N/A,N/A,1532,1536,N/A,38,4
2,N/A,N/A,N/A,1530,1532,N/A,42,2
2,N/A,N/A,N/A,1528,1530,N/A,48,2
5,N/A,N/A,N/A,1523,1528,N/A,51,5
5,N/A,N/A,N/A,1518,1523,N/A,57,5
2,N/A,N/A,N/A,1516,1518,N/A,61,3
3,N/A,N/A,N/A,1513,1516,N/A,66,2
6,N/A,N/A,N/A,1507,1513,N/A,70,6
1,N/A,N/A,N/A,1506,1507,N/A,76,0
4,N/A,N/A,N/A,1502,1506,N/A,80,4
2,N/A,N/A,N/A,1500,1502,N/A,84,2
7,N/A,N/A,N/A,1493,1500,N/A,88,6
3,N/A,N/A,N/A,1490,1493,N/A,91,3
7,N/A,N/A,N/A,1483,1490,N/A,94,6
3,N/A,N/A,N/A,1480,1483,N/A,98,4
2,N/A,N/A,N/A,1478,1480,N/A,101,1
7,N/A,N/A,N/A,1471,1478,N/A,106,6
2,N/A,N/A,N/A,1469,1471,N/A,109,3
2,N/A,N/A,N/A,1467,1469,N/A,113,1
3,N/A,N/A,N/A,1464,1467,N/A,116,4
3,N/A,N/A,N/A,1461,1464,N/A,122,4
2,N/A,N/A,N/A,1459,1461,N/A,126,2
4,N/A,N/A,N/A,1339,1343,N/A,6,4
3,N/A,N/A,N/A,1336,1339,N/A,10,2
2,N/A,N/A,N/A,1334,1336,N/A,16,2
1,N/A,N/A,N/A,1333,1334,N/A,21,1
5,N/A,N/A,N/A,1328,1333,N/A,25,5
5,N/A,N/A,N/A,1323,1328,N/A,31,5
4,N/A,N/A,N/A,1319,1323,N/A,36,4
1,N/A,N/A,N/A,1318,1319,N/A,39,1
3,N/A,N/A,N/A,1315,1318,N/A,42,4
2,N/A,N/A,N/A,1313,1315,N/A,46,2
5,N/A,N/A,N/A,1308,1313,N/A,49,5
3,N/A,N/A,N/A,1305,1308,N/A,54,4
2,N/A,N/A,N/A,1303,1305,N/A,59,3
1,N/A,N/A,N/A,1302,1303,N/A,63,1
5,N/A,N/A,N/A,1297,1302,N/A,67,5
4,N/A,N/A,N/A,1293,1297,N/A,72,4
2,N/A,N/A,N/A,1291,1293,N/A,76,2
6,N/A,N/A,N/A,1285,1291,N/A,79,5
3,N/A,N/A,N/A,1282,1285,N/A,84,4
2,N/A,N/A,N/A,1280,1282,N/A,87,1
7,N/A,N/A,N/A,1273,1280,N/A,92,6
4,N/A,N/A,N/A,1269,1273,N/A,96,4
1,N/A,N/A,N/A,1268,1269,N/A,99,1
3,N/A,N/A,N/A,1265,1268,N/A,102,4
4,N/A,N/A,N/A,1261,1265,N/A,108,4
3,N/A,N/A,N/A,1258,1261,N/A,112,2
5,N/A,N/A,N/A,1253,1258,N/A,115,5
3,N/A,N/A,N/A,1250,1253,N/A,119,3
6,N/A,N/A,N/A,1244,1250,N/A,122,6
5,N/A,N/A,N/A,1239,1244,N/A,127,5
6,N/A,N/A,N/A,1122,1128,N/A,4,6
2,N/A,N/A,N/A,1120,1122,N/A,10,0
6,N/A,N/A,N/A,1114,1120,N/A,15,5
3,N/A,N/A,N/A,1111,1114,N/A,20,4
2,N/A,N/A,N/A,1109,1111,N/A,23,1
2,N/A,N/A,N/A,1107,1109,N/A,29,1
2,N/A,N/A,N/A,1105,1107,N/A,35,1
6,N/A,N/A,N/A,1099,1105,N/A,40,6
1,N/A,N/A,N/A,1098,1099,N/A,46,0
3,N/A,N/A,N/A,1095,1098,N/A,49,3
2,N/A,N/A,N/A,1093,1095,N/A,53,1
3,N/A,N/A,N/A,1090,1093,N/A,56,4
2,N/A,N/A,N/A,1088,1090,N/A,61,3
2,N/A,N/A,N/A,1086,1088,N/A,67,3
6,N/A,N/A,N/A,1080,1086,N/A,70,6
1,N/A,N/A,N/A,1079,1080,N/A,76,0
5,N/A,N/A,N/A,1074,1079,N/A,81,5
2,N/A,N/A,N/A,1072,1074,N/A,84,2
5,N/A,N/A,N/A,1067,1072,N/A,87,5
2,N/A,N/A,N/A,1065,1067,N/A,91,3
1,N/A,N/A,N/A,1064,1065,N/A,95,1
3,N/A,N/A,N/A,1061,1064,N/A,98,4
2,N/A,N/A,N/A,1059,1061,N/A,102,2
7,N/A,N/A,N/A,1052,1059,N/A,106,6
3,N/A,N/A,N/A,1049,1052,N/A,110,4
3,N/A,N/A,N/A,1046,1049,N/A,116,4
2,N/A,N/A,N/A,1044,1046,N/A,120,2
6,N/A,N/A,N/A,1038,1044,N/A,124,6
3,N/A,N/A,N/A,1035,1038,N/A,127,3
3,N/A,N/A,N/A,1032,1035,N/A,132,2
6,N/A,N/A,N/A,804,810,N/A,6,6
3,N/A,N/A,N/A,801,804,N/A,10,4
3,N/A,N/A,N/A,798,801,N/A,15,3
3,N/A,N/A,N/A,795,798,N/A,20,2
6,N/A,N/A,N/A,789,795,N/A,24,6
5,N/A,N/A,N/A,784,789,N/A,29,5
2,N/A,N/A,N/A,782,784,N/A,33,3
3,N/A,N/A,N/A,779,782,N/A,38,2
7,N/A,N/A,N/A,772,779,N/A,42,6
3,N/A,N/A,N/A,769,772,N/A,46,4
3,N/A,N/A,N/A,766,769,N/A,52,4
3,N/A,N/A,N/A,763,766,N/A,56,2
2,N/A,N/A,N/A,761,763,N/A,62,2
5,N/A,N/A,N/A,756,761,N/A,65,5
3,N/A,N/A,N/A,753,756,N/A,70,4
3,N/A,N/A,N/A,750,753,N/A,76,4
2,N/A,N/A,N/A,748,750,N/A,80,2
1,N/A,N/A,N/A,747,748,N/A,85,1
7,N/A,N/A,N/A,740,747,N/A,90,6
5,N/A,N/A,N/A,735,740,N/A,95,5
3,N/A,N/A,N/A,732,735,N/A,100,4
4,N/A,N/A,N/A,728,732,N/A,106,4
3,N/A,N/A,N/A,725,728,N/A,110,2
3,N/A,N/A,N/A,722,725,N/A,116,2
2,N/A,N/A,N/A,720,722,N/A,122,2
2,N/A,N/A,N/A,718,720,N/A,128,2
2,N/A,N/A,N/A,716,718,N/A,134,2
3,N/A,N/A,N/A,713,716,N/A,140,2
6,N/A,N/A,N/A,707,713,N/A,144,6
3,N/A,N/A,N/A,704,707,N/A,148,4
6,N/A,N/A,N/A,662,668,N/A,6,6
3,N/A,N/A,N/A,659,662,N/A,9,3
3,N/A,N/A,N/A,656,659,N/A,15,3
2,N/A,N/A,N/A,654,656,N/A,19,1
6,N/A,N/A,N/A,648,654,N/A,23,5
6,N/A,N/A,N/A,642,648,N/A,29,5
4,N/A,N/A,N/A,638,642,N/A,34,4
1,N/A,N/A,N/A,637,638,N/A,37,1
3,N/A,N/A,N/A,634,637,N/A,40,4
2,N/A,N/A,N/A,632,634,N/A,44,2
6,N/A,N/A,N/A,626,632,N/A,48,6
6,N/A,N/A,N/A,620,626,N/A,53,5
2,N/A,N/A,N/A,618,620,N/A,56,2
3,N/A,N/A,N/A,615,618,N/A,62,2
6,N/A,N/A,N/A,609,615,N/A,65,5
2,N/A,N/A,N/A,607,609,N/A,68,2
3,N/A,N/A,N/A,604,607,N/A,74,2
2,N/A,N/A,N/A,602,604,N/A,79,1
1,N/A,N/A,N/A,601,602,N/A,85,1
6,N/A,N/A,N/A,595,601,N/A,90,6
3,N/A,N/A,N/A,592,595,N/A,93,3
3,N/A,N/A,N/A,589,592,N/A,99,3
7,N/A,N/A,N/A,582,589,N/A,102,6
3,N/A,N/A,N/A,579,582,N/A,105,3
7,N/A,N/A,N/A,572,579,N/A,108,6
2,N/A,N/A,N/A,570,572,N/A,114,0
7,N/A,N/A,N/A,563,570,N/A,120,6
4,N/A,N/A,N/A,559,563,N/A,124,4
2,N/A,N/A,N/A,557,559,N/A,128,2
2,N/A,N/A,N/A,555,557,N/A,134,2
6,N/A,N/A,N/A,411,417,N/A,4,5
2,N/A,N/A,N/A,409,411,N/A,7,2
1,N/A,N/A,N/A,408,409,N/A,12,1
5,N/A,N/A,N/A,403,408,N/A,16,5
3,N/A,N/A,N/A,400,403,N/A,21,4
2,N/A,N/A,N/A,398,400,N/A,25,2
1,N/A,N/A,N/A,397,398,N/A,30,1
6,N/A,N/A,N/A,391,397,N/A,35,6
5,N/A,N/A,N/A,386,391,N/A,40,5
2,N/A,N/A,N/A,384,386,N/A,43,2
6,N/A,N/A,N/A,378,384,N/A,47,6
3,N/A,N/A,N/A,375,378,N/A,50,3
1,N/A,N/A,N/A,374,375,N/A,54,1
6,N/A,N/A,N/A,368,374,N/A,59,6
2,N/A,N/A,N/A,366,368,N/A,62,3
6,N/A,N/A,N/A,360,366,N/A,65,6
2,N/A,N/A,N/A,358,360,N/A,71,0
6,N/A,N/A,N/A,352,358,N/A,77,6
6,N/A,N/A,N/A,346,352,N/A,82,5
2,N/A,N/A,N/A,344,346,N/A,85,2
6,N/A,N/A,N/A,338,344,N/A,89,6
3,N/A,N/A,N/A,335,338,N/A,93,4
1,N/A,N/A,N/A,334,335,N/A,96,1
3,N/A,N/A,N/A,331,334,N/A,99,4
3,N/A,N/A,N/A,328,331,N/A,103,2
6,N/A,N/A,N/A,322,328,N/A,106,5
3,N/A,N/A,N/A,319,322,N/A,109,2
5,N/A,N/A,N/A,314,319,N/A,112,5
3,N/A,N/A,N/A,311,314,N/A,115,2
6,N/A,N/A,N/A,305,311,N/A,118,5
7,N/A,N/A,N/A,1372,1379,N/A,6,6
4,N/A,N/A,N/A,1368,1372,N/A,10,4
3,N/A,N/A,N/A,1365,1368,N/A,16,4
2,N/A,N/A,N/A,1363,1365,N/A,21,3
7,N/A,N/A,N/A,1356,1363,N/A,24,6
4,N/A,N/A,N/A,1352,1356,N/A,28,4
1,N/A,N/A,N/A,1351,1352,N/A,31,1
5,N/A,N/A,N/A,1346,1351,N/A,35,5
5,N/A,N/A,N/A,1341,1346,N/A,41,5
4,N/A,N/A,N/A,1337,1341,N/A,46,4
2,N/A,N/A,N/A,1335,1337,N/A,50,2
3,N/A,N/A,N/A,1332,1335,N/A,56,2
1,N/A,N/A,N/A,1331,1332,N/A,61,1
6,N/A,N/A,N/A,1325,1331,N/A,65,5
5,N/A,N/A,N/A,1320,1325,N/A,71,5
6,N/A,N/A,N/A,1314,1320,N/A,77,5
4,N/A,N/A,N/A,1310,1314,N/A,82,4
2,N/A,N/A,N/A,1308,1310,N/A,86,2
6,N/A,N/A,N/A,1302,1308,N/A,89,5
6,N/A,N/A,N/A,1296,1302,N/A,95,5
3,N/A,N/A,N/A,1293,1296,N/A,98,2
7,N/A,N/A,N/A,1286,1293,N/A,102,6
4,N/A,N/A,N/A,1282,1286,N/A,106,4
4,N/A,N/A,N/A,1278,1282,N/A,112,4
2,N/A,N/A,N/A,1276,1278,N/A,115,1
6,N/A,N/A,N/A,1270,1276,N/A,120,6
5,N/A,N/A,N/A,1265,1270,N/A,125,5
3,N/A,N/A,N/A,1262,1265,N/A,129,3
2,N/A,N/A,N/A,1260,1262,N/A,134,2
7,N/A,N/A,N/A,1253,1260,N/A,138,6
4,N/A,N/A,N/A,1184,1188,N/A,5,4
2,N/A,N/A,N/A,1182,1184,N/A,8,1
2,N/A,N/A,N/A,1180,1182,N/A,14,1
6,N/A,N/A,N/A,1174,1180,N/A,19,6
6,N/A,N/A,N/A,1168,1174,N/A,24,5
6,N/A,N/A,N/A,1162,1168,N/A,30,5
3,N/A,N/A,N/A,1159,1162,N/A,34,3
7,N/A,N/A,N/A,1152,1159,N/A,37,6
4,N/A,N/A,N/A,1148,1152,N/A,41,4
3,N/A,N/A,N/A,1145,1148,N/A,46,3
3,N/A,N/A,N/A,1142,1145,N/A,52,3
3,N/A,N/A,N/A,1139,1142,N/A,57,2
5,N/A,N/A,N/A,1134,1139,N/A,60,5
6,N/A,N/A,N/A,1128,1134,N/A,66,5
6,N/A,N/A,N/A,1122,1128,N/A,72,5
2,N/A,N/A,N/A,1120,1122,N/A,76,3
2,N/A,N/A,N/A,1118,1120,N/A,82,3
2,N/A,N/A,N/A,1116,1118,N/A,87,2
5,N/A,N/A,N/A,1111,1116,N/A,90,5
4,N/A,N/A,N/A,1107,1111,N/A,95,4
2,N/A,N/A,N/A,1105,1107,N/A,98,1
6,N/A,N/A,N/A,1099,1105,N/A,103,6
6,N/A,N/A,N/A,1093,1099,N/A,108,5
3,N/A,N/A,N/A,1090,1093,N/A,111,2
7,N/A,N/A,N/A,1083,1090,N/A,115,6
2,N/A,N/A,N/A,1081,1083,N/A,121,0
4,N/A,N/A,N/A,1077,1081,N/A,125,4
3,N/A,N/A,N/A,1074,1077,N/A,129,2
7,N/A,N/A,N/A,1067,1074,N/A,133,6
2,N/A,N/A,N/A,1065,1067,N/A,136,3
3,N/A,N/A,N/A,552,555,N/A,4,3
3,N/A,N/A,N/A,549,552,N/A,10,3
1,N/A,N/A,N/A,548,549,N/A,14,1
5,N/A,N/A,N/A,543,548,N/A,18,5
5,N/A,N/A,N/A,538,543,N/A,24,5
3,N/A,N/A,N/A,535,538,N/A,29,4
3,N/A,N/A,N/A,532,535,N/A,33,2
5,N/A,N/A,N/A,527,532,N/A,36,5
4,N/A,N/A,N/A,523,527,N/A,41,4
4,N/A,N/A,N/A,519,523,N/A,47,4
2,N/A,N/A,N/A,517,519,N/A,52,3
2,N/A,N/A,N/A,515,517,N/A,57,2
2,N/A,N/A,N/A,513,515,N/A,63,2
6,N/A,N/A,N/A,507,513,N/A,66,5
4,N/A,N/A,N/A,503,507,N/A,71,4
1,N/A,N/A,N/A,502,503,N/A,74,1
1,N/A,N/A,N/A,501,502,N/A,80,1
6,N/A,N/A,N/A,495,501,N/A,85,6
3,N/A,N/A,N/A,492,495,N/A,89,4
1,N/A,N/A,N/A,491,492,N/A,92,1
2,N/A,N/A,N/A,489,491,N/A,98,1
7,N/A,N/A,N/A,482,489,N/A,103,6
1,N/A,N/A,N/A,481,482,N/A,109,0
6,N/A,N/A,N/A,475,481,N/A,115,6
2,N/A,N/A,N/A,473,475,N/A,118,3
2,N/A,N/A,N/A,471,473,N/A,122,1
4,N/A,N/A,N/A,467,471,N/A,125,4
2,N/A,N/A,N/A,465,467,N/A,128,1
4,N/A,N/A,N/A,461,465,N/A,131,4
2,N/A,N/A,N/A,459,461,N/A,135,2
7,N/A,N/A,N/A,1412,1419,N/A,4,6
2,N/A,N/A,N/A,1410,1412,N/A,7,3
2,N/A,N/A,N/A,1408,1410,N/A,13,3
2,N/A,N/A,N/A,1406,1408,N/A,19,3
2,N/A,N/A,N/A,1404,1406,N/A,23,1
6,N/A,N/A,N/A,1398,1404,N/A,27,5
3,N/A,N/A,N/A,1395,1398,N/A,30,2
2,N/A,N/A,N/A,1393,1395,N/A,36,2
6,N/A,N/A,N/A,1387,1393,N/A,39,5
4,N/A,N/A,N/A,1383,1387,N/A,44,4
2,N/A,N/A,N/A,1381,1383,N/A,47,1
3,N/A,N/A,N/A,1378,1381,N/A,50,4
3,N/A,N/A,N/A,1375,1378,N/A,56,4
1,N/A,N/A,N/A,1374,1375,N/A,59,1
6,N/A,N/A,N/A,1368,1374,N/A,63,5
6,N/A,N/A,N/A,1362,1368,N/A,69,5
2,N/A,N/A,N/A,1360,1362,N/A,73,3
6,N/A,N/A,N/A,1354,1360,N/A,76,6
4,N/A,N/A,N/A,1350,1354,N/A,80,4
2,N/A,N/A,N/A,1348,1350,N/A,84,2
3,N/A,N/A,N/A,1345,1348,N/A,90,2
6,N/A,N/A,N/A,1339,1345,N/A,93,5
3,N/A,N/A,N/A,1336,1339,N/A,98,4
2,N/A,N/A,N/A,1334,1336,N/A,101,1
7,N/A,N/A,N/A,1327,1334,N/A,106,6
6,N/A,N/A,N/A,1321,1327,N/A,111,5
6,N/A,N/A,N/A,1315,1321,N/A,117,5
3,N/A,N/A,N/A,1312,1315,N/A,122,4
4,N/A,N/A,N/A,1308,1312,N/A,128,4
2,N/A,N/A,N/A,1306,1308,N/A,133,3
6,N/A,N/A,N/A,485,491,N/A,5,5
2,N/A,N/A,N/A,483,485,N/A,9,3
2,N/A,N/A,N/A,481,483,N/A,15,3
2,N/A,N/A,N/A,479,481,N/A,19,1
1,N/A,N/A,N/A,478,479,N/A,25,1
7,N/A,N/A,N/A,471,478,N/A,30,6
6,N/A,N/A,N/A,465,471,N/A,35,5
4,N/A,N/A,N/A,461,465,N/A,40,4
2,N/A,N/A,N/A,459,461,N/A,44,2
2,N/A,N/A,N/A,457,459,N/A,49,1
2,N/A,N/A,N/A,455,457,N/A,55,1
1,N/A,N/A,N/A,454,455,N/A,61,1
4,N/A,N/A,N/A,450,454,N/A,64,4
3,N/A,N/A,N/A,447,450,N/A,68,2
2,N/A,N/A,N/A,445,447,N/A,74,2
5,N/A,N/A,N/A,440,445,N/A,77,5
2,N/A,N/A,N/A,438,440,N/A,81,3
2,N/A,N/A,N/A,436,438,N/A,86,2
5,N/A,N/A,N/A,431,436,N/A,89,5
3,N/A,N/A,N/A,428,431,N/A,92,2
6,N/A,N/A,N/A,422,428,N/A,95,5
5,N/A,N/A,N/A,417,422,N/A,101,5
2,N/A,N/A,N/A,415,417,N/A,105,3
1,N/A,N/A,N/A,414,415,N/A,109,1
1,N/A,N/A,N/A,413,414,N/A,115,1
7,N/A,N/A,N/A,406,413,N/A,120,6
4,N/A,N/A,N/A,402,406,N/A,124,4
3,N/A,N/A,N/A,399,402,N/A,129,3
3,N/A,N/A,N/A,396,399,N/A,134,2
6,N/A,N/A,N/A,390,396,N/A,137,5
6,N/A,N/A,N/A,999,1005,N/A,6,6
1,N/A,N/A,N/A,998,999,N/A,12,0
6,N/A,N/A,N/A,992,998,N/A,18,6
1,N/A,N/A,N/A,991,992,N/A,24,0
3,N/A,N/A,N/A,988,991,N/A,27,3
6,N/A,N/A,N/A,982,988,N/A,30,6
2,N/A,N/A,N/A,980,982,N/A,36,0
5,N/A,N/A,N/A,975,980,N/A,41,5
2,N/A,N/A,N/A,973,975,N/A,45,3
2,N/A,N/A,N/A,971,973,N/A,51,3
2,N/A,N/A,N/A,969,971,N/A,57,3
3,N/A,N/A,N/A,966,969,N/A,63,3
2,N/A,N/A,N/A,964,966,N/A,68,2
2,N/A,N/A,N/A,962,964,N/A,74,2
3,N/A,N/A,N/A,959,962,N/A,80,2
6,N/A,N/A,N/A,953,959,N/A,83,5
2,N/A,N/A,N/A,951,953,N/A,86,2
2,N/A,N/A,N/A,949,951,N/A,92,2
6,N/A,N/A,N/A,943,949,N/A,96,6
4,N/A,N/A,N/A,939,943,N/A,100,4
3,N/A,N/A,N/A,936,939,N/A,106,4
2,N/A,N/A,N/A,934,936,N/A,111,3
2,N/A,N/A,N/A,932,934,N/A,117,3
3,N/A,N/A,N/A,929,932,N/A,123,3
2,N/A,N/A,N/A,927,929,N/A,127,1
5,N/A,N/A,N/A,922,927,N/A,131,5
2,N/A,N/A,N/A,920,922,N/A,135,3
7,N/A,N/A,N/A,913,920,N/A,138,6
5,N/A,N/A,N/A,908,913,N/A,143,5
2,N/A,N/A,N/A,906,908,N/A,147,3
6,N/A,N/A,N/A,1612,1618,N/A,6,6
1,N/A,N/A,N/A,1611,1612,N/A,12,0
4,N/A,N/A,N/A,1607,1611,N/A,16,4
2,N/A,N/A,N/A,1605,1607,N/A,20,2
7,N/A,N/A,N/A,1598,1605,N/A,24,6
4,N/A,N/A,N/A,1594,1598,N/A,28,4
3,N/A,N/A,N/A,1591,1594,N/A,33,3
2,N/A,N/A,N/A,1589,1591,N/A,37,1
2,N/A,N/A,N/A,1587,1589,N/A,43,1
4,N/A,N/A,N/A,1583,1587,N/A,46,4
2,N/A,N/A,N/A,1581,1583,N/A,51,3
6,N/A,N/A,N/A,1575,1581,N/A,54,6
5,N/A,N/A,N/A,1570,1575,N/A,59,5
3,N/A,N/A,N/A,1567,1570,N/A,62,2
2,N/A,N/A,N/A,1565,1567,N/A,68,2
1,N/A,N/A,N/A,1564,1565,N/A,73,1
3,N/A,N/A,N/A,1561,1564,N/A,76,4
4,N/A,N/A,N/A,1557,1561,N/A,82,4
2,N/A,N/A,N/A,1555,1557,N/A,86,2
1,N/A,N/A,N/A,1554,1555,N/A,91,1
6,N/A,N/A,N/A,1548,1554,N/A,96,6
2,N/A,N/A,N/A,1546,1548,N/A,99,3
2,N/A,N/A,N/A,1544,1546,N/A,105,3
6,N/A,N/A,N/A,1538,1544,N/A,108,6
4,N/A,N/A,N/A,1534,1538,N/A,112,4
2,N/A,N/A,N/A,1532,1534,N/A,116,2
2,N/A,N/A,N/A,1530,1532,N/A,122,2
7,N/A,N/A,N/A,1523,1530,N/A,126,6
3,N/A,N/A,N/A,1520,1523,N/A,129,3
6,N/A,N/A,N/A,1514,1520,N/A,132,6
6,N/A,N/A,N/A,1460,1466,N/A,6,6
3,N/A,N/A,N/A,1457,1460,N/A,10,4
4,N/A,N/A,N/A,1453,1457,N/A,16,4
4,N/A,N/A,N/A,1449,1453,N/A,22,4
3,N/A,N/A,N/A,1446,1449,N/A,27,3
2,N/A,N/A,N/A,1444,1446,N/A,33,3
2,N/A,N/A,N/A,1442,1444,N/A,37,1
2,N/A,N/A,N/A,1440,1442,N/A,43,1
4,N/A,N/A,N/A,1436,1440,N/A,46,4
2,N/A,N/A,N/A,1434,1436,N/A,51,3
6,N/A,N/A,N/A,1428,1434,N/A,54,6
2,N/A,N/A,N/A,1426,1428,N/A,60,0
4,N/A,N/A,N/A,1422,1426,N/A,64,4
3,N/A,N/A,N/A,1419,1422,N/A,68,2
2,N/A,N/A,N/A,1417,1419,N/A,73,1
1,N/A,N/A,N/A,1416,1417,N/A,79,1
7,N/A,N/A,N/A,1409,1416,N/A,84,6
3,N/A,N/A,N/A,1406,1409,N/A,87,3
3,N/A,N/A,N/A,1403,1406,N/A,92,2
1,N/A,N/A,N/A,1402,1403,N/A,97,1
7,N/A,N/A,N/A,1395,1402,N/A,102,6
6,N/A,N/A,N/A,1389,1395,N/A,107,5
4,N/A,N/A,N/A,1385,1389,N/A,112,4
2,N/A,N/A,N/A,1383,1385,N/A,117,3
6,N/A,N/A,N/A,1377,1383,N/A,120,6
3,N/A,N/A,N/A,1374,1377,N/A,123,3
2,N/A,N/A,N/A,1372,1374,N/A,129,3
6,N/A,N/A,N/A,1366,1372,N/A,132,6
1,N/A,N/A,N/A,1365,1366,N/A,138,0
4,N/A,N/A,N/A,1361,1365,N/A,142,4
2,N/A,N/A,N/A,468,470,N/A,3,3
1,N/A,N/A,N/A,467,468,N/A,7,1
2,N/A,N/A,N/A,465,467,N/A,13,1
2,N/A,N/A,N/A,463,465,N/A,19,1
2,N/A,N/A,N/A,461,463,N/A,25,1
1,N/A,N/A,N/A,460,461,N/A,31,1
4,N/A,N/A,N/A,456,460,N/A,34,4
2,N/A,N/A,N/A,454,456,N/A,38,2
2,N/A,N/A,N/A,452,454,N/A,44,2
3,N/A,N/A,N/A,449,452,N/A,50,2
3,N/A,N/A,N/A,446,449,N/A,56,2
1,N/A,N/A,N/A,445,446,N/A,61,1
6,N/A,N/A,N/A,439,445,N/A,66,6
3,N/A,N/A,N/A,436,439,N/A,70,4
2,N/A,N/A,N/A,434,436,N/A,74,2
2,N/A,N/A,N/A,432,434,N/A,80,2
6,N/A,N/A,N/A,426,432,N/A,84,6
4,N/A,N/A,N/A,422,426,N/A,88,4
3,N/A,N/A,N/A,419,422,N/A,94,4
2,N/A,N/A,N/A,417,419,N/A,98,2
2,N/A,N/A,N/A,415,417,N/A,103,1
6,N/A,N/A,N/A,409,415,N/A,107,5
6,N/A,N/A,N/A,403,409,N/A,113,5
5,N/A,N/A,N/A,398,403,N/A,119,5
2,N/A,N/A,N/A,396,398,N/A,123,3
3,N/A,N/A,N/A,393,396,N/A,128,2
3,N/A,N/A,N/A,390,393,N/A,134,2
5,N/A,N/A,N/A,385,390,N/A,137,5
3,N/A,N/A,N/A,382,385,N/A,140,2
1,N/A,N/A,N/A,381,382,N/A,145,1
3,N/A,N/A,N/A,324,327,N/A,3,2
6,N/A,N/A,N/A,318,324,N/A,6,5
4,N/A,N/A,N/A,314,318,N/A,11,4
2,N/A,N/A,N/A,312,314,N/A,16,3
2,N/A,N/A,N/A,310,312,N/A,21,2
6,N/A,N/A,N/A,304,310,N/A,24,5
6,N/A,N/A,N/A,298,304,N/A,30,5
4,N/A,N/A,N/A,294,298,N/A,35,4
2,N/A,N/A,N/A,292,294,N/A,40,3
3,N/A,N/A,N/A,289,292,N/A,46,3
6,N/A,N/A,N/A,283,289,N/A,49,6
2,N/A,N/A,N/A,281,283,N/A,52,3
3,N/A,N/A,N/A,278,281,N/A,57,2
7,N/A,N/A,N/A,271,278,N/A,61,6
1,N/A,N/A,N/A,270,271,N/A,67,0
6,N/A,N/A,N/A,264,270,N/A,73,6
4,N/A,N/A,N/A,260,264,N/A,77,4
2,N/A,N/A,N/A,258,260,N/A,80,1
7,N/A,N/A,N/A,251,258,N/A,85,6
3,N/A,N/A,N/A,248,251,N/A,88,3
2,N/A,N/A,N/A,246,248,N/A,92,1
4,N/A,N/A,N/A,242,246,N/A,95,4
2,N/A,N/A,N/A,240,242,N/A,98,1
6,N/A,N/A,N/A,234,240,N/A,103,6
3,N/A,N/A,N/A,231,234,N/A,107,4
4,N/A,N/A,N/A,227,231,N/A,113,4
2,N/A,N/A,N/A,225,227,N/A,118,3
3,N/A,N/A,N/A,222,225,N/A,123,2
6,N/A,N/A,N/A,216,222,N/A,126,5
6,N/A,N/A,N/A,210,216,N/A,132,5
2,N/A,N/A,N/A,807,809,N/A,4,3
1,N/A,N/A,N/A,806,807,N/A,8,1
6,N/A,N/A,N/A,800,806,N/A,12,5
3,N/A,N/A,N/A,797,800,N/A,15,2
3,N/A,N/A,N/A,794,797,N/A,21,2
3,N/A,N/A,N/A,791,794,N/A,27,2
7,N/A,N/A,N/A,784,791,N/A,31,6
5,N/A,N/A,N/A,779,784,N/A,36,5
5,N/A,N/A,N/A,774,779,N/A,42,5
2,N/A,N/A,N/A,772,774,N/A,46,3
2,N/A,N/A,N/A,770,772,N/A,52,3
2,N/A,N/A,N/A,768,770,N/A,56,1
3,N/A,N/A,N/A,765,768,N/A,59,4
2,N/A,N/A,N/A,763,765,N/A,64,3
7,N/A,N/A,N/A,756,763,N/A,67,6
3,N/A,N/A,N/A,753,756,N/A,70,3
6,N/A,N/A,N/A,747,753,N/A,73,6
4,N/A,N/A,N/A,743,747,N/A,77,4
2,N/A,N/A,N/A,741,743,N/A,81,2
5,N/A,N/A,N/A,736,741,N/A,84,5
3,N/A,N/A,N/A,733,736,N/A,88,3
1,N/A,N/A,N/A,732,733,N/A,92,1
6,N/A,N/A,N/A,726,732,N/A,97,6
4,N/A,N/A,N/A,722,726,N/A,101,4
2,N/A,N/A,N/A,720,722,N/A,105,2
3,N/A,N/A,N/A,717,720,N/A,111,2
3,N/A,N/A,N/A,714,717,N/A,117,2
7,N/A,N/A,N/A,707,714,N/A,121,6
6,N/A,N/A,N/A,701,707,N/A,126,5
2,N/A,N/A,N/A,699,701,N/A,130,3
5,N/A,N/A,N/A,1778,1783,N/A,5,5
3,N/A,N/A,N/A,1775,1778,N/A,8,2
7,N/A,N/A,N/A,1768,1775,N/A,12,6
5,N/A,N/A,N/A,1763,1768,N/A,17,5
2,N/A,N/A,N/A,1761,1763,N/A,21,3
1,N/A,N/A,N/A,1760,1761,N/A,25,1
2,N/A,N/A,N/A,1758,1760,N/A,31,1
3,N/A,N/A,N/A,1755,1758,N/A,34,4
3,N/A,N/A,N/A,1752,1755,N/A,39,3
3,N/A,N/A,N/A,1749,1752,N/A,44,2
5,N/A,N/A,N/A,1744,1749,N/A,47,5
6,N/A,N/A,N/A,1738,1744,N/A,53,5
4,N/A,N/A,N/A,1734,1738,N/A,58,4
3,N/A,N/A,N/A,1731,1734,N/A,63,3
2,N/A,N/A,N/A,1729,1731,N/A,69,3
2,N/A,N/A,N/A,1727,1729,N/A,73,1
3,N/A,N/A,N/A,1724,1727,N/A,76,4
2,N/A,N/A,N/A,1722,1724,N/A,80,2
1,N/A,N/A,N/A,1721,1722,N/A,85,1
3,N/A,N/A,N/A,1718,1721,N/A,88,4
3,N/A,N/A,N/A,1715,1718,N/A,94,4
3,N/A,N/A,N/A,1712,1715,N/A,99,3
2,N/A,N/A,N/A,1710,1712,N/A,103,1
1,N/A,N/A,N/A,1709,1710,N/A,109,1
1,N/A,N/A,N/A,1708,1709,N/A,115,1
2,N/A,N/A,N/A,1706,1708,N/A,121,1
5,N/A,N/A,N/A,1701,1706,N/A,125,5
3,N/A,N/A,N/A,1698,1701,N/A,128,2
6,N/A,N/A,N/A,1692,1698,N/A,131,5
3,N/A,N/A,N/A,1689,1692,N/A,135,3
3,N/A,N/A,N/A,466,469,N/A,6,2
2,N/A,N/A,N/A,464,466,N/A,12,2
5,N/A,N/A,N/A,459,464,N/A,15,5
4,N/A,N/A,N/A,455,459,N/A,20,4
3,N/A,N/A,N/A,452,455,N/A,25,3
3,N/A,N/A,N/A,449,452,N/A,31,3
1,N/A,N/A,N/A,448,449,N/A,35,1
3,N/A,N/A,N/A,445,448,N/A,38,4
2,N/A,N/A,N/A,443,445,N/A,43,3
3,N/A,N/A,N/A,440,443,N/A,48,2
2,N/A,N/A,N/A,438,440,N/A,53,1
7,N/A,N/A,N/A,431,438,N/A,58,6
3,N/A,N/A,N/A,428,431,N/A,62,4
4,N/A,N/A,N/A,424,428,N/A,68,4
2,N/A,N/A,N/A,422,424,N/A,72,2
6,N/A,N/A,N/A,416,422,N/A,75,5
4,N/A,N/A,N/A,412,416,N/A,80,4
4,N/A,N/A,N/A,408,412,N/A,86,4
2,N/A,N/A,N/A,406,408,N/A,90,2
5,N/A,N/A,N/A,401,406,N/A,93,5
2,N/A,N/A,N/A,399,401,N/A,97,3
2,N/A,N/A,N/A,397,399,N/A,103,3
6,N/A,N/A,N/A,391,397,N/A,106,6
1,N/A,N/A,N/A,390,391,N/A,112,0
7,N/A,N/A,N/A,383,390,N/A,118,6
5,N/A,N/A,N/A,378,383,N/A,123,5
2,N/A,N/A,N/A,376,378,N/A,127,3
2,N/A,N/A,N/A,374,376,N/A,132,2
5,N/A,N/A,N/A,369,374,N/A,135,5
2,N/A,N/A,N/A,367,369,N/A,138,2
6,N/A,N/A,N/A,446,452,N/A,6,6
5,N/A,N/A,N/A,441,446,N/A,11,5
6,N/A,N/A,N/A,435,441,N/A,17,5
2,N/A,N/A,N/A,433,435,N/A,20,2
1,N/A,N/A,N/A,432,433,N/A,25,1
1,N/A,N/A,N/A,431,432,N/A,31,1
5,N/A,N/A,N/A,426,431,N/A,35,5
5,N/A,N/A,N/A,421,426,N/A,41,5
2,N/A,N/A,N/A,419,421,N/A,44,2
5,N/A,N/A,N/A,414,419,N/A,47,5
3,N/A,N/A,N/A,411,414,N/A,50,2
6,N/A,N/A,N/A,405,411,N/A,53,5
3,N/A,N/A,N/A,402,405,N/A,58,4
1,N/A,N/A,N/A,401,402,N/A,61,1
5,N/A,N/A,N/A,396,401,N/A,65,5
6,N/A,N/A,N/A,390,396,N/A,71,5
2,N/A,N/A,N/A,388,390,N/A,75,3
2,N/A,N/A,N/A,386,388,N/A,81,3
2,N/A,N/A,N/A,384,386,N/A,85,1
3,N/A,N/A,N/A,381,384,N/A,88,4
3,N/A,N/A,N/A,378,381,N/A,93,3
2,N/A,N/A,N/A,376,378,N/A,99,3
7,N/A,N/A,N/A,369,376,N/A,102,6
2,N/A,N/A,N/A,367,369,N/A,108,0
3,N/A,N/A,N/A,364,367,N/A,111,3
7,N/A,N/A,N/A,357,364,N/A,114,6
3,N/A,N/A,N/A,354,357,N/A,118,4
3,N/A,N/A,N/A,351,354,N/A,124,4
4,N/A,N/A,N/A,347,351,N/A,130,4
1,N/A,N/A,N/A,346,347,N/A,133,1
5,N/A,N/A,N/A,493,498,N/A,3,5
2,N/A,N/A,N/A,491,493,N/A,7,3
2,N/A,N/A,N/A,489,491,N/A,12,2
2,N/A,N/A,N/A,487,489,N/A,17,1
5,N/A,N/A,N/A,482,487,N/A,21,5
6,N/A,N/A,N/A,476,482,N/A,27,5
2,N/A,N/A,N/A,474,476,N/A,30,2
3,N/A,N/A,N/A,471,474,N/A,36,2
5,N/A,N/A,N/A,466,471,N/A,39,5
2,N/A,N/A,N/A,464,466,N/A,43,3
3,N/A,N/A,N/A,461,464,N/A,49,3
6,N/A,N/A,N/A,455,461,N/A,52,6
6,N/A,N/A,N/A,449,455,N/A,57,5
2,N/A,N/A,N/A,447,449,N/A,60,2
1,N/A,N/A,N/A,446,447,N/A,65,1
1,N/A,N/A,N/A,445,446,N/A,71,1
3,N/A,N/A,N/A,442,445,N/A,74,4
4,N/A,N/A,N/A,438,442,N/A,80,4
3,N/A,N/A,N/A,435,438,N/A,84,2
6,N/A,N/A,N/A,429,435,N/A,87,5
2,N/A,N/A,N/A,427,429,N/A,91,3
1,N/A,N/A,N/A,426,427,N/A,95,1
6,N/A,N/A,N/A,420,426,N/A,100,6
1,N/A,N/A,N/A,419,420,N/A,106,0
6,N/A,N/A,N/A,413,419,N/A,111,5
5,N/A,N/A,N/A,408,413,N/A,117,5
2,N/A,N/A,N/A,406,408,N/A,121,3
2,N/A,N/A,N/A,404,406,N/A,125,1
6,N/A,N/A,N/A,398,404,N/A,130,6
5,N/A,N/A,N/A,393,398,N/A,135,5
5,N/A,N/A,N/A,1689,1694,N/A,3,5
5,N/A,N/A,N/A,1684,1689,N/A,9,5
3,N/A,N/A,N/A,1681,1684,N/A,14,4
3,N/A,N/A,N/A,1678,1681,N/A,20,4
2,N/A,N/A,N/A,1676,1678,N/A,25,3
6,N/A,N/A,N/A,1670,1676,N/A,28,6
4,N/A,N/A,N/A,1666,1670,N/A,32,4
3,N/A,N/A,N/A,1663,1666,N/A,37,3
2,N/A,N/A,N/A,1661,1663,N/A,42,2
7,N/A,N/A,N/A,1654,1661,N/A,46,6
1,N/A,N/A,N/A,1653,1654,N/A,52,0
5,N/A,N/A,N/A,1648,1653,N/A,57,5
2,N/A,N/A,N/A,1646,1648,N/A,61,3
2,N/A,N/A,N/A,1644,1646,N/A,65,1
6,N/A,N/A,N/A,1638,1644,N/A,70,6
3,N/A,N/A,N/A,1635,1638,N/A,73,3
1,N/A,N/A,N/A,1634,1635,N/A,77,1
4,N/A,N/A,N/A,1630,1634,N/A,80,4
2,N/A,N/A,N/A,1628,1630,N/A,83,1
6,N/A,N/A,N/A,1622,1628,N/A,88,6
1,N/A,N/A,N/A,1621,1622,N/A,94,0
2,N/A,N/A,N/A,1619,1621,N/A,97,3
3,N/A,N/A,N/A,1616,1619,N/A,102,2
1,N/A,N/A,N/A,1615,1616,N/A,107,1
1,N/A,N/A,N/A,1614,1615,N/A,113,1
6,N/A,N/A,N/A,1608,1614,N/A,118,6
3,N/A,N/A,N/A,1605,1608,N/A,122,4
2,N/A,N/A,N/A,1603,1605,N/A,125,1
2,N/A,N/A,N/A,1601,1603,N/A,131,1
6,N/A,N/A,N/A,1595,1601,N/A,136,6
3,N/A,N/A,N/A,1928,1931,N/A,4,3
1,N/A,N/A,N/A,1927,1928,N/A,8,1
2,N/A,N/A,N/A,1925,1927,N/A,14,1
6,N/A,N/A,N/A,1919,1925,N/A,19,6
1,N/A,N/A,N/A,1918,1919,N/A,25,0
3,N/A,N/A,N/A,1915,1918,N/A,29,4
1,N/A,N/A,N/A,1914,1915,N/A,32,1
6,N/A,N/A,N/A,1908,1914,N/A,36,5
5,N/A,N/A,N/A,1903,1908,N/A,42,5
3,N/A,N/A,N/A,1900,1903,N/A,47,4
3,N/A,N/A,N/A,1897,1900,N/A,53,4
3,N/A,N/A,N/A,1894,1897,N/A,57,2
2,N/A,N/A,N/A,1892,1894,N/A,63,2
5,N/A,N/A,N/A,1887,1892,N/A,66,5
3,N/A,N/A,N/A,1884,1887,N/A,69,2
6,N/A,N/A,N/A,1878,1884,N/A,72,5
2,N/A,N/A,N/A,1876,1878,N/A,76,3
7,N/A,N/A,N/A,1869,1876,N/A,79,6
1,N/A,N/A,N/A,1868,1869,N/A,85,0
4,N/A,N/A,N/A,1864,1868,N/A,89,4
3,N/A,N/A,N/A,1861,1864,N/A,93,2
7,N/A,N/A,N/A,1854,1861,N/A,97,6
3,N/A,N/A,N/A,1851,1854,N/A,101,4
4,N/A,N/A,N/A,1847,1851,N/A,107,4
2,N/A,N/A,N/A,1845,1847,N/A,111,2
6,N/A,N/A,N/A,1839,1845,N/A,114,5
5,N/A,N/A,N/A,1834,1839,N/A,120,5
4,N/A,N/A,N/A,1830,1834,N/A,125,4
1,N/A,N/A,N/A,1829,1830,N/A,128,1
4,N/A,N/A,N/A,1825,1829,N/A,131,4
7,N/A,N/A,N/A,1890,1897,N/A,4,6
4,N/A,N/A,N/A,1886,1890,N/A,8,4
3,N/A,N/A,N/A,1883,1886,N/A,14,4
2,N/A,N/A,N/A,1881,1883,N/A,17,1
3,N/A,N/A,N/A,1878,1881,N/A,20,4
1,N/A,N/A,N/A,1877,1878,N/A,23,1
3,N/A,N/A,N/A,1874,1877,N/A,26,4
1,N/A,N/A,N/A,1873,1874,N/A,29,1
6,N/A,N/A,N/A,1867,1873,N/A,33,5
6,N/A,N/A,N/A,1861,1867,N/A,39,5
3,N/A,N/A,N/A,1858,1861,N/A,42,2
6,N/A,N/A,N/A,1852,1858,N/A,46,6
2,N/A,N/A,N/A,1850,1852,N/A,52,0
6,N/A,N/A,N/A,1844,1850,N/A,57,5
3,N/A,N/A,N/A,1841,1844,N/A,61,3
1,N/A,N/A,N/A,1840,1841,N/A,65,1
7,N/A,N/A,N/A,1833,1840,N/A,70,6
4,N/A,N/A,N/A,1829,1833,N/A,74,4
1,N/A,N/A,N/A,1828,1829,N/A,77,1
6,N/A,N/A,N/A,1822,1828,N/A,81,5
6,N/A,N/A,N/A,1816,1822,N/A,87,5
3,N/A,N/A,N/A,1813,1816,N/A,90,2
6,N/A,N/A,N/A,1807,1813,N/A,94,6
2,N/A,N/A,N/A,1805,1807,N/A,100,0
2,N/A,N/A,N/A,1803,1805,N/A,103,3
7,N/A,N/A,N/A,1796,1803,N/A,106,6
1,N/A,N/A,N/A,1795,1796,N/A,112,0
6,N/A,N/A,N/A,1789,1795,N/A,117,5
6,N/A,N/A,N/A,1783,1789,N/A,123,5
3,N/A,N/A,N/A,1780,1783,N/A,127,3
2,N/A,N/A,N/A,1343,1345,N/A,4,2
3,N/A,N/A,N/A,1340,1343,N/A,10,2
3,N/A,N/A,N/A,1337,1340,N/A,16,2
6,N/A,N/A,N/A,1331,1337,N/A,20,6
6,N/A,N/A,N/A,1325,1331,N/A,25,5
2,N/A,N/A,N/A,1323,1325,N/A,29,3
7,N/A,N/A,N/A,1316,1323,N/A,32,6
3,N/A,N/A,N/A,1313,1316,N/A,35,3
3,N/A,N/A,N/A,1310,1313,N/A,41,3
7,N/A,N/A,N/A,1303,1310,N/A,44,6
3,N/A,N/A,N/A,1300,1303,N/A,48,4
4,N/A,N/A,N/A,1296,1300,N/A,54,4
3,N/A,N/A,N/A,1293,1296,N/A,58,2
2,N/A,N/A,N/A,1291,1293,N/A,64,2
1,N/A,N/A,N/A,1290,1291,N/A,69,1
6,N/A,N/A,N/A,1284,1290,N/A,74,6
5,N/A,N/A,N/A,1279,1284,N/A,79,5
3,N/A,N/A,N/A,1276,1279,N/A,84,4
1,N/A,N/A,N/A,1275,1276,N/A,87,1
4,N/A,N/A,N/A,1271,1275,N/A,90,4
1,N/A,N/A,N/A,1270,1271,N/A,93,1
4,N/A,N/A,N/A,1266,1270,N/A,96,4
2,N/A,N/A,N/A,1264,1266,N/A,99,1
1,N/A,N/A,N/A,1263,1264,N/A,105,1
1,N/A,N/A,N/A,1262,1263,N/A,111,1
1,N/A,N/A,N/A,1261,1262,N/A,117,1
5,N/A,N/A,N/A,1256,1261,N/A,121,5
5,N/A,N/A,N/A,1251,1256,N/A,127,5
4,N/A,N/A,N/A,1247,1251,N/A,132,4
1,N/A,N/A,N/A,1246,1247,N/A,135,1
3,N/A,N/A,N/A,1831,1834,N/A,4,3
2,N/A,N/A,N/A,1829,1831,N/A,9,2
5,N/A,N/A,N/A,1824,1829,N/A,12,5
4,N/A,N/A,N/A,1820,1824,N/A,17,4
4,N/A,N/A,N/A,1816,1820,N/A,23,4
2,N/A,N/A,N/A,1814,1816,N/A,27,2
5,N/A,N/A,N/A,1809,1814,N/A,30,5
3,N/A,N/A,N/A,1806,1809,N/A,34,3
3,N/A,N/A,N/A,1803,1806,N/A,39,2
6,N/A,N/A,N/A,1797,1803,N/A,42,5
4,N/A,N/A,N/A,1793,1797,N/A,47,4
1,N/A,N/A,N/A,1792,1793,N/A,50,1
7,N/A,N/A,N/A,1785,1792,N/A,55,6
2,N/A,N/A,N/A,1783,1785,N/A,61,0
3,N/A,N/A,N/A,1780,1783,N/A,65,4
1,N/A,N/A,N/A,1779,1780,N/A,68,1
6,N/A,N/A,N/A,1773,1779,N/A,72,5
3,N/A,N/A,N/A,1770,1773,N/A,77,4
2,N/A,N/A,N/A,1768,1770,N/A,81,2
6,N/A,N/A,N/A,1762,1768,N/A,84,5
3,N/A,N/A,N/A,1759,1762,N/A,89,4
1,N/A,N/A,N/A,1758,1759,N/A,92,1
4,N/A,N/A,N/A,1754,1758,N/A,95,4
2,N/A,N/A,N/A,1752,1754,N/A,100,3
6,N/A,N/A,N/A,1746,1752,N/A,103,6
1,N/A,N/A,N/A,1745,1746,N/A,109,0
4,N/A,N/A,N/A,1741,1745,N/A,113,4
2,N/A,N/A,N/A,1739,1741,N/A,116,1
6,N/A,N/A,N/A,1733,1739,N/A,120,5
5,N/A,N/A,N/A,1728,1733,N/A,126,5
6,N/A,N/A,N/A,1269,1275,N/A,6,6
3,N/A,N/A,N/A,1266,1269,N/A,10,4
4,N/A,N/A,N/A,1262,1266,N/A,16,4
3,N/A,N/A,N/A,1259,1262,N/A,20,2
6,N/A,N/A,N/A,1253,1259,N/A,23,5
5,N/A,N/A,N/A,1248,1253,N/A,29,5
5,N/A,N/A,N/A,1243,1248,N/A,35,5
6,N/A,N/A,N/A,1237,1243,N/A,41,5
2,N/A,N/A,N/A,1235,1237,N/A,45,3
3,N/A,N/A,N/A,1232,1235,N/A,50,2
7,N/A,N/A,N/A,1225,1232,N/A,54,6
4,N/A,N/A,N/A,1221,1225,N/A,58,4
2,N/A,N/A,N/A,1219,1221,N/A,63,3
2,N/A,N/A,N/A,1217,1219,N/A,67,1
2,N/A,N/A,N/A,1215,1217,N/A,73,1
3,N/A,N/A,N/A,1212,1215,N/A,76,4
3,N/A,N/A,N/A,1209,1212,N/A,80,2
1,N/A,N/A,N/A,1208,1209,N/A,85,1
6,N/A,N/A,N/A,1202,1208,N/A,90,6
3,N/A,N/A,N/A,1199,1202,N/A,93,3
2,N/A,N/A,N/A,1197,1199,N/A,97,1
1,N/A,N/A,N/A,1196,1197,N/A,103,1
1,N/A,N/A,N/A,1195,1196,N/A,109,1
4,N/A,N/A,N/A,1191,1195,N/A,112,4
2,N/A,N/A,N/A,1189,1191,N/A,115,1
7,N/A,N/A,N/A,1182,1189,N/A,120,6
2,N/A,N/A,N/A,1180,1182,N/A,123,3
2,N/A,N/A,N/A,1178,1180,N/A,127,1
5,N/A,N/A,N/A,1173,1178,N/A,131,5
5,N/A,N/A,N/A,1168,1173,N/A,137,5
3,N/A,N/A,N/A,1826,1829,N/A,6,4
3,N/A,N/A,N/A,1823,1826,N/A,11,3
1,N/A,N/A,N/A,1822,1823,N/A,15,1
3,N/A,N/A,N/A,1819,1822,N/A,18,4
2,N/A,N/A,N/A,1817,1819,N/A,21,1
4,N/A,N/A,N/A,1813,1817,N/A,24,4
2,N/A,N/A,N/A,1811,1813,N/A,27,1
7,N/A,N/A,N/A,1804,1811,N/A,32,6
2,N/A,N/A,N/A,1802,1804,N/A,38,0
7,N/A,N/A,N/A,1795,1802,N/A,44,6
6,N/A,N/A,N/A,1789,1795,N/A,49,5
2,N/A,N/A,N/A,1787,1789,N/A,53,3
2,N/A,N/A,N/A,1785,1787,N/A,57,1
1,N/A,N/A,N/A,1784,1785,N/A,63,1
6,N/A,N/A,N/A,1778,1784,N/A,68,6
6,N/A,N/A,N/A,1772,1778,N/A,73,5
4,N/A,N/A,N/A,1768,1772,N/A,78,4
2,N/A,N/A,N/A,1766,1768,N/A,83,3
7,N/A,N/A,N/A,1759,1766,N/A,86,6
2,N/A,N/A,N/A,1757,1759,N/A,89,3
1,N/A,N/A,N/A,1756,1757,N/A,93,1
7,N/A,N/A,N/A,1749,1756,N/A,98,6
1,N/A,N/A,N/A,1748,1749,N/A,104,0
3,N/A,N/A,N/A,1745,1748,N/A,107,3
3,N/A,N/A,N/A,1742,1745,N/A,113,3
2,N/A,N/A,N/A,1740,1742,N/A,118,2
1,N/A,N/A,N/A,1739,1740,N/A,123,1
6,N/A,N/A,N/A,1733,1739,N/A,127,5
5,N/A,N/A,N/A,1728,1733,N/A,133,5
4,N/A,N/A,N/A,1724,1728,N/A,138,4
6,N/A,N/A,N/A,521,527,N/A,3,5
3,N/A,N/A,N/A,518,521,N/A,6,2
5,N/A,N/A,N/A,513,518,N/A,9,5
3,N/A,N/A,N/A,510,513,N/A,14,4
2,N/A,N/A,N/A,508,510,N/A,19,3
6,N/A,N/A,N/A,502,508,N/A,22,6
5,N/A,N/A,N/A,497,502,N/A,27,5
2,N/A,N/A,N/A,495,497,N/A,30,2
5,N/A,N/A,N/A,490,495,N/A,33,5
5,N/A,N/A,N/A,485,490,N/A,39,5
4,N/A,N/A,N/A,481,485,N/A,44,4
3,N/A,N/A,N/A,478,481,N/A,48,2
2,N/A,N/A,N/A,476,478,N/A,53,1
7,N/A,N/A,N/A,469,476,N/A,58,6
2,N/A,N/A,N/A,467,469,N/A,61,3
3,N/A,N/A,N/A,464,467,N/A,66,2
3,N/A,N/A,N/A,461,464,N/A,72,2
5,N/A,N/A,N/A,456,461,N/A,75,5
6,N/A,N/A,N/A,450,456,N/A,81,5
3,N/A,N/A,N/A,447,450,N/A,85,3
2,N/A,N/A,N/A,445,447,N/A,91,3
3,N/A,N/A,N/A,442,445,N/A,97,3
3,N/A,N/A,N/A,439,442,N/A,103,3
3,N/A,N/A,N/A,436,439,N/A,108,2
2,N/A,N/A,N/A,434,436,N/A,114,2
2,N/A,N/A,N/A,432,434,N/A,119,1
1,N/A,N/A,N/A,431,432,N/A,125,1
5,N/A,N/A,N/A,426,431,N/A,129,5
2,N/A,N/A,N/A,424,426,N/A,133,3
3,N/A,N/A,N/A,421,424,N/A,139,3
5,N/A,N/A,N/A,1263,1268,N/A,6,5
6,N/A,N/A,N/A,1257,1263,N/A,12,5
5,N/A,N/A,N/A,1252,1257,N/A,18,5
3,N/A,N/A,N/A,1249,1252,N/A,21,2
5,N/A,N/A,N/A,1244,1249,N/A,24,5
5,N/A,N/A,N/A,1239,1244,N/A,30,5
4,N/A,N/A,N/A,1235,1239,N/A,35,4
3,N/A,N/A,N/A,1232,1235,N/A,39,2
5,N/A,N/A,N/A,1227,1232,N/A,42,5
3,N/A,N/A,N/A,1224,1227,N/A,47,4
4,N/A,N/A,N/A,1220,1224,N/A,53,4
2,N/A,N/A,N/A,1218,1220,N/A,58,3
1,N/A,N/A,N/A,1217,1218,N/A,62,1
4,N/A,N/A,N/A,1213,1217,N/A,65,4
1,N/A,N/A,N/A,1212,1213,N/A,68,1
5,N/A,N/A,N/A,1207,1212,N/A,72,5
5,N/A,N/A,N/A,1202,1207,N/A,78,5
2,N/A,N/A,N/A,1200,1202,N/A,82,3
1,N/A,N/A,N/A,1199,1200,N/A,86,1
6,N/A,N/A,N/A,1193,1199,N/A,90,5
4,N/A,N/A,N/A,1189,1193,N/A,95,4
4,N/A,N/A,N/A,1185,1189,N/A,101,4
4,N/A,N/A,N/A,1181,1185,N/A,107,4
2,N/A,N/A,N/A,1179,1181,N/A,110,1
3,N/A,N/A,N/A,1176,1179,N/A,113,4
4,N/A,N/A,N/A,1172,1176,N/A,119,4
3,N/A,N/A,N/A,1169,1172,N/A,123,2
2,N/A,N/A,N/A,1167,1169,N/A,129,2
5,N/A,N/A,N/A,1162,1167,N/A,132,5
3,N/A,N/A,N/A,1159,1162,N/A,137,4
3,N/A,N/A,N/A,1211,1214,N/A,3,3
6,N/A,N/A,N/A,1205,1211,N/A,6,6
2,N/A,N/A,N/A,1203,1205,N/A,12,0
7,N/A,N/A,N/A,1196,1203,N/A,18,6
3,N/A,N/A,N/A,1193,1196,N/A,21,3
2,N/A,N/A,N/A,1191,1193,N/A,25,1
3,N/A,N/A,N/A,1188,1191,N/A,28,4
2,N/A,N/A,N/A,1186,1188,N/A,32,2
6,N/A,N/A,N/A,1180,1186,N/A,36,6
3,N/A,N/A,N/A,1177,1180,N/A,39,3
6,N/A,N/A,N/A,1171,1177,N/A,42,6
6,N/A,N/A,N/A,1165,1171,N/A,47,5
3,N/A,N/A,N/A,1162,1165,N/A,51,3
6,N/A,N/A,N/A,1156,1162,N/A,54,6
3,N/A,N/A,N/A,1153,1156,N/A,57,3
6,N/A,N/A,N/A,1147,1153,N/A,60,6
5,N/A,N/A,N/A,1142,1147,N/A,65,5
6,N/A,N/A,N/A,1136,1142,N/A,71,5
5,N/A,N/A,N/A,1131,1136,N/A,77,5
3,N/A,N/A,N/A,1128,1131,N/A,80,2
6,N/A,N/A,N/A,1122,1128,N/A,83,5
3,N/A,N/A,N/A,1119,1122,N/A,86,2
7,N/A,N/A,N/A,1112,1119,N/A,90,6
1,N/A,N/A,N/A,1111,1112,N/A,96,0
6,N/A,N/A,N/A,1105,1111,N/A,102,6
5,N/A,N/A,N/A,1100,1105,N/A,107,5
4,N/A,N/A,N/A,1096,1100,N/A,112,4
2,N/A,N/A,N/A,1094,1096,N/A,117,3
2,N/A,N/A,N/A,1092,1094,N/A,122,2
3,N/A,N/A,N/A,1089,1092,N/A,128,2
6,N/A,N/A,N/A,697,703,N/A,3,6
1,N/A,N/A,N/A,696,697,N/A,9,0
2,N/A,N/A,N/A,694,696,N/A,12,3
2,N/A,N/A,N/A,692,694,N/A,18,3
3,N/A,N/A,N/A,689,692,N/A,23,2
6,N/A,N/A,N/A,683,689,N/A,27,6
2,N/A,N/A,N/A,681,683,N/A,33,0
3,N/A,N/A,N/A,678,681,N/A,36,3
6,N/A,N/A,N/A,672,678,N/A,39,6
2,N/A,N/A,N/A,670,672,N/A,42,3
2,N/A,N/A,N/A,668,670,N/A,46,1
6,N/A,N/A,N/A,662,668,N/A,50,5
6,N/A,N/A,N/A,656,662,N/A,56,5
6,N/A,N/A,N/A,650,656,N/A,62,5
3,N/A,N/A,N/A,647,650,N/A,65,2
7,N/A,N/A,N/A,640,647,N/A,69,6
2,N/A,N/A,N/A,638,640,N/A,75,0
3,N/A,N/A,N/A,635,638,N/A,78,3
2,N/A,N/A,N/A,633,635,N/A,82,1
5,N/A,N/A,N/A,628,633,N/A,86,5
3,N/A,N/A,N/A,625,628,N/A,91,4
3,N/A,N/A,N/A,622,625,N/A,96,3
3,N/A,N/A,N/A,619,622,N/A,102,3
1,N/A,N/A,N/A,618,619,N/A,106,1
6,N/A,N/A,N/A,612,618,N/A,110,5
3,N/A,N/A,N/A,609,612,N/A,114,3
3,N/A,N/A,N/A,606,609,N/A,119,2
6,N/A,N/A,N/A,600,606,N/A,122,5
6,N/A,N/A,N/A,594,600,N/A,128,5
3,N/A,N/A,N/A,591,594,N/A,132,3
6,N/A,N/A,N/A,1270,1276,N/A,6,5
4,N/A,N/A,N/A,1266,1270,N/A,11,4
2,N/A,N/A,N/A,1264,1266,N/A,14,1
6,N/A,N/A,N/A,1258,1264,N/A,19,6
3,N/A,N/A,N/A,1255,1258,N/A,23,4
3,N/A,N/A,N/A,1252,1255,N/A,28,3
2,N/A,N/A,N/A,1250,1252,N/A,34,3
2,N/A,N/A,N/A,1248,1250,N/A,40,3
6,N/A,N/A,N/A,1242,1248,N/A,43,6
2,N/A,N/A,N/A,1240,1242,N/A,46,3
2,N/A,N/A,N/A,1238,1240,N/A,50,1
1,N/A,N/A,N/A,1237,1238,N/A,56,1
4,N/A,N/A,N/A,1233,1237,N/A,59,4
1,N/A,N/A,N/A,1232,1233,N/A,62,1
5,N/A,N/A,N/A,1227,1232,N/A,66,5
5,N/A,N/A,N/A,1222,1227,N/A,72,5
5,N/A,N/A,N/A,1217,1222,N/A,78,5
2,N/A,N/A,N/A,1215,1217,N/A,81,2
2,N/A,N/A,N/A,1213,1215,N/A,86,1
5,N/A,N/A,N/A,1208,1213,N/A,90,5
2,N/A,N/A,N/A,1206,1208,N/A,93,2
7,N/A,N/A,N/A,1199,1206,N/A,97,6
1,N/A,N/A,N/A,1198,1199,N/A,103,0
3,N/A,N/A,N/A,1195,1198,N/A,107,4
3,N/A,N/A,N/A,1192,1195,N/A,111,2
2,N/A,N/A,N/A,1190,1192,N/A,117,2
6,N/A,N/A,N/A,1184,1190,N/A,121,6
5,N/A,N/A,N/A,1179,1184,N/A,126,5
5,N/A,N/A,N/A,1174,1179,N/A,132,5
4,N/A,N/A,N/A,1170,1174,N/A,137,4
2,N/A,N/A,N/A,1337,1339,N/A,3,2
7,N/A,N/A,N/A,1330,1337,N/A,7,6
5,N/A,N/A,N/A,1325,1330,N/A,12,5
3,N/A,N/A,N/A,1322,1325,N/A,15,2
5,N/A,N/A,N/A,1317,1322,N/A,18,5
3,N/A,N/A,N/A,1314,1317,N/A,23,4
2,N/A,N/A,N/A,1312,1314,N/A,27,2
3,N/A,N/A,N/A,1309,1312,N/A,33,2
3,N/A,N/A,N/A,1306,1309,N/A,39,2
5,N/A,N/A,N/A,1301,1306,N/A,42,5
4,N/A,N/A,N/A,1297,1301,N/A,47,4
3,N/A,N/A,N/A,1294,1297,N/A,51,2
5,N/A,N/A,N/A,1289,1294,N/A,54,5
3,N/A,N/A,N/A,1286,1289,N/A,59,4
2,N/A,N/A,N/A,1284,1286,N/A,64,3
3,N/A,N/A,N/A,1281,1284,N/A,69,2
1,N/A,N/A,N/A,1280,1281,N/A,74,1
4,N/A,N/A,N/A,1276,1280,N/A,77,4
2,N/A,N/A,N/A,1274,1276,N/A,81,2
7,N/A,N/A,N/A,1267,1274,N/A,85,6
5,N/A,N/A,N/A,1262,1267,N/A,90,5
5,N/A,N/A,N/A,1257,1262,N/A,96,5
2,N/A,N/A,N/A,1255,1257,N/A,100,3
7,N/A,N/A,N/A,1248,1255,N/A,103,6
2,N/A,N/A,N/A,1246,1248,N/A,106,3
6,N/A,N/A,N/A,1240,1246,N/A,109,6
2,N/A,N/A,N/A,1238,1240,N/A,115,0
5,N/A,N/A,N/A,1233,1238,N/A,120,5
2,N/A,N/A,N/A,1231,1233,N/A,123,2
2,N/A,N/A,N/A,1229,1231,N/A,128,1
7,N/A,N/A,N/A,350,357,N/A,4,6
2,N/A,N/A,N/A,348,350,N/A,7,3
6,N/A,N/A,N/A,342,348,N/A,10,6
3,N/A,N/A,N/A,339,342,N/A,14,4
3,N/A,N/A,N/A,336,339,N/A,19,3
7,N/A,N/A,N/A,329,336,N/A,22,6
2,N/A,N/A,N/A,327,329,N/A,25,3
2,N/A,N/A,N/A,325,327,N/A,29,1
3,N/A,N/A,N/A,322,325,N/A,32,4
1,N/A,N/A,N/A,321,322,N/A,35,1
6,N/A,N/A,N/A,315,321,N/A,39,5
3,N/A,N/A,N/A,312,315,N/A,44,4
3,N/A,N/A,N/A,309,312,N/A,49,3
6,N/A,N/A,N/A,303,309,N/A,52,6
6,N/A,N/A,N/A,297,303,N/A,57,5
3,N/A,N/A,N/A,294,297,N/A,61,3
7,N/A,N/A,N/A,287,294,N/A,64,6
2,N/A,N/A,N/A,285,287,N/A,70,0
3,N/A,N/A,N/A,282,285,N/A,73,3
2,N/A,N/A,N/A,280,282,N/A,77,1
1,N/A,N/A,N/A,279,280,N/A,83,1
4,N/A,N/A,N/A,275,279,N/A,86,4
3,N/A,N/A,N/A,272,275,N/A,92,4
3,N/A,N/A,N/A,269,272,N/A,98,4
3,N/A,N/A,N/A,266,269,N/A,102,2
1,N/A,N/A,N/A,265,266,N/A,107,1
7,N/A,N/A,N/A,258,265,N/A,112,6
1,N/A,N/A,N/A,257,258,N/A,118,0
3,N/A,N/A,N/A,254,257,N/A,122,4
3,N/A,N/A,N/A,251,254,N/A,127,3
2,N/A,N/A,N/A,1796,1798,N/A,3,2
2,N/A,N/A,N/A,1794,1796,N/A,9,2
6,N/A,N/A,N/A,1788,1794,N/A,13,6
2,N/A,N/A,N/A,1786,1788,N/A,16,3
3,N/A,N/A,N/A,1783,1786,N/A,22,3
2,N/A,N/A,N/A,1781,1783,N/A,26,1
1,N/A,N/A,N/A,1780,1781,N/A,32,1
4,N/A,N/A,N/A,1776,1780,N/A,35,4
3,N/A,N/A,N/A,1773,1776,N/A,41,4
2,N/A,N/A,N/A,1771,1773,N/A,44,1
2,N/A,N/A,N/A,1769,1771,N/A,50,1
7,N/A,N/A,N/A,1762,1769,N/A,55,6
2,N/A,N/A,N/A,1760,1762,N/A,61,0
6,N/A,N/A,N/A,1754,1760,N/A,67,6
2,N/A,N/A,N/A,1752,1754,N/A,73,0
5,N/A,N/A,N/A,1747,1752,N/A,78,5
4,N/A,N/A,N/A,1743,1747,N/A,83,4
3,N/A,N/A,N/A,1740,1743,N/A,88,3
1,N/A,N/A,N/A,1739,1740,N/A,92,1
7,N/A,N/A,N/A,1732,1739,N/A,97,6
3,N/A,N/A,N/A,1729,1732,N/A,101,4
1,N/A,N/A,N/A,1728,1729,N/A,104,1
6,N/A,N/A,N/A,1722,1728,N/A,109,6
4,N/A,N/A,N/A,1718,1722,N/A,113,4
2,N/A,N/A,N/A,1716,1718,N/A,116,1
4,N/A,N/A,N/A,1712,1716,N/A,119,4
3,N/A,N/A,N/A,1709,1712,N/A,124,3
7,N/A,N/A,N/A,1702,1709,N/A,127,6
5,N/A,N/A,N/A,1697,1702,N/A,132,5
5,N/A,N/A,N/A,1692,1697,N/A,138,5
1,N/A,N/A,N/A,1846,1847,N/A,5,1
6,N/A,N/A,N/A,1840,1846,N/A,9,5
4,N/A,N/A,N/A,1836,1840,N/A,14,4
3,N/A,N/A,N/A,1833,1836,N/A,18,2
3,N/A,N/A,N/A,1830,1833,N/A,24,2
3,N/A,N/A,N/A,1827,1830,N/A,30,2
3,N/A,N/A,N/A,1824,1827,N/A,36,2
6,N/A,N/A,N/A,1818,1824,N/A,40,6
1,N/A,N/A,N/A,1817,1818,N/A,46,0
7,N/A,N/A,N/A,1810,1817,N/A,52,6
2,N/A,N/A,N/A,1808,1810,N/A,58,0
3,N/A,N/A,N/A,1805,1808,N/A,62,4
2,N/A,N/A,N/A,1803,1805,N/A,66,2
3,N/A,N/A,N/A,1800,1803,N/A,72,2
2,N/A,N/A,N/A,1798,1800,N/A,77,1
1,N/A,N/A,N/A,1797,1798,N/A,83,1
2,N/A,N/A,N/A,1795,1797,N/A,89,1
4,N/A,N/A,N/A,1791,1795,N/A,92,4
4,N/A,N/A,N/A,1787,1791,N/A,98,4
3,N/A,N/A,N/A,1784,1787,N/A,104,4
4,N/A,N/A,N/A,1780,1784,N/A,110,4
3,N/A,N/A,N/A,1777,1780,N/A,115,3
7,N/A,N/A,N/A,1770,1777,N/A,118,6
4,N/A,N/A,N/A,1766,1770,N/A,122,4
4,N/A,N/A,N/A,1762,1766,N/A,128,4
3,N/A,N/A,N/A,1759,1762,N/A,132,2
2,N/A,N/A,N/A,1757,1759,N/A,138,2
1,N/A,N/A,N/A,1756,1757,N/A,143,1
3,N/A,N/A,N/A,1753,1756,N/A,146,4
2,N/A,N/A,N/A,1751,1753,N/A,151,3
2,N/A,N/A,N/A,512,514,N/A,3,3
7,N/A,N/A,N/A,505,512,N/A,6,6
6,N/A,N/A,N/A,499,505,N/A,11,5
3,N/A,N/A,N/A,496,499,N/A,14,2
2,N/A,N/A,N/A,494,496,N/A,19,1
4,N/A,N/A,N/A,490,494,N/A,22,4
1,N/A,N/A,N/A,489,490,N/A,25,1
6,N/A,N/A,N/A,483,489,N/A,30,6
1,N/A,N/A,N/A,482,483,N/A,36,0
6,N/A,N/A,N/A,476,482,N/A,41,5
3,N/A,N/A,N/A,473,476,N/A,45,3
2,N/A,N/A,N/A,471,473,N/A,51,3
2,N/A,N/A,N/A,469,471,N/A,55,1
6,N/A,N/A,N/A,463,469,N/A,60,6
2,N/A,N/A,N/A,461,463,N/A,66,0
3,N/A,N/A,N/A,458,461,N/A,69,3
6,N/A,N/A,N/A,452,458,N/A,72,6
3,N/A,N/A,N/A,449,452,N/A,76,4
3,N/A,N/A,N/A,446,449,N/A,80,2
2,N/A,N/A,N/A,444,446,N/A,85,1
3,N/A,N/A,N/A,441,444,N/A,88,4
1,N/A,N/A,N/A,440,441,N/A,91,1
3,N/A,N/A,N/A,437,440,N/A,94,4
2,N/A,N/A,N/A,435,437,N/A,97,1
3,N/A,N/A,N/A,432,435,N/A,100,4
2,N/A,N/A,N/A,430,432,N/A,103,1
5,N/A,N/A,N/A,425,430,N/A,107,5
2,N/A,N/A,N/A,423,425,N/A,110,2
7,N/A,N/A,N/A,416,423,N/A,114,6
6,N/A,N/A,N/A,410,416,N/A,119,5
6,N/A,N/A,N/A,1704,1710,N/A,4,6
6,N/A,N/A,N/A,1698,1704,N/A,9,5
3,N/A,N/A,N/A,1695,1698,N/A,12,2
6,N/A,N/A,N/A,1689,1695,N/A,15,5
2,N/A,N/A,N/A,1687,1689,N/A,18,2
2,N/A,N/A,N/A,1685,1687,N/A,24,2
6,N/A,N/A,N/A,1679,1685,N/A,27,5
5,N/A,N/A,N/A,1674,1679,N/A,33,5
5,N/A,N/A,N/A,1669,1674,N/A,39,5
3,N/A,N/A,N/A,1666,1669,N/A,44,4
1,N/A,N/A,N/A,1665,1666,N/A,47,1
6,N/A,N/A,N/A,1659,1665,N/A,52,6
3,N/A,N/A,N/A,1656,1659,N/A,55,3
1,N/A,N/A,N/A,1655,1656,N/A,59,1
1,N/A,N/A,N/A,1654,1655,N/A,65,1
3,N/A,N/A,N/A,1651,1654,N/A,68,4
3,N/A,N/A,N/A,1648,1651,N/A,72,2
7,N/A,N/A,N/A,1641,1648,N/A,76,6
3,N/A,N/A,N/A,1638,1641,N/A,79,3
7,N/A,N/A,N/A,1631,1638,N/A,82,6
1,N/A,N/A,N/A,1630,1631,N/A,88,0
3,N/A,N/A,N/A,1627,1630,N/A,92,4
1,N/A,N/A,N/A,1626,1627,N/A,95,1
6,N/A,N/A,N/A,1620,1626,N/A,100,6
2,N/A,N/A,N/A,1618,1620,N/A,103,3
3,N/A,N/A,N/A,1615,1618,N/A,108,2
3,N/A,N/A,N/A,1612,1615,N/A,114,2
6,N/A,N/A,N/A,1606,1612,N/A,118,6
2,N/A,N/A,N/A,1604,1606,N/A,121,3
2,N/A,N/A,N/A,1602,1604,N/A,126,2
3,N/A,N/A,N/A,1604,1607,N/A,5,4
3,N/A,N/A,N/A,1601,1604,N/A,10,3
2,N/A,N/A,N/A,1599,1601,N/A,14,1
2,N/A,N/A,N/A,1597,1599,N/A,20,1
6,N/A,N/A,N/A,1591,1597,N/A,24,5
3,N/A,N/A,N/A,1588,1591,N/A,29,4
3,N/A,N/A,N/A,1585,1588,N/A,33,2
2,N/A,N/A,N/A,1583,1585,N/A,38,1
4,N/A,N/A,N/A,1579,1583,N/A,41,4
3,N/A,N/A,N/A,1576,1579,N/A,47,4
2,N/A,N/A,N/A,1574,1576,N/A,51,2
6,N/A,N/A,N/A,1568,1574,N/A,55,6
3,N/A,N/A,N/A,1565,1568,N/A,58,3
2,N/A,N/A,N/A,1563,1565,N/A,63,2
7,N/A,N/A,N/A,1556,1563,N/A,67,6
2,N/A,N/A,N/A,1554,1556,N/A,70,3
2,N/A,N/A,N/A,1552,1554,N/A,76,3
3,N/A,N/A,N/A,1549,1552,N/A,82,3
2,N/A,N/A,N/A,1547,1549,N/A,88,3
6,N/A,N/A,N/A,1541,1547,N/A,91,6
4,N/A,N/A,N/A,1537,1541,N/A,95,4
3,N/A,N/A,N/A,1534,1537,N/A,100,3
3,N/A,N/A,N/A,1531,1534,N/A,105,2
5,N/A,N/A,N/A,1526,1531,N/A,108,5
3,N/A,N/A,N/A,1523,1526,N/A,111,2
6,N/A,N/A,N/A,1517,1523,N/A,114,5
2,N/A,N/A,N/A,1515,1517,N/A,118,3
6,N/A,N/A,N/A,1509,1515,N/A,121,6
3,N/A,N/A,N/A,1506,1509,N/A,124,3
7,N/A,N/A,N/A,1499,1506,N/A,127,6
6,N/A,N/A,N/A,1458,1464,N/A,5,6
3,N/A,N/A,N/A,1455,1458,N/A,9,4
3,N/A,N/A,N/A,1452,1455,N/A,14,3
6,N/A,N/A,N/A,1446,1452,N/A,17,6
3,N/A,N/A,N/A,1443,1446,N/A,20,3
6,N/A,N/A,N/A,1437,1443,N/A,23,6
3,N/A,N/A,N/A,1434,1437,N/A,27,4
4,N/A,N/A,N/A,1430,1434,N/A,33,4
3,N/A,N/A,N/A,1427,1430,N/A,38,3
3,N/A,N/A,N/A,1424,1427,N/A,44,3
2,N/A,N/A,N/A,1422,1424,N/A,48,1
3,N/A,N/A,N/A,1419,1422,N/A,51,4
3,N/A,N/A,N/A,1416,1419,N/A,55,2
7,N/A,N/A,N/A,1409,1416,N/A,59,6
3,N/A,N/A,N/A,1406,1409,N/A,62,3
2,N/A,N/A,N/A,1404,1406,N/A,67,2
6,N/A,N/A,N/A,1398,1404,N/A,70,5
2,N/A,N/A,N/A,1396,1398,N/A,73,2
2,N/A,N/A,N/A,1394,1396,N/A,78,1
1,N/A,N/A,N/A,1393,1394,N/A,84,1
3,N/A,N/A,N/A,1390,1393,N/A,87,4
2,N/A,N/A,N/A,1388,1390,N/A,91,2
6,N/A,N/A,N/A,1382,1388,N/A,95,6
2,N/A,N/A,N/A,1380,1382,N/A,98,3
2,N/A,N/A,N/A,1378,1380,N/A,104,3
1,N/A,N/A,N/A,1377,1378,N/A,108,1
6,N/A,N/A,N/A,1371,1377,N/A,112,5
6,N/A,N/A,N/A,1365,1371,N/A,118,5
2,N/A,N/A,N/A,1363,1365,N/A,122,3
7,N/A,N/A,N/A,1356,1363,N/A,125,6
2,N/A,N/A,N/A,504,506,N/A,5,2
6,N/A,N/A,N/A,498,504,N/A,8,5
5,N/A,N/A,N/A,493,498,N/A,14,5
3,N/A,N/A,N/A,490,493,N/A,19,4
3,N/A,N/A,N/A,487,490,N/A,24,3
2,N/A,N/A,N/A,485,487,N/A,30,3
1,N/A,N/A,N/A,484,485,N/A,34,1
5,N/A,N/A,N/A,479,484,N/A,38,5
3,N/A,N/A,N/A,476,479,N/A,43,4
2,N/A,N/A,N/A,474,476,N/A,47,2
3,N/A,N/A,N/A,471,474,N/A,53,2
3,N/A,N/A,N/A,468,471,N/A,59,2
6,N/A,N/A,N/A,462,468,N/A,62,5
3,N/A,N/A,N/A,459,462,N/A,65,2
1,N/A,N/A,N/A,458,459,N/A,70,1
7,N/A,N/A,N/A,451,458,N/A,75,6
6,N/A,N/A,N/A,445,451,N/A,80,5
5,N/A,N/A,N/A,440,445,N/A,86,5
4,N/A,N/A,N/A,436,440,N/A,91,4
1,N/A,N/A,N/A,435,436,N/A,94,1
6,N/A,N/A,N/A,429,435,N/A,99,6
3,N/A,N/A,N/A,426,429,N/A,103,4
3,N/A,N/A,N/A,423,426,N/A,107,2
2,N/A,N/A,N/A,421,423,N/A,113,2
2,N/A,N/A,N/A,419,421,N/A,119,2
2,N/A,N/A,N/A,417,419,N/A,124,1
1,N/A,N/A,N/A,416,417,N/A,130,1
6,N/A,N/A,N/A,410,416,N/A,135,6
3,N/A,N/A,N/A,407,410,N/A,139,4
2,N/A,N/A,N/A,405,407,N/A,142,1
1,N/A,N/A,N/A,1248,1249,N/A,4,1
7,N/A,N/A,N/A,1241,1248,N/A,9,6
6,N/A,N/A,N/A,1235,1241,N/A,14,5
3,N/A,N/A,N/A,1232,1235,N/A,19,4
3,N/A,N/A,N/A,1229,1232,N/A,24,3
1,N/A,N/A,N/A,1228,1229,N/A,28,1
2,N/A,N/A,N/A,1226,1228,N/A,34,1
5,N/A,N/A,N/A,1221,1226,N/A,38,5
5,N/A,N/A,N/A,1216,1221,N/A,44,5
2,N/A,N/A,N/A,1214,1216,N/A,48,3
6,N/A,N/A,N/A,1208,1214,N/A,51,6
5,N/A,N/A,N/A,1203,1208,N/A,56,5
3,N/A,N/A,N/A,1200,1203,N/A,59,2
1,N/A,N/A,N/A,1199,1200,N/A,64,1
1,N/A,N/A,N/A,1198,1199,N/A,70,1
1,N/A,N/A,N/A,1197,1198,N/A,76,1
3,N/A,N/A,N/A,1194,1197,N/A,79,4
2,N/A,N/A,N/A,1192,1194,N/A,83,2
6,N/A,N/A,N/A,1186,1192,N/A,87,6
2,N/A,N/A,N/A,1184,1186,N/A,90,3
6,N/A,N/A,N/A,1178,1184,N/A,93,6
2,N/A,N/A,N/A,1176,1178,N/A,99,0
6,N/A,N/A,N/A,1170,1176,N/A,105,6
3,N/A,N/A,N/A,1167,1170,N/A,109,4
2,N/A,N/A,N/A,1165,1167,N/A,112,1
6,N/A,N/A,N/A,1159,1165,N/A,116,5
4,N/A,N/A,N/A,1155,1159,N/A,121,4
2,N/A,N/A,N/A,1153,1155,N/A,126,3
3,N/A,N/A,N/A,1150,1153,N/A,131,2
6,N/A,N/A,N/A,1144,1150,N/A,134,5
2,N/A,N/A,N/A,1242,1244,N/A,6,2
6,N/A,N/A,N/A,1236,1242,N/A,10,6
1,N/A,N/A,N/A,1235,1236,N/A,16,0
3,N/A,N/A,N/A,1232,1235,N/A,19,3
2,N/A,N/A,N/A,1230,1232,N/A,23,1
6,N/A,N/A,N/A,1224,1230,N/A,27,5
3,N/A,N/A,N/A,1221,1224,N/A,31,3
3,N/A,N/A,N/A,1218,1221,N/A,36,2
2,N/A,N/A,N/A,1216,1218,N/A,42,2
7,N/A,N/A,N/A,1209,1216,N/A,46,6
3,N/A,N/A,N/A,1206,1209,N/A,50,4
2,N/A,N/A,N/A,1204,1206,N/A,54,2
3,N/A,N/A,N/A,1201,1204,N/A,60,2
1,N/A,N/A,N/A,1200,1201,N/A,65,1
6,N/A,N/A,N/A,1194,1200,N/A,70,6
1,N/A,N/A,N/A,1193,1194,N/A,76,0
2,N/A,N/A,N/A,1191,1193,N/A,79,3
7,N/A,N/A,N/A,1184,1191,N/A,82,6
1,N/A,N/A,N/A,1183,1184,N/A,88,0
3,N/A,N/A,N/A,1180,1183,N/A,92,4
1,N/A,N/A,N/A,1179,1180,N/A,95,1
1,N/A,N/A,N/A,1178,1179,N/A,101,1
7,N/A,N/A,N/A,1171,1178,N/A,106,6
2,N/A,N/A,N/A,1169,1171,N/A,112,0
6,N/A,N/A,N/A,1163,1169,N/A,118,6
3,N/A,N/A,N/A,1160,1163,N/A,122,4
3,N/A,N/A,N/A,1157,1160,N/A,126,2
2,N/A,N/A,N/A,1155,1157,N/A,131,1
2,N/A,N/A,N/A,1153,1155,N/A,137,1
3,N/A,N/A,N/A,1150,1153,N/A,140,4
7,N/A,N/A,N/A,606,613,N/A,5,6
2,N/A,N/A,N/A,604,606,N/A,11,0
3,N/A,N/A,N/A,601,604,N/A,15,4
1,N/A,N/A,N/A,600,601,N/A,18,1
6,N/A,N/A,N/A,594,600,N/A,22,5
3,N/A,N/A,N/A,591,594,N/A,27,4
2,N/A,N/A,N/A,589,591,N/A,30,1
6,N/A,N/A,N/A,583,589,N/A,34,5
6,N/A,N/A,N/A,577,583,N/A,40,5
3,N/A,N/A,N/A,574,577,N/A,43,2
3,N/A,N/A,N/A,571,574,N/A,49,2
6,N/A,N/A,N/A,565,571,N/A,52,5
3,N/A,N/A,N/A,562,565,N/A,55,2
1,N/A,N/A,N/A,561,562,N/A,60,1
2,N/A,N/A,N/A,559,561,N/A,66,1
4,N/A,N/A,N/A,555,559,N/A,69,4
3,N/A,N/A,N/A,552,555,N/A,74,3
7,N/A,N/A,N/A,545,552,N/A,77,6
1,N/A,N/A,N/A,544,545,N/A,83,0
5,N/A,N/A,N/A,539,544,N/A,88,5
2,N/A,N/A,N/A,537,539,N/A,92,3
2,N/A,N/A,N/A,535,537,N/A,98,3
1,N/A,N/A,N/A,534,535,N/A,102,1
7,N/A,N/A,N/A,527,534,N/A,107,6
2,N/A,N/A,N/A,525,527,N/A,110,3
3,N/A,N/A,N/A,522,525,N/A,115,2
7,N/A,N/A,N/A,515,522,N/A,119,6
4,N/A,N/A,N/A,511,515,N/A,123,4
3,N/A,N/A,N/A,508,511,N/A,129,4
2,N/A,N/A,N/A,506,508,N/A,132,1
4,N/A,N/A,N/A,709,713,N/A,4,4
2,N/A,N/A,N/A,707,709,N/A,9,3
2,N/A,N/A,N/A,705,707,N/A,14,2
7,N/A,N/A,N/A,698,705,N/A,18,6
2,N/A,N/A,N/A,696,698,N/A,21,3
2,N/A,N/A,N/A,694,696,N/A,27,3
2,N/A,N/A,N/A,692,694,N/A,31,1
4,N/A,N/A,N/A,688,692,N/A,34,4
3,N/A,N/A,N/A,685,688,N/A,40,4
3,N/A,N/A,N/A,682,685,N/A,46,4
2,N/A,N/A,N/A,680,682,N/A,49,1
6,N/A,N/A,N/A,674,680,N/A,53,5
5,N/A,N/A,N/A,669,674,N/A,59,5
4,N/A,N/A,N/A,665,669,N/A,64,4
2,N/A,N/A,N/A,663,665,N/A,67,1
4,N/A,N/A,N/A,659,663,N/A,70,4
2,N/A,N/A,N/A,657,659,N/A,74,2
2,N/A,N/A,N/A,655,657,N/A,79,1
2,N/A,N/A,N/A,653,655,N/A,85,1
5,N/A,N/A,N/A,648,653,N/A,89,5
3,N/A,N/A,N/A,645,648,N/A,94,4
3,N/A,N/A,N/A,642,645,N/A,98,2
5,N/A,N/A,N/A,637,642,N/A,101,5
2,N/A,N/A,N/A,635,637,N/A,105,3
1,N/A,N/A,N/A,634,635,N/A,109,1
1,N/A,N/A,N/A,633,634,N/A,115,1
2,N/A,N/A,N/A,631,633,N/A,121,1
1,N/A,N/A,N/A,630,631,N/A,127,1
6,N/A,N/A,N/A,624,630,N/A,132,6
3,N/A,N/A,N/A,621,624,N/A,135,3
2,N/A,N/A,N/A,514,516,N/A,4,3
6,N/A,N/A,N/A,508,514,N/A,7,6
1,N/A,N/A,N/A,507,508,N/A,13,0
7,N/A,N/A,N/A,500,507,N/A,19,6
3,N/A,N/A,N/A,497,500,N/A,23,4
3,N/A,N/A,N/A,494,497,N/A,27,2
7,N/A,N/A,N/A,487,494,N/A,31,6
5,N/A,N/A,N/A,482,487,N/A,36,5
2,N/A,N/A,N/A,480,482,N/A,39,2
2,N/A,N/A,N/A,478,480,N/A,45,2
3,N/A,N/A,N/A,475,478,N/A,51,2
6,N/A,N/A,N/A,469,475,N/A,54,5
3,N/A,N/A,N/A,466,469,N/A,59,4
3,N/A,N/A,N/A,463,466,N/A,65,4
4,N/A,N/A,N/A,459,463,N/A,71,4
3,N/A,N/A,N/A,456,459,N/A,75,2
5,N/A,N/A,N/A,451,456,N/A,78,5
5,N/A,N/A,N/A,446,451,N/A,84,5
4,N/A,N/A,N/A,442,446,N/A,89,4
2,N/A,N/A,N/A,440,442,N/A,93,2
6,N/A,N/A,N/A,434,440,N/A,97,6
5,N/A,N/A,N/A,429,434,N/A,102,5
3,N/A,N/A,N/A,426,429,N/A,106,3
6,N/A,N/A,N/A,420,426,N/A,109,6
5,N/A,N/A,N/A,415,420,N/A,114,5
6,N/A,N/A,N/A,409,415,N/A,120,5
4,N/A,N/A,N/A,405,409,N/A,125,4
3,N/A,N/A,N/A,402,405,N/A,131,4
2,N/A,N/A,N/A,400,402,N/A,134,1
1,N/A,N/A,N/A,399,400,N/A,140,1
3,N/A,N/A,N/A,1824,1827,N/A,5,3
7,N/A,N/A,N/A,1817,1824,N/A,8,6
6,N/A,N/A,N/A,1811,1817,N/A,13,5
3,N/A,N/A,N/A,1808,1811,N/A,17,3
1,N/A,N/A,N/A,1807,1808,N/A,21,1
5,N/A,N/A,N/A,1802,1807,N/A,25,5
2,N/A,N/A,N/A,1800,1802,N/A,29,3
2,N/A,N/A,N/A,1798,1800,N/A,35,3
6,N/A,N/A,N/A,1792,1798,N/A,38,6
2,N/A,N/A,N/A,1790,1792,N/A,44,0
4,N/A,N/A,N/A,1786,1790,N/A,48,4
3,N/A,N/A,N/A,1783,1786,N/A,52,2
3,N/A,N/A,N/A,1780,1783,N/A,58,2
2,N/A,N/A,N/A,1778,1780,N/A,63,1
4,N/A,N/A,N/A,1774,1778,N/A,66,4
4,N/A,N/A,N/A,1770,1774,N/A,72,4
3,N/A,N/A,N/A,1767,1770,N/A,76,2
3,N/A,N/A,N/A,1764,1767,N/A,82,2
3,N/A,N/A,N/A,1761,1764,N/A,88,2
6,N/A,N/A,N/A,1755,1761,N/A,92,6
3,N/A,N/A,N/A,1752,1755,N/A,96,4
1,N/A,N/A,N/A,1751,1752,N/A,99,1
4,N/A,N/A,N/A,1747,1751,N/A,102,4
3,N/A,N/A,N/A,1744,1747,N/A,107,3
6,N/A,N/A,N/A,1738,1744,N/A,110,6
4,N/A,N/A,N/A,1734,1738,N/A,114,4
3,N/A,N/A,N/A,1731,1734,N/A,120,4
3,N/A,N/A,N/A,1728,1731,N/A,126,4
3,N/A,N/A,N/A,1725,1728,N/A,130,2
6,N/A,N/A,N/A,1719,1725,N/A,134,6
3,N/A,N/A,N/A,1450,1453,N/A,6,2
1,N/A,N/A,N/A,1449,1450,N/A,11,1
7,N/A,N/A,N/A,1442,1449,N/A,16,6
3,N/A,N/A,N/A,1439,1442,N/A,20,4
3,N/A,N/A,N/A,1436,1439,N/A,25,3
3,N/A,N/A,N/A,1433,1436,N/A,31,3
6,N/A,N/A,N/A,1427,1433,N/A,34,6
5,N/A,N/A,N/A,1422,1427,N/A,39,5
6,N/A,N/A,N/A,1416,1422,N/A,45,5
2,N/A,N/A,N/A,1414,1416,N/A,48,2
1,N/A,N/A,N/A,1413,1414,N/A,53,1
6,N/A,N/A,N/A,1407,1413,N/A,57,5
3,N/A,N/A,N/A,1404,1407,N/A,61,3
2,N/A,N/A,N/A,1402,1404,N/A,67,3
2,N/A,N/A,N/A,1400,1402,N/A,73,3
3,N/A,N/A,N/A,1397,1400,N/A,78,2
2,N/A,N/A,N/A,1395,1397,N/A,84,2
3,N/A,N/A,N/A,1392,1395,N/A,90,2
2,N/A,N/A,N/A,1390,1392,N/A,96,2
5,N/A,N/A,N/A,1385,1390,N/A,99,5
5,N/A,N/A,N/A,1380,1385,N/A,105,5
6,N/A,N/A,N/A,1374,1380,N/A,111,5
5,N/A,N/A,N/A,1369,1374,N/A,117,5
6,N/A,N/A,N/A,1363,1369,N/A,123,5
2,N/A,N/A,N/A,1361,1363,N/A,127,3
2,N/A,N/A,N/A,1359,1361,N/A,132,2
2,N/A,N/A,N/A,1357,1359,N/A,138,2
6,N/A,N/A,N/A,1351,1357,N/A,142,6
2,N/A,N/A,N/A,1349,1351,N/A,145,3
2,N/A,N/A,N/A,1347,1349,N/A,149,1
3,N/A,N/A,N/A,335,338,N/A,4,2
3,N/A,N/A,N/A,332,335,N/A,10,2
2,N/A,N/A,N/A,330,332,N/A,15,1
3,N/A,N/A,N/A,327,330,N/A,18,4
1,N/A,N/A,N/A,326,327,N/A,21,1
6,N/A,N/A,N/A,320,326,N/A,26,6
4,N/A,N/A,N/A,316,320,N/A,30,4
3,N/A,N/A,N/A,313,316,N/A,36,4
3,N/A,N/A,N/A,310,313,N/A,42,4
2,N/A,N/A,N/A,308,310,N/A,46,2
7,N/A,N/A,N/A,301,308,N/A,50,6
1,N/A,N/A,N/A,300,301,N/A,56,0
2,N/A,N/A,N/A,298,300,N/A,59,3
6,N/A,N/A,N/A,292,298,N/A,62,6
6,N/A,N/A,N/A,286,292,N/A,67,5
2,N/A,N/A,N/A,284,286,N/A,71,3
1,N/A,N/A,N/A,283,284,N/A,75,1
4,N/A,N/A,N/A,279,283,N/A,78,4
2,N/A,N/A,N/A,277,279,N/A,81,1
4,N/A,N/A,N/A,273,277,N/A,84,4
2,N/A,N/A,N/A,271,273,N/A,88,2
1,N/A,N/A,N/A,270,271,N/A,93,1
6,N/A,N/A,N/A,264,270,N/A,98,6
5,N/A,N/A,N/A,259,264,N/A,103,5
5,N/A,N/A,N/A,254,259,N/A,109,5
5,N/A,N/A,N/A,249,254,N/A,115,5
2,N/A,N/A,N/A,247,249,N/A,118,2
5,N/A,N/A,N/A,242,247,N/A,121,5
3,N/A,N/A,N/A,239,242,N/A,125,3
6,N/A,N/A,N/A,233,239,N/A,128,6
2,N/A,N/A,N/A,610,612,N/A,6,1
7,N/A,N/A,N/A,603,610,N/A,11,6
4,N/A,N/A,N/A,599,603,N/A,15,4
2,N/A,N/A,N/A,597,599,N/A,18,1
6,N/A,N/A,N/A,591,597,N/A,23,6
2,N/A,N/A,N/A,589,591,N/A,29,0
5,N/A,N/A,N/A,584,589,N/A,34,5
4,N/A,N/A,N/A,580,584,N/A,39,4
2,N/A,N/A,N/A,578,580,N/A,42,1
6,N/A,N/A,N/A,572,578,N/A,46,5
3,N/A,N/A,N/A,569,572,N/A,51,4
2,N/A,N/A,N/A,567,569,N/A,54,1
6,N/A,N/A,N/A,561,567,N/A,58,5
3,N/A,N/A,N/A,558,561,N/A,61,2
1,N/A,N/A,N/A,557,558,N/A,66,1
2,N/A,N/A,N/A,555,557,N/A,72,1
3,N/A,N/A,N/A,552,555,N/A,75,4
4,N/A,N/A,N/A,548,552,N/A,81,4
2,N/A,N/A,N/A,546,548,N/A,84,1
7,N/A,N/A,N/A,539,546,N/A,89,6
1,N/A,N/A,N/A,538,539,N/A,95,0
7,N/A,N/A,N/A,531,538,N/A,101,6
6,N/A,N/A,N/A,525,531,N/A,106,5
4,N/A,N/A,N/A,521,525,N/A,111,4
3,N/A,N/A,N/A,518,521,N/A,116,3
1,N/A,N/A,N/A,517,518,N/A,120,1
1,N/A,N/A,N/A,516,517,N/A,126,1
5,N/A,N/A,N/A,511,516,N/A,130,5
3,N/A,N/A,N/A,508,511,N/A,134,3
3,N/A,N/A,N/A,505,508,N/A,140,3
2,N/A,N/A,N/A,894,896,N/A,6,3
3,N/A,N/A,N/A,891,894,N/A,12,3
2,N/A,N/A,N/A,889,891,N/A,18,3
2,N/A,N/A,N/A,887,889,N/A,23,2
6,N/A,N/A,N/A,881,887,N/A,26,5
3,N/A,N/A,N/A,878,881,N/A,30,3
3,N/A,N/A,N/A,875,878,N/A,36,3
3,N/A,N/A,N/A,872,875,N/A,41,2
2,N/A,N/A,N/A,870,872,N/A,46,1
1,N/A,N/A,N/A,869,870,N/A,52,1
6,N/A,N/A,N/A,863,869,N/A,56,5
5,N/A,N/A,N/A,858,863,N/A,62,5
3,N/A,N/A,N/A,855,858,N/A,66,3
1,N/A,N/A,N/A,854,855,N/A,70,1
5,N/A,N/A,N/A,849,854,N/A,74,5
5,N/A,N/A,N/A,844,849,N/A,80,5
2,N/A,N/A,N/A,842,844,N/A,84,3
7,N/A,N/A,N/A,835,842,N/A,87,6
4,N/A,N/A,N/A,831,835,N/A,91,4
4,N/A,N/A,N/A,827,831,N/A,97,4
4,N/A,N/A,N/A,823,827,N/A,103,4
1,N/A,N/A,N/A,822,823,N/A,106,1
3,N/A,N/A,N/A,819,822,N/A,109,4
2,N/A,N/A,N/A,817,819,N/A,114,3
7,N/A,N/A,N/A,810,817,N/A,117,6
6,N/A,N/A,N/A,804,810,N/A,122,5
5,N/A,N/A,N/A,799,804,N/A,128,5
2,N/A,N/A,N/A,797,799,N/A,131,2
6,N/A,N/A,N/A,791,797,N/A,134,5
3,N/A,N/A,N/A,788,791,N/A,139,4
3,N/A,N/A,N/A,777,780,N/A,3,4
2,N/A,N/A,N/A,775,777,N/A,6,1
6,N/A,N/A,N/A,769,775,N/A,10,5
3,N/A,N/A,N/A,766,769,N/A,14,3
7,N/A,N/A,N/A,759,766,N/A,17,6
2,N/A,N/A,N/A,757,759,N/A,23,0
6,N/A,N/A,N/A,751,757,N/A,28,5
4,N/A,N/A,N/A,747,751,N/A,33,4
3,N/A,N/A,N/A,744,747,N/A,38,3
3,N/A,N/A,N/A,741,744,N/A,43,2
6,N/A,N/A,N/A,735,741,N/A,47,6
1,N/A,N/A,N/A,734,735,N/A,53,0
7,N/A,N/A,N/A,727,734,N/A,59,6
2,N/A,N/A,N/A,725,727,N/A,62,3
6,N/A,N/A,N/A,719,725,N/A,65,6
5,N/A,N/A,N/A,714,719,N/A,70,5
3,N/A,N/A,N/A,711,714,N/A,73,2
7,N/A,N/A,N/A,704,711,N/A,77,6
4,N/A,N/A,N/A,700,704,N/A,81,4
4,N/A,N/A,N/A,696,700,N/A,87,4
2,N/A,N/A,N/A,694,696,N/A,90,1
2,N/A,N/A,N/A,692,694,N/A,96,1
3,N/A,N/A,N/A,689,692,N/A,99,4
2,N/A,N/A,N/A,687,689,N/A,103,2
2,N/A,N/A,N/A,685,687,N/A,109,2
5,N/A,N/A,N/A,680,685,N/A,112,5
6,N/A,N/A,N/A,674,680,N/A,118,5
4,N/A,N/A,N/A,670,674,N/A,123,4
4,N/A,N/A,N/A,666,670,N/A,129,4
3,N/A,N/A,N/A,663,666,N/A,135,4
6,N/A,N/A,N/A,1928,1934,N/A,5,5
4,N/A,N/A,N/A,1924,1928,N/A,10,4
2,N/A,N/A,N/A,1922,1924,N/A,15,3
2,N/A,N/A,N/A,1920,1922,N/A,20,2
6,N/A,N/A,N/A,1914,1920,N/A,23,5
3,N/A,N/A,N/A,1911,1914,N/A,27,3
7,N/A,N/A,N/A,1904,1911,N/A,30,6
2,N/A,N/A,N/A,1902,1904,N/A,33,3
1,N/A,N/A,N/A,1901,1902,N/A,37,1
1,N/A,N/A,N/A,1900,1901,N/A,43,1
3,N/A,N/A,N/A,1897,1900,N/A,46,4
3,N/A,N/A,N/A,1894,1897,N/A,51,3
2,N/A,N/A,N/A,1892,1894,N/A,57,3
2,N/A,N/A,N/A,1890,1892,N/A,61,1
7,N/A,N/A,N/A,1883,1890,N/A,66,6
1,N/A,N/A,N/A,1882,1883,N/A,72,0
6,N/A,N/A,N/A,1876,1882,N/A,77,5
3,N/A,N/A,N/A,1873,1876,N/A,81,3
3,N/A,N/A,N/A,1870,1873,N/A,87,3
2,N/A,N/A,N/A,1868,1870,N/A,92,2
6,N/A,N/A,N/A,1862,1868,N/A,95,5
2,N/A,N/A,N/A,1860,1862,N/A,99,3
3,N/A,N/A,N/A,1857,1860,N/A,104,2
6,N/A,N/A,N/A,1851,1857,N/A,107,5
2,N/A,N/A,N/A,1849,1851,N/A,111,3
2,N/A,N/A,N/A,1847,1849,N/A,115,1
1,N/A,N/A,N/A,1846,1847,N/A,121,1
7,N/A,N/A,N/A,1839,1846,N/A,126,6
3,N/A,N/A,N/A,1836,1839,N/A,130,4
3,N/A,N/A,N/A,1833,1836,N/A,135,3
6,N/A,N/A,N/A,997,1003,N/A,3,6
1,N/A,N/A,N/A,996,997,N/A,9,0
4,N/A,N/A,N/A,992,996,N/A,13,4
2,N/A,N/A,N/A,990,992,N/A,17,2
7,N/A,N/A,N/A,983,990,N/A,21,6
1,N/A,N/A,N/A,982,983,N/A,27,0
6,N/A,N/A,N/A,976,982,N/A,32,5
2,N/A,N/A,N/A,974,976,N/A,35,2
2,N/A,N/A,N/A,972,974,N/A,41,2
6,N/A,N/A,N/A,966,972,N/A,45,6
6,N/A,N/A,N/A,960,966,N/A,50,5
3,N/A,N/A,N/A,957,960,N/A,54,3
3,N/A,N/A,N/A,954,957,N/A,60,3
6,N/A,N/A,N/A,948,954,N/A,63,6
2,N/A,N/A,N/A,946,948,N/A,66,3
6,N/A,N/A,N/A,940,946,N/A,69,6
6,N/A,N/A,N/A,934,940,N/A,74,5
3,N/A,N/A,N/A,931,934,N/A,78,3
2,N/A,N/A,N/A,929,931,N/A,84,3
3,N/A,N/A,N/A,926,929,N/A,90,3
2,N/A,N/A,N/A,924,926,N/A,95,2
2,N/A,N/A,N/A,922,924,N/A,100,1
3,N/A,N/A,N/A,919,922,N/A,103,4
3,N/A,N/A,N/A,916,919,N/A,107,2
1,N/A,N/A,N/A,915,916,N/A,112,1
5,N/A,N/A,N/A,910,915,N/A,116,5
3,N/A,N/A,N/A,907,910,N/A,119,2
5,N/A,N/A,N/A,902,907,N/A,122,5
2,N/A,N/A,N/A,900,902,N/A,125,2
7,N/A,N/A,N/A,893,900,N/A,129,6
3,N/A,N/A,N/A,1664,1667,N/A,6,2
7,N/A,N/A,N/A,1657,1664,N/A,10,6
5,N/A,N/A,N/A,1652,1657,N/A,15,5
2,N/A,N/A,N/A,1650,1652,N/A,18,2
5,N/A,N/A,N/A,1645,1650,N/A,21,5
2,N/A,N/A,N/A,1643,1645,N/A,25,3
7,N/A,N/A,N/A,1636,1643,N/A,28,6
1,N/A,N/A,N/A,1635,1636,N/A,34,0
4,N/A,N/A,N/A,1631,1635,N/A,38,4
2,N/A,N/A,N/A,1629,1631,N/A,41,1
2,N/A,N/A,N/A,1627,1629,N/A,47,1
6,N/A,N/A,N/A,1621,1627,N/A,51,5
2,N/A,N/A,N/A,1619,1621,N/A,55,3
2,N/A,N/A,N/A,1617,1619,N/A,60,2
3,N/A,N/A,N/A,1614,1617,N/A,66,2
7,N/A,N/A,N/A,1607,1614,N/A,70,6
2,N/A,N/A,N/A,1605,1607,N/A,73,3
7,N/A,N/A,N/A,1598,1605,N/A,76,6
1,N/A,N/A,N/A,1597,1598,N/A,82,0
6,N/A,N/A,N/A,1591,1597,N/A,88,6
1,N/A,N/A,N/A,1590,1591,N/A,94,0
6,N/A,N/A,N/A,1584,1590,N/A,99,5
6,N/A,N/A,N/A,1578,1584,N/A,105,5
5,N/A,N/A,N/A,1573,1578,N/A,111,5
6,N/A,N/A,N/A,1567,1573,N/A,117,5
2,N/A,N/A,N/A,1565,1567,N/A,120,2
5,N/A,N/A,N/A,1560,1565,N/A,123,5
4,N/A,N/A,N/A,1556,1560,N/A,128,4
3,N/A,N/A,N/A,1553,1556,N/A,132,2
2,N/A,N/A,N/A,1551,1553,N/A,138,2
1,N/A,N/A,N/A,1103,1104,N/A,3,1
1,N/A,N/A,N/A,1102,1103,N/A,9,1
6,N/A,N/A,N/A,1096,1102,N/A,14,6
2,N/A,N/A,N/A,1094,1096,N/A,20,0
3,N/A,N/A,N/A,1091,1094,N/A,24,4
2,N/A,N/A,N/A,1089,1091,N/A,29,3
1,N/A,N/A,N/A,1088,1089,N/A,33,1
2,N/A,N/A,N/A,1086,1088,N/A,39,1
6,N/A,N/A,N/A,1080,1086,N/A,43,5
4,N/A,N/A,N/A,1076,1080,N/A,48,4
3,N/A,N/A,N/A,1073,1076,N/A,54,4
1,N/A,N/A,N/A,1072,1073,N/A,57,1
4,N/A,N/A,N/A,1068,1072,N/A,60,4
3,N/A,N/A,N/A,1065,1068,N/A,65,3
6,N/A,N/A,N/A,1059,1065,N/A,68,6
6,N/A,N/A,N/A,1053,1059,N/A,73,5
4,N/A,N/A,N/A,1049,1053,N/A,78,4
2,N/A,N/A,N/A,1047,1049,N/A,83,3
6,N/A,N/A,N/A,1041,1047,N/A,86,6
5,N/A,N/A,N/A,1036,1041,N/A,91,5
2,N/A,N/A,N/A,1034,1036,N/A,95,3
2,N/A,N/A,N/A,1032,1034,N/A,99,1
1,N/A,N/A,N/A,1031,1032,N/A,105,1
5,N/A,N/A,N/A,1026,1031,N/A,109,5
5,N/A,N/A,N/A,1021,1026,N/A,115,5
6,N/A,N/A,N/A,1015,1021,N/A,121,5
4,N/A,N/A,N/A,1011,1015,N/A,126,4
2,N/A,N/A,N/A,1009,1011,N/A,129,1
4,N/A,N/A,N/A,1005,1009,N/A,132,4
1,N/A,N/A,N/A,1004,1005,N/A,135,1
2,N/A,N/A,N/A,1151,1153,N/A,3,2
7,N/A,N/A,N/A,1144,1151,N/A,7,6
6,N/A,N/A,N/A,1138,1144,N/A,12,5
5,N/A,N/A,N/A,1133,1138,N/A,18,5
2,N/A,N/A,N/A,1131,1133,N/A,22,3
3,N/A,N/A,N/A,1128,1131,N/A,28,3
7,N/A,N/A,N/A,1121,1128,N/A,31,6
2,N/A,N/A,N/A,1119,1121,N/A,37,0
4,N/A,N/A,N/A,1115,1119,N/A,41,4
3,N/A,N/A,N/A,1112,1115,N/A,46,3
6,N/A,N/A,N/A,1106,1112,N/A,49,6
4,N/A,N/A,N/A,1102,1106,N/A,53,4
2,N/A,N/A,N/A,1100,1102,N/A,58,3
1,N/A,N/A,N/A,1099,1100,N/A,62,1
3,N/A,N/A,N/A,1096,1099,N/A,65,4
1,N/A,N/A,N/A,1095,1096,N/A,68,1
5,N/A,N/A,N/A,1090,1095,N/A,72,5
2,N/A,N/A,N/A,1088,1090,N/A,76,3
3,N/A,N/A,N/A,1085,1088,N/A,81,2
7,N/A,N/A,N/A,1078,1085,N/A,85,6
3,N/A,N/A,N/A,1075,1078,N/A,89,4
4,N/A,N/A,N/A,1071,1075,N/A,95,4
2,N/A,N/A,N/A,1069,1071,N/A,98,1
3,N/A,N/A,N/A,1066,1069,N/A,101,4
3,N/A,N/A,N/A,1063,1066,N/A,107,4
3,N/A,N/A,N/A,1060,1063,N/A,111,2
1,N/A,N/A,N/A,1059,1060,N/A,116,1
6,N/A,N/A,N/A,1053,1059,N/A,121,6
4,N/A,N/A,N/A,1049,1053,N/A,125,4
2,N/A,N/A,N/A,1047,1049,N/A,129,2
6,N/A,N/A,N/A,1967,1973,N/A,4,5
5,N/A,N/A,N/A,1962,1967,N/A,10,5
5,N/A,N/A,N/A,1957,1962,N/A,16,5
5,N/A,N/A,N/A,1952,1957,N/A,22,5
6,N/A,N/A,N/A,1946,1952,N/A,28,5
5,N/A,N/A,N/A,1941,1946,N/A,34,5
2,N/A,N/A,N/A,1939,1941,N/A,37,2
2,N/A,N/A,N/A,1937,1939,N/A,43,2
3,N/A,N/A,N/A,1934,1937,N/A,49,2
6,N/A,N/A,N/A,1928,1934,N/A,52,5
3,N/A,N/A,N/A,1925,1928,N/A,56,3
2,N/A,N/A,N/A,1923,1925,N/A,62,3
3,N/A,N/A,N/A,1920,1923,N/A,67,2
5,N/A,N/A,N/A,1915,1920,N/A,70,5
6,N/A,N/A,N/A,1909,1915,N/A,76,5
3,N/A,N/A,N/A,1906,1909,N/A,81,4
2,N/A,N/A,N/A,1904,1906,N/A,85,2
3,N/A,N/A,N/A,1901,1904,N/A,91,2
2,N/A,N/A,N/A,1899,1901,N/A,97,2
6,N/A,N/A,N/A,1893,1899,N/A,101,6
1,N/A,N/A,N/A,1892,1893,N/A,107,0
4,N/A,N/A,N/A,1888,1892,N/A,111,4
2,N/A,N/A,N/A,1886,1888,N/A,114,1
6,N/A,N/A,N/A,1880,1886,N/A,119,6
3,N/A,N/A,N/A,1877,1880,N/A,123,4
2,N/A,N/A,N/A,1875,1877,N/A,126,1
3,N/A,N/A,N/A,1872,1875,N/A,129,4
3,N/A,N/A,N/A,1869,1872,N/A,133,2
7,N/A,N/A,N/A,1862,1869,N/A,137,6
2,N/A,N/A,N/A,1860,1862,N/A,140,3
2,N/A,N/A,N/A,1760,1762,N/A,3,2
5,N/A,N/A,N/A,1755,1760,N/A,6,5
2,N/A,N/A,N/A,1753,1755,N/A,9,2
5,N/A,N/A,N/A,1748,1753,N/A,12,5
3,N/A,N/A,N/A,1745,1748,N/A,16,3
1,N/A,N/A,N/A,1744,1745,N/A,20,1
5,N/A,N/A,N/A,1739,1744,N/A,24,5
4,N/A,N/A,N/A,1735,1739,N/A,29,4
2,N/A,N/A,N/A,1733,1735,N/A,34,3
6,N/A,N/A,N/A,1727,1733,N/A,37,6
3,N/A,N/A,N/A,1724,1727,N/A,40,3
7,N/A,N/A,N/A,1717,1724,N/A,43,6
5,N/A,N/A,N/A,1712,1717,N/A,48,5
2,N/A,N/A,N/A,1710,1712,N/A,51,2
2,N/A,N/A,N/A,1708,1710,N/A,56,1
2,N/A,N/A,N/A,1706,1708,N/A,62,1
6,N/A,N/A,N/A,1700,1706,N/A,66,5
6,N/A,N/A,N/A,1694,1700,N/A,72,5
2,N/A,N/A,N/A,1692,1694,N/A,75,2
6,N/A,N/A,N/A,1686,1692,N/A,79,6
5,N/A,N/A,N/A,1681,1686,N/A,84,5
6,N/A,N/A,N/A,1675,1681,N/A,90,5
3,N/A,N/A,N/A,1672,1675,N/A,95,4
3,N/A,N/A,N/A,1669,1672,N/A,101,4
4,N/A,N/A,N/A,1665,1669,N/A,107,4
2,N/A,N/A,N/A,1663,1665,N/A,112,3
2,N/A,N/A,N/A,1661,1663,N/A,118,3
6,N/A,N/A,N/A,1655,1661,N/A,121,6
2,N/A,N/A,N/A,1653,1655,N/A,124,3
2,N/A,N/A,N/A,1651,1653,N/A,128,1
5,N/A,N/A,N/A,1683,1688,N/A,6,5
3,N/A,N/A,N/A,1680,1683,N/A,11,4
3,N/A,N/A,N/A,1677,1680,N/A,16,3
2,N/A,N/A,N/A,1675,1677,N/A,22,3
2,N/A,N/A,N/A,1673,1675,N/A,27,2
7,N/A,N/A,N/A,1666,1673,N/A,31,6
4,N/A,N/A,N/A,1662,1666,N/A,35,4
2,N/A,N/A,N/A,1660,1662,N/A,39,2
3,N/A,N/A,N/A,1657,1660,N/A,45,2
6,N/A,N/A,N/A,1651,1657,N/A,48,5
4,N/A,N/A,N/A,1647,1651,N/A,53,4
2,N/A,N/A,N/A,1645,1647,N/A,56,1
4,N/A,N/A,N/A,1641,1645,N/A,59,4
2,N/A,N/A,N/A,1639,1641,N/A,62,1
2,N/A,N/A,N/A,1637,1639,N/A,68,1
2,N/A,N/A,N/A,1635,1637,N/A,74,1
2,N/A,N/A,N/A,1633,1635,N/A,80,1
1,N/A,N/A,N/A,1632,1633,N/A,86,1
3,N/A,N/A,N/A,1629,1632,N/A,89,4
3,N/A,N/A,N/A,1626,1629,N/A,93,2
6,N/A,N/A,N/A,1620,1626,N/A,97,6
3,N/A,N/A,N/A,1617,1620,N/A,101,4
1,N/A,N/A,N/A,1616,1617,N/A,104,1
6,N/A,N/A,N/A,1610,1616,N/A,109,6
3,N/A,N/A,N/A,1607,1610,N/A,113,4
3,N/A,N/A,N/A,1604,1607,N/A,118,3
3,N/A,N/A,N/A,1601,1604,N/A,124,3
3,N/A,N/A,N/A,1598,1601,N/A,129,2
2,N/A,N/A,N/A,1596,1598,N/A,134,1
3,N/A,N/A,N/A,1593,1596,N/A,137,4
4,N/A,N/A,N/A,599,603,N/A,6,4
4,N/A,N/A,N/A,595,599,N/A,12,4
3,N/A,N/A,N/A,592,595,N/A,17,3
7,N/A,N/A,N/A,585,592,N/A,20,6
1,N/A,N/A,N/A,584,585,N/A,26,0
3,N/A,N/A,N/A,581,584,N/A,30,4
3,N/A,N/A,N/A,578,581,N/A,34,2
3,N/A,N/A,N/A,575,578,N/A,40,2
7,N/A,N/A,N/A,568,575,N/A,44,6
2,N/A,N/A,N/A,566,568,N/A,47,3
1,N/A,N/A,N/A,565,566,N/A,51,1
2,N/A,N/A,N/A,563,565,N/A,57,1
6,N/A,N/A,N/A,557,563,N/A,61,5
5,N/A,N/A,N/A,552,557,N/A,67,5
2,N/A,N/A,N/A,550,552,N/A,70,2
7,N/A,N/A,N/A,543,550,N/A,74,6
3,N/A,N/A,N/A,540,543,N/A,78,4
2,N/A,N/A,N/A,538,540,N/A,82,2
1,N/A,N/A,N/A,537,538,N/A,87,1
4,N/A,N/A,N/A,533,537,N/A,90,4
2,N/A,N/A,N/A,531,533,N/A,94,2
3,N/A,N/A,N/A,528,531,N/A,100,2
5,N/A,N/A,N/A,523,528,N/A,103,5
5,N/A,N/A,N/A,518,523,N/A,109,5
3,N/A,N/A,N/A,515,518,N/A,112,2
1,N/A,N/A,N/A,514,515,N/A,117,1
5,N/A,N/A,N/A,509,514,N/A,121,5
6,N/A,N/A,N/A,503,509,N/A,127,5
2,N/A,N/A,N/A,501,503,N/A,130,2
2,N/A,N/A,N/A,499,501,N/A,136,2
3,N/A,N/A,N/A,1383,1386,N/A,5,4
2,N/A,N/A,N/A,1381,1383,N/A,10,3
2,N/A,N/A,N/A,1379,1381,N/A,15,2
3,N/A,N/A,N/A,1376,1379,N/A,21,2
3,N/A,N/A,N/A,1373,1376,N/A,27,2
7,N/A,N/A,N/A,1366,1373,N/A,31,6
2,N/A,N/A,N/A,1364,1366,N/A,37,0
4,N/A,N/A,N/A,1360,1364,N/A,41,4
4,N/A,N/A,N/A,1356,1360,N/A,47,4
2,N/A,N/A,N/A,1354,1356,N/A,52,3
6,N/A,N/A,N/A,1348,1354,N/A,55,6
4,N/A,N/A,N/A,1344,1348,N/A,59,4
2,N/A,N/A,N/A,1342,1344,N/A,64,3
2,N/A,N/A,N/A,1340,1342,N/A,70,3
2,N/A,N/A,N/A,1338,1340,N/A,74,1
7,N/A,N/A,N/A,1331,1338,N/A,79,6
6,N/A,N/A,N/A,1325,1331,N/A,84,5
4,N/A,N/A,N/A,1321,1325,N/A,89,4
3,N/A,N/A,N/A,1318,1321,N/A,95,4
3,N/A,N/A,N/A,1315,1318,N/A,99,2
3,N/A,N/A,N/A,1312,1315,N/A,105,2
3,N/A,N/A,N/A,1309,1312,N/A,111,2
2,N/A,N/A,N/A,1307,1309,N/A,116,1
6,N/A,N/A,N/A,1301,1307,N/A,120,5
4,N/A,N/A,N/A,1297,1301,N/A,125,4
2,N/A,N/A,N/A,1295,1297,N/A,128,1
6,N/A,N/A,N/A,1289,1295,N/A,133,6
4,N/A,N/A,N/A,1285,1289,N/A,137,4
2,N/A,N/A,N/A,1283,1285,N/A,141,2
3,N/A,N/A,N/A,1280,1283,N/A,147,2
3,N/A,N/A,N/A,395,398,N/A,4,3
7,N/A,N/A,N/A,388,395,N/A,7,6
4,N/A,N/A,N/A,384,388,N/A,11,4
4,N/A,N/A,N/A,380,384,N/A,17,4
2,N/A,N/A,N/A,378,380,N/A,20,1
7,N/A,N/A,N/A,371,378,N/A,25,6
2,N/A,N/A,N/A,369,371,N/A,31,0
4,N/A,N/A,N/A,365,369,N/A,35,4
1,N/A,N/A,N/A,364,365,N/A,38,1
5,N/A,N/A,N/A,359,364,N/A,42,5
3,N/A,N/A,N/A,356,359,N/A,45,2
2,N/A,N/A,N/A,354,356,N/A,51,2
3,N/A,N/A,N/A,351,354,N/A,57,2
5,N/A,N/A,N/A,346,351,N/A,60,5
3,N/A,N/A,N/A,343,346,N/A,64,3
1,N/A,N/A,N/A,342,343,N/A,68,1
2,N/A,N/A,N/A,340,342,N/A,74,1
2,N/A,N/A,N/A,338,340,N/A,80,1
7,N/A,N/A,N/A,331,338,N/A,85,6
6,N/A,N/A,N/A,325,331,N/A,90,5
2,N/A,N/A,N/A,323,325,N/A,93,2
2,N/A,N/A,N/A,321,323,N/A,98,1
2,N/A,N/A,N/A,319,321,N/A,104,1
2,N/A,N/A,N/A,317,319,N/A,110,1
3,N/A,N/A,N/A,314,317,N/A,113,4
4,N/A,N/A,N/A,310,314,N/A,119,4
1,N/A,N/A,N/A,309,310,N/A,122,1
7,N/A,N/A,N/A,302,309,N/A,127,6
1,N/A,N/A,N/A,301,302,N/A,133,0
7,N/A,N/A,N/A,294,301,N/A,139,6
2,N/A,N/A,N/A,881,883,N/A,3,1
2,N/A,N/A,N/A,879,881,N/A,9,1
6,N/A,N/A,N/A,873,879,N/A,14,6
6,N/A,N/A,N/A,867,873,N/A,19,5
2,N/A,N/A,N/A,865,867,N/A,22,2
3,N/A,N/A,N/A,862,865,N/A,28,2
5,N/A,N/A,N/A,857,862,N/A,31,5
3,N/A,N/A,N/A,854,857,N/A,35,3
2,N/A,N/A,N/A,852,854,N/A,41,3
1,N/A,N/A,N/A,851,852,N/A,45,1
1,N/A,N/A,N/A,850,851,N/A,51,1
6,N/A,N/A,N/A,844,850,N/A,55,5
3,N/A,N/A,N/A,841,844,N/A,60,4
3,N/A,N/A,N/A,838,841,N/A,66,4
2,N/A,N/A,N/A,836,838,N/A,70,2
2,N/A,N/A,N/A,834,836,N/A,76,2
2,N/A,N/A,N/A,832,834,N/A,81,1
1,N/A,N/A,N/A,831,832,N/A,87,1
6,N/A,N/A,N/A,825,831,N/A,92,6
3,N/A,N/A,N/A,822,825,N/A,95,3
6,N/A,N/A,N/A,816,822,N/A,98,6
4,N/A,N/A,N/A,812,816,N/A,102,4
3,N/A,N/A,N/A,809,812,N/A,106,2
6,N/A,N/A,N/A,803,809,N/A,109,5
3,N/A,N/A,N/A,800,803,N/A,113,3
1,N/A,N/A,N/A,799,800,N/A,117,1
5,N/A,N/A,N/A,794,799,N/A,121,5
6,N/A,N/A,N/A,788,794,N/A,127,5
3,N/A,N/A,N/A,785,788,N/A,132,4
1,N/A,N/A,N/A,784,785,N/A,135,1
2,N/A,N/A,N/A,1164,1166,N/A,5,1
2,N/A,N/A,N/A,1162,1164,N/A,11,1
2,N/A,N/A,N/A,1160,1162,N/A,17,1
2,N/A,N/A,N/A,1158,1160,N/A,23,1
6,N/A,N/A,N/A,1152,1158,N/A,27,5
3,N/A,N/A,N/A,1149,1152,N/A,30,2
5,N/A,N/A,N/A,1144,1149,N/A,33,5
6,N/A,N/A,N/A,1138,1144,N/A,39,5
2,N/A,N/A,N/A,1136,1138,N/A,42,2
2,N/A,N/A,N/A,1134,1136,N/A,47,1
4,N/A,N/A,N/A,1130,1134,N/A,50,4
3,N/A,N/A,N/A,1127,1130,N/A,56,4
3,N/A,N/A,N/A,1124,1127,N/A,62,4
3,N/A,N/A,N/A,1121,1124,N/A,67,3
6,N/A,N/A,N/A,1115,1121,N/A,70,6
6,N/A,N/A,N/A,1109,1115,N/A,75,5
3,N/A,N/A,N/A,1106,1109,N/A,80,4
3,N/A,N/A,N/A,1103,1106,N/A,84,2
2,N/A,N/A,N/A,1101,1103,N/A,90,2
6,N/A,N/A,N/A,1095,1101,N/A,94,6
2,N/A,N/A,N/A,1093,1095,N/A,100,0
5,N/A,N/A,N/A,1088,1093,N/A,105,5
3,N/A,N/A,N/A,1085,1088,N/A,109,3
6,N/A,N/A,N/A,1079,1085,N/A,112,6
1,N/A,N/A,N/A,1078,1079,N/A,118,0
3,N/A,N/A,N/A,1075,1078,N/A,121,3
2,N/A,N/A,N/A,1073,1075,N/A,127,3
3,N/A,N/A,N/A,1070,1073,N/A,132,2
3,N/A,N/A,N/A,1067,1070,N/A,138,2
2,N/A,N/A,N/A,1065,1067,N/A,143,1
2,N/A,N/A,N/A,1813,1815,N/A,3,3
3,N/A,N/A,N/A,1810,1813,N/A,8,2
2,N/A,N/A,N/A,1808,1810,N/A,14,2
3,N/A,N/A,N/A,1805,1808,N/A,20,2
5,N/A,N/A,N/A,1800,1805,N/A,23,5
3,N/A,N/A,N/A,1797,1800,N/A,26,2
7,N/A,N/A,N/A,1790,1797,N/A,30,6
5,N/A,N/A,N/A,1785,1790,N/A,35,5
2,N/A,N/A,N/A,1783,1785,N/A,39,3
6,N/A,N/A,N/A,1777,1783,N/A,42,6
6,N/A,N/A,N/A,1771,1777,N/A,47,5
3,N/A,N/A,N/A,1768,1771,N/A,52,4
2,N/A,N/A,N/A,1766,1768,N/A,55,1
6,N/A,N/A,N/A,1760,1766,N/A,59,5
2,N/A,N/A,N/A,1758,1760,N/A,62,2
7,N/A,N/A,N/A,1751,1758,N/A,66,6
2,N/A,N/A,N/A,1749,1751,N/A,72,0
6,N/A,N/A,N/A,1743,1749,N/A,77,5
2,N/A,N/A,N/A,1741,1743,N/A,81,3
2,N/A,N/A,N/A,1739,1741,N/A,86,2
2,N/A,N/A,N/A,1737,1739,N/A,92,2
2,N/A,N/A,N/A,1735,1737,N/A,97,1
4,N/A,N/A,N/A,1731,1735,N/A,100,4
2,N/A,N/A,N/A,1729,1731,N/A,103,1
7,N/A,N/A,N/A,1722,1729,N/A,108,6
3,N/A,N/A,N/A,1719,1722,N/A,112,4
3,N/A,N/A,N/A,1716,1719,N/A,117,3
1,N/A,N/A,N/A,1715,1716,N/A,121,1
7,N/A,N/A,N/A,1708,1715,N/A,126,6
4,N/A,N/A,N/A,1704,1708,N/A,130,4
3,N/A,N/A,N/A,1541,1544,N/A,4,4
4,N/A,N/A,N/A,1537,1541,N/A,10,4
3,N/A,N/A,N/A,1534,1537,N/A,15,3
3,N/A,N/A,N/A,1531,1534,N/A,20,2
5,N/A,N/A,N/A,1526,1531,N/A,23,5
3,N/A,N/A,N/A,1523,1526,N/A,28,4
4,N/A,N/A,N/A,1519,1523,N/A,34,4
2,N/A,N/A,N/A,1517,1519,N/A,38,2
5,N/A,N/A,N/A,1512,1517,N/A,41,5
2,N/A,N/A,N/A,1510,1512,N/A,45,3
6,N/A,N/A,N/A,1504,1510,N/A,48,6
6,N/A,N/A,N/A,1498,1504,N/A,53,5
3,N/A,N/A,N/A,1495,1498,N/A,56,2
3,N/A,N/A,N/A,1492,1495,N/A,62,2
3,N/A,N/A,N/A,1489,1492,N/A,68,2
2,N/A,N/A,N/A,1487,1489,N/A,74,2
6,N/A,N/A,N/A,1481,1487,N/A,77,5
3,N/A,N/A,N/A,1478,1481,N/A,81,3
6,N/A,N/A,N/A,1472,1478,N/A,84,6
6,N/A,N/A,N/A,1466,1472,N/A,89,5
3,N/A,N/A,N/A,1463,1466,N/A,92,2
6,N/A,N/A,N/A,1457,1463,N/A,95,5
6,N/A,N/A,N/A,1451,1457,N/A,101,5
6,N/A,N/A,N/A,1445,1451,N/A,107,5
5,N/A,N/A,N/A,1440,1445,N/A,113,5
3,N/A,N/A,N/A,1437,1440,N/A,117,3
6,N/A,N/A,N/A,1431,1437,N/A,120,6
6,N/A,N/A,N/A,1425,1431,N/A,125,5
2,N/A,N/A,N/A,1423,1425,N/A,129,3
2,N/A,N/A,N/A,1421,1423,N/A,134,2
6,N/A,N/A,N/A,1793,1799,N/A,3,6
4,N/A,N/A,N/A,1789,1793,N/A,7,4
2,N/A,N/A,N/A,1787,1789,N/A,11,2
2,N/A,N/A,N/A,1785,1787,N/A,16,1
2,N/A,N/A,N/A,1783,1785,N/A,22,1
5,N/A,N/A,N/A,1778,1783,N/A,26,5
6,N/A,N/A,N/A,1772,1778,N/A,32,5
6,N/A,N/A,N/A,1766,1772,N/A,38,5
2,N/A,N/A,N/A,1764,1766,N/A,41,2
1,N/A,N/A,N/A,1763,1764,N/A,46,1
4,N/A,N/A,N/A,1759,1763,N/A,49,4
2,N/A,N/A,N/A,1757,1759,N/A,53,2
7,N/A,N/A,N/A,1750,1757,N/A,57,6
3,N/A,N/A,N/A,1747,1750,N/A,60,3
2,N/A,N/A,N/A,1745,1747,N/A,66,3
3,N/A,N/A,N/A,1742,1745,N/A,72,3
3,N/A,N/A,N/A,1739,1742,N/A,77,2
6,N/A,N/A,N/A,1733,1739,N/A,80,5
3,N/A,N/A,N/A,1730,1733,N/A,83,2
2,N/A,N/A,N/A,1728,1730,N/A,89,2
2,N/A,N/A,N/A,1726,1728,N/A,94,1
1,N/A,N/A,N/A,1725,1726,N/A,100,1
1,N/A,N/A,N/A,1724,1725,N/A,106,1
3,N/A,N/A,N/A,1721,1724,N/A,109,4
1,N/A,N/A,N/A,1720,1721,N/A,112,1
4,N/A,N/A,N/A,1716,1720,N/A,115,4
2,N/A,N/A,N/A,1714,1716,N/A,119,2
5,N/A,N/A,N/A,1709,1714,N/A,122,5
5,N/A,N/A,N/A,1704,1709,N/A,128,5
2,N/A,N/A,N/A,1702,1704,N/A,132,3
2,N/A,N/A,N/A,1524,1526,N/A,3,2
6,N/A,N/A,N/A,1518,1524,N/A,7,6
3,N/A,N/A,N/A,1515,1518,N/A,10,3
7,N/A,N/A,N/A,1508,1515,N/A,13,6
3,N/A,N/A,N/A,1505,1508,N/A,17,4
2,N/A,N/A,N/A,1503,1505,N/A,20,1
3,N/A,N/A,N/A,1500,1503,N/A,23,4
2,N/A,N/A,N/A,1498,1500,N/A,28,3
3,N/A,N/A,N/A,1495,1498,N/A,33,2
1,N/A,N/A,N/A,1494,1495,N/A,38,1
1,N/A,N/A,N/A,1493,1494,N/A,44,1
2,N/A,N/A,N/A,1491,1493,N/A,50,1
2,N/A,N/A,N/A,1489,1491,N/A,56,1
5,N/A,N/A,N/A,1484,1489,N/A,60,5
2,N/A,N/A,N/A,1482,1484,N/A,63,2
5,N/A,N/A,N/A,1477,1482,N/A,66,5
5,N/A,N/A,N/A,1472,1477,N/A,72,5
5,N/A,N/A,N/A,1467,1472,N/A,78,5
3,N/A,N/A,N/A,1464,1467,N/A,81,2
6,N/A,N/A,N/A,1458,1464,N/A,85,6
2,N/A,N/A,N/A,1456,1458,N/A,88,3
2,N/A,N/A,N/A,1454,1456,N/A,94,3
7,N/A,N/A,N/A,1447,1454,N/A,97,6
6,N/A,N/A,N/A,1441,1447,N/A,102,5
4,N/A,N/A,N/A,1437,1441,N/A,107,4
1,N/A,N/A,N/A,1436,1437,N/A,110,1
7,N/A,N/A,N/A,1429,1436,N/A,115,6
3,N/A,N/A,N/A,1426,1429,N/A,118,3
3,N/A,N/A,N/A,1423,1426,N/A,124,3
7,N/A,N/A,N/A,1416,1423,N/A,127,6
7,N/A,N/A,N/A,1058,1065,N/A,6,6
4,N/A,N/A,N/A,1054,1058,N/A,10,4
2,N/A,N/A,N/A,1052,1054,N/A,13,1
5,N/A,N/A,N/A,1047,1052,N/A,17,5
4,N/A,N/A,N/A,1043,1047,N/A,22,4
3,N/A,N/A,N/A,1040,1043,N/A,27,3
2,N/A,N/A,N/A,1038,1040,N/A,31,1
4,N/A,N/A,N/A,1034,1038,N/A,34,4
1,N/A,N/A,N/A,1033,1034,N/A,37,1
1,N/A,N/A,N/A,1032,1033,N/A,43,1
4,N/A,N/A,N/A,1028,1032,N/A,46,4
4,N/A,N/A,N/A,1024,1028,N/A,52,4
2,N/A,N/A,N/A,1022,1024,N/A,56,2
1,N/A,N/A,N/A,1021,1022,N/A,61,1
6,N/A,N/A,N/A,1015,1021,N/A,66,6
1,N/A,N/A,N/A,1014,1015,N/A,72,0
6,N/A,N/A,N/A,1008,1014,N/A,77,5
4,N/A,N/A,N/A,1004,1008,N/A,82,4
1,N/A,N/A,N/A,1003,1004,N/A,85,1
6,N/A,N/A,N/A,997,1003,N/A,89,5
3,N/A,N/A,N/A,994,997,N/A,92,2
2,N/A,N/A,N/A,992,994,N/A,98,2
2,N/A,N/A,N/A,990,992,N/A,103,1
3,N/A,N/A,N/A,987,990,N/A,106,4
3,N/A,N/A,N/A,984,987,N/A,110,2
5,N/A,N/A,N/A,979,984,N/A,113,5
5,N/A,N/A,N/A,974,979,N/A,119,5
2,N/A,N/A,N/A,972,974,N/A,123,3
1,N/A,N/A,N/A,971,972,N/A,127,1
4,N/A,N/A,N/A,967,971,N/A,130,4
3,N/A,N/A,N/A,1647,1650,N/A,6,2
7,N/A,N/A,N/A,1640,1647,N/A,10,6
6,N/A,N/A,N/A,1634,1640,N/A,15,5
4,N/A,N/A,N/A,1630,1634,N/A,20,4
4,N/A,N/A,N/A,1626,1630,N/A,26,4
4,N/A,N/A,N/A,1622,1626,N/A,32,4
2,N/A,N/A,N/A,1620,1622,N/A,37,3
6,N/A,N/A,N/A,1614,1620,N/A,40,6
3,N/A,N/A,N/A,1611,1614,N/A,44,4
2,N/A,N/A,N/A,1609,1611,N/A,48,2
3,N/A,N/A,N/A,1606,1609,N/A,54,2
7,N/A,N/A,N/A,1599,1606,N/A,58,6
3,N/A,N/A,N/A,1596,1599,N/A,62,4
3,N/A,N/A,N/A,1593,1596,N/A,67,3
2,N/A,N/A,N/A,1591,1593,N/A,71,1
3,N/A,N/A,N/A,1588,1591,N/A,74,4
3,N/A,N/A,N/A,1585,1588,N/A,78,2
3,N/A,N/A,N/A,1582,1585,N/A,84,2
3,N/A,N/A,N/A,1579,1582,N/A,90,2
3,N/A,N/A,N/A,1576,1579,N/A,96,2
1,N/A,N/A,N/A,1575,1576,N/A,101,1
1,N/A,N/A,N/A,1574,1575,N/A,107,1
5,N/A,N/A,N/A,1569,1574,N/A,111,5
3,N/A,N/A,N/A,1566,1569,N/A,115,3
3,N/A,N/A,N/A,1563,1566,N/A,121,3
7,N/A,N/A,N/A,1556,1563,N/A,124,6
3,N/A,N/A,N/A,1553,1556,N/A,128,4
1,N/A,N/A,N/A,1552,1553,N/A,131,1
5,N/A,N/A,N/A,1547,1552,N/A,135,5
6,N/A,N/A,N/A,1541,1547,N/A,141,5
5,N/A,N/A,N/A,397,402,N/A,3,5
3,N/A,N/A,N/A,394,397,N/A,6,2
3,N/A,N/A,N/A,391,394,N/A,12,2
7,N/A,N/A,N/A,384,391,N/A,16,6
3,N/A,N/A,N/A,381,384,N/A,20,4
3,N/A,N/A,N/A,378,381,N/A,25,3
6,N/A,N/A,N/A,372,378,N/A,28,6
3,N/A,N/A,N/A,369,372,N/A,32,4
2,N/A,N/A,N/A,367,369,N/A,37,3
1,N/A,N/A,N/A,366,367,N/A,41,1
4,N/A,N/A,N/A,362,366,N/A,44,4
2,N/A,N/A,N/A,360,362,N/A,47,1
6,N/A,N/A,N/A,354,360,N/A,52,6
2,N/A,N/A,N/A,352,354,N/A,58,0
3,N/A,N/A,N/A,349,352,N/A,62,4
3,N/A,N/A,N/A,346,349,N/A,68,4
4,N/A,N/A,N/A,342,346,N/A,74,4
2,N/A,N/A,N/A,340,342,N/A,79,3
2,N/A,N/A,N/A,338,340,N/A,83,1
1,N/A,N/A,N/A,337,338,N/A,89,1
5,N/A,N/A,N/A,332,337,N/A,93,5
3,N/A,N/A,N/A,329,332,N/A,98,4
1,N/A,N/A,N/A,328,329,N/A,101,1
7,N/A,N/A,N/A,321,328,N/A,106,6
1,N/A,N/A,N/A,320,321,N/A,112,0
3,N/A,N/A,N/A,317,320,N/A,115,3
2,N/A,N/A,N/A,315,317,N/A,120,2
7,N/A,N/A,N/A,308,315,N/A,124,6
1,N/A,N/A,N/A,307,308,N/A,130,0
4,N/A,N/A,N/A,303,307,N/A,134,4
2,N/A,N/A,N/A,1419,1421,N/A,4,1
4,N/A,N/A,N/A,1415,1419,N/A,7,4
2,N/A,N/A,N/A,1413,1415,N/A,11,2
1,N/A,N/A,N/A,1412,1413,N/A,16,1
2,N/A,N/A,N/A,1410,1412,N/A,22,1
3,N/A,N/A,N/A,1407,1410,N/A,25,4
1,N/A,N/A,N/A,1406,1407,N/A,28,1
7,N/A,N/A,N/A,1399,1406,N/A,33,6
3,N/A,N/A,N/A,1396,1399,N/A,37,4
1,N/A,N/A,N/A,1395,1396,N/A,40,1
2,N/A,N/A,N/A,1393,1395,N/A,46,1
5,N/A,N/A,N/A,1388,1393,N/A,50,5
3,N/A,N/A,N/A,1385,1388,N/A,55,4
2,N/A,N/A,N/A,1383,1385,N/A,60,3
2,N/A,N/A,N/A,1381,1383,N/A,66,3
7,N/A,N/A,N/A,1374,1381,N/A,69,6
1,N/A,N/A,N/A,1373,1374,N/A,75,0
2,N/A,N/A,N/A,1371,1373,N/A,78,3
3,N/A,N/A,N/A,1368,1371,N/A,84,3
2,N/A,N/A,N/A,1366,1368,N/A,89,2
2,N/A,N/A,N/A,1364,1366,N/A,95,2
2,N/A,N/A,N/A,1362,1364,N/A,101,2
6,N/A,N/A,N/A,1356,1362,N/A,105,6
3,N/A,N/A,N/A,1353,1356,N/A,108,3
2,N/A,N/A,N/A,1351,1353,N/A,113,2
6,N/A,N/A,N/A,1345,1351,N/A,116,5
3,N/A,N/A,N/A,1342,1345,N/A,121,4
3,N/A,N/A,N/A,1339,1342,N/A,126,3
2,N/A,N/A,N/A,1337,1339,N/A,132,3
7,N/A,N/A,N/A,1330,1337,N/A,135,6
3,N/A,N/A,N/A,974,977,N/A,6,4
2,N/A,N/A,N/A,972,974,N/A,9,1
7,N/A,N/A,N/A,965,972,N/A,14,6
3,N/A,N/A,N/A,962,965,N/A,17,3
1,N/A,N/A,N/A,961,962,N/A,21,1
4,N/A,N/A,N/A,957,961,N/A,24,4
4,N/A,N/A,N/A,953,957,N/A,30,4
1,N/A,N/A,N/A,952,953,N/A,33,1
1,N/A,N/A,N/A,951,952,N/A,39,1
1,N/A,N/A,N/A,950,951,N/A,45,1
4,N/A,N/A,N/A,946,950,N/A,48,4
2,N/A,N/A,N/A,944,946,N/A,52,2
2,N/A,N/A,N/A,942,944,N/A,58,2
6,N/A,N/A,N/A,936,942,N/A,62,6
2,N/A,N/A,N/A,934,936,N/A,65,3
2,N/A,N/A,N/A,932,934,N/A,71,3
2,N/A,N/A,N/A,930,932,N/A,75,1
5,N/A,N/A,N/A,925,930,N/A,79,5
3,N/A,N/A,N/A,922,925,N/A,84,4
3,N/A,N/A,N/A,919,922,N/A,88,2
3,N/A,N/A,N/A,916,919,N/A,94,2
2,N/A,N/A,N/A,914,916,N/A,99,1
3,N/A,N/A,N/A,911,914,N/A,102,4
3,N/A,N/A,N/A,908,911,N/A,106,2
2,N/A,N/A,N/A,906,908,N/A,112,2
2,N/A,N/A,N/A,904,906,N/A,118,2
1,N/A,N/A,N/A,903,904,N/A,123,1
7,N/A,N/A,N/A,896,903,N/A,128,6
6,N/A,N/A,N/A,890,896,N/A,133,5
5,N/A,N/A,N/A,885,890,N/A,139,5
5,N/A,N/A,N/A,307,312,N/A,3,5
5,N/A,N/A,N/A,302,307,N/A,9,5
4,N/A,N/A,N/A,298,302,N/A,14,4
2,N/A,N/A,N/A,296,298,N/A,17,1
7,N/A,N/A,N/A,289,296,N/A,22,6
6,N/A,N/A,N/A,283,289,N/A,27,5
2,N/A,N/A,N/A,281,283,N/A,30,2
2,N/A,N/A,N/A,279,281,N/A,35,1
1,N/A,N/A,N/A,278,279,N/A,41,1
7,N/A,N/A,N/A,271,278,N/A,46,6
2,N/A,N/A,N/A,269,271,N/A,52,0
6,N/A,N/A,N/A,263,269,N/A,58,6
1,N/A,N/A,N/A,262,263,N/A,64,0
6,N/A,N/A,N/A,256,262,N/A,69,5
5,N/A,N/A,N/A,251,256,N/A,75,5
3,N/A,N/A,N/A,248,251,N/A,80,4
3,N/A,N/A,N/A,245,248,N/A,86,4
3,N/A,N/A,N/A,242,245,N/A,91,3
7,N/A,N/A,N/A,235,242,N/A,94,6
2,N/A,N/A,N/A,233,235,N/A,97,3
7,N/A,N/A,N/A,226,233,N/A,100,6
4,N/A,N/A,N/A,222,226,N/A,104,4
4,N/A,N/A,N/A,218,222,N/A,110,4
1,N/A,N/A,N/A,217,218,N/A,113,1
5,N/A,N/A,N/A,212,217,N/A,117,5
3,N/A,N/A,N/A,209,212,N/A,122,4
1,N/A,N/A,N/A,208,209,N/A,125,1
4,N/A,N/A,N/A,204,208,N/A,128,4
4,N/A,N/A,N/A,200,204,N/A,134,4
2,N/A,N/A,N/A,198,200,N/A,137,1
3,N/A,N/A,N/A,655,658,N/A,4,3
2,N/A,N/A,N/A,653,655,N/A,9,2
1,N/A,N/A,N/A,652,653,N/A,14,1
5,N/A,N/A,N/A,647,652,N/A,18,5
4,N/A,N/A,N/A,643,647,N/A,23,4
2,N/A,N/A,N/A,641,643,N/A,28,3
3,N/A,N/A,N/A,638,641,N/A,33,2
5,N/A,N/A,N/A,633,638,N/A,36,5
2,N/A,N/A,N/A,631,633,N/A,39,2
1,N/A,N/A,N/A,630,631,N/A,44,1
7,N/A,N/A,N/A,623,630,N/A,49,6
2,N/A,N/A,N/A,621,623,N/A,52,3
1,N/A,N/A,N/A,620,621,N/A,56,1
1,N/A,N/A,N/A,619,620,N/A,62,1
2,N/A,N/A,N/A,617,619,N/A,68,1
6,N/A,N/A,N/A,611,617,N/A,73,6
2,N/A,N/A,N/A,609,611,N/A,76,3
3,N/A,N/A,N/A,606,609,N/A,82,3
3,N/A,N/A,N/A,603,606,N/A,88,3
2,N/A,N/A,N/A,601,603,N/A,93,2
2,N/A,N/A,N/A,599,601,N/A,98,1
1,N/A,N/A,N/A,598,599,N/A,104,1
3,N/A,N/A,N/A,595,598,N/A,107,4
2,N/A,N/A,N/A,593,595,N/A,111,2
3,N/A,N/A,N/A,590,593,N/A,117,2
5,N/A,N/A,N/A,585,590,N/A,120,5
6,N/A,N/A,N/A,579,585,N/A,126,5
4,N/A,N/A,N/A,575,579,N/A,131,4
3,N/A,N/A,N/A,572,575,N/A,135,2
2,N/A,N/A,N/A,570,572,N/A,140,1
2,N/A,N/A,N/A,1877,1879,N/A,3,1
6,N/A,N/A,N/A,1871,1877,N/A,7,5
5,N/A,N/A,N/A,1866,1871,N/A,13,5
3,N/A,N/A,N/A,1863,1866,N/A,16,2
2,N/A,N/A,N/A,1861,1863,N/A,22,2
5,N/A,N/A,N/A,1856,1861,N/A,25,5
3,N/A,N/A,N/A,1853,1856,N/A,28,2
1,N/A,N/A,N/A,1852,1853,N/A,33,1
7,N/A,N/A,N/A,1845,1852,N/A,38,6
2,N/A,N/A,N/A,1843,1845,N/A,44,0
6,N/A,N/A,N/A,1837,1843,N/A,49,5
3,N/A,N/A,N/A,1834,1837,N/A,53,3
1,N/A,N/A,N/A,1833,1834,N/A,57,1
7,N/A,N/A,N/A,1826,1833,N/A,62,6
3,N/A,N/A,N/A,1823,1826,N/A,66,4
3,N/A,N/A,N/A,1820,1823,N/A,70,2
1,N/A,N/A,N/A,1819,1820,N/A,75,1
1,N/A,N/A,N/A,1818,1819,N/A,81,1
2,N/A,N/A,N/A,1816,1818,N/A,87,1
5,N/A,N/A,N/A,1811,1816,N/A,91,5
5,N/A,N/A,N/A,1806,1811,N/A,97,5
4,N/A,N/A,N/A,1802,1806,N/A,102,4
2,N/A,N/A,N/A,1800,1802,N/A,106,2
2,N/A,N/A,N/A,1798,1800,N/A,111,1
3,N/A,N/A,N/A,1795,1798,N/A,114,4
2,N/A,N/A,N/A,1793,1795,N/A,118,2
6,N/A,N/A,N/A,1787,1793,N/A,122,6
3,N/A,N/A,N/A,1784,1787,N/A,126,4
3,N/A,N/A,N/A,1781,1784,N/A,132,4
3,N/A,N/A,N/A,1778,1781,N/A,136,2
1,N/A,N/A,N/A,738,739,N/A,6,1
4,N/A,N/A,N/A,734,738,N/A,9,4
4,N/A,N/A,N/A,730,734,N/A,15,4
3,N/A,N/A,N/A,727,730,N/A,21,4
4,N/A,N/A,N/A,723,727,N/A,27,4
2,N/A,N/A,N/A,721,723,N/A,30,1
7,N/A,N/A,N/A,714,721,N/A,35,6
5,N/A,N/A,N/A,709,714,N/A,40,5
4,N/A,N/A,N/A,705,709,N/A,45,4
2,N/A,N/A,N/A,703,705,N/A,49,2
7,N/A,N/A,N/A,696,703,N/A,53,6
1,N/A,N/A,N/A,695,696,N/A,59,0
6,N/A,N/A,N/A,689,695,N/A,64,5
2,N/A,N/A,N/A,687,689,N/A,67,2
2,N/A,N/A,N/A,685,687,N/A,72,1
6,N/A,N/A,N/A,679,685,N/A,77,6
5,N/A,N/A,N/A,674,679,N/A,82,5
5,N/A,N/A,N/A,669,674,N/A,88,5
4,N/A,N/A,N/A,665,669,N/A,93,4
2,N/A,N/A,N/A,663,665,N/A,96,1
3,N/A,N/A,N/A,660,663,N/A,99,4
2,N/A,N/A,N/A,658,660,N/A,104,3
3,N/A,N/A,N/A,655,658,N/A,109,2
7,N/A,N/A,N/A,648,655,N/A,113,6
1,N/A,N/A,N/A,647,648,N/A,119,0
3,N/A,N/A,N/A,644,647,N/A,123,4
2,N/A,N/A,N/A,642,644,N/A,126,1
5,N/A,N/A,N/A,637,642,N/A,130,5
3,N/A,N/A,N/A,634,637,N/A,134,3
2,N/A,N/A,N/A,632,634,N/A,140,3
1,N/A,N/A,N/A,695,696,N/A,3,1
1,N/A,N/A,N/A,694,695,N/A,9,1
5,N/A,N/A,N/A,689,694,N/A,13,5
3,N/A,N/A,N/A,686,689,N/A,16,2
7,N/A,N/A,N/A,679,686,N/A,20,6
3,N/A,N/A,N/A,676,679,N/A,24,4
2,N/A,N/A,N/A,674,676,N/A,28,2
6,N/A,N/A,N/A,668,674,N/A,31,5
3,N/A,N/A,N/A,665,668,N/A,35,3
3,N/A,N/A,N/A,662,665,N/A,41,3
2,N/A,N/A,N/A,660,662,N/A,46,2
5,N/A,N/A,N/A,655,660,N/A,49,5
3,N/A,N/A,N/A,652,655,N/A,53,3
2,N/A,N/A,N/A,650,652,N/A,58,2
6,N/A,N/A,N/A,644,650,N/A,61,5
2,N/A,N/A,N/A,642,644,N/A,65,3
2,N/A,N/A,N/A,640,642,N/A,70,2
1,N/A,N/A,N/A,639,640,N/A,75,1
6,N/A,N/A,N/A,633,639,N/A,80,6
4,N/A,N/A,N/A,629,633,N/A,84,4
2,N/A,N/A,N/A,627,629,N/A,89,3
2,N/A,N/A,N/A,625,627,N/A,95,3
7,N/A,N/A,N/A,618,625,N/A,98,6
6,N/A,N/A,N/A,612,618,N/A,103,5
2,N/A,N/A,N/A,610,612,N/A,107,3
2,N/A,N/A,N/A,608,610,N/A,111,1
6,N/A,N/A,N/A,602,608,N/A,116,6
3,N/A,N/A,N/A,599,602,N/A,120,4
2,N/A,N/A,N/A,597,599,N/A,124,2
6,N/A,N/A,N/A,591,597,N/A,128,6
5,N/A,N/A,N/A,1452,1457,N/A,6,5
3,N/A,N/A,N/A,1449,1452,N/A,9,2
5,N/A,N/A,N/A,1444,1449,N/A,12,5
4,N/A,N/A,N/A,1440,1444,N/A,17,4
3,N/A,N/A,N/A,1437,1440,N/A,21,2
1,N/A,N/A,N/A,1436,1437,N/A,26,1
6,N/A,N/A,N/A,1430,1436,N/A,30,5
2,N/A,N/A,N/A,1428,1430,N/A,34,3
7,N/A,N/A,N/A,1421,1428,N/A,37,6
4,N/A,N/A,N/A,1417,1421,N/A,41,4
3,N/A,N/A,N/A,1414,1417,N/A,45,2
2,N/A,N/A,N/A,1412,1414,N/A,51,2
5,N/A,N/A,N/A,1407,1412,N/A,54,5
3,N/A,N/A,N/A,1404,1407,N/A,57,2
2,N/A,N/A,N/A,1402,1404,N/A,63,2
3,N/A,N/A,N/A,1399,1402,N/A,69,2
5,N/A,N/A,N/A,1394,1399,N/A,72,5
2,N/A,N/A,N/A,1392,1394,N/A,76,3
6,N/A,N/A,N/A,1386,1392,N/A,79,6
1,N/A,N/A,N/A,1385,1386,N/A,85,0
7,N/A,N/A,N/A,1378,1385,N/A,91,6
2,N/A,N/A,N/A,1376,1378,N/A,94,3
3,N/A,N/A,N/A,1373,1376,N/A,100,3
2,N/A,N/A,N/A,1371,1373,N/A,105,2
5,N/A,N/A,N/A,1366,1371,N/A,108,5
5,N/A,N/A,N/A,1361,1366,N/A,114,5
4,N/A,N/A,N/A,1357,1361,N/A,119,4
2,N/A,N/A,N/A,1355,1357,N/A,122,1
6,N/A,N/A,N/A,1349,1355,N/A,127,6
3,N/A,N/A,N/A,1346,1349,N/A,131,4
2,N/A,N/A,N/A,1215,1217,N/A,3,2
3,N/A,N/A,N/A,1212,1215,N/A,9,2
2,N/A,N/A,N/A,1210,1212,N/A,14,1
6,N/A,N/A,N/A,1204,1210,N/A,18,5
2,N/A,N/A,N/A,1202,1204,N/A,21,2
1,N/A,N/A,N/A,1201,1202,N/A,26,1
7,N/A,N/A,N/A,1194,1201,N/A,31,6
2,N/A,N/A,N/A,1192,1194,N/A,34,3
1,N/A,N/A,N/A,1191,1192,N/A,38,1
2,N/A,N/A,N/A,1189,1191,N/A,44,1
6,N/A,N/A,N/A,1183,1189,N/A,48,5
2,N/A,N/A,N/A,1181,1183,N/A,51,2
2,N/A,N/A,N/A,1179,1181,N/A,57,2
1,N/A,N/A,N/A,1178,1179,N/A,62,1
7,N/A,N/A,N/A,1171,1178,N/A,67,6
3,N/A,N/A,N/A,1168,1171,N/A,70,3
3,N/A,N/A,N/A,1165,1168,N/A,76,3
7,N/A,N/A,N/A,1158,1165,N/A,79,6
2,N/A,N/A,N/A,1156,1158,N/A,82,3
1,N/A,N/A,N/A,1155,1156,N/A,86,1
6,N/A,N/A,N/A,1149,1155,N/A,90,5
4,N/A,N/A,N/A,1145,1149,N/A,95,4
2,N/A,N/A,N/A,1143,1145,N/A,98,1
4,N/A,N/A,N/A,1139,1143,N/A,101,4
1,N/A,N/A,N/A,1138,1139,N/A,104,1
6,N/A,N/A,N/A,1132,1138,N/A,108,5
3,N/A,N/A,N/A,1129,1132,N/A,113,4
4,N/A,N/A,N/A,1125,1129,N/A,119,4
2,N/A,N/A,N/A,1123,1125,N/A,123,2
2,N/A,N/A,N/A,1121,1123,N/A,129,2
6,N/A,N/A,N/A,491,497,N/A,6,6
3,N/A,N/A,N/A,488,491,N/A,10,4
1,N/A,N/A,N/A,487,488,N/A,13,1
6,N/A,N/A,N/A,481,487,N/A,18,6
2,N/A,N/A,N/A,479,481,N/A,21,3
2,N/A,N/A,N/A,477,479,N/A,27,3
3,N/A,N/A,N/A,474,477,N/A,33,3
1,N/A,N/A,N/A,473,474,N/A,37,1
1,N/A,N/A,N/A,472,473,N/A,43,1
5,N/A,N/A,N/A,467,472,N/A,47,5
4,N/A,N/A,N/A,463,467,N/A,52,4
2,N/A,N/A,N/A,461,463,N/A,55,1
7,N/A,N/A,N/A,454,461,N/A,60,6
2,N/A,N/A,N/A,452,454,N/A,66,0
3,N/A,N/A,N/A,449,452,N/A,69,3
2,N/A,N/A,N/A,447,449,N/A,75,3
2,N/A,N/A,N/A,445,447,N/A,81,3
2,N/A,N/A,N/A,443,445,N/A,86,2
1,N/A,N/A,N/A,442,443,N/A,91,1
4,N/A,N/A,N/A,438,442,N/A,94,4
1,N/A,N/A,N/A,437,438,N/A,97,1
6,N/A,N/A,N/A,431,437,N/A,102,6
4,N/A,N/A,N/A,427,431,N/A,106,4
3,N/A,N/A,N/A,424,427,N/A,112,4
3,N/A,N/A,N/A,421,424,N/A,118,4
3,N/A,N/A,N/A,418,421,N/A,124,4
3,N/A,N/A,N/A,415,418,N/A,128,2
7,N/A,N/A,N/A,408,415,N/A,132,6
2,N/A,N/A,N/A,406,408,N/A,138,0
7,N/A,N/A,N/A,399,406,N/A,144,6
2,N/A,N/A,N/A,1540,1542,N/A,5,1
6,N/A,N/A,N/A,1534,1540,N/A,9,5
6,N/A,N/A,N/A,1528,1534,N/A,15,5
2,N/A,N/A,N/A,1526,1528,N/A,19,3
2,N/A,N/A,N/A,1524,1526,N/A,23,1
6,N/A,N/A,N/A,1518,1524,N/A,28,6
3,N/A,N/A,N/A,1515,1518,N/A,31,3
2,N/A,N/A,N/A,1513,1515,N/A,36,2
7,N/A,N/A,N/A,1506,1513,N/A,40,6
2,N/A,N/A,N/A,1504,1506,N/A,46,0
7,N/A,N/A,N/A,1497,1504,N/A,52,6
4,N/A,N/A,N/A,1493,1497,N/A,56,4
1,N/A,N/A,N/A,1492,1493,N/A,59,1
7,N/A,N/A,N/A,1485,1492,N/A,64,6
2,N/A,N/A,N/A,1483,1485,N/A,70,0
3,N/A,N/A,N/A,1480,1483,N/A,73,3
7,N/A,N/A,N/A,1473,1480,N/A,76,6
1,N/A,N/A,N/A,1472,1473,N/A,82,0
2,N/A,N/A,N/A,1470,1472,N/A,85,3
2,N/A,N/A,N/A,1468,1470,N/A,89,1
6,N/A,N/A,N/A,1462,1468,N/A,93,5
4,N/A,N/A,N/A,1458,1462,N/A,98,4
2,N/A,N/A,N/A,1456,1458,N/A,102,2
5,N/A,N/A,N/A,1451,1456,N/A,105,5
6,N/A,N/A,N/A,1445,1451,N/A,111,5
3,N/A,N/A,N/A,1442,1445,N/A,114,2
2,N/A,N/A,N/A,1440,1442,N/A,120,2
2,N/A,N/A,N/A,1438,1440,N/A,126,2
2,N/A,N/A,N/A,1436,1438,N/A,132,2
2,N/A,N/A,N/A,1434,1436,N/A,138,2
5,N/A,N/A,N/A,587,592,N/A,4,5
5,N/A,N/A,N/A,582,587,N/A,10,5
3,N/A,N/A,N/A,579,582,N/A,13,2
1,N/A,N/A,N/A,578,579,N/A,18,1
1,N/A,N/A,N/A,577,578,N/A,24,1
1,N/A,N/A,N/A,576,577,N/A,30,1
5,N/A,N/A,N/A,571,576,N/A,34,5
3,N/A,N/A,N/A,568,571,N/A,37,2
5,N/A,N/A,N/A,563,568,N/A,40,5
4,N/A,N/A,N/A,559,563,N/A,45,4
3,N/A,N/A,N/A,556,559,N/A,51,4
2,N/A,N/A,N/A,554,556,N/A,55,2
5,N/A,N/A,N/A,549,554,N/A,58,5
3,N/A,N/A,N/A,546,549,N/A,61,2
6,N/A,N/A,N/A,540,546,N/A,65,6
4,N/A,N/A,N/A,536,540,N/A,69,4
3,N/A,N/A,N/A,533,536,N/A,74,3
2,N/A,N/A,N/A,531,533,N/A,78,1
7,N/A,N/A,N/A,524,531,N/A,83,6
1,N/A,N/A,N/A,523,524,N/A,89,0
3,N/A,N/A,N/A,520,523,N/A,92,3
7,N/A,N/A,N/A,513,520,N/A,95,6
3,N/A,N/A,N/A,510,513,N/A,99,4
4,N/A,N/A,N/A,506,510,N/A,105,4
4,N/A,N/A,N/A,502,506,N/A,111,4
3,N/A,N/A,N/A,499,502,N/A,116,3
7,N/A,N/A,N/A,492,499,N/A,119,6
2,N/A,N/A,N/A,490,492,N/A,122,3
2,N/A,N/A,N/A,488,490,N/A,127,2
2,N/A,N/A,N/A,486,488,N/A,133,2
6,N/A,N/A,N/A,1928,1934,N/A,4,6
2,N/A,N/A,N/A,1926,1928,N/A,7,3
7,N/A,N/A,N/A,1919,1926,N/A,10,6
6,N/A,N/A,N/A,1913,1919,N/A,15,5
5,N/A,N/A,N/A,1908,1913,N/A,21,5
2,N/A,N/A,N/A,1906,1908,N/A,24,2
2,N/A,N/A,N/A,1904,1906,N/A,30,2
1,N/A,N/A,N/A,1903,1904,N/A,35,1
3,N/A,N/A,N/A,1900,1903,N/A,38,4
2,N/A,N/A,N/A,1898,1900,N/A,42,2
2,N/A,N/A,N/A,1896,1898,N/A,48,2
1,N/A,N/A,N/A,1895,1896,N/A,53,1
7,N/A,N/A,N/A,1888,1895,N/A,58,6
3,N/A,N/A,N/A,1885,1888,N/A,62,4
3,N/A,N/A,N/A,1882,1885,N/A,68,4
3,N/A,N/A,N/A,1879,1882,N/A,74,4
4,N/A,N/A,N/A,1875,1879,N/A,80,4
2,N/A,N/A,N/A,1873,1875,N/A,83,1
7,N/A,N/A,N/A,1866,1873,N/A,88,6
5,N/A,N/A,N/A,1861,1866,N/A,93,5
3,N/A,N/A,N/A,1858,1861,N/A,96,2
6,N/A,N/A,N/A,1852,1858,N/A,99,5
3,N/A,N/A,N/A,1849,1852,N/A,104,4
1,N/A,N/A,N/A,1848,1849,N/A,107,1
7,N/A,N/A,N/A,1841,1848,N/A,112,6
4,N/A,N/A,N/A,1837,1841,N/A,116,4
3,N/A,N/A,N/A,1834,1837,N/A,121,3
1,N/A,N/A,N/A,1833,1834,N/A,125,1
3,N/A,N/A,N/A,1830,1833,N/A,128,4
4,N/A,N/A,N/A,1826,1830,N/A,134,4
6,N/A,N/A,N/A,1826,1832,N/A,4,5
3,N/A,N/A,N/A,1823,1826,N/A,9,4
3,N/A,N/A,N/A,1820,1823,N/A,15,4
3,N/A,N/A,N/A,1817,1820,N/A,21,4
1,N/A,N/A,N/A,1816,1817,N/A,24,1
7,N/A,N/A,N/A,1809,1816,N/A,29,6
1,N/A,N/A,N/A,1808,1809,N/A,35,0
3,N/A,N/A,N/A,1805,1808,N/A,39,4
3,N/A,N/A,N/A,1802,1805,N/A,45,4
3,N/A,N/A,N/A,1799,1802,N/A,50,3
6,N/A,N/A,N/A,1793,1799,N/A,53,6
3,N/A,N/A,N/A,1790,1793,N/A,56,3
6,N/A,N/A,N/A,1784,1790,N/A,59,6
3,N/A,N/A,N/A,1781,1784,N/A,63,4
3,N/A,N/A,N/A,1778,1781,N/A,68,3
3,N/A,N/A,N/A,1775,1778,N/A,73,2
2,N/A,N/A,N/A,1773,1775,N/A,78,1
5,N/A,N/A,N/A,1768,1773,N/A,82,5
3,N/A,N/A,N/A,1765,1768,N/A,87,4
3,N/A,N/A,N/A,1762,1765,N/A,93,4
4,N/A,N/A,N/A,1758,1762,N/A,99,4
4,N/A,N/A,N/A,1754,1758,N/A,105,4
1,N/A,N/A,N/A,1753,1754,N/A,108,1
2,N/A,N/A,N/A,1751,1753,N/A,114,1
7,N/A,N/A,N/A,1744,1751,N/A,119,6
6,N/A,N/A,N/A,1738,1744,N/A,124,5
4,N/A,N/A,N/A,1734,1738,N/A,129,4
2,N/A,N/A,N/A,1732,1734,N/A,132,1
7,N/A,N/A,N/A,1725,1732,N/A,137,6
1,N/A,N/A,N/A,1724,1725,N/A,143,0
2,N/A,N/A,N/A,625,627,N/A,6,2
5,N/A,N/A,N/A,620,625,N/A,9,5
2,N/A,N/A,N/A,618,620,N/A,13,3
2,N/A,N/A,N/A,616,618,N/A,19,3
1,N/A,N/A,N/A,615,616,N/A,23,1
3,N/A,N/A,N/A,612,615,N/A,26,4
3,N/A,N/A,N/A,609,612,N/A,30,2
7,N/A,N/A,N/A,602,609,N/A,34,6
2,N/A,N/A,N/A,600,602,N/A,37,3
2,N/A,N/A,N/A,598,600,N/A,41,1
6,N/A,N/A,N/A,592,598,N/A,45,5
3,N/A,N/A,N/A,589,592,N/A,49,3
3,N/A,N/A,N/A,586,589,N/A,54,2
2,N/A,N/A,N/A,584,586,N/A,60,2
6,N/A,N/A,N/A,578,584,N/A,63,5
2,N/A,N/A,N/A,576,578,N/A,67,3
1,N/A,N/A,N/A,575,576,N/A,71,1
2,N/A,N/A,N/A,573,575,N/A,77,1
7,N/A,N/A,N/A,566,573,N/A,82,6
3,N/A,N/A,N/A,563,566,N/A,86,4
3,N/A,N/A,N/A,560,563,N/A,91,3
7,N/A,N/A,N/A,553,560,N/A,94,6
6,N/A,N/A,N/A,547,553,N/A,99,5
3,N/A,N/A,N/A,544,547,N/A,103,3
7,N/A,N/A,N/A,537,544,N/A,106,6
3,N/A,N/A,N/A,534,537,N/A,110,4
3,N/A,N/A,N/A,531,534,N/A,116,4
2,N/A,N/A,N/A,529,531,N/A,121,3
2,N/A,N/A,N/A,527,529,N/A,126,2
3,N/A,N/A,N/A,524,527,N/A,132,2
4,N/A,N/A,N/A,632,636,N/A,5,4
2,N/A,N/A,N/A,630,632,N/A,8,1
3,N/A,N/A,N/A,627,630,N/A,11,4
2,N/A,N/A,N/A,625,627,N/A,14,1
7,N/A,N/A,N/A,618,625,N/A,19,6
5,N/A,N/A,N/A,613,618,N/A,24,5
2,N/A,N/A,N/A,611,613,N/A,27,2
2,N/A,N/A,N/A,609,611,N/A,33,2
5,N/A,N/A,N/A,604,609,N/A,36,5
5,N/A,N/A,N/A,599,604,N/A,42,5
3,N/A,N/A,N/A,596,599,N/A,47,4
3,N/A,N/A,N/A,593,596,N/A,51,2
2,N/A,N/A,N/A,591,593,N/A,57,2
2,N/A,N/A,N/A,589,591,N/A,62,1
4,N/A,N/A,N/A,585,589,N/A,65,4
4,N/A,N/A,N/A,581,585,N/A,71,4
3,N/A,N/A,N/A,578,581,N/A,76,3
7,N/A,N/A,N/A,571,578,N/A,79,6
3,N/A,N/A,N/A,568,571,N/A,83,4
3,N/A,N/A,N/A,565,568,N/A,89,4
3,N/A,N/A,N/A,562,565,N/A,93,2
5,N/A,N/A,N/A,557,562,N/A,96,5
3,N/A,N/A,N/A,554,557,N/A,99,2
6,N/A,N/A,N/A,548,554,N/A,103,6
4,N/A,N/A,N/A,544,548,N/A,107,4
3,N/A,N/A,N/A,541,544,N/A,113,4
3,N/A,N/A,N/A,538,541,N/A,119,4
3,N/A,N/A,N/A,535,538,N/A,125,4
4,N/A,N/A,N/A,531,535,N/A,131,4
4,N/A,N/A,N/A,527,531,N/A,137,4
2,N/A,N/A,N/A,1083,1085,N/A,4,2
2,N/A,N/A,N/A,1081,1083,N/A,10,2
6,N/A,N/A,N/A,1075,1081,N/A,13,5
4,N/A,N/A,N/A,1071,1075,N/A,18,4
4,N/A,N/A,N/A,1067,1071,N/A,24,4
3,N/A,N/A,N/A,1064,1067,N/A,28,2
6,N/A,N/A,N/A,1058,1064,N/A,31,5
3,N/A,N/A,N/A,1055,1058,N/A,36,4
2,N/A,N/A,N/A,1053,1055,N/A,41,3
2,N/A,N/A,N/A,1051,1053,N/A,45,1
1,N/A,N/A,N/A,1050,1051,N/A,51,1
6,N/A,N/A,N/A,1044,1050,N/A,55,5
5,N/A,N/A,N/A,1039,1044,N/A,61,5
2,N/A,N/A,N/A,1037,1039,N/A,64,2
3,N/A,N/A,N/A,1034,1037,N/A,70,2
2,N/A,N/A,N/A,1032,1034,N/A,76,2
3,N/A,N/A,N/A,1029,1032,N/A,82,2
2,N/A,N/A,N/A,1027,1029,N/A,87,1
5,N/A,N/A,N/A,1022,1027,N/A,91,5
4,N/A,N/A,N/A,1018,1022,N/A,96,4
3,N/A,N/A,N/A,1015,1018,N/A,101,3
7,N/A,N/A,N/A,1008,1015,N/A,104,6
3,N/A,N/A,N/A,1005,1008,N/A,108,4
2,N/A,N/A,N/A,1003,1005,N/A,113,3
7,N/A,N/A,N/A,996,1003,N/A,116,6
3,N/A,N/A,N/A,993,996,N/A,119,3
2,N/A,N/A,N/A,991,993,N/A,124,2
7,N/A,N/A,N/A,984,991,N/A,128,6
2,N/A,N/A,N/A,982,984,N/A,134,0
7,N/A,N/A,N/A,975,982,N/A,140,6
2,N/A,N/A,N/A,475,477,N/A,4,3
2,N/A,N/A,N/A,473,475,N/A,8,1
2,N/A,N/A,N/A,471,473,N/A,14,1
1,N/A,N/A,N/A,470,471,N/A,20,1
4,N/A,N/A,N/A,466,470,N/A,23,4
3,N/A,N/A,N/A,463,466,N/A,27,2
1,N/A,N/A,N/A,462,463,N/A,32,1
5,N/A,N/A,N/A,457,462,N/A,36,5
3,N/A,N/A,N/A,454,457,N/A,41,4
3,N/A,N/A,N/A,451,454,N/A,47,4
3,N/A,N/A,N/A,448,451,N/A,53,4
4,N/A,N/A,N/A,444,448,N/A,59,4
2,N/A,N/A,N/A,442,444,N/A,62,1
6,N/A,N/A,N/A,436,442,N/A,67,6
2,N/A,N/A,N/A,434,436,N/A,73,0
6,N/A,N/A,N/A,428,434,N/A,78,5
3,N/A,N/A,N/A,425,428,N/A,83,4
1,N/A,N/A,N/A,424,425,N/A,86,1
3,N/A,N/A,N/A,421,424,N/A,89,4
1,N/A,N/A,N/A,420,421,N/A,92,1
2,N/A,N/A,N/A,418,420,N/A,98,1
6,N/A,N/A,N/A,412,418,N/A,103,6
6,N/A,N/A,N/A,406,412,N/A,108,5
3,N/A,N/A,N/A,403,406,N/A,113,4
3,N/A,N/A,N/A,400,403,N/A,117,2
3,N/A,N/A,N/A,397,400,N/A,123,2
6,N/A,N/A,N/A,391,397,N/A,127,6
6,N/A,N/A,N/A,385,391,N/A,132,5
5,N/A,N/A,N/A,380,385,N/A,138,5
2,N/A,N/A,N/A,378,380,N/A,141,2
2,N/A,N/A,N/A,1965,1967,N/A,5,2
1,N/A,N/A,N/A,1964,1965,N/A,10,1
5,N/A,N/A,N/A,1959,1964,N/A,14,5
3,N/A,N/A,N/A,1956,1959,N/A,19,4
4,N/A,N/A,N/A,1952,1956,N/A,25,4
1,N/A,N/A,N/A,1951,1952,N/A,28,1
3,N/A,N/A,N/A,1948,1951,N/A,31,4
3,N/A,N/A,N/A,1945,1948,N/A,36,3
3,N/A,N/A,N/A,1942,1945,N/A,41,2
2,N/A,N/A,N/A,1940,1942,N/A,47,2
5,N/A,N/A,N/A,1935,1940,N/A,50,5
3,N/A,N/A,N/A,1932,1935,N/A,53,2
5,N/A,N/A,N/A,1927,1932,N/A,56,5
3,N/A,N/A,N/A,1924,1927,N/A,59,2
5,N/A,N/A,N/A,1919,1924,N/A,62,5
3,N/A,N/A,N/A,1916,1919,N/A,67,4
1,N/A,N/A,N/A,1915,1916,N/A,70,1
6,N/A,N/A,N/A,1909,1915,N/A,75,6
1,N/A,N/A,N/A,1908,1909,N/A,81,0
3,N/A,N/A,N/A,1905,1908,N/A,85,4
1,N/A,N/A,N/A,1904,1905,N/A,88,1
3,N/A,N/A,N/A,1901,1904,N/A,91,4
3,N/A,N/A,N/A,1898,1901,N/A,96,3
2,N/A,N/A,N/A,1896,1898,N/A,100,1
4,N/A,N/A,N/A,1892,1896,N/A,103,4
4,N/A,N/A,N/A,1888,1892,N/A,109,4
4,N/A,N/A,N/A,1884,1888,N/A,115,4
2,N/A,N/A,N/A,1882,1884,N/A,118,1
2,N/A,N/A,N/A,1880,1882,N/A,124,1
3,N/A,N/A,N/A,1877,1880,N/A,127,4
2,N/A,N/A,N/A,771,773,N/A,3,3
2,N/A,N/A,N/A,769,771,N/A,8,2
6,N/A,N/A,N/A,763,769,N/A,11,5
3,N/A,N/A,N/A,760,763,N/A,16,4
2,N/A,N/A,N/A,758,760,N/A,19,1
2,N/A,N/A,N/A,756,758,N/A,25,1
2,N/A,N/A,N/A,754,756,N/A,31,1
6,N/A,N/A,N/A,748,754,N/A,35,5
3,N/A,N/A,N/A,745,748,N/A,40,4
2,N/A,N/A,N/A,743,745,N/A,43,1
5,N/A,N/A,N/A,738,743,N/A,47,5
2,N/A,N/A,N/A,736,738,N/A,50,2
2,N/A,N/A,N/A,734,736,N/A,55,1
7,N/A,N/A,N/A,727,734,N/A,60,6
3,N/A,N/A,N/A,724,727,N/A,63,3
2,N/A,N/A,N/A,722,724,N/A,68,2
1,N/A,N/A,N/A,721,722,N/A,73,1
5,N/A,N/A,N/A,716,721,N/A,77,5
4,N/A,N/A,N/A,712,716,N/A,82,4
3,N/A,N/A,N/A,709,712,N/A,87,3
1,N/A,N/A,N/A,708,709,N/A,91,1
6,N/A,N/A,N/A,702,708,N/A,95,5
6,N/A,N/A,N/A,696,702,N/A,101,5
2,N/A,N/A,N/A,694,696,N/A,104,2
6,N/A,N/A,N/A,688,694,N/A,108,6
1,N/A,N/A,N/A,687,688,N/A,114,0
3,N/A,N/A,N/A,684,687,N/A,118,4
2,N/A,N/A,N/A,682,684,N/A,123,3
1,N/A,N/A,N/A,681,682,N/A,127,1
1,N/A,N/A,N/A,680,681,N/A,133,1
2,N/A,N/A,N/A,606,608,N/A,6,1
1,N/A,N/A,N/A,605,606,N/A,12,1
2,N/A,N/A,N/A,603,605,N/A,18,1
6,N/A,N/A,N/A,597,603,N/A,22,5
6,N/A,N/A,N/A,591,597,N/A,28,5
3,N/A,N/A,N/A,588,591,N/A,32,3
2,N/A,N/A,N/A,586,588,N/A,36,1
6,N/A,N/A,N/A,580,586,N/A,41,6
2,N/A,N/A,N/A,578,580,N/A,47,0
6,N/A,N/A,N/A,572,578,N/A,52,5
3,N/A,N/A,N/A,569,572,N/A,57,4
2,N/A,N/A,N/A,567,569,N/A,61,2
3,N/A,N/A,N/A,564,567,N/A,67,2
2,N/A,N/A,N/A,562,564,N/A,72,1
2,N/A,N/A,N/A,560,562,N/A,78,1
2,N/A,N/A,N/A,558,560,N/A,84,1
2,N/A,N/A,N/A,556,558,N/A,90,1
1,N/A,N/A,N/A,555,556,N/A,96,1
5,N/A,N/A,N/A,550,555,N/A,100,5
2,N/A,N/A,N/A,548,550,N/A,104,3
2,N/A,N/A,N/A,546,548,N/A,109,2
3,N/A,N/A,N/A,543,546,N/A,115,2
3,N/A,N/A,N/A,540,543,N/A,121,2
2,N/A,N/A,N/A,538,540,N/A,127,2
7,N/A,N/A,N/A,531,538,N/A,131,6
2,N/A,N/A,N/A,529,531,N/A,134,3
2,N/A,N/A,N/A,527,529,N/A,138,1
4,N/A,N/A,N/A,523,527,N/A,141,4
2,N/A,N/A,N/A,521,523,N/A,144,1
1,N/A,N/A,N/A,520,521,N/A,150,1
3,N/A,N/A,N/A,476,479,N/A,6,2
1,N/A,N/A,N/A,475,476,N/A,11,1
1,N/A,N/A,N/A,474,475,N/A,17,1
4,N/A,N/A,N/A,470,474,N/A,20,4
3,N/A,N/A,N/A,467,470,N/A,24,2
7,N/A,N/A,N/A,460,467,N/A,28,6
3,N/A,N/A,N/A,457,460,N/A,31,3
2,N/A,N/A,N/A,455,457,N/A,37,3
3,N/A,N/A,N/A,452,455,N/A,42,2
2,N/A,N/A,N/A,450,452,N/A,47,1
2,N/A,N/A,N/A,448,450,N/A,53,1
5,N/A,N/A,N/A,443,448,N/A,57,5
3,N/A,N/A,N/A,440,443,N/A,60,2
5,N/A,N/A,N/A,435,440,N/A,63,5
3,N/A,N/A,N/A,432,435,N/A,67,3
6,N/A,N/A,N/A,426,432,N/A,70,6
6,N/A,N/A,N/A,420,426,N/A,75,5
2,N/A,N/A,N/A,418,420,N/A,78,2
1,N/A,N/A,N/A,417,418,N/A,83,1
6,N/A,N/A,N/A,411,417,N/A,88,6
2,N/A,N/A,N/A,409,411,N/A,94,0
2,N/A,N/A,N/A,407,409,N/A,97,3
2,N/A,N/A,N/A,405,407,N/A,101,1
4,N/A,N/A,N/A,401,405,N/A,104,4
3,N/A,N/A,N/A,398,401,N/A,110,4
2,N/A,N/A,N/A,396,398,N/A,113,1
3,N/A,N/A,N/A,393,396,N/A,116,4
2,N/A,N/A,N/A,391,393,N/A,121,3
7,N/A,N/A,N/A,384,391,N/A,124,6
6,N/A,N/A,N/A,378,384,N/A,129,5
6,N/A,N/A,N/A,1428,1434,N/A,6,6
1,N/A,N/A,N/A,1427,1428,N/A,12,0
3,N/A,N/A,N/A,1424,1427,N/A,16,4
2,N/A,N/A,N/A,1422,1424,N/A,19,1
2,N/A,N/A,N/A,1420,1422,N/A,25,1
2,N/A,N/A,N/A,1418,1420,N/A,31,1
3,N/A,N/A,N/A,1415,1418,N/A,34,4
3,N/A,N/A,N/A,1412,1415,N/A,40,4
3,N/A,N/A,N/A,1409,1412,N/A,44,2
5,N/A,N/A,N/A,1404,1409,N/A,47,5
3,N/A,N/A,N/A,1401,1404,N/A,51,3
3,N/A,N/A,N/A,1398,1401,N/A,57,3
3,N/A,N/A,N/A,1395,1398,N/A,63,3
2,N/A,N/A,N/A,1393,1395,N/A,68,2
7,N/A,N/A,N/A,1386,1393,N/A,72,6
5,N/A,N/A,N/A,1381,1386,N/A,77,5
6,N/A,N/A,N/A,1375,1381,N/A,83,5
3,N/A,N/A,N/A,1372,1375,N/A,87,3
3,N/A,N/A,N/A,1369,1372,N/A,93,3
6,N/A,N/A,N/A,1363,1369,N/A,96,6
4,N/A,N/A,N/A,1359,1363,N/A,100,4
3,N/A,N/A,N/A,1356,1359,N/A,105,3
2,N/A,N/A,N/A,1354,1356,N/A,109,1
1,N/A,N/A,N/A,1353,1354,N/A,115,1
5,N/A,N/A,N/A,1348,1353,N/A,119,5
4,N/A,N/A,N/A,1344,1348,N/A,124,4
2,N/A,N/A,N/A,1342,1344,N/A,129,3
6,N/A,N/A,N/A,1336,1342,N/A,132,6
2,N/A,N/A,N/A,1334,1336,N/A,135,3
3,N/A,N/A,N/A,1331,1334,N/A,140,2
3,N/A,N/A,N/A,1467,1470,N/A,5,4
3,N/A,N/A,N/A,1464,1467,N/A,9,2
5,N/A,N/A,N/A,1459,1464,N/A,12,5
3,N/A,N/A,N/A,1456,1459,N/A,16,3
7,N/A,N/A,N/A,1449,1456,N/A,19,6
5,N/A,N/A,N/A,1444,1449,N/A,24,5
3,N/A,N/A,N/A,1441,1444,N/A,29,4
2,N/A,N/A,N/A,1439,1441,N/A,34,3
3,N/A,N/A,N/A,1436,1439,N/A,40,3
6,N/A,N/A,N/A,1430,1436,N/A,43,6
1,N/A,N/A,N/A,1429,1430,N/A,49,0
2,N/A,N/A,N/A,1427,1429,N/A,52,3
3,N/A,N/A,N/A,1424,1427,N/A,58,3
2,N/A,N/A,N/A,1422,1424,N/A,64,3
2,N/A,N/A,N/A,1420,1422,N/A,68,1
1,N/A,N/A,N/A,1419,1420,N/A,74,1
6,N/A,N/A,N/A,1413,1419,N/A,78,5
2,N/A,N/A,N/A,1411,1413,N/A,81,2
1,N/A,N/A,N/A,1410,1411,N/A,86,1
4,N/A,N/A,N/A,1406,1410,N/A,89,4
3,N/A,N/A,N/A,1403,1406,N/A,95,4
1,N/A,N/A,N/A,1402,1403,N/A,98,1
4,N/A,N/A,N/A,1398,1402,N/A,101,4
3,N/A,N/A,N/A,1395,1398,N/A,106,3
3,N/A,N/A,N/A,1392,1395,N/A,111,2
3,N/A,N/A,N/A,1389,1392,N/A,117,2
1,N/A,N/A,N/A,1388,1389,N/A,122,1
1,N/A,N/A,N/A,1387,1388,N/A,128,1
6,N/A,N/A,N/A,1381,1387,N/A,133,6
3,N/A,N/A,N/A,1378,1381,N/A,136,3
1,N/A,N/A,N/A,441,442,N/A,6,1
4,N/A,N/A,N/A,437,441,N/A,9,4
3,N/A,N/A,N/A,434,437,N/A,13,2
1,N/A,N/A,N/A,433,434,N/A,18,1
5,N/A,N/A,N/A,428,433,N/A,22,5
2,N/A,N/A,N/A,426,428,N/A,25,2
3,N/A,N/A,N/A,423,426,N/A,31,2
3,N/A,N/A,N/A,420,423,N/A,37,2
5,N/A,N/A,N/A,415,420,N/A,40,5
2,N/A,N/A,N/A,413,415,N/A,43,2
3,N/A,N/A,N/A,410,413,N/A,49,2
2,N/A,N/A,N/A,408,410,N/A,54,1
3,N/A,N/A,N/A,405,408,N/A,57,4
4,N/A,N/A,N/A,401,405,N/A,63,4
1,N/A,N/A,N/A,400,401,N/A,66,1
1,N/A,N/A,N/A,399,400,N/A,72,1
2,N/A,N/A,N/A,397,399,N/A,78,1
6,N/A,N/A,N/A,391,397,N/A,83,6
2,N/A,N/A,N/A,389,391,N/A,86,3
3,N/A,N/A,N/A,386,389,N/A,91,2
1,N/A,N/A,N/A,385,386,N/A,96,1
3,N/A,N/A,N/A,382,385,N/A,99,4
3,N/A,N/A,N/A,379,382,N/A,104,3
7,N/A,N/A,N/A,372,379,N/A,107,6
3,N/A,N/A,N/A,369,372,N/A,111,4
3,N/A,N/A,N/A,366,369,N/A,116,3
2,N/A,N/A,N/A,364,366,N/A,120,1
4,N/A,N/A,N/A,360,364,N/A,123,4
3,N/A,N/A,N/A,357,360,N/A,127,2
2,N/A,N/A,N/A,355,357,N/A,132,1
6,N/A,N/A,N/A,963,969,N/A,4,6
1,N/A,N/A,N/A,962,963,N/A,10,0
7,N/A,N/A,N/A,955,962,N/A,16,6
6,N/A,N/A,N/A,949,955,N/A,21,5
5,N/A,N/A,N/A,944,949,N/A,27,5
2,N/A,N/A,N/A,942,944,N/A,31,3
2,N/A,N/A,N/A,940,942,N/A,36,2
2,N/A,N/A,N/A,938,940,N/A,42,2
5,N/A,N/A,N/A,933,938,N/A,45,5
5,N/A,N/A,N/A,928,933,N/A,51,5
4,N/A,N/A,N/A,924,928,N/A,56,4
2,N/A,N/A,N/A,922,924,N/A,60,2
7,N/A,N/A,N/A,915,922,N/A,64,6
2,N/A,N/A,N/A,913,915,N/A,67,3
6,N/A,N/A,N/A,907,913,N/A,70,6
3,N/A,N/A,N/A,904,907,N/A,74,4
2,N/A,N/A,N/A,902,904,N/A,77,1
4,N/A,N/A,N/A,898,902,N/A,80,4
2,N/A,N/A,N/A,896,898,N/A,83,1
1,N/A,N/A,N/A,895,896,N/A,89,1
3,N/A,N/A,N/A,892,895,N/A,92,4
1,N/A,N/A,N/A,891,892,N/A,95,1
3,N/A,N/A,N/A,888,891,N/A,98,4
4,N/A,N/A,N/A,884,888,N/A,104,4
2,N/A,N/A,N/A,882,884,N/A,108,2
6,N/A,N/A,N/A,876,882,N/A,111,5
4,N/A,N/A,N/A,872,876,N/A,116,4
3,N/A,N/A,N/A,869,872,N/A,122,4
4,N/A,N/A,N/A,865,869,N/A,128,4
4,N/A,N/A,N/A,861,865,N/A,134,4
5,N/A,N/A,N/A,1773,1778,N/A,5,5
4,N/A,N/A,N/A,1769,1773,N/A,10,4
3,N/A,N/A,N/A,1766,1769,N/A,14,2
6,N/A,N/A,N/A,1760,1766,N/A,18,6
5,N/A,N/A,N/A,1755,1760,N/A,23,5
5,N/A,N/A,N/A,1750,1755,N/A,29,5
5,N/A,N/A,N/A,1745,1750,N/A,35,5
3,N/A,N/A,N/A,1742,1745,N/A,38,2
3,N/A,N/A,N/A,1739,1742,N/A,44,2
3,N/A,N/A,N/A,1736,1739,N/A,50,2
6,N/A,N/A,N/A,1730,1736,N/A,54,6
3,N/A,N/A,N/A,1727,1730,N/A,58,4
2,N/A,N/A,N/A,1725,1727,N/A,62,2
6,N/A,N/A,N/A,1719,1725,N/A,66,6
2,N/A,N/A,N/A,1717,1719,N/A,72,0
3,N/A,N/A,N/A,1714,1717,N/A,75,3
3,N/A,N/A,N/A,1711,1714,N/A,80,2
6,N/A,N/A,N/A,1705,1711,N/A,84,6
3,N/A,N/A,N/A,1702,1705,N/A,88,4
2,N/A,N/A,N/A,1700,1702,N/A,93,3
2,N/A,N/A,N/A,1698,1700,N/A,99,3
3,N/A,N/A,N/A,1695,1698,N/A,105,3
6,N/A,N/A,N/A,1689,1695,N/A,108,6
2,N/A,N/A,N/A,1687,1689,N/A,111,3
1,N/A,N/A,N/A,1686,1687,N/A,115,1
4,N/A,N/A,N/A,1682,1686,N/A,118,4
3,N/A,N/A,N/A,1679,1682,N/A,122,2
3,N/A,N/A,N/A,1676,1679,N/A,128,2
6,N/A,N/A,N/A,1670,1676,N/A,132,6
2,N/A,N/A,N/A,1668,1670,N/A,135,3
2,N/A,N/A,N/A,1572,1574,N/A,4,2
2,N/A,N/A,N/A,1570,1572,N/A,9,1
6,N/A,N/A,N/A,1564,1570,N/A,13,5
3,N/A,N/A,N/A,1561,1564,N/A,16,2
2,N/A,N/A,N/A,1559,1561,N/A,21,1
6,N/A,N/A,N/A,1553,1559,N/A,25,5
6,N/A,N/A,N/A,1547,1553,N/A,31,5
4,N/A,N/A,N/A,1543,1547,N/A,36,4
2,N/A,N/A,N/A,1541,1543,N/A,40,2
7,N/A,N/A,N/A,1534,1541,N/A,44,6
3,N/A,N/A,N/A,1531,1534,N/A,47,3
2,N/A,N/A,N/A,1529,1531,N/A,51,1
6,N/A,N/A,N/A,1523,1529,N/A,56,6
2,N/A,N/A,N/A,1521,1523,N/A,59,3
3,N/A,N/A,N/A,1518,1521,N/A,64,2
6,N/A,N/A,N/A,1512,1518,N/A,68,6
4,N/A,N/A,N/A,1508,1512,N/A,72,4
2,N/A,N/A,N/A,1506,1508,N/A,76,2
6,N/A,N/A,N/A,1500,1506,N/A,79,5
3,N/A,N/A,N/A,1497,1500,N/A,84,4
3,N/A,N/A,N/A,1494,1497,N/A,89,3
7,N/A,N/A,N/A,1487,1494,N/A,92,6
2,N/A,N/A,N/A,1485,1487,N/A,98,0
2,N/A,N/A,N/A,1483,1485,N/A,101,3
2,N/A,N/A,N/A,1481,1483,N/A,105,1
6,N/A,N/A,N/A,1475,1481,N/A,110,6
3,N/A,N/A,N/A,1472,1475,N/A,114,4
2,N/A,N/A,N/A,1470,1472,N/A,118,2
2,N/A,N/A,N/A,1468,1470,N/A,124,2
2,N/A,N/A,N/A,1466,1468,N/A,130,2
6,N/A,N/A,N/A,1298,1304,N/A,4,5
3,N/A,N/A,N/A,1295,1298,N/A,7,2
5,N/A,N/A,N/A,1290,1295,N/A,10,5
3,N/A,N/A,N/A,1287,1290,N/A,15,4
2,N/A,N/A,N/A,1285,1287,N/A,18,1
6,N/A,N/A,N/A,1279,1285,N/A,23,6
5,N/A,N/A,N/A,1274,1279,N/A,28,5
5,N/A,N/A,N/A,1269,1274,N/A,34,5
5,N/A,N/A,N/A,1264,1269,N/A,40,5
3,N/A,N/A,N/A,1261,1264,N/A,44,3
3,N/A,N/A,N/A,1258,1261,N/A,50,3
1,N/A,N/A,N/A,1257,1258,N/A,54,1
2,N/A,N/A,N/A,1255,1257,N/A,60,1
3,N/A,N/A,N/A,1252,1255,N/A,63,4
2,N/A,N/A,N/A,1250,1252,N/A,68,3
3,N/A,N/A,N/A,1247,1250,N/A,73,2
6,N/A,N/A,N/A,1241,1247,N/A,77,6
2,N/A,N/A,N/A,1239,1241,N/A,80,3
2,N/A,N/A,N/A,1237,1239,N/A,85,2
6,N/A,N/A,N/A,1231,1237,N/A,88,5
4,N/A,N/A,N/A,1227,1231,N/A,93,4
3,N/A,N/A,N/A,1224,1227,N/A,98,3
3,N/A,N/A,N/A,1221,1224,N/A,103,2
1,N/A,N/A,N/A,1220,1221,N/A,108,1
3,N/A,N/A,N/A,1217,1220,N/A,111,4
3,N/A,N/A,N/A,1214,1217,N/A,115,2
6,N/A,N/A,N/A,1208,1214,N/A,119,6
3,N/A,N/A,N/A,1205,1208,N/A,122,3
3,N/A,N/A,N/A,1202,1205,N/A,127,2
6,N/A,N/A,N/A,1196,1202,N/A,131,6
2,N/A,N/A,N/A,1346,1348,N/A,6,1
1,N/A,N/A,N/A,1345,1346,N/A,12,1
3,N/A,N/A,N/A,1342,1345,N/A,15,4
3,N/A,N/A,N/A,1339,1342,N/A,20,3
2,N/A,N/A,N/A,1337,1339,N/A,26,3
2,N/A,N/A,N/A,1335,1337,N/A,31,2
2,N/A,N/A,N/A,1333,1335,N/A,36,1
6,N/A,N/A,N/A,1327,1333,N/A,40,5
4,N/A,N/A,N/A,1323,1327,N/A,45,4
3,N/A,N/A,N/A,1320,1323,N/A,50,3
2,N/A,N/A,N/A,1318,1320,N/A,56,3
6,N/A,N/A,N/A,1312,1318,N/A,59,6
2,N/A,N/A,N/A,1310,1312,N/A,65,0
5,N/A,N/A,N/A,1305,1310,N/A,70,5
2,N/A,N/A,N/A,1303,1305,N/A,73,2
2,N/A,N/A,N/A,1301,1303,N/A,79,2
3,N/A,N/A,N/A,1298,1301,N/A,85,2
2,N/A,N/A,N/A,1296,1298,N/A,91,2
2,N/A,N/A,N/A,1294,1296,N/A,97,2
2,N/A,N/A,N/A,1292,1294,N/A,102,1
6,N/A,N/A,N/A,1286,1292,N/A,107,6
2,N/A,N/A,N/A,1284,1286,N/A,110,3
3,N/A,N/A,N/A,1281,1284,N/A,116,3
3,N/A,N/A,N/A,1278,1281,N/A,121,2
2,N/A,N/A,N/A,1276,1278,N/A,126,1
6,N/A,N/A,N/A,1270,1276,N/A,130,5
2,N/A,N/A,N/A,1268,1270,N/A,133,2
7,N/A,N/A,N/A,1261,1268,N/A,137,6
2,N/A,N/A,N/A,1259,1261,N/A,140,3
1,N/A,N/A,N/A,1258,1259,N/A,144,1
3,N/A,N/A,N/A,1505,1508,N/A,4,4
2,N/A,N/A,N/A,1503,1505,N/A,7,1
2,N/A,N/A,N/A,1501,1503,N/A,13,1
6,N/A,N/A,N/A,1495,1501,N/A,18,6
6,N/A,N/A,N/A,1489,1495,N/A,23,5
4,N/A,N/A,N/A,1485,1489,N/A,28,4
2,N/A,N/A,N/A,1483,1485,N/A,31,1
1,N/A,N/A,N/A,1482,1483,N/A,37,1
6,N/A,N/A,N/A,1476,1482,N/A,41,5
3,N/A,N/A,N/A,1473,1476,N/A,44,2
6,N/A,N/A,N/A,1467,1473,N/A,48,6
3,N/A,N/A,N/A,1464,1467,N/A,51,3
1,N/A,N/A,N/A,1463,1464,N/A,55,1
3,N/A,N/A,N/A,1460,1463,N/A,58,4
3,N/A,N/A,N/A,1457,1460,N/A,62,2
2,N/A,N/A,N/A,1455,1457,N/A,67,1
6,N/A,N/A,N/A,1449,1455,N/A,72,6
3,N/A,N/A,N/A,1446,1449,N/A,75,3
7,N/A,N/A,N/A,1439,1446,N/A,78,6
4,N/A,N/A,N/A,1435,1439,N/A,82,4
4,N/A,N/A,N/A,1431,1435,N/A,88,4
2,N/A,N/A,N/A,1429,1431,N/A,93,3
2,N/A,N/A,N/A,1427,1429,N/A,97,1
6,N/A,N/A,N/A,1421,1427,N/A,101,5
5,N/A,N/A,N/A,1416,1421,N/A,107,5
3,N/A,N/A,N/A,1413,1416,N/A,112,4
2,N/A,N/A,N/A,1411,1413,N/A,117,3
1,N/A,N/A,N/A,1410,1411,N/A,121,1
5,N/A,N/A,N/A,1405,1410,N/A,125,5
6,N/A,N/A,N/A,1399,1405,N/A,131,5
3,N/A,N/A,N/A,616,619,N/A,5,4
1,N/A,N/A,N/A,615,616,N/A,8,1
2,N/A,N/A,N/A,613,615,N/A,14,1
5,N/A,N/A,N/A,608,613,N/A,18,5
2,N/A,N/A,N/A,606,608,N/A,21,2
6,N/A,N/A,N/A,600,606,N/A,24,5
3,N/A,N/A,N/A,597,600,N/A,28,3
3,N/A,N/A,N/A,594,597,N/A,33,2
7,N/A,N/A,N/A,587,594,N/A,37,6
1,N/A,N/A,N/A,586,587,N/A,43,0
7,N/A,N/A,N/A,579,586,N/A,49,6
5,N/A,N/A,N/A,574,579,N/A,54,5
2,N/A,N/A,N/A,572,574,N/A,57,2
6,N/A,N/A,N/A,566,572,N/A,60,5
5,N/A,N/A,N/A,561,566,N/A,66,5
6,N/A,N/A,N/A,555,561,N/A,72,5
6,N/A,N/A,N/A,549,555,N/A,78,5
3,N/A,N/A,N/A,546,549,N/A,82,3
2,N/A,N/A,N/A,544,546,N/A,86,1
3,N/A,N/A,N/A,541,544,N/A,89,4
3,N/A,N/A,N/A,538,541,N/A,94,3
3,N/A,N/A,N/A,535,538,N/A,99,2
2,N/A,N/A,N/A,533,535,N/A,105,2
5,N/A,N/A,N/A,528,533,N/A,108,5
2,N/A,N/A,N/A,526,528,N/A,111,2
3,N/A,N/A,N/A,523,526,N/A,117,2
5,N/A,N/A,N/A,518,523,N/A,120,5
5,N/A,N/A,N/A,513,518,N/A,126,5
5,N/A,N/A,N/A,508,513,N/A,132,5
2,N/A,N/A,N/A,506,508,N/A,135,2
3,N/A,N/A,N/A,590,593,N/A,6,2
6,N/A,N/A,N/A,584,590,N/A,10,6
2,N/A,N/A,N/A,582,584,N/A,13,3
1,N/A,N/A,N/A,581,582,N/A,17,1
7,N/A,N/A,N/A,574,581,N/A,22,6
5,N/A,N/A,N/A,569,574,N/A,27,5
2,N/A,N/A,N/A,567,569,N/A,31,3
3,N/A,N/A,N/A,564,567,N/A,37,3
2,N/A,N/A,N/A,562,564,N/A,41,1
2,N/A,N/A,N/A,560,562,N/A,47,1
4,N/A,N/A,N/A,556,560,N/A,50,4
2,N/A,N/A,N/A,554,556,N/A,53,1
4,N/A,N/A,N/A,550,554,N/A,56,4
3,N/A,N/A,N/A,547,550,N/A,62,4
2,N/A,N/A,N/A,545,547,N/A,65,1
4,N/A,N/A,N/A,541,545,N/A,68,4
2,N/A,N/A,N/A,539,541,N/A,72,2
7,N/A,N/A,N/A,532,539,N/A,76,6
1,N/A,N/A,N/A,531,532,N/A,82,0
6,N/A,N/A,N/A,525,531,N/A,88,6
6,N/A,N/A,N/A,519,525,N/A,93,5
3,N/A,N/A,N/A,516,519,N/A,97,3
6,N/A,N/A,N/A,510,516,N/A,100,6
6,N/A,N/A,N/A,504,510,N/A,105,5
3,N/A,N/A,N/A,501,504,N/A,109,3
3,N/A,N/A,N/A,498,501,N/A,114,2
1,N/A,N/A,N/A,497,498,N/A,119,1
3,N/A,N/A,N/A,494,497,N/A,122,4
3,N/A,N/A,N/A,491,494,N/A,126,2
3,N/A,N/A,N/A,488,491,N/A,132,2
7,N/A,N/A,N/A,422,429,N/A,3,6
5,N/A,N/A,N/A,417,422,N/A,8,5
5,N/A,N/A,N/A,412,417,N/A,14,5
3,N/A,N/A,N/A,409,412,N/A,19,4
2,N/A,N/A,N/A,407,409,N/A,23,2
6,N/A,N/A,N/A,401,407,N/A,26,5
3,N/A,N/A,N/A,398,401,N/A,29,2
5,N/A,N/A,N/A,393,398,N/A,32,5
2,N/A,N/A,N/A,391,393,N/A,36,3
1,N/A,N/A,N/A,390,391,N/A,40,1
5,N/A,N/A,N/A,385,390,N/A,44,5
5,N/A,N/A,N/A,380,385,N/A,50,5
2,N/A,N/A,N/A,378,380,N/A,54,3
6,N/A,N/A,N/A,372,378,N/A,57,6
2,N/A,N/A,N/A,370,372,N/A,63,0
4,N/A,N/A,N/A,366,370,N/A,67,4
2,N/A,N/A,N/A,364,366,N/A,71,2
2,N/A,N/A,N/A,362,364,N/A,76,1
6,N/A,N/A,N/A,356,362,N/A,80,5
3,N/A,N/A,N/A,353,356,N/A,84,3
6,N/A,N/A,N/A,347,353,N/A,87,6
2,N/A,N/A,N/A,345,347,N/A,90,3
2,N/A,N/A,N/A,343,345,N/A,96,3
7,N/A,N/A,N/A,336,343,N/A,99,6
4,N/A,N/A,N/A,332,336,N/A,103,4
1,N/A,N/A,N/A,331,332,N/A,106,1
5,N/A,N/A,N/A,326,331,N/A,110,5
2,N/A,N/A,N/A,324,326,N/A,114,3
2,N/A,N/A,N/A,322,324,N/A,119,2
6,N/A,N/A,N/A,316,322,N/A,123,6
2,N/A,N/A,N/A,1116,1118,N/A,6,3
1,N/A,N/A,N/A,1115,1116,N/A,10,1
6,N/A,N/A,N/A,1109,1115,N/A,14,5
3,N/A,N/A,N/A,1106,1109,N/A,19,4
3,N/A,N/A,N/A,1103,1106,N/A,25,4
4,N/A,N/A,N/A,1099,1103,N/A,31,4
3,N/A,N/A,N/A,1096,1099,N/A,37,4
2,N/A,N/A,N/A,1094,1096,N/A,42,3
1,N/A,N/A,N/A,1093,1094,N/A,46,1
7,N/A,N/A,N/A,1086,1093,N/A,51,6
6,N/A,N/A,N/A,1080,1086,N/A,56,5
4,N/A,N/A,N/A,1076,1080,N/A,61,4
4,N/A,N/A,N/A,1072,1076,N/A,67,4
3,N/A,N/A,N/A,1069,1072,N/A,73,4
3,N/A,N/A,N/A,1066,1069,N/A,77,2
6,N/A,N/A,N/A,1060,1066,N/A,80,5
4,N/A,N/A,N/A,1056,1060,N/A,85,4
2,N/A,N/A,N/A,1054,1056,N/A,88,1
5,N/A,N/A,N/A,1049,1054,N/A,92,5
3,N/A,N/A,N/A,1046,1049,N/A,95,2
6,N/A,N/A,N/A,1040,1046,N/A,98,5
3,N/A,N/A,N/A,1037,1040,N/A,102,3
1,N/A,N/A,N/A,1036,1037,N/A,106,1
5,N/A,N/A,N/A,1031,1036,N/A,110,5
4,N/A,N/A,N/A,1027,1031,N/A,115,4
3,N/A,N/A,N/A,1024,1027,N/A,120,3
2,N/A,N/A,N/A,1022,1024,N/A,124,1
2,N/A,N/A,N/A,1020,1022,N/A,130,1
4,N/A,N/A,N/A,1016,1020,N/A,133,4
1,N/A,N/A,N/A,1015,1016,N/A,136,1
2,N/A,N/A,N/A,1578,1580,N/A,5,3
7,N/A,N/A,N/A,1571,1578,N/A,8,6
3,N/A,N/A,N/A,1568,1571,N/A,11,3
1,N/A,N/A,N/A,1567,1568,N/A,15,1
5,N/A,N/A,N/A,1562,1567,N/A,19,5
4,N/A,N/A,N/A,1558,1562,N/A,24,4
1,N/A,N/A,N/A,1557,1558,N/A,27,1
6,N/A,N/A,N/A,1551,1557,N/A,31,5
5,N/A,N/A,N/A,1546,1551,N/A,37,5
4,N/A,N/A,N/A,1542,1546,N/A,42,4
3,N/A,N/A,N/A,1539,1542,N/A,48,4
3,N/A,N/A,N/A,1536,1539,N/A,54,4
3,N/A,N/A,N/A,1533,1536,N/A,58,2
7,N/A,N/A,N/A,1526,1533,N/A,62,6
5,N/A,N/A,N/A,1521,1526,N/A,67,5
3,N/A,N/A,N/A,1518,1521,N/A,72,4
3,N/A,N/A,N/A,1515,1518,N/A,78,4
3,N/A,N/A,N/A,1512,1515,N/A,83,3
7,N/A,N/A,N/A,1505,1512,N/A,86,6
2,N/A,N/A,N/A,1503,1505,N/A,89,3
2,N/A,N/A,N/A,1501,1503,N/A,95,3
2,N/A,N/A,N/A,1499,1501,N/A,99,1
6,N/A,N/A,N/A,1493,1499,N/A,104,6
3,N/A,N/A,N/A,1490,1493,N/A,107,3
6,N/A,N/A,N/A,1484,1490,N/A,110,6
3,N/A,N/A,N/A,1481,1484,N/A,114,4
2,N/A,N/A,N/A,1479,1481,N/A,117,1
1,N/A,N/A,N/A,1478,1479,N/A,123,1
6,N/A,N/A,N/A,1472,1478,N/A,128,6
6,N/A,N/A,N/A,1466,1472,N/A,133,5
3,N/A,N/A,N/A,1605,1608,N/A,3,3
3,N/A,N/A,N/A,1602,1605,N/A,8,2
6,N/A,N/A,N/A,1596,1602,N/A,11,5
5,N/A,N/A,N/A,1591,1596,N/A,17,5
2,N/A,N/A,N/A,1589,1591,N/A,21,3
3,N/A,N/A,N/A,1586,1589,N/A,26,2
1,N/A,N/A,N/A,1585,1586,N/A,31,1
7,N/A,N/A,N/A,1578,1585,N/A,36,6
5,N/A,N/A,N/A,1573,1578,N/A,41,5
6,N/A,N/A,N/A,1567,1573,N/A,47,5
4,N/A,N/A,N/A,1563,1567,N/A,52,4
3,N/A,N/A,N/A,1560,1563,N/A,56,2
5,N/A,N/A,N/A,1555,1560,N/A,59,5
3,N/A,N/A,N/A,1552,1555,N/A,62,2
2,N/A,N/A,N/A,1550,1552,N/A,68,2
6,N/A,N/A,N/A,1544,1550,N/A,72,6
2,N/A,N/A,N/A,1542,1544,N/A,78,0
3,N/A,N/A,N/A,1539,1542,N/A,81,3
2,N/A,N/A,N/A,1537,1539,N/A,87,3
1,N/A,N/A,N/A,1536,1537,N/A,91,1
5,N/A,N/A,N/A,1531,1536,N/A,95,5
3,N/A,N/A,N/A,1528,1531,N/A,99,3
3,N/A,N/A,N/A,1525,1528,N/A,104,2
3,N/A,N/A,N/A,1522,1525,N/A,110,2
6,N/A,N/A,N/A,1516,1522,N/A,113,5
3,N/A,N/A,N/A,1513,1516,N/A,117,3
2,N/A,N/A,N/A,1511,1513,N/A,123,3
2,N/A,N/A,N/A,1509,1511,N/A,129,3
3,N/A,N/A,N/A,1506,1509,N/A,135,3
2,N/A,N/A,N/A,1504,1506,N/A,141,3
6,N/A,N/A,N/A,659,665,N/A,3,6
2,N/A,N/A,N/A,657,659,N/A,6,3
2,N/A,N/A,N/A,655,657,N/A,12,3
2,N/A,N/A,N/A,653,655,N/A,16,1
7,N/A,N/A,N/A,646,653,N/A,21,6
6,N/A,N/A,N/A,640,646,N/A,26,5
4,N/A,N/A,N/A,636,640,N/A,31,4
3,N/A,N/A,N/A,633,636,N/A,35,2
1,N/A,N/A,N/A,632,633,N/A,40,1
6,N/A,N/A,N/A,626,632,N/A,45,6
4,N/A,N/A,N/A,622,626,N/A,49,4
2,N/A,N/A,N/A,620,622,N/A,54,3
6,N/A,N/A,N/A,614,620,N/A,57,6
6,N/A,N/A,N/A,608,614,N/A,62,5
5,N/A,N/A,N/A,603,608,N/A,68,5
6,N/A,N/A,N/A,597,603,N/A,74,5
2,N/A,N/A,N/A,595,597,N/A,78,3
6,N/A,N/A,N/A,589,595,N/A,81,6
5,N/A,N/A,N/A,584,589,N/A,86,5
2,N/A,N/A,N/A,582,584,N/A,90,3
3,N/A,N/A,N/A,579,582,N/A,95,2
6,N/A,N/A,N/A,573,579,N/A,98,5
3,N/A,N/A,N/A,570,573,N/A,101,2
7,N/A,N/A,N/A,563,570,N/A,105,6
4,N/A,N/A,N/A,559,563,N/A,109,4
1,N/A,N/A,N/A,558,559,N/A,112,1
1,N/A,N/A,N/A,557,558,N/A,118,1
6,N/A,N/A,N/A,551,557,N/A,123,6
3,N/A,N/A,N/A,548,551,N/A,127,4
2,N/A,N/A,N/A,546,548,N/A,130,1
5,N/A,N/A,N/A,362,367,N/A,5,5
2,N/A,N/A,N/A,360,362,N/A,8,2
3,N/A,N/A,N/A,357,360,N/A,14,2
7,N/A,N/A,N/A,350,357,N/A,18,6
2,N/A,N/A,N/A,348,350,N/A,24,0
2,N/A,N/A,N/A,346,348,N/A,27,3
2,N/A,N/A,N/A,344,346,N/A,33,3
3,N/A,N/A,N/A,341,344,N/A,38,2
6,N/A,N/A,N/A,335,341,N/A,41,5
5,N/A,N/A,N/A,330,335,N/A,47,5
6,N/A,N/A,N/A,324,330,N/A,53,5
4,N/A,N/A,N/A,320,324,N/A,58,4
3,N/A,N/A,N/A,317,320,N/A,62,2
2,N/A,N/A,N/A,315,317,N/A,67,1
2,N/A,N/A,N/A,313,315,N/A,73,1
3,N/A,N/A,N/A,310,313,N/A,76,4
1,N/A,N/A,N/A,309,310,N/A,79,1
6,N/A,N/A,N/A,303,309,N/A,84,6
4,N/A,N/A,N/A,299,303,N/A,88,4
3,N/A,N/A,N/A,296,299,N/A,92,2
7,N/A,N/A,N/A,289,296,N/A,96,6
2,N/A,N/A,N/A,287,289,N/A,102,0
2,N/A,N/A,N/A,285,287,N/A,105,3
3,N/A,N/A,N/A,282,285,N/A,111,3
6,N/A,N/A,N/A,276,282,N/A,114,6
3,N/A,N/A,N/A,273,276,N/A,118,4
2,N/A,N/A,N/A,271,273,N/A,122,2
5,N/A,N/A,N/A,266,271,N/A,125,5
3,N/A,N/A,N/A,263,266,N/A,129,3
3,N/A,N/A,N/A,260,263,N/A,134,2
3,N/A,N/A,N/A,922,925,N/A,5,2
2,N/A,N/A,N/A,920,922,N/A,11,2
1,N/A,N/A,N/A,919,920,N/A,16,1
6,N/A,N/A,N/A,913,919,N/A,21,6
2,N/A,N/A,N/A,911,913,N/A,27,0
3,N/A,N/A,N/A,908,911,N/A,30,3
2,N/A,N/A,N/A,906,908,N/A,36,3
2,N/A,N/A,N/A,904,906,N/A,42,3
2,N/A,N/A,N/A,902,904,N/A,47,2
2,N/A,N/A,N/A,900,902,N/A,52,1
6,N/A,N/A,N/A,894,900,N/A,56,5
3,N/A,N/A,N/A,891,894,N/A,60,3
3,N/A,N/A,N/A,888,891,N/A,65,2
1,N/A,N/A,N/A,887,888,N/A,70,1
3,N/A,N/A,N/A,884,887,N/A,73,4
3,N/A,N/A,N/A,881,884,N/A,79,4
2,N/A,N/A,N/A,879,881,N/A,84,3
1,N/A,N/A,N/A,878,879,N/A,88,1
5,N/A,N/A,N/A,873,878,N/A,92,5
4,N/A,N/A,N/A,869,873,N/A,97,4
3,N/A,N/A,N/A,866,869,N/A,102,3
7,N/A,N/A,N/A,859,866,N/A,105,6
5,N/A,N/A,N/A,854,859,N/A,110,5
3,N/A,N/A,N/A,851,854,N/A,113,2
2,N/A,N/A,N/A,849,851,N/A,119,2
1,N/A,N/A,N/A,848,849,N/A,124,1
6,N/A,N/A,N/A,842,848,N/A,128,5
4,N/A,N/A,N/A,838,842,N/A,133,4
2,N/A,N/A,N/A,836,838,N/A,138,3
1,N/A,N/A,N/A,835,836,N/A,142,1
6,N/A,N/A,N/A,500,506,N/A,6,5
4,N/A,N/A,N/A,496,500,N/A,11,4
4,N/A,N/A,N/A,492,496,N/A,17,4
4,N/A,N/A,N/A,488,492,N/A,23,4
1,N/A,N/A,N/A,487,488,N/A,26,1
6,N/A,N/A,N/A,481,487,N/A,31,6
4,N/A,N/A,N/A,477,481,N/A,35,4
2,N/A,N/A,N/A,475,477,N/A,40,3
1,N/A,N/A,N/A,474,475,N/A,44,1
2,N/A,N/A,N/A,472,474,N/A,50,1
3,N/A,N/A,N/A,469,472,N/A,53,4
3,N/A,N/A,N/A,466,469,N/A,58,3
1,N/A,N/A,N/A,465,466,N/A,62,1
1,N/A,N/A,N/A,464,465,N/A,68,1
3,N/A,N/A,N/A,461,464,N/A,71,4
3,N/A,N/A,N/A,458,461,N/A,75,2
1,N/A,N/A,N/A,457,458,N/A,80,1
5,N/A,N/A,N/A,452,457,N/A,84,5
3,N/A,N/A,N/A,449,452,N/A,89,4
2,N/A,N/A,N/A,447,449,N/A,94,3
6,N/A,N/A,N/A,441,447,N/A,97,6
2,N/A,N/A,N/A,439,441,N/A,100,3
3,N/A,N/A,N/A,436,439,N/A,105,2
2,N/A,N/A,N/A,434,436,N/A,110,1
7,N/A,N/A,N/A,427,434,N/A,115,6
3,N/A,N/A,N/A,424,427,N/A,118,3
3,N/A,N/A,N/A,421,424,N/A,124,3
3,N/A,N/A,N/A,418,421,N/A,129,2
6,N/A,N/A,N/A,412,418,N/A,132,5
5,N/A,N/A,N/A,407,412,N/A,138,5
2,N/A,N/A,N/A,487,489,N/A,4,1
1,N/A,N/A,N/A,486,487,N/A,10,1
4,N/A,N/A,N/A,482,486,N/A,13,4
2,N/A,N/A,N/A,480,482,N/A,18,3
3,N/A,N/A,N/A,477,480,N/A,24,3
2,N/A,N/A,N/A,475,477,N/A,28,1
6,N/A,N/A,N/A,469,475,N/A,32,5
6,N/A,N/A,N/A,463,469,N/A,38,5
3,N/A,N/A,N/A,460,463,N/A,43,4
3,N/A,N/A,N/A,457,460,N/A,48,3
6,N/A,N/A,N/A,451,457,N/A,51,6
2,N/A,N/A,N/A,449,451,N/A,57,0
7,N/A,N/A,N/A,442,449,N/A,63,6
5,N/A,N/A,N/A,437,442,N/A,68,5
3,N/A,N/A,N/A,434,437,N/A,71,2
7,N/A,N/A,N/A,427,434,N/A,75,6
4,N/A,N/A,N/A,423,427,N/A,79,4
3,N/A,N/A,N/A,420,423,N/A,85,4
2,N/A,N/A,N/A,418,420,N/A,89,2
2,N/A,N/A,N/A,416,418,N/A,94,1
6,N/A,N/A,N/A,410,416,N/A,98,5
2,N/A,N/A,N/A,408,410,N/A,102,3
2,N/A,N/A,N/A,406,408,N/A,107,2
1,N/A,N/A,N/A,405,406,N/A,112,1
4,N/A,N/A,N/A,401,405,N/A,115,4
2,N/A,N/A,N/A,399,401,N/A,120,3
1,N/A,N/A,N/A,398,399,N/A,124,1
3,N/A,N/A,N/A,395,398,N/A,127,4
2,N/A,N/A,N/A,393,395,N/A,131,2
2,N/A,N/A,N/A,391,393,N/A,136,1
4,N/A,N/A,N/A,870,874,N/A,6,4
3,N/A,N/A,N/A,867,870,N/A,12,4
3,N/A,N/A,N/A,864,867,N/A,16,2
5,N/A,N/A,N/A,859,864,N/A,19,5
3,N/A,N/A,N/A,856,859,N/A,22,2
7,N/A,N/A,N/A,849,856,N/A,26,6
2,N/A,N/A,N/A,847,849,N/A,29,3
3,N/A,N/A,N/A,844,847,N/A,35,3
2,N/A,N/A,N/A,842,844,N/A,41,3
3,N/A,N/A,N/A,839,842,N/A,46,2
2,N/A,N/A,N/A,837,839,N/A,52,2
6,N/A,N/A,N/A,831,837,N/A,56,6
4,N/A,N/A,N/A,827,831,N/A,60,4
1,N/A,N/A,N/A,826,827,N/A,63,1
3,N/A,N/A,N/A,823,826,N/A,66,4
4,N/A,N/A,N/A,819,823,N/A,72,4
3,N/A,N/A,N/A,816,819,N/A,76,2
2,N/A,N/A,N/A,814,816,N/A,81,1
4,N/A,N/A,N/A,810,814,N/A,84,4
2,N/A,N/A,N/A,808,810,N/A,88,2
5,N/A,N/A,N/A,803,808,N/A,91,5
3,N/A,N/A,N/A,800,803,N/A,95,3
2,N/A,N/A,N/A,798,800,N/A,99,1
6,N/A,N/A,N/A,792,798,N/A,103,5
5,N/A,N/A,N/A,787,792,N/A,109,5
2,N/A,N/A,N/A,785,787,N/A,113,3
6,N/A,N/A,N/A,779,785,N/A,116,6
3,N/A,N/A,N/A,776,779,N/A,119,3
6,N/A,N/A,N/A,770,776,N/A,122,6
6,N/A,N/A,N/A,764,770,N/A,127,5
6,N/A,N/A,N/A,1391,1397,N/A,6,6
2,N/A,N/A,N/A,1389,1391,N/A,12,0
7,N/A,N/A,N/A,1382,1389,N/A,18,6
6,N/A,N/A,N/A,1376,1382,N/A,23,5
2,N/A,N/A,N/A,1374,1376,N/A,26,2
2,N/A,N/A,N/A,1372,1374,N/A,31,1
1,N/A,N/A,N/A,1371,1372,N/A,37,1
1,N/A,N/A,N/A,1370,1371,N/A,43,1
6,N/A,N/A,N/A,1364,1370,N/A,48,6
5,N/A,N/A,N/A,1359,1364,N/A,53,5
3,N/A,N/A,N/A,1356,1359,N/A,58,4
3,N/A,N/A,N/A,1353,1356,N/A,62,2
6,N/A,N/A,N/A,1347,1353,N/A,66,6
2,N/A,N/A,N/A,1345,1347,N/A,72,0
7,N/A,N/A,N/A,1338,1345,N/A,78,6
3,N/A,N/A,N/A,1335,1338,N/A,82,4
2,N/A,N/A,N/A,1333,1335,N/A,87,3
2,N/A,N/A,N/A,1331,1333,N/A,92,2
3,N/A,N/A,N/A,1328,1331,N/A,98,2
2,N/A,N/A,N/A,1326,1328,N/A,103,1
1,N/A,N/A,N/A,1325,1326,N/A,109,1
6,N/A,N/A,N/A,1319,1325,N/A,113,5
6,N/A,N/A,N/A,1313,1319,N/A,119,5
3,N/A,N/A,N/A,1310,1313,N/A,124,4
3,N/A,N/A,N/A,1307,1310,N/A,130,4
2,N/A,N/A,N/A,1305,1307,N/A,135,3
7,N/A,N/A,N/A,1298,1305,N/A,138,6
4,N/A,N/A,N/A,1294,1298,N/A,142,4
2,N/A,N/A,N/A,1292,1294,N/A,146,2
6,N/A,N/A,N/A,1286,1292,N/A,149,5
2,N/A,N/A,N/A,851,853,N/A,5,2
6,N/A,N/A,N/A,845,851,N/A,9,6
6,N/A,N/A,N/A,839,845,N/A,14,5
3,N/A,N/A,N/A,836,839,N/A,18,3
1,N/A,N/A,N/A,835,836,N/A,22,1
5,N/A,N/A,N/A,830,835,N/A,26,5
3,N/A,N/A,N/A,827,830,N/A,31,4
3,N/A,N/A,N/A,824,827,N/A,36,3
3,N/A,N/A,N/A,821,824,N/A,41,2
7,N/A,N/A,N/A,814,821,N/A,45,6
3,N/A,N/A,N/A,811,814,N/A,49,4
1,N/A,N/A,N/A,810,811,N/A,52,1
7,N/A,N/A,N/A,803,810,N/A,57,6
6,N/A,N/A,N/A,797,803,N/A,62,5
2,N/A,N/A,N/A,795,797,N/A,66,3
1,N/A,N/A,N/A,794,795,N/A,70,1
5,N/A,N/A,N/A,789,794,N/A,74,5
6,N/A,N/A,N/A,783,789,N/A,80,5
2,N/A,N/A,N/A,781,783,N/A,84,3
2,N/A,N/A,N/A,779,781,N/A,88,1
5,N/A,N/A,N/A,774,779,N/A,92,5
2,N/A,N/A,N/A,772,774,N/A,96,3
1,N/A,N/A,N/A,771,772,N/A,100,1
6,N/A,N/A,N/A,765,771,N/A,105,6
2,N/A,N/A,N/A,763,765,N/A,111,0
4,N/A,N/A,N/A,759,763,N/A,115,4
3,N/A,N/A,N/A,756,759,N/A,121,4
2,N/A,N/A,N/A,754,756,N/A,125,2
5,N/A,N/A,N/A,749,754,N/A,128,5
4,N/A,N/A,N/A,745,749,N/A,133,4
2,N/A,N/A,N/A,999,1001,N/A,3,2
6,N/A,N/A,N/A,993,999,N/A,7,6
2,N/A,N/A,N/A,991,993,N/A,13,0
4,N/A,N/A,N/A,987,991,N/A,17,4
3,N/A,N/A,N/A,984,987,N/A,21,2
5,N/A,N/A,N/A,979,984,N/A,24,5
3,N/A,N/A,N/A,976,979,N/A,29,4
2,N/A,N/A,N/A,974,976,N/A,32,1
3,N/A,N/A,N/A,971,974,N/A,35,4
3,N/A,N/A,N/A,968,971,N/A,40,3
2,N/A,N/A,N/A,966,968,N/A,45,2
7,N/A,N/A,N/A,959,966,N/A,49,6
4,N/A,N/A,N/A,955,959,N/A,53,4
4,N/A,N/A,N/A,951,955,N/A,59,4
4,N/A,N/A,N/A,947,951,N/A,65,4
4,N/A,N/A,N/A,943,947,N/A,71,4
2,N/A,N/A,N/A,941,943,N/A,74,1
7,N/A,N/A,N/A,934,941,N/A,79,6
5,N/A,N/A,N/A,929,934,N/A,84,5
5,N/A,N/A,N/A,924,929,N/A,90,5
3,N/A,N/A,N/A,921,924,N/A,93,2
5,N/A,N/A,N/A,916,921,N/A,96,5
2,N/A,N/A,N/A,914,916,N/A,100,3
3,N/A,N/A,N/A,911,914,N/A,105,2
2,N/A,N/A,N/A,909,911,N/A,111,2
6,N/A,N/A,N/A,903,909,N/A,115,6
2,N/A,N/A,N/A,901,903,N/A,121,0
5,N/A,N/A,N/A,896,901,N/A,126,5
2,N/A,N/A,N/A,894,896,N/A,130,3
3,N/A,N/A,N/A,891,894,N/A,135,2
4,N/A,N/A,N/A,1519,1523,N/A,5,4
4,N/A,N/A,N/A,1515,1519,N/A,11,4
3,N/A,N/A,N/A,1512,1515,N/A,17,4
3,N/A,N/A,N/A,1509,1512,N/A,21,2
5,N/A,N/A,N/A,1504,1509,N/A,24,5
2,N/A,N/A,N/A,1502,1504,N/A,28,3
3,N/A,N/A,N/A,1499,1502,N/A,34,3
3,N/A,N/A,N/A,1496,1499,N/A,39,2
2,N/A,N/A,N/A,1494,1496,N/A,44,1
3,N/A,N/A,N/A,1491,1494,N/A,47,4
3,N/A,N/A,N/A,1488,1491,N/A,53,4
2,N/A,N/A,N/A,1486,1488,N/A,56,1
6,N/A,N/A,N/A,1480,1486,N/A,60,5
2,N/A,N/A,N/A,1478,1480,N/A,64,3
3,N/A,N/A,N/A,1475,1478,N/A,70,3
2,N/A,N/A,N/A,1473,1475,N/A,74,1
6,N/A,N/A,N/A,1467,1473,N/A,79,6
6,N/A,N/A,N/A,1461,1467,N/A,84,5
3,N/A,N/A,N/A,1458,1461,N/A,89,4
3,N/A,N/A,N/A,1455,1458,N/A,93,2
2,N/A,N/A,N/A,1453,1455,N/A,99,2
2,N/A,N/A,N/A,1451,1453,N/A,105,2
5,N/A,N/A,N/A,1446,1451,N/A,108,5
2,N/A,N/A,N/A,1444,1446,N/A,111,2
1,N/A,N/A,N/A,1443,1444,N/A,116,1
3,N/A,N/A,N/A,1440,1443,N/A,119,4
3,N/A,N/A,N/A,1437,1440,N/A,123,2
2,N/A,N/A,N/A,1435,1437,N/A,128,1
6,N/A,N/A,N/A,1429,1435,N/A,133,6
6,N/A,N/A,N/A,1423,1429,N/A,138,5
5,N/A,N/A,N/A,744,749,N/A,5,5
4,N/A,N/A,N/A,740,744,N/A,10,4
2,N/A,N/A,N/A,738,740,N/A,13,1
1,N/A,N/A,N/A,737,738,N/A,19,1
6,N/A,N/A,N/A,731,737,N/A,23,5
3,N/A,N/A,N/A,728,731,N/A,27,3
2,N/A,N/A,N/A,726,728,N/A,32,2
7,N/A,N/A,N/A,719,726,N/A,36,6
4,N/A,N/A,N/A,715,719,N/A,40,4
1,N/A,N/A,N/A,714,715,N/A,43,1
6,N/A,N/A,N/A,708,714,N/A,48,6
1,N/A,N/A,N/A,707,708,N/A,54,0
7,N/A,N/A,N/A,700,707,N/A,60,6
1,N/A,N/A,N/A,699,700,N/A,66,0
5,N/A,N/A,N/A,694,699,N/A,71,5
5,N/A,N/A,N/A,689,694,N/A,77,5
2,N/A,N/A,N/A,687,689,N/A,81,3
6,N/A,N/A,N/A,681,687,N/A,84,6
4,N/A,N/A,N/A,677,681,N/A,88,4
3,N/A,N/A,N/A,674,677,N/A,92,2
6,N/A,N/A,N/A,668,674,N/A,95,5
4,N/A,N/A,N/A,664,668,N/A,100,4
2,N/A,N/A,N/A,662,664,N/A,105,3
3,N/A,N/A,N/A,659,662,N/A,111,3
2,N/A,N/A,N/A,657,659,N/A,115,1
4,N/A,N/A,N/A,653,657,N/A,118,4
4,N/A,N/A,N/A,649,653,N/A,124,4
3,N/A,N/A,N/A,646,649,N/A,129,3
6,N/A,N/A,N/A,640,646,N/A,132,6
1,N/A,N/A,N/A,639,640,N/A,138,0
2,N/A,N/A,N/A,1480,1482,N/A,6,2
2,N/A,N/A,N/A,1478,1480,N/A,12,2
2,N/A,N/A,N/A,1476,1478,N/A,18,2
1,N/A,N/A,N/A,1475,1476,N/A,23,1
2,N/A,N/A,N/A,1473,1475,N/A,29,1
4,N/A,N/A,N/A,1469,1473,N/A,32,4
2,N/A,N/A,N/A,1467,1469,N/A,35,1
5,N/A,N/A,N/A,1462,1467,N/A,39,5
3,N/A,N/A,N/A,1459,1462,N/A,43,3
3,N/A,N/A,N/A,1456,1459,N/A,49,3
2,N/A,N/A,N/A,1454,1456,N/A,54,2
1,N/A,N/A,N/A,1453,1454,N/A,59,1
4,N/A,N/A,N/A,1449,1453,N/A,62,4
4,N/A,N/A,N/A,1445,1449,N/A,68,4
3,N/A,N/A,N/A,1442,1445,N/A,74,4
3,N/A,N/A,N/A,1439,1442,N/A,79,3
2,N/A,N/A,N/A,1437,1439,N/A,84,2
7,N/A,N/A,N/A,1430,1437,N/A,88,6
3,N/A,N/A,N/A,1427,1430,N/A,92,4
1,N/A,N/A,N/A,1426,1427,N/A,95,1
2,N/A,N/A,N/A,1424,1426,N/A,101,1
1,N/A,N/A,N/A,1423,1424,N/A,107,1
4,N/A,N/A,N/A,1419,1423,N/A,110,4
3,N/A,N/A,N/A,1416,1419,N/A,114,2
2,N/A,N/A,N/A,1414,1416,N/A,120,2
2,N/A,N/A,N/A,1412,1414,N/A,126,2
6,N/A,N/A,N/A,1406,1412,N/A,130,6
1,N/A,N/A,N/A,1405,1406,N/A,136,0
3,N/A,N/A,N/A,1402,1405,N/A,140,4
3,N/A,N/A,N/A,1399,1402,N/A,146,4
2,N/A,N/A,N/A,1273,1275,N/A,5,3
6,N/A,N/A,N/A,1267,1273,N/A,8,6
2,N/A,N/A,N/A,1265,1267,N/A,11,3
2,N/A,N/A,N/A,1263,1265,N/A,15,1
7,N/A,N/A,N/A,1256,1263,N/A,20,6
6,N/A,N/A,N/A,1250,1256,N/A,25,5
6,N/A,N/A,N/A,1244,1250,N/A,31,5
3,N/A,N/A,N/A,1241,1244,N/A,34,2
2,N/A,N/A,N/A,1239,1241,N/A,39,1
3,N/A,N/A,N/A,1236,1239,N/A,42,4
2,N/A,N/A,N/A,1234,1236,N/A,47,3
2,N/A,N/A,N/A,1232,1234,N/A,53,3
7,N/A,N/A,N/A,1225,1232,N/A,56,6
4,N/A,N/A,N/A,1221,1225,N/A,60,4
3,N/A,N/A,N/A,1218,1221,N/A,66,4
3,N/A,N/A,N/A,1215,1218,N/A,70,2
6,N/A,N/A,N/A,1209,1215,N/A,73,5
3,N/A,N/A,N/A,1206,1209,N/A,76,2
2,N/A,N/A,N/A,1204,1206,N/A,81,1
7,N/A,N/A,N/A,1197,1204,N/A,86,6
2,N/A,N/A,N/A,1195,1197,N/A,89,3
2,N/A,N/A,N/A,1193,1195,N/A,95,3
2,N/A,N/A,N/A,1191,1193,N/A,101,3
2,N/A,N/A,N/A,1189,1191,N/A,105,1
5,N/A,N/A,N/A,1184,1189,N/A,109,5
3,N/A,N/A,N/A,1181,1184,N/A,114,4
2,N/A,N/A,N/A,1179,1181,N/A,117,1
7,N/A,N/A,N/A,1172,1179,N/A,122,6
2,N/A,N/A,N/A,1170,1172,N/A,128,0
5,N/A,N/A,N/A,1165,1170,N/A,133,5
3,N/A,N/A,N/A,524,527,N/A,5,4
3,N/A,N/A,N/A,521,524,N/A,11,4
3,N/A,N/A,N/A,518,521,N/A,15,2
5,N/A,N/A,N/A,513,518,N/A,18,5
3,N/A,N/A,N/A,510,513,N/A,23,4
3,N/A,N/A,N/A,507,510,N/A,29,4
2,N/A,N/A,N/A,505,507,N/A,32,1
4,N/A,N/A,N/A,501,505,N/A,35,4
1,N/A,N/A,N/A,500,501,N/A,38,1
6,N/A,N/A,N/A,494,500,N/A,43,6
2,N/A,N/A,N/A,492,494,N/A,46,3
3,N/A,N/A,N/A,489,492,N/A,52,3
3,N/A,N/A,N/A,486,489,N/A,57,2
1,N/A,N/A,N/A,485,486,N/A,62,1
5,N/A,N/A,N/A,480,485,N/A,66,5
2,N/A,N/A,N/A,478,480,N/A,70,3
3,N/A,N/A,N/A,475,478,N/A,76,3
6,N/A,N/A,N/A,469,475,N/A,79,6
5,N/A,N/A,N/A,464,469,N/A,84,5
5,N/A,N/A,N/A,459,464,N/A,90,5
6,N/A,N/A,N/A,453,459,N/A,96,5
6,N/A,N/A,N/A,447,453,N/A,102,5
2,N/A,N/A,N/A,445,447,N/A,105,2
3,N/A,N/A,N/A,442,445,N/A,111,2
7,N/A,N/A,N/A,435,442,N/A,115,6
1,N/A,N/A,N/A,434,435,N/A,121,0
2,N/A,N/A,N/A,432,434,N/A,124,3
2,N/A,N/A,N/A,430,432,N/A,130,3
1,N/A,N/A,N/A,429,430,N/A,134,1
5,N/A,N/A,N/A,424,429,N/A,138,5
2,N/A,N/A,N/A,1073,1075,N/A,3,1
2,N/A,N/A,N/A,1071,1073,N/A,9,1
3,N/A,N/A,N/A,1068,1071,N/A,12,4
2,N/A,N/A,N/A,1066,1068,N/A,15,1
6,N/A,N/A,N/A,1060,1066,N/A,20,6
3,N/A,N/A,N/A,1057,1060,N/A,24,4
3,N/A,N/A,N/A,1054,1057,N/A,28,2
2,N/A,N/A,N/A,1052,1054,N/A,33,1
3,N/A,N/A,N/A,1049,1052,N/A,36,4
4,N/A,N/A,N/A,1045,1049,N/A,42,4
4,N/A,N/A,N/A,1041,1045,N/A,48,4
2,N/A,N/A,N/A,1039,1041,N/A,51,1
3,N/A,N/A,N/A,1036,1039,N/A,54,4
3,N/A,N/A,N/A,1033,1036,N/A,59,3
3,N/A,N/A,N/A,1030,1033,N/A,65,3
2,N/A,N/A,N/A,1028,1030,N/A,69,1
6,N/A,N/A,N/A,1022,1028,N/A,73,5
5,N/A,N/A,N/A,1017,1022,N/A,79,5
2,N/A,N/A,N/A,1015,1017,N/A,82,2
6,N/A,N/A,N/A,1009,1015,N/A,85,5
6,N/A,N/A,N/A,1003,1009,N/A,91,5
3,N/A,N/A,N/A,1000,1003,N/A,94,2
6,N/A,N/A,N/A,994,1000,N/A,97,5
4,N/A,N/A,N/A,990,994,N/A,102,4
1,N/A,N/A,N/A,989,990,N/A,105,1
2,N/A,N/A,N/A,987,989,N/A,111,1
2,N/A,N/A,N/A,985,987,N/A,117,1
3,N/A,N/A,N/A,982,985,N/A,120,4
3,N/A,N/A,N/A,979,982,N/A,125,3
1,N/A,N/A,N/A,978,979,N/A,129,1
6,N/A,N/A,N/A,1717,1723,N/A,5,5
2,N/A,N/A,N/A,1715,1717,N/A,9,3
3,N/A,N/A,N/A,1712,1715,N/A,15,3
7,N/A,N/A,N/A,1705,1712,N/A,18,6
6,N/A,N/A,N/A,1699,1705,N/A,23,5
5,N/A,N/A,N/A,1694,1699,N/A,29,5
5,N/A,N/A,N/A,1689,1694,N/A,35,5
3,N/A,N/A,N/A,1686,1689,N/A,38,2
5,N/A,N/A,N/A,1681,1686,N/A,41,5
2,N/A,N/A,N/A,1679,1681,N/A,44,2
5,N/A,N/A,N/A,1674,1679,N/A,47,5
3,N/A,N/A,N/A,1671,1674,N/A,51,3
7,N/A,N/A,N/A,1664,1671,N/A,54,6
2,N/A,N/A,N/A,1662,1664,N/A,60,0
5,N/A,N/A,N/A,1657,1662,N/A,65,5
3,N/A,N/A,N/A,1654,1657,N/A,70,4
2,N/A,N/A,N/A,1652,1654,N/A,74,2
5,N/A,N/A,N/A,1647,1652,N/A,77,5
2,N/A,N/A,N/A,1645,1647,N/A,81,3
6,N/A,N/A,N/A,1639,1645,N/A,84,6
3,N/A,N/A,N/A,1636,1639,N/A,88,4
1,N/A,N/A,N/A,1635,1636,N/A,91,1
1,N/A,N/A,N/A,1634,1635,N/A,97,1
6,N/A,N/A,N/A,1628,1634,N/A,101,5
3,N/A,N/A,N/A,1625,1628,N/A,105,3
2,N/A,N/A,N/A,1623,1625,N/A,109,1
6,N/A,N/A,N/A,1617,1623,N/A,114,6
4,N/A,N/A,N/A,1613,1617,N/A,118,4
3,N/A,N/A,N/A,1610,1613,N/A,124,4
1,N/A,N/A,N/A,1609,1610,N/A,127,1
2,N/A,N/A,N/A,507,509,N/A,3,3
2,N/A,N/A,N/A,505,507,N/A,9,3
7,N/A,N/A,N/A,498,505,N/A,12,6
6,N/A,N/A,N/A,492,498,N/A,17,5
5,N/A,N/A,N/A,487,492,N/A,23,5
5,N/A,N/A,N/A,482,487,N/A,29,5
3,N/A,N/A,N/A,479,482,N/A,32,2
7,N/A,N/A,N/A,472,479,N/A,36,6
4,N/A,N/A,N/A,468,472,N/A,40,4
2,N/A,N/A,N/A,466,468,N/A,45,3
2,N/A,N/A,N/A,464,466,N/A,50,2
7,N/A,N/A,N/A,457,464,N/A,54,6
3,N/A,N/A,N/A,454,457,N/A,58,4
2,N/A,N/A,N/A,452,454,N/A,61,1
5,N/A,N/A,N/A,447,452,N/A,65,5
3,N/A,N/A,N/A,444,447,N/A,68,2
2,N/A,N/A,N/A,442,444,N/A,74,2
6,N/A,N/A,N/A,436,442,N/A,78,6
3,N/A,N/A,N/A,433,436,N/A,81,3
7,N/A,N/A,N/A,426,433,N/A,84,6
5,N/A,N/A,N/A,421,426,N/A,89,5
3,N/A,N/A,N/A,418,421,N/A,92,2
6,N/A,N/A,N/A,412,418,N/A,95,5
6,N/A,N/A,N/A,406,412,N/A,101,5
3,N/A,N/A,N/A,403,406,N/A,104,2
5,N/A,N/A,N/A,398,403,N/A,107,5
3,N/A,N/A,N/A,395,398,N/A,111,3
3,N/A,N/A,N/A,392,395,N/A,116,2
5,N/A,N/A,N/A,387,392,N/A,119,5
3,N/A,N/A,N/A,384,387,N/A,124,4
4,N/A,N/A,N/A,385,389,N/A,5,4
3,N/A,N/A,N/A,382,385,N/A,9,2
2,N/A,N/A,N/A,380,382,N/A,14,1
6,N/A,N/A,N/A,374,380,N/A,19,6
4,N/A,N/A,N/A,370,374,N/A,23,4
3,N/A,N/A,N/A,367,370,N/A,29,4
2,N/A,N/A,N/A,365,367,N/A,33,2
1,N/A,N/A,N/A,364,365,N/A,38,1
1,N/A,N/A,N/A,363,364,N/A,44,1
3,N/A,N/A,N/A,360,363,N/A,47,4
2,N/A,N/A,N/A,358,360,N/A,51,2
5,N/A,N/A,N/A,353,358,N/A,54,5
2,N/A,N/A,N/A,351,353,N/A,57,2
5,N/A,N/A,N/A,346,351,N/A,60,5
2,N/A,N/A,N/A,344,346,N/A,64,3
3,N/A,N/A,N/A,341,344,N/A,70,3
2,N/A,N/A,N/A,339,341,N/A,75,2
6,N/A,N/A,N/A,333,339,N/A,79,6
4,N/A,N/A,N/A,329,333,N/A,83,4
2,N/A,N/A,N/A,327,329,N/A,86,1
5,N/A,N/A,N/A,322,327,N/A,90,5
2,N/A,N/A,N/A,320,322,N/A,94,3
2,N/A,N/A,N/A,318,320,N/A,98,1
5,N/A,N/A,N/A,313,318,N/A,102,5
3,N/A,N/A,N/A,310,313,N/A,107,4
3,N/A,N/A,N/A,307,310,N/A,111,2
6,N/A,N/A,N/A,301,307,N/A,115,6
1,N/A,N/A,N/A,300,301,N/A,121,0
3,N/A,N/A,N/A,297,300,N/A,125,4
2,N/A,N/A,N/A,295,297,N/A,129,2
5,N/A,N/A,N/A,419,424,N/A,6,5
3,N/A,N/A,N/A,416,419,N/A,9,2
6,N/A,N/A,N/A,410,416,N/A,13,6
1,N/A,N/A,N/A,409,410,N/A,19,0
6,N/A,N/A,N/A,403,409,N/A,24,5
2,N/A,N/A,N/A,401,403,N/A,27,2
1,N/A,N/A,N/A,400,401,N/A,32,1
2,N/A,N/A,N/A,398,400,N/A,38,1
7,N/A,N/A,N/A,391,398,N/A,43,6
4,N/A,N/A,N/A,387,391,N/A,47,4
1,N/A,N/A,N/A,386,387,N/A,50,1
4,N/A,N/A,N/A,382,386,N/A,53,4
3,N/A,N/A,N/A,379,382,N/A,57,2
6,N/A,N/A,N/A,373,379,N/A,61,6
2,N/A,N/A,N/A,371,373,N/A,67,0
7,N/A,N/A,N/A,364,371,N/A,73,6
1,N/A,N/A,N/A,363,364,N/A,79,0
2,N/A,N/A,N/A,361,363,N/A,82,3
7,N/A,N/A,N/A,354,361,N/A,85,6
6,N/A,N/A,N/A,348,354,N/A,90,5
4,N/A,N/A,N/A,344,348,N/A,95,4
1,N/A,N/A,N/A,343,344,N/A,98,1
3,N/A,N/A,N/A,340,343,N/A,101,4
1,N/A,N/A,N/A,339,340,N/A,104,1
5,N/A,N/A,N/A,334,339,N/A,108,5
2,N/A,N/A,N/A,332,334,N/A,112,3
2,N/A,N/A,N/A,330,332,N/A,117,2
6,N/A,N/A,N/A,324,330,N/A,121,6
2,N/A,N/A,N/A,322,324,N/A,127,0
7,N/A,N/A,N/A,315,322,N/A,133,6
7,N/A,N/A,N/A,558,565,N/A,3,6
3,N/A,N/A,N/A,555,558,N/A,6,3
1,N/A,N/A,N/A,554,555,N/A,10,1
4,N/A,N/A,N/A,550,554,N/A,13,4
2,N/A,N/A,N/A,548,550,N/A,17,2
5,N/A,N/A,N/A,543,548,N/A,20,5
3,N/A,N/A,N/A,540,543,N/A,25,4
4,N/A,N/A,N/A,536,540,N/A,31,4
3,N/A,N/A,N/A,533,536,N/A,36,3
1,N/A,N/A,N/A,532,533,N/A,40,1
4,N/A,N/A,N/A,528,532,N/A,43,4
2,N/A,N/A,N/A,526,528,N/A,48,3
2,N/A,N/A,N/A,524,526,N/A,52,1
6,N/A,N/A,N/A,518,524,N/A,56,5
6,N/A,N/A,N/A,512,518,N/A,62,5
2,N/A,N/A,N/A,510,512,N/A,65,2
2,N/A,N/A,N/A,508,510,N/A,71,2
6,N/A,N/A,N/A,502,508,N/A,75,6
3,N/A,N/A,N/A,499,502,N/A,79,4
3,N/A,N/A,N/A,496,499,N/A,85,4
3,N/A,N/A,N/A,493,496,N/A,89,2
3,N/A,N/A,N/A,490,493,N/A,95,2
7,N/A,N/A,N/A,483,490,N/A,99,6
6,N/A,N/A,N/A,477,483,N/A,104,5
4,N/A,N/A,N/A,473,477,N/A,109,4
2,N/A,N/A,N/A,471,473,N/A,112,1
6,N/A,N/A,N/A,465,471,N/A,116,5
3,N/A,N/A,N/A,462,465,N/A,119,2
6,N/A,N/A,N/A,456,462,N/A,122,5
3,N/A,N/A,N/A,453,456,N/A,126,3
4,N/A,N/A,N/A,1454,1458,N/A,6,4
2,N/A,N/A,N/A,1452,1454,N/A,10,2
7,N/A,N/A,N/A,1445,1452,N/A,14,6
3,N/A,N/A,N/A,1442,1445,N/A,17,3
1,N/A,N/A,N/A,1441,1442,N/A,21,1
2,N/A,N/A,N/A,1439,1441,N/A,27,1
6,N/A,N/A,N/A,1433,1439,N/A,31,5
2,N/A,N/A,N/A,1431,1433,N/A,34,2
2,N/A,N/A,N/A,1429,1431,N/A,40,2
5,N/A,N/A,N/A,1424,1429,N/A,43,5
6,N/A,N/A,N/A,1418,1424,N/A,49,5
2,N/A,N/A,N/A,1416,1418,N/A,52,2
2,N/A,N/A,N/A,1414,1416,N/A,57,1
1,N/A,N/A,N/A,1413,1414,N/A,63,1
6,N/A,N/A,N/A,1407,1413,N/A,68,6
1,N/A,N/A,N/A,1406,1407,N/A,74,0
2,N/A,N/A,N/A,1404,1406,N/A,77,3
3,N/A,N/A,N/A,1401,1404,N/A,82,2
7,N/A,N/A,N/A,1394,1401,N/A,86,6
1,N/A,N/A,N/A,1393,1394,N/A,92,0
3,N/A,N/A,N/A,1390,1393,N/A,96,4
2,N/A,N/A,N/A,1388,1390,N/A,99,1
5,N/A,N/A,N/A,1383,1388,N/A,103,5
5,N/A,N/A,N/A,1378,1383,N/A,109,5
3,N/A,N/A,N/A,1375,1378,N/A,114,4
3,N/A,N/A,N/A,1372,1375,N/A,120,4
2,N/A,N/A,N/A,1370,1372,N/A,123,1
6,N/A,N/A,N/A,1364,1370,N/A,128,6
2,N/A,N/A,N/A,1362,1364,N/A,134,0
4,N/A,N/A,N/A,1358,1362,N/A,138,4
5,N/A,N/A,N/A,1296,1301,N/A,6,5
3,N/A,N/A,N/A,1293,1296,N/A,10,3
2,N/A,N/A,N/A,1291,1293,N/A,15,2
1,N/A,N/A,N/A,1290,1291,N/A,20,1
6,N/A,N/A,N/A,1284,1290,N/A,24,5
2,N/A,N/A,N/A,1282,1284,N/A,28,3
3,N/A,N/A,N/A,1279,1282,N/A,34,3
6,N/A,N/A,N/A,1273,1279,N/A,37,6
1,N/A,N/A,N/A,1272,1273,N/A,43,0
7,N/A,N/A,N/A,1265,1272,N/A,49,6
1,N/A,N/A,N/A,1264,1265,N/A,55,0
2,N/A,N/A,N/A,1262,1264,N/A,58,3
2,N/A,N/A,N/A,1260,1262,N/A,64,3
6,N/A,N/A,N/A,1254,1260,N/A,67,6
3,N/A,N/A,N/A,1251,1254,N/A,70,3
2,N/A,N/A,N/A,1249,1251,N/A,75,2
1,N/A,N/A,N/A,1248,1249,N/A,80,1
5,N/A,N/A,N/A,1243,1248,N/A,84,5
3,N/A,N/A,N/A,1240,1243,N/A,87,2
5,N/A,N/A,N/A,1235,1240,N/A,90,5
3,N/A,N/A,N/A,1232,1235,N/A,95,4
1,N/A,N/A,N/A,1231,1232,N/A,98,1
7,N/A,N/A,N/A,1224,1231,N/A,103,6
3,N/A,N/A,N/A,1221,1224,N/A,106,3
2,N/A,N/A,N/A,1219,1221,N/A,110,1
6,N/A,N/A,N/A,1213,1219,N/A,115,6
3,N/A,N/A,N/A,1210,1213,N/A,118,3
7,N/A,N/A,N/A,1203,1210,N/A,121,6
4,N/A,N/A,N/A,1199,1203,N/A,125,4
4,N/A,N/A,N/A,1195,1199,N/A,131,4
3,N/A,N/A,N/A,500,503,N/A,3,2
6,N/A,N/A,N/A,494,500,N/A,7,6
2,N/A,N/A,N/A,492,494,N/A,13,0
3,N/A,N/A,N/A,489,492,N/A,17,4
4,N/A,N/A,N/A,485,489,N/A,23,4
2,N/A,N/A,N/A,483,485,N/A,27,2
2,N/A,N/A,N/A,481,483,N/A,33,2
2,N/A,N/A,N/A,479,481,N/A,38,1
5,N/A,N/A,N/A,474,479,N/A,42,5
5,N/A,N/A,N/A,469,474,N/A,48,5
2,N/A,N/A,N/A,467,469,N/A,51,2
5,N/A,N/A,N/A,462,467,N/A,54,5
3,N/A,N/A,N/A,459,462,N/A,58,3
7,N/A,N/A,N/A,452,459,N/A,61,6
3,N/A,N/A,N/A,449,452,N/A,65,4
2,N/A,N/A,N/A,447,449,N/A,69,2
7,N/A,N/A,N/A,440,447,N/A,73,6
2,N/A,N/A,N/A,438,440,N/A,76,3
1,N/A,N/A,N/A,437,438,N/A,80,1
5,N/A,N/A,N/A,432,437,N/A,84,5
4,N/A,N/A,N/A,428,432,N/A,89,4
3,N/A,N/A,N/A,425,428,N/A,93,2
5,N/A,N/A,N/A,420,425,N/A,96,5
3,N/A,N/A,N/A,417,420,N/A,99,2
1,N/A,N/A,N/A,416,417,N/A,104,1
1,N/A,N/A,N/A,415,416,N/A,110,1
3,N/A,N/A,N/A,412,415,N/A,113,4
2,N/A,N/A,N/A,410,412,N/A,118,3
2,N/A,N/A,N/A,408,410,N/A,124,3
1,N/A,N/A,N/A,407,408,N/A,128,1
4,N/A,N/A,N/A,1216,1220,N/A,5,4
2,N/A,N/A,N/A,1214,1216,N/A,8,1
7,N/A,N/A,N/A,1207,1214,N/A,13,6
5,N/A,N/A,N/A,1202,1207,N/A,18,5
3,N/A,N/A,N/A,1199,1202,N/A,23,4
3,N/A,N/A,N/A,1196,1199,N/A,27,2
3,N/A,N/A,N/A,1193,1196,N/A,33,2
2,N/A,N/A,N/A,1191,1193,N/A,38,1
1,N/A,N/A,N/A,1190,1191,N/A,44,1
3,N/A,N/A,N/A,1187,1190,N/A,47,4
2,N/A,N/A,N/A,1185,1187,N/A,52,3
2,N/A,N/A,N/A,1183,1185,N/A,56,1
5,N/A,N/A,N/A,1178,1183,N/A,60,5
3,N/A,N/A,N/A,1175,1178,N/A,65,4
2,N/A,N/A,N/A,1173,1175,N/A,70,3
3,N/A,N/A,N/A,1170,1173,N/A,75,2
1,N/A,N/A,N/A,1169,1170,N/A,80,1
1,N/A,N/A,N/A,1168,1169,N/A,86,1
3,N/A,N/A,N/A,1165,1168,N/A,89,4
1,N/A,N/A,N/A,1164,1165,N/A,92,1
6,N/A,N/A,N/A,1158,1164,N/A,96,5
3,N/A,N/A,N/A,1155,1158,N/A,100,3
6,N/A,N/A,N/A,1149,1155,N/A,103,6
2,N/A,N/A,N/A,1147,1149,N/A,106,3
6,N/A,N/A,N/A,1141,1147,N/A,109,6
6,N/A,N/A,N/A,1135,1141,N/A,114,5
6,N/A,N/A,N/A,1129,1135,N/A,120,5
3,N/A,N/A,N/A,1126,1129,N/A,123,2
1,N/A,N/A,N/A,1125,1126,N/A,128,1
6,N/A,N/A,N/A,1119,1125,N/A,133,6
2,N/A,N/A,N/A,474,476,N/A,5,3
7,N/A,N/A,N/A,467,474,N/A,8,6
2,N/A,N/A,N/A,465,467,N/A,14,0
3,N/A,N/A,N/A,462,465,N/A,17,3
2,N/A,N/A,N/A,460,462,N/A,21,1
1,N/A,N/A,N/A,459,460,N/A,27,1
6,N/A,N/A,N/A,453,459,N/A,32,6
2,N/A,N/A,N/A,451,453,N/A,38,0
3,N/A,N/A,N/A,448,451,N/A,41,3
2,N/A,N/A,N/A,446,448,N/A,47,3
3,N/A,N/A,N/A,443,446,N/A,53,3
3,N/A,N/A,N/A,440,443,N/A,59,3
3,N/A,N/A,N/A,437,440,N/A,65,3
2,N/A,N/A,N/A,435,437,N/A,70,2
3,N/A,N/A,N/A,432,435,N/A,76,2
2,N/A,N/A,N/A,430,432,N/A,81,1
6,N/A,N/A,N/A,424,430,N/A,86,6
1,N/A,N/A,N/A,423,424,N/A,92,0
6,N/A,N/A,N/A,417,423,N/A,97,5
6,N/A,N/A,N/A,411,417,N/A,103,5
3,N/A,N/A,N/A,408,411,N/A,107,3
2,N/A,N/A,N/A,406,408,N/A,112,2
6,N/A,N/A,N/A,400,406,N/A,115,5
6,N/A,N/A,N/A,394,400,N/A,121,5
5,N/A,N/A,N/A,389,394,N/A,127,5
3,N/A,N/A,N/A,386,389,N/A,132,4
3,N/A,N/A,N/A,383,386,N/A,136,2
2,N/A,N/A,N/A,381,383,N/A,141,1
5,N/A,N/A,N/A,376,381,N/A,145,5
2,N/A,N/A,N/A,374,376,N/A,149,3
1,N/A,N/A,N/A,347,348,N/A,6,1
4,N/A,N/A,N/A,343,347,N/A,9,4
1,N/A,N/A,N/A,342,343,N/A,12,1
6,N/A,N/A,N/A,336,342,N/A,17,6
2,N/A,N/A,N/A,334,336,N/A,23,0
6,N/A,N/A,N/A,328,334,N/A,29,6
2,N/A,N/A,N/A,326,328,N/A,32,3
2,N/A,N/A,N/A,324,326,N/A,37,2
2,N/A,N/A,N/A,322,324,N/A,42,1
1,N/A,N/A,N/A,321,322,N/A,48,1
6,N/A,N/A,N/A,315,321,N/A,52,5
2,N/A,N/A,N/A,313,315,N/A,56,3
2,N/A,N/A,N/A,311,313,N/A,60,1
6,N/A,N/A,N/A,305,311,N/A,65,6
1,N/A,N/A,N/A,304,305,N/A,71,0
6,N/A,N/A,N/A,298,304,N/A,76,5
4,N/A,N/A,N/A,294,298,N/A,81,4
3,N/A,N/A,N/A,291,294,N/A,87,4
2,N/A,N/A,N/A,289,291,N/A,90,1
4,N/A,N/A,N/A,285,289,N/A,93,4
3,N/A,N/A,N/A,282,285,N/A,98,3
3,N/A,N/A,N/A,279,282,N/A,103,2
2,N/A,N/A,N/A,277,279,N/A,109,2
7,N/A,N/A,N/A,270,277,N/A,113,6
3,N/A,N/A,N/A,267,270,N/A,117,4
3,N/A,N/A,N/A,264,267,N/A,121,2
3,N/A,N/A,N/A,261,264,N/A,127,2
6,N/A,N/A,N/A,255,261,N/A,130,5
2,N/A,N/A,N/A,253,255,N/A,134,3
3,N/A,N/A,N/A,250,253,N/A,140,3
5,N/A,N/A,N/A,1203,1208,N/A,4,5
2,N/A,N/A,N/A,1201,1203,N/A,7,2
6,N/A,N/A,N/A,1195,1201,N/A,11,6
2,N/A,N/A,N/A,1193,1195,N/A,17,0
6,N/A,N/A,N/A,1187,1193,N/A,22,5
3,N/A,N/A,N/A,1184,1187,N/A,25,2
7,N/A,N/A,N/A,1177,1184,N/A,29,6
5,N/A,N/A,N/A,1172,1177,N/A,34,5
6,N/A,N/A,N/A,1166,1172,N/A,40,5
2,N/A,N/A,N/A,1164,1166,N/A,44,3
6,N/A,N/A,N/A,1158,1164,N/A,47,6
6,N/A,N/A,N/A,1152,1158,N/A,52,5
2,N/A,N/A,N/A,1150,1152,N/A,55,2
6,N/A,N/A,N/A,1144,1150,N/A,58,5
3,N/A,N/A,N/A,1141,1144,N/A,61,2
2,N/A,N/A,N/A,1139,1141,N/A,66,1
6,N/A,N/A,N/A,1133,1139,N/A,70,5
4,N/A,N/A,N/A,1129,1133,N/A,75,4
3,N/A,N/A,N/A,1126,1129,N/A,81,4
3,N/A,N/A,N/A,1123,1126,N/A,85,2
6,N/A,N/A,N/A,1117,1123,N/A,88,5
4,N/A,N/A,N/A,1113,1117,N/A,93,4
4,N/A,N/A,N/A,1109,1113,N/A,99,4
2,N/A,N/A,N/A,1107,1109,N/A,102,1
5,N/A,N/A,N/A,1102,1107,N/A,106,5
4,N/A,N/A,N/A,1098,1102,N/A,111,4
3,N/A,N/A,N/A,1095,1098,N/A,117,4
3,N/A,N/A,N/A,1092,1095,N/A,121,2
3,N/A,N/A,N/A,1089,1092,N/A,127,2
1,N/A,N/A,N/A,1088,1089,N/A,132,1
3,N/A,N/A,N/A,867,870,N/A,6,4
4,N/A,N/A,N/A,863,867,N/A,12,4
3,N/A,N/A,N/A,860,863,N/A,16,2
5,N/A,N/A,N/A,855,860,N/A,19,5
3,N/A,N/A,N/A,852,855,N/A,22,2
5,N/A,N/A,N/A,847,852,N/A,25,5
2,N/A,N/A,N/A,845,847,N/A,29,3
3,N/A,N/A,N/A,842,845,N/A,34,2
6,N/A,N/A,N/A,836,842,N/A,38,6
1,N/A,N/A,N/A,835,836,N/A,44,0
4,N/A,N/A,N/A,831,835,N/A,48,4
2,N/A,N/A,N/A,829,831,N/A,53,3
3,N/A,N/A,N/A,826,829,N/A,59,3
2,N/A,N/A,N/A,824,826,N/A,64,2
6,N/A,N/A,N/A,818,824,N/A,67,5
2,N/A,N/A,N/A,816,818,N/A,71,3
1,N/A,N/A,N/A,815,816,N/A,75,1
1,N/A,N/A,N/A,814,815,N/A,81,1
2,N/A,N/A,N/A,812,814,N/A,87,1
7,N/A,N/A,N/A,805,812,N/A,92,6
4,N/A,N/A,N/A,801,805,N/A,96,4
3,N/A,N/A,N/A,798,801,N/A,100,2
6,N/A,N/A,N/A,792,798,N/A,104,6
2,N/A,N/A,N/A,790,792,N/A,107,3
6,N/A,N/A,N/A,784,790,N/A,110,6
2,N/A,N/A,N/A,782,784,N/A,116,0
7,N/A,N/A,N/A,775,782,N/A,122,6
5,N/A,N/A,N/A,770,775,N/A,127,5
5,N/A,N/A,N/A,765,770,N/A,133,5
2,N/A,N/A,N/A,763,765,N/A,137,3
3,N/A,N/A,N/A,1114,1117,N/A,6,4
3,N/A,N/A,N/A,1111,1114,N/A,10,2
7,N/A,N/A,N/A,1104,1111,N/A,14,6
1,N/A,N/A,N/A,1103,1104,N/A,20,0
2,N/A,N/A,N/A,1101,1103,N/A,23,3
3,N/A,N/A,N/A,1098,1101,N/A,29,3
7,N/A,N/A,N/A,1091,1098,N/A,32,6
3,N/A,N/A,N/A,1088,1091,N/A,35,3
2,N/A,N/A,N/A,1086,1088,N/A,39,1
6,N/A,N/A,N/A,1080,1086,N/A,43,5
3,N/A,N/A,N/A,1077,1080,N/A,48,4
2,N/A,N/A,N/A,1075,1077,N/A,52,2
5,N/A,N/A,N/A,1070,1075,N/A,55,5
3,N/A,N/A,N/A,1067,1070,N/A,60,4
4,N/A,N/A,N/A,1063,1067,N/A,66,4
1,N/A,N/A,N/A,1062,1063,N/A,69,1
5,N/A,N/A,N/A,1057,1062,N/A,73,5
3,N/A,N/A,N/A,1054,1057,N/A,77,3
3,N/A,N/A,N/A,1051,1054,N/A,82,2
6,N/A,N/A,N/A,1045,1051,N/A,86,6
2,N/A,N/A,N/A,1043,1045,N/A,89,3
3,N/A,N/A,N/A,1040,1043,N/A,95,3
6,N/A,N/A,N/A,1034,1040,N/A,98,6
4,N/A,N/A,N/A,1030,1034,N/A,102,4
3,N/A,N/A,N/A,1027,1030,N/A,107,3
1,N/A,N/A,N/A,1026,1027,N/A,111,1
6,N/A,N/A,N/A,1020,1026,N/A,116,6
4,N/A,N/A,N/A,1016,1020,N/A,120,4
3,N/A,N/A,N/A,1013,1016,N/A,124,2
1,N/A,N/A,N/A,1012,1013,N/A,129,1
4,N/A,N/A,N/A,1670,1674,N/A,6,4
3,N/A,N/A,N/A,1667,1670,N/A,10,2
2,N/A,N/A,N/A,1665,1667,N/A,16,2
6,N/A,N/A,N/A,1659,1665,N/A,19,5
3,N/A,N/A,N/A,1656,1659,N/A,22,2
1,N/A,N/A,N/A,1655,1656,N/A,27,1
7,N/A,N/A,N/A,1648,1655,N/A,32,6
3,N/A,N/A,N/A,1645,1648,N/A,35,3
1,N/A,N/A,N/A,1644,1645,N/A,39,1
1,N/A,N/A,N/A,1643,1644,N/A,45,1
2,N/A,N/A,N/A,1641,1643,N/A,51,1
6,N/A,N/A,N/A,1635,1641,N/A,55,5
3,N/A,N/A,N/A,1632,1635,N/A,60,4
3,N/A,N/A,N/A,1629,1632,N/A,64,2
5,N/A,N/A,N/A,1624,1629,N/A,67,5
2,N/A,N/A,N/A,1622,1624,N/A,70,2
6,N/A,N/A,N/A,1616,1622,N/A,74,6
2,N/A,N/A,N/A,1614,1616,N/A,80,0
2,N/A,N/A,N/A,1612,1614,N/A,83,3
6,N/A,N/A,N/A,1606,1612,N/A,86,6
1,N/A,N/A,N/A,1605,1606,N/A,92,0
7,N/A,N/A,N/A,1598,1605,N/A,98,6
6,N/A,N/A,N/A,1592,1598,N/A,103,5
2,N/A,N/A,N/A,1590,1592,N/A,107,3
1,N/A,N/A,N/A,1589,1590,N/A,111,1
4,N/A,N/A,N/A,1585,1589,N/A,114,4
2,N/A,N/A,N/A,1583,1585,N/A,117,1
5,N/A,N/A,N/A,1578,1583,N/A,121,5
3,N/A,N/A,N/A,1575,1578,N/A,126,4
1,N/A,N/A,N/A,1574,1575,N/A,129,1
1,N/A,N/A,N/A,1692,1693,N/A,6,1
6,N/A,N/A,N/A,1686,1692,N/A,10,5
3,N/A,N/A,N/A,1683,1686,N/A,13,2
3,N/A,N/A,N/A,1680,1683,N/A,19,2
5,N/A,N/A,N/A,1675,1680,N/A,22,5
6,N/A,N/A,N/A,1669,1675,N/A,28,5
3,N/A,N/A,N/A,1666,1669,N/A,33,4
3,N/A,N/A,N/A,1663,1666,N/A,39,4
4,N/A,N/A,N/A,1659,1663,N/A,45,4
2,N/A,N/A,N/A,1657,1659,N/A,50,3
2,N/A,N/A,N/A,1655,1657,N/A,56,3
7,N/A,N/A,N/A,1648,1655,N/A,59,6
4,N/A,N/A,N/A,1644,1648,N/A,63,4
2,N/A,N/A,N/A,1642,1644,N/A,68,3
2,N/A,N/A,N/A,1640,1642,N/A,74,3
1,N/A,N/A,N/A,1639,1640,N/A,78,1
6,N/A,N/A,N/A,1633,1639,N/A,82,5
2,N/A,N/A,N/A,1631,1633,N/A,85,2
1,N/A,N/A,N/A,1630,1631,N/A,90,1
4,N/A,N/A,N/A,1626,1630,N/A,93,4
3,N/A,N/A,N/A,1623,1626,N/A,99,4
2,N/A,N/A,N/A,1621,1623,N/A,104,3
7,N/A,N/A,N/A,1614,1621,N/A,107,6
2,N/A,N/A,N/A,1612,1614,N/A,113,0
4,N/A,N/A,N/A,1608,1612,N/A,117,4
3,N/A,N/A,N/A,1605,1608,N/A,122,3
2,N/A,N/A,N/A,1603,1605,N/A,126,1
7,N/A,N/A,N/A,1596,1603,N/A,131,6
5,N/A,N/A,N/A,1591,1596,N/A,136,5
6,N/A,N/A,N/A,1585,1591,N/A,142,5
3,N/A,N/A,N/A,546,549,N/A,3,2
7,N/A,N/A,N/A,539,546,N/A,7,6
5,N/A,N/A,N/A,534,539,N/A,12,5
3,N/A,N/A,N/A,531,534,N/A,16,3
3,N/A,N/A,N/A,528,531,N/A,22,3
2,N/A,N/A,N/A,526,528,N/A,27,2
1,N/A,N/A,N/A,525,526,N/A,32,1
2,N/A,N/A,N/A,523,525,N/A,38,1
2,N/A,N/A,N/A,521,523,N/A,44,1
2,N/A,N/A,N/A,519,521,N/A,50,1
7,N/A,N/A,N/A,512,519,N/A,55,6
2,N/A,N/A,N/A,510,512,N/A,58,3
2,N/A,N/A,N/A,508,510,N/A,62,1
6,N/A,N/A,N/A,502,508,N/A,67,6
3,N/A,N/A,N/A,499,502,N/A,71,4
3,N/A,N/A,N/A,496,499,N/A,77,4
2,N/A,N/A,N/A,494,496,N/A,82,3
6,N/A,N/A,N/A,488,494,N/A,85,6
3,N/A,N/A,N/A,485,488,N/A,88,3
3,N/A,N/A,N/A,482,485,N/A,93,2
7,N/A,N/A,N/A,475,482,N/A,97,6
5,N/A,N/A,N/A,470,475,N/A,102,5
5,N/A,N/A,N/A,465,470,N/A,108,5
4,N/A,N/A,N/A,461,465,N/A,113,4
2,N/A,N/A,N/A,459,461,N/A,116,1
2,N/A,N/A,N/A,457,459,N/A,122,1
7,N/A,N/A,N/A,450,457,N/A,127,6
2,N/A,N/A,N/A,448,450,N/A,133,0
7,N/A,N/A,N/A,441,448,N/A,139,6
4,N/A,N/A,N/A,437,441,N/A,143,4
2,N/A,N/A,N/A,1213,1215,N/A,4,3
6,N/A,N/A,N/A,1207,1213,N/A,7,6
3,N/A,N/A,N/A,1204,1207,N/A,11,4
1,N/A,N/A,N/A,1203,1204,N/A,14,1
2,N/A,N/A,N/A,1201,1203,N/A,20,1
6,N/A,N/A,N/A,1195,1201,N/A,24,5
4,N/A,N/A,N/A,1191,1195,N/A,29,4
2,N/A,N/A,N/A,1189,1191,N/A,34,3
2,N/A,N/A,N/A,1187,1189,N/A,40,3
3,N/A,N/A,N/A,1184,1187,N/A,45,2
7,N/A,N/A,N/A,1177,1184,N/A,49,6
2,N/A,N/A,N/A,1175,1177,N/A,52,3
3,N/A,N/A,N/A,1172,1175,N/A,57,2
6,N/A,N/A,N/A,1166,1172,N/A,60,5
5,N/A,N/A,N/A,1161,1166,N/A,66,5
2,N/A,N/A,N/A,1159,1161,N/A,69,2
6,N/A,N/A,N/A,1153,1159,N/A,72,5
6,N/A,N/A,N/A,1147,1153,N/A,78,5
4,N/A,N/A,N/A,1143,1147,N/A,83,4
3,N/A,N/A,N/A,1140,1143,N/A,87,2
2,N/A,N/A,N/A,1138,1140,N/A,93,2
1,N/A,N/A,N/A,1137,1138,N/A,98,1
2,N/A,N/A,N/A,1135,1137,N/A,104,1
1,N/A,N/A,N/A,1134,1135,N/A,110,1
6,N/A,N/A,N/A,1128,1134,N/A,114,5
3,N/A,N/A,N/A,1125,1128,N/A,117,2
2,N/A,N/A,N/A,1123,1125,N/A,122,1
7,N/A,N/A,N/A,1116,1123,N/A,127,6
6,N/A,N/A,N/A,1110,1116,N/A,132,5
3,N/A,N/A,N/A,1107,1110,N/A,136,3
6,N/A,N/A,N/A,661,667,N/A,5,6
6,N/A,N/A,N/A,655,661,N/A,10,5
4,N/A,N/A,N/A,651,655,N/A,15,4
2,N/A,N/A,N/A,649,651,N/A,18,1
7,N/A,N/A,N/A,642,649,N/A,23,6
3,N/A,N/A,N/A,639,642,N/A,26,3
1,N/A,N/A,N/A,638,639,N/A,30,1
1,N/A,N/A,N/A,637,638,N/A,36,1
7,N/A,N/A,N/A,630,637,N/A,41,6
6,N/A,N/A,N/A,624,630,N/A,46,5
6,N/A,N/A,N/A,618,624,N/A,52,5
4,N/A,N/A,N/A,614,618,N/A,57,4
3,N/A,N/A,N/A,611,614,N/A,61,2
2,N/A,N/A,N/A,609,611,N/A,67,2
6,N/A,N/A,N/A,603,609,N/A,70,5
6,N/A,N/A,N/A,597,603,N/A,76,5
6,N/A,N/A,N/A,591,597,N/A,82,5
5,N/A,N/A,N/A,586,591,N/A,88,5
3,N/A,N/A,N/A,583,586,N/A,93,4
4,N/A,N/A,N/A,579,583,N/A,99,4
1,N/A,N/A,N/A,578,579,N/A,102,1
7,N/A,N/A,N/A,571,578,N/A,107,6
2,N/A,N/A,N/A,569,571,N/A,113,0
4,N/A,N/A,N/A,565,569,N/A,117,4
2,N/A,N/A,N/A,563,565,N/A,122,3
2,N/A,N/A,N/A,561,563,N/A,127,2
5,N/A,N/A,N/A,556,561,N/A,130,5
3,N/A,N/A,N/A,553,556,N/A,133,2
2,N/A,N/A,N/A,551,553,N/A,139,2
2,N/A,N/A,N/A,549,551,N/A,144,1
6,N/A,N/A,N/A,362,368,N/A,4,5
2,N/A,N/A,N/A,360,362,N/A,7,2
1,N/A,N/A,N/A,359,360,N/A,12,1
2,N/A,N/A,N/A,357,359,N/A,18,1
5,N/A,N/A,N/A,352,357,N/A,22,5
2,N/A,N/A,N/A,350,352,N/A,25,2
6,N/A,N/A,N/A,344,350,N/A,29,6
2,N/A,N/A,N/A,342,344,N/A,35,0
6,N/A,N/A,N/A,336,342,N/A,40,5
3,N/A,N/A,N/A,333,336,N/A,44,3
7,N/A,N/A,N/A,326,333,N/A,47,6
1,N/A,N/A,N/A,325,326,N/A,53,0
7,N/A,N/A,N/A,318,325,N/A,59,6
2,N/A,N/A,N/A,316,318,N/A,62,3
1,N/A,N/A,N/A,315,316,N/A,66,1
2,N/A,N/A,N/A,313,315,N/A,72,1
6,N/A,N/A,N/A,307,313,N/A,77,6
6,N/A,N/A,N/A,301,307,N/A,82,5
3,N/A,N/A,N/A,298,301,N/A,87,4
1,N/A,N/A,N/A,297,298,N/A,90,1
1,N/A,N/A,N/A,296,297,N/A,96,1
6,N/A,N/A,N/A,290,296,N/A,100,5
4,N/A,N/A,N/A,286,290,N/A,105,4
3,N/A,N/A,N/A,283,286,N/A,109,2
6,N/A,N/A,N/A,277,283,N/A,112,5
4,N/A,N/A,N/A,273,277,N/A,117,4
2,N/A,N/A,N/A,271,273,N/A,122,3
2,N/A,N/A,N/A,269,271,N/A,128,3
3,N/A,N/A,N/A,266,269,N/A,134,3
6,N/A,N/A,N/A,260,266,N/A,137,6
2,N/A,N/A,N/A,1455,1457,N/A,5,3
2,N/A,N/A,N/A,1453,1455,N/A,10,2
2,N/A,N/A,N/A,1451,1453,N/A,15,1
6,N/A,N/A,N/A,1445,1451,N/A,19,5
5,N/A,N/A,N/A,1440,1445,N/A,25,5
3,N/A,N/A,N/A,1437,1440,N/A,29,3
2,N/A,N/A,N/A,1435,1437,N/A,34,2
1,N/A,N/A,N/A,1434,1435,N/A,39,1
2,N/A,N/A,N/A,1432,1434,N/A,45,1
6,N/A,N/A,N/A,1426,1432,N/A,50,6
3,N/A,N/A,N/A,1423,1426,N/A,53,3
3,N/A,N/A,N/A,1420,1423,N/A,59,3
3,N/A,N/A,N/A,1417,1420,N/A,64,2
6,N/A,N/A,N/A,1411,1417,N/A,68,6
2,N/A,N/A,N/A,1409,1411,N/A,71,3
2,N/A,N/A,N/A,1407,1409,N/A,77,3
2,N/A,N/A,N/A,1405,1407,N/A,81,1
6,N/A,N/A,N/A,1399,1405,N/A,85,5
2,N/A,N/A,N/A,1397,1399,N/A,88,2
3,N/A,N/A,N/A,1394,1397,N/A,94,2
5,N/A,N/A,N/A,1389,1394,N/A,97,5
6,N/A,N/A,N/A,1383,1389,N/A,103,5
3,N/A,N/A,N/A,1380,1383,N/A,107,3
2,N/A,N/A,N/A,1378,1380,N/A,112,2
2,N/A,N/A,N/A,1376,1378,N/A,118,2
6,N/A,N/A,N/A,1370,1376,N/A,122,6
4,N/A,N/A,N/A,1366,1370,N/A,126,4
2,N/A,N/A,N/A,1364,1366,N/A,131,3
3,N/A,N/A,N/A,1361,1364,N/A,136,2
5,N/A,N/A,N/A,1356,1361,N/A,139,5
6,N/A,N/A,N/A,357,363,N/A,6,5
2,N/A,N/A,N/A,355,357,N/A,9,2
6,N/A,N/A,N/A,349,355,N/A,12,5
6,N/A,N/A,N/A,343,349,N/A,18,5
2,N/A,N/A,N/A,341,343,N/A,21,2
1,N/A,N/A,N/A,340,341,N/A,26,1
7,N/A,N/A,N/A,333,340,N/A,31,6
3,N/A,N/A,N/A,330,333,N/A,34,3
2,N/A,N/A,N/A,328,330,N/A,40,3
2,N/A,N/A,N/A,326,328,N/A,44,1
1,N/A,N/A,N/A,325,326,N/A,50,1
6,N/A,N/A,N/A,319,325,N/A,54,5
3,N/A,N/A,N/A,316,319,N/A,57,2
3,N/A,N/A,N/A,313,316,N/A,63,2
6,N/A,N/A,N/A,307,313,N/A,67,6
5,N/A,N/A,N/A,302,307,N/A,72,5
5,N/A,N/A,N/A,297,302,N/A,78,5
2,N/A,N/A,N/A,295,297,N/A,82,3
2,N/A,N/A,N/A,293,295,N/A,86,1
1,N/A,N/A,N/A,292,293,N/A,92,1
1,N/A,N/A,N/A,291,292,N/A,98,1
4,N/A,N/A,N/A,287,291,N/A,101,4
1,N/A,N/A,N/A,286,287,N/A,104,1
2,N/A,N/A,N/A,284,286,N/A,110,1
2,N/A,N/A,N/A,282,284,N/A,116,1
6,N/A,N/A,N/A,276,282,N/A,120,5
5,N/A,N/A,N/A,271,276,N/A,126,5
4,N/A,N/A,N/A,267,271,N/A,131,4
3,N/A,N/A,N/A,264,267,N/A,135,2
1,N/A,N/A,N/A,263,264,N/A,140,1
6,N/A,N/A,N/A,384,390,N/A,4,5
3,N/A,N/A,N/A,381,384,N/A,7,2
7,N/A,N/A,N/A,374,381,N/A,11,6
6,N/A,N/A,N/A,368,374,N/A,16,5
2,N/A,N/A,N/A,366,368,N/A,19,2
2,N/A,N/A,N/A,364,366,N/A,24,1
7,N/A,N/A,N/A,357,364,N/A,29,6
3,N/A,N/A,N/A,354,357,N/A,32,3
3,N/A,N/A,N/A,351,354,N/A,38,3
7,N/A,N/A,N/A,344,351,N/A,41,6
3,N/A,N/A,N/A,341,344,N/A,45,4
2,N/A,N/A,N/A,339,341,N/A,48,1
1,N/A,N/A,N/A,338,339,N/A,54,1
2,N/A,N/A,N/A,336,338,N/A,60,1
3,N/A,N/A,N/A,333,336,N/A,63,4
2,N/A,N/A,N/A,331,333,N/A,67,2
6,N/A,N/A,N/A,325,331,N/A,70,5
2,N/A,N/A,N/A,323,325,N/A,73,2
5,N/A,N/A,N/A,318,323,N/A,76,5
6,N/A,N/A,N/A,312,318,N/A,82,5
2,N/A,N/A,N/A,310,312,N/A,85,2
6,N/A,N/A,N/A,304,310,N/A,88,5
5,N/A,N/A,N/A,299,304,N/A,94,5
3,N/A,N/A,N/A,296,299,N/A,98,3
7,N/A,N/A,N/A,289,296,N/A,101,6
1,N/A,N/A,N/A,288,289,N/A,107,0
7,N/A,N/A,N/A,281,288,N/A,113,6
1,N/A,N/A,N/A,280,281,N/A,119,0
4,N/A,N/A,N/A,276,280,N/A,123,4
3,N/A,N/A,N/A,273,276,N/A,127,2
3,N/A,N/A,N/A,506,509,N/A,4,2
3,N/A,N/A,N/A,503,506,N/A,10,2
2,N/A,N/A,N/A,501,503,N/A,16,2
1,N/A,N/A,N/A,500,501,N/A,21,1
3,N/A,N/A,N/A,497,500,N/A,24,4
4,N/A,N/A,N/A,493,497,N/A,30,4
3,N/A,N/A,N/A,490,493,N/A,36,4
2,N/A,N/A,N/A,488,490,N/A,40,2
6,N/A,N/A,N/A,482,488,N/A,44,6
6,N/A,N/A,N/A,476,482,N/A,49,5
3,N/A,N/A,N/A,473,476,N/A,54,4
2,N/A,N/A,N/A,471,473,N/A,58,2
6,N/A,N/A,N/A,465,471,N/A,62,6
3,N/A,N/A,N/A,462,465,N/A,66,4
2,N/A,N/A,N/A,460,462,N/A,71,3
2,N/A,N/A,N/A,458,460,N/A,77,3
2,N/A,N/A,N/A,456,458,N/A,82,2
7,N/A,N/A,N/A,449,456,N/A,86,6
6,N/A,N/A,N/A,443,449,N/A,91,5
3,N/A,N/A,N/A,440,443,N/A,95,3
2,N/A,N/A,N/A,438,440,N/A,100,2
2,N/A,N/A,N/A,436,438,N/A,106,2
2,N/A,N/A,N/A,434,436,N/A,111,1
6,N/A,N/A,N/A,428,434,N/A,116,6
5,N/A,N/A,N/A,423,428,N/A,121,5
6,N/A,N/A,N/A,417,423,N/A,127,5
3,N/A,N/A,N/A,414,417,N/A,131,3
2,N/A,N/A,N/A,412,414,N/A,135,1
4,N/A,N/A,N/A,408,412,N/A,138,4
3,N/A,N/A,N/A,405,408,N/A,144,4
4,N/A,N/A,N/A,960,964,N/A,3,4
3,N/A,N/A,N/A,957,960,N/A,8,3
1,N/A,N/A,N/A,956,957,N/A,12,1
3,N/A,N/A,N/A,953,956,N/A,15,4
3,N/A,N/A,N/A,950,953,N/A,19,2
5,N/A,N/A,N/A,945,950,N/A,22,5
4,N/A,N/A,N/A,941,945,N/A,27,4
2,N/A,N/A,N/A,939,941,N/A,31,2
5,N/A,N/A,N/A,934,939,N/A,34,5
6,N/A,N/A,N/A,928,934,N/A,40,5
3,N/A,N/A,N/A,925,928,N/A,43,2
6,N/A,N/A,N/A,919,925,N/A,46,5
6,N/A,N/A,N/A,913,919,N/A,52,5
4,N/A,N/A,N/A,909,913,N/A,57,4
2,N/A,N/A,N/A,907,909,N/A,60,1
3,N/A,N/A,N/A,904,907,N/A,63,4
2,N/A,N/A,N/A,902,904,N/A,66,1
2,N/A,N/A,N/A,900,902,N/A,72,1
1,N/A,N/A,N/A,899,900,N/A,78,1
6,N/A,N/A,N/A,893,899,N/A,82,5
4,N/A,N/A,N/A,889,893,N/A,87,4
4,N/A,N/A,N/A,885,889,N/A,93,4
1,N/A,N/A,N/A,884,885,N/A,96,1
4,N/A,N/A,N/A,880,884,N/A,99,4
2,N/A,N/A,N/A,878,880,N/A,103,2
1,N/A,N/A,N/A,877,878,N/A,108,1
6,N/A,N/A,N/A,871,877,N/A,112,5
2,N/A,N/A,N/A,869,871,N/A,115,2
5,N/A,N/A,N/A,864,869,N/A,118,5
5,N/A,N/A,N/A,859,864,N/A,124,5
7,N/A,N/A,N/A,816,823,N/A,6,6
3,N/A,N/A,N/A,813,816,N/A,10,4
2,N/A,N/A,N/A,811,813,N/A,14,2
5,N/A,N/A,N/A,806,811,N/A,17,5
6,N/A,N/A,N/A,800,806,N/A,23,5
2,N/A,N/A,N/A,798,800,N/A,26,2
1,N/A,N/A,N/A,797,798,N/A,31,1
1,N/A,N/A,N/A,796,797,N/A,37,1
6,N/A,N/A,N/A,790,796,N/A,42,6
4,N/A,N/A,N/A,786,790,N/A,46,4
1,N/A,N/A,N/A,785,786,N/A,49,1
3,N/A,N/A,N/A,782,785,N/A,52,4
2,N/A,N/A,N/A,780,782,N/A,56,2
6,N/A,N/A,N/A,774,780,N/A,60,6
1,N/A,N/A,N/A,773,774,N/A,66,0
6,N/A,N/A,N/A,767,773,N/A,71,5
6,N/A,N/A,N/A,761,767,N/A,77,5
5,N/A,N/A,N/A,756,761,N/A,83,5
2,N/A,N/A,N/A,754,756,N/A,87,3
7,N/A,N/A,N/A,747,754,N/A,90,6
3,N/A,N/A,N/A,744,747,N/A,94,4
2,N/A,N/A,N/A,742,744,N/A,97,1
5,N/A,N/A,N/A,737,742,N/A,101,5
4,N/A,N/A,N/A,733,737,N/A,106,4
2,N/A,N/A,N/A,731,733,N/A,109,1
4,N/A,N/A,N/A,727,731,N/A,112,4
4,N/A,N/A,N/A,723,727,N/A,118,4
3,N/A,N/A,N/A,720,723,N/A,123,3
3,N/A,N/A,N/A,717,720,N/A,129,3
7,N/A,N/A,N/A,710,717,N/A,132,6
1,N/A,N/A,N/A,1229,1230,N/A,6,1
6,N/A,N/A,N/A,1223,1229,N/A,11,6
3,N/A,N/A,N/A,1220,1223,N/A,15,4
3,N/A,N/A,N/A,1217,1220,N/A,20,3
2,N/A,N/A,N/A,1215,1217,N/A,25,2
7,N/A,N/A,N/A,1208,1215,N/A,29,6
5,N/A,N/A,N/A,1203,1208,N/A,34,5
3,N/A,N/A,N/A,1200,1203,N/A,37,2
5,N/A,N/A,N/A,1195,1200,N/A,40,5
3,N/A,N/A,N/A,1192,1195,N/A,45,4
3,N/A,N/A,N/A,1189,1192,N/A,51,4
2,N/A,N/A,N/A,1187,1189,N/A,56,3
2,N/A,N/A,N/A,1185,1187,N/A,61,2
2,N/A,N/A,N/A,1183,1185,N/A,67,2
5,N/A,N/A,N/A,1178,1183,N/A,70,5
4,N/A,N/A,N/A,1174,1178,N/A,75,4
2,N/A,N/A,N/A,1172,1174,N/A,80,3
2,N/A,N/A,N/A,1170,1172,N/A,86,3
3,N/A,N/A,N/A,1167,1170,N/A,92,3
2,N/A,N/A,N/A,1165,1167,N/A,98,3
1,N/A,N/A,N/A,1164,1165,N/A,102,1
6,N/A,N/A,N/A,1158,1164,N/A,107,6
2,N/A,N/A,N/A,1156,1158,N/A,110,3
6,N/A,N/A,N/A,1150,1156,N/A,113,6
1,N/A,N/A,N/A,1149,1150,N/A,119,0
2,N/A,N/A,N/A,1147,1149,N/A,122,3
7,N/A,N/A,N/A,1140,1147,N/A,125,6
6,N/A,N/A,N/A,1134,1140,N/A,130,5
3,N/A,N/A,N/A,1131,1134,N/A,133,2
2,N/A,N/A,N/A,1129,1131,N/A,139,2
5,N/A,N/A,N/A,1016,1021,N/A,5,5
3,N/A,N/A,N/A,1013,1016,N/A,9,3
1,N/A,N/A,N/A,1012,1013,N/A,13,1
7,N/A,N/A,N/A,1005,1012,N/A,18,6
4,N/A,N/A,N/A,1001,1005,N/A,22,4
3,N/A,N/A,N/A,998,1001,N/A,27,3
6,N/A,N/A,N/A,992,998,N/A,30,6
3,N/A,N/A,N/A,989,992,N/A,33,3
6,N/A,N/A,N/A,983,989,N/A,36,6
2,N/A,N/A,N/A,981,983,N/A,42,0
2,N/A,N/A,N/A,979,981,N/A,45,3
2,N/A,N/A,N/A,977,979,N/A,49,1
3,N/A,N/A,N/A,974,977,N/A,52,4
1,N/A,N/A,N/A,973,974,N/A,55,1
3,N/A,N/A,N/A,970,973,N/A,58,4
3,N/A,N/A,N/A,967,970,N/A,64,4
2,N/A,N/A,N/A,965,967,N/A,67,1
6,N/A,N/A,N/A,959,965,N/A,71,5
2,N/A,N/A,N/A,957,959,N/A,75,3
3,N/A,N/A,N/A,954,957,N/A,80,2
6,N/A,N/A,N/A,948,954,N/A,84,6
3,N/A,N/A,N/A,945,948,N/A,87,3
3,N/A,N/A,N/A,942,945,N/A,93,3
2,N/A,N/A,N/A,940,942,N/A,99,3
1,N/A,N/A,N/A,939,940,N/A,103,1
7,N/A,N/A,N/A,932,939,N/A,108,6
3,N/A,N/A,N/A,929,932,N/A,111,3
3,N/A,N/A,N/A,926,929,N/A,116,2
3,N/A,N/A,N/A,923,926,N/A,122,2
2,N/A,N/A,N/A,921,923,N/A,128,2
6,N/A,N/A,N/A,725,731,N/A,5,5
2,N/A,N/A,N/A,723,725,N/A,8,2
5,N/A,N/A,N/A,718,723,N/A,11,5
2,N/A,N/A,N/A,716,718,N/A,14,2
7,N/A,N/A,N/A,709,716,N/A,18,6
1,N/A,N/A,N/A,708,709,N/A,24,0
6,N/A,N/A,N/A,702,708,N/A,30,6
2,N/A,N/A,N/A,700,702,N/A,33,3
2,N/A,N/A,N/A,698,700,N/A,37,1
7,N/A,N/A,N/A,691,698,N/A,42,6
1,N/A,N/A,N/A,690,691,N/A,48,0
7,N/A,N/A,N/A,683,690,N/A,54,6
2,N/A,N/A,N/A,681,683,N/A,60,0
5,N/A,N/A,N/A,676,681,N/A,65,5
6,N/A,N/A,N/A,670,676,N/A,71,5
5,N/A,N/A,N/A,665,670,N/A,77,5
4,N/A,N/A,N/A,661,665,N/A,82,4
2,N/A,N/A,N/A,659,661,N/A,85,1
4,N/A,N/A,N/A,655,659,N/A,88,4
3,N/A,N/A,N/A,652,655,N/A,93,3
6,N/A,N/A,N/A,646,652,N/A,96,6
6,N/A,N/A,N/A,640,646,N/A,101,5
3,N/A,N/A,N/A,637,640,N/A,104,2
2,N/A,N/A,N/A,635,637,N/A,110,2
3,N/A,N/A,N/A,632,635,N/A,116,2
7,N/A,N/A,N/A,625,632,N/A,120,6
2,N/A,N/A,N/A,623,625,N/A,123,3
1,N/A,N/A,N/A,622,623,N/A,127,1
5,N/A,N/A,N/A,617,622,N/A,131,5
4,N/A,N/A,N/A,613,617,N/A,136,4
5,N/A,N/A,N/A,817,822,N/A,6,5
3,N/A,N/A,N/A,814,817,N/A,9,2
1,N/A,N/A,N/A,813,814,N/A,14,1
2,N/A,N/A,N/A,811,813,N/A,20,1
6,N/A,N/A,N/A,805,811,N/A,24,5
3,N/A,N/A,N/A,802,805,N/A,29,4
2,N/A,N/A,N/A,800,802,N/A,34,3
2,N/A,N/A,N/A,798,800,N/A,38,1
6,N/A,N/A,N/A,792,798,N/A,42,5
5,N/A,N/A,N/A,787,792,N/A,48,5
3,N/A,N/A,N/A,784,787,N/A,51,2
3,N/A,N/A,N/A,781,784,N/A,57,2
1,N/A,N/A,N/A,780,781,N/A,62,1
5,N/A,N/A,N/A,775,780,N/A,66,5
2,N/A,N/A,N/A,773,775,N/A,69,2
2,N/A,N/A,N/A,771,773,N/A,75,2
6,N/A,N/A,N/A,765,771,N/A,79,6
4,N/A,N/A,N/A,761,765,N/A,83,4
2,N/A,N/A,N/A,759,761,N/A,87,2
6,N/A,N/A,N/A,753,759,N/A,91,6
2,N/A,N/A,N/A,751,753,N/A,97,0
7,N/A,N/A,N/A,744,751,N/A,103,6
3,N/A,N/A,N/A,741,744,N/A,106,3
3,N/A,N/A,N/A,738,741,N/A,111,2
2,N/A,N/A,N/A,736,738,N/A,116,1
1,N/A,N/A,N/A,735,736,N/A,122,1
5,N/A,N/A,N/A,730,735,N/A,126,5
3,N/A,N/A,N/A,727,730,N/A,129,2
2,N/A,N/A,N/A,725,727,N/A,135,2
2,N/A,N/A,N/A,723,725,N/A,140,1
3,N/A,N/A,N/A,797,800,N/A,4,3
6,N/A,N/A,N/A,791,797,N/A,7,6
2,N/A,N/A,N/A,789,791,N/A,13,0
3,N/A,N/A,N/A,786,789,N/A,17,4
3,N/A,N/A,N/A,783,786,N/A,23,4
3,N/A,N/A,N/A,780,783,N/A,27,2
6,N/A,N/A,N/A,774,780,N/A,31,6
2,N/A,N/A,N/A,772,774,N/A,34,3
3,N/A,N/A,N/A,769,772,N/A,39,2
1,N/A,N/A,N/A,768,769,N/A,44,1
3,N/A,N/A,N/A,765,768,N/A,47,4
3,N/A,N/A,N/A,762,765,N/A,53,4
1,N/A,N/A,N/A,761,762,N/A,56,1
6,N/A,N/A,N/A,755,761,N/A,61,6
1,N/A,N/A,N/A,754,755,N/A,67,0
2,N/A,N/A,N/A,752,754,N/A,70,3
2,N/A,N/A,N/A,750,752,N/A,75,2
2,N/A,N/A,N/A,748,750,N/A,81,2
7,N/A,N/A,N/A,741,748,N/A,85,6
3,N/A,N/A,N/A,738,741,N/A,89,4
4,N/A,N/A,N/A,734,738,N/A,95,4
2,N/A,N/A,N/A,732,734,N/A,98,1
1,N/A,N/A,N/A,731,732,N/A,104,1
1,N/A,N/A,N/A,730,731,N/A,110,1
4,N/A,N/A,N/A,726,730,N/A,113,4
3,N/A,N/A,N/A,723,726,N/A,118,3
3,N/A,N/A,N/A,720,723,N/A,124,3
2,N/A,N/A,N/A,718,720,N/A,129,2
1,N/A,N/A,N/A,717,718,N/A,134,1
1,N/A,N/A,N/A,716,717,N/A,140,1
3,N/A,N/A,N/A,1396,1399,N/A,5,2
3,N/A,N/A,N/A,1393,1396,N/A,11,2
2,N/A,N/A,N/A,1391,1393,N/A,16,1
5,N/A,N/A,N/A,1386,1391,N/A,20,5
3,N/A,N/A,N/A,1383,1386,N/A,25,4
4,N/A,N/A,N/A,1379,1383,N/A,31,4
2,N/A,N/A,N/A,1377,1379,N/A,35,2
6,N/A,N/A,N/A,1371,1377,N/A,39,6
4,N/A,N/A,N/A,1367,1371,N/A,43,4
4,N/A,N/A,N/A,1363,1367,N/A,49,4
2,N/A,N/A,N/A,1361,1363,N/A,54,3
2,N/A,N/A,N/A,1359,1361,N/A,58,1
5,N/A,N/A,N/A,1354,1359,N/A,62,5
2,N/A,N/A,N/A,1352,1354,N/A,65,2
6,N/A,N/A,N/A,1346,1352,N/A,69,6
1,N/A,N/A,N/A,1345,1346,N/A,75,0
5,N/A,N/A,N/A,1340,1345,N/A,80,5
3,N/A,N/A,N/A,1337,1340,N/A,84,3
1,N/A,N/A,N/A,1336,1337,N/A,88,1
1,N/A,N/A,N/A,1335,1336,N/A,94,1
7,N/A,N/A,N/A,1328,1335,N/A,99,6
2,N/A,N/A,N/A,1326,1328,N/A,105,0
4,N/A,N/A,N/A,1322,1326,N/A,109,4
3,N/A,N/A,N/A,1319,1322,N/A,114,3
1,N/A,N/A,N/A,1318,1319,N/A,118,1
3,N/A,N/A,N/A,1315,1318,N/A,121,4
2,N/A,N/A,N/A,1313,1315,N/A,124,1
5,N/A,N/A,N/A,1308,1313,N/A,128,5
2,N/A,N/A,N/A,1306,1308,N/A,131,2
6,N/A,N/A,N/A,1300,1306,N/A,135,6
3,N/A,N/A,N/A,738,741,N/A,4,3
2,N/A,N/A,N/A,736,738,N/A,10,3
3,N/A,N/A,N/A,733,736,N/A,15,2
5,N/A,N/A,N/A,728,733,N/A,18,5
3,N/A,N/A,N/A,725,728,N/A,23,4
4,N/A,N/A,N/A,721,725,N/A,29,4
3,N/A,N/A,N/A,718,721,N/A,35,4
1,N/A,N/A,N/A,717,718,N/A,38,1
6,N/A,N/A,N/A,711,717,N/A,42,5
2,N/A,N/A,N/A,709,711,N/A,46,3
6,N/A,N/A,N/A,703,709,N/A,49,6
6,N/A,N/A,N/A,697,703,N/A,54,5
2,N/A,N/A,N/A,695,697,N/A,58,3
1,N/A,N/A,N/A,694,695,N/A,62,1
4,N/A,N/A,N/A,690,694,N/A,65,4
2,N/A,N/A,N/A,688,690,N/A,68,1
4,N/A,N/A,N/A,684,688,N/A,71,4
2,N/A,N/A,N/A,682,684,N/A,74,1
1,N/A,N/A,N/A,681,682,N/A,80,1
5,N/A,N/A,N/A,676,681,N/A,84,5
4,N/A,N/A,N/A,672,676,N/A,89,4
3,N/A,N/A,N/A,669,672,N/A,93,2
2,N/A,N/A,N/A,667,669,N/A,99,2
6,N/A,N/A,N/A,661,667,N/A,103,6
2,N/A,N/A,N/A,659,661,N/A,109,0
2,N/A,N/A,N/A,657,659,N/A,112,3
3,N/A,N/A,N/A,654,657,N/A,118,3
6,N/A,N/A,N/A,648,654,N/A,121,6
6,N/A,N/A,N/A,642,648,N/A,126,5
2,N/A,N/A,N/A,640,642,N/A,130,3
3,N/A,N/A,N/A,626,629,N/A,4,3
7,N/A,N/A,N/A,619,626,N/A,7,6
4,N/A,N/A,N/A,615,619,N/A,11,4
4,N/A,N/A,N/A,611,615,N/A,17,4
2,N/A,N/A,N/A,609,611,N/A,21,2
6,N/A,N/A,N/A,603,609,N/A,24,5
4,N/A,N/A,N/A,599,603,N/A,29,4
4,N/A,N/A,N/A,595,599,N/A,35,4
2,N/A,N/A,N/A,593,595,N/A,39,2
5,N/A,N/A,N/A,588,593,N/A,42,5
6,N/A,N/A,N/A,582,588,N/A,48,5
3,N/A,N/A,N/A,579,582,N/A,51,2
7,N/A,N/A,N/A,572,579,N/A,55,6
3,N/A,N/A,N/A,569,572,N/A,58,3
7,N/A,N/A,N/A,562,569,N/A,61,6
4,N/A,N/A,N/A,558,562,N/A,65,4
4,N/A,N/A,N/A,554,558,N/A,71,4
1,N/A,N/A,N/A,553,554,N/A,74,1
2,N/A,N/A,N/A,551,553,N/A,80,1
7,N/A,N/A,N/A,544,551,N/A,85,6
1,N/A,N/A,N/A,543,544,N/A,91,0
6,N/A,N/A,N/A,537,543,N/A,97,6
3,N/A,N/A,N/A,534,537,N/A,101,4
2,N/A,N/A,N/A,532,534,N/A,106,3
2,N/A,N/A,N/A,530,532,N/A,112,3
1,N/A,N/A,N/A,529,530,N/A,116,1
2,N/A,N/A,N/A,527,529,N/A,122,1
6,N/A,N/A,N/A,521,527,N/A,127,6
6,N/A,N/A,N/A,515,521,N/A,132,5
6,N/A,N/A,N/A,509,515,N/A,138,5
3,N/A,N/A,N/A,449,452,N/A,6,3
3,N/A,N/A,N/A,446,449,N/A,11,2
2,N/A,N/A,N/A,444,446,N/A,16,1
6,N/A,N/A,N/A,438,444,N/A,20,5
3,N/A,N/A,N/A,435,438,N/A,25,4
1,N/A,N/A,N/A,434,435,N/A,28,1
6,N/A,N/A,N/A,428,434,N/A,32,5
3,N/A,N/A,N/A,425,428,N/A,35,2
5,N/A,N/A,N/A,420,425,N/A,38,5
3,N/A,N/A,N/A,417,420,N/A,42,3
2,N/A,N/A,N/A,415,417,N/A,48,3
2,N/A,N/A,N/A,413,415,N/A,52,1
6,N/A,N/A,N/A,407,413,N/A,57,6
2,N/A,N/A,N/A,405,407,N/A,63,0
2,N/A,N/A,N/A,403,405,N/A,66,3
6,N/A,N/A,N/A,397,403,N/A,69,6
5,N/A,N/A,N/A,392,397,N/A,74,5
2,N/A,N/A,N/A,390,392,N/A,78,3
2,N/A,N/A,N/A,388,390,N/A,84,3
3,N/A,N/A,N/A,385,388,N/A,90,3
3,N/A,N/A,N/A,382,385,N/A,95,2
6,N/A,N/A,N/A,376,382,N/A,98,5
3,N/A,N/A,N/A,373,376,N/A,103,4
4,N/A,N/A,N/A,369,373,N/A,109,4
3,N/A,N/A,N/A,366,369,N/A,113,2
5,N/A,N/A,N/A,361,366,N/A,116,5
3,N/A,N/A,N/A,358,361,N/A,121,4
3,N/A,N/A,N/A,355,358,N/A,125,2
2,N/A,N/A,N/A,353,355,N/A,130,1
4,N/A,N/A,N/A,349,353,N/A,133,4
3,N/A,N/A,N/A,865,868,N/A,6,2
3,N/A,N/A,N/A,862,865,N/A,12,2
2,N/A,N/A,N/A,860,862,N/A,17,1
1,N/A,N/A,N/A,859,860,N/A,23,1
7,N/A,N/A,N/A,852,859,N/A,28,6
6,N/A,N/A,N/A,846,852,N/A,33,5
3,N/A,N/A,N/A,843,846,N/A,36,2
2,N/A,N/A,N/A,841,843,N/A,41,1
3,N/A,N/A,N/A,838,841,N/A,44,4
3,N/A,N/A,N/A,835,838,N/A,49,3
2,N/A,N/A,N/A,833,835,N/A,55,3
1,N/A,N/A,N/A,832,833,N/A,59,1
2,N/A,N/A,N/A,830,832,N/A,65,1
6,N/A,N/A,N/A,824,830,N/A,69,5
4,N/A,N/A,N/A,820,824,N/A,74,4
2,N/A,N/A,N/A,818,820,N/A,79,3
3,N/A,N/A,N/A,815,818,N/A,85,3
7,N/A,N/A,N/A,808,815,N/A,88,6
1,N/A,N/A,N/A,807,808,N/A,94,0
4,N/A,N/A,N/A,803,807,N/A,98,4
3,N/A,N/A,N/A,800,803,N/A,104,4
2,N/A,N/A,N/A,798,800,N/A,109,3
3,N/A,N/A,N/A,795,798,N/A,114,2
6,N/A,N/A,N/A,789,795,N/A,117,5
3,N/A,N/A,N/A,786,789,N/A,122,4
3,N/A,N/A,N/A,783,786,N/A,127,3
6,N/A,N/A,N/A,777,783,N/A,130,6
5,N/A,N/A,N/A,772,777,N/A,135,5
3,N/A,N/A,N/A,769,772,N/A,138,2
3,N/A,N/A,N/A,766,769,N/A,144,2
4,N/A,N/A,N/A,957,961,N/A,5,4
2,N/A,N/A,N/A,955,957,N/A,9,2
6,N/A,N/A,N/A,949,955,N/A,13,6
4,N/A,N/A,N/A,945,949,N/A,17,4
2,N/A,N/A,N/A,943,945,N/A,20,1
7,N/A,N/A,N/A,936,943,N/A,25,6
1,N/A,N/A,N/A,935,936,N/A,31,0
3,N/A,N/A,N/A,932,935,N/A,34,3
2,N/A,N/A,N/A,930,932,N/A,39,2
3,N/A,N/A,N/A,927,930,N/A,45,2
3,N/A,N/A,N/A,924,927,N/A,51,2
6,N/A,N/A,N/A,918,924,N/A,54,5
3,N/A,N/A,N/A,915,918,N/A,59,4
3,N/A,N/A,N/A,912,915,N/A,64,3
2,N/A,N/A,N/A,910,912,N/A,68,1
2,N/A,N/A,N/A,908,910,N/A,74,1
6,N/A,N/A,N/A,902,908,N/A,79,6
5,N/A,N/A,N/A,897,902,N/A,84,5
6,N/A,N/A,N/A,891,897,N/A,90,5
3,N/A,N/A,N/A,888,891,N/A,95,4
2,N/A,N/A,N/A,886,888,N/A,99,2
6,N/A,N/A,N/A,880,886,N/A,102,5
3,N/A,N/A,N/A,877,880,N/A,106,3
6,N/A,N/A,N/A,871,877,N/A,109,6
5,N/A,N/A,N/A,866,871,N/A,114,5
5,N/A,N/A,N/A,861,866,N/A,120,5
2,N/A,N/A,N/A,859,861,N/A,124,3
6,N/A,N/A,N/A,853,859,N/A,127,6
1,N/A,N/A,N/A,852,853,N/A,133,0
4,N/A,N/A,N/A,848,852,N/A,137,4
2,N/A,N/A,N/A,1904,1906,N/A,6,3
3,N/A,N/A,N/A,1901,1904,N/A,12,3
7,N/A,N/A,N/A,1894,1901,N/A,15,6
5,N/A,N/A,N/A,1889,1894,N/A,20,5
5,N/A,N/A,N/A,1884,1889,N/A,26,5
5,N/A,N/A,N/A,1879,1884,N/A,32,5
5,N/A,N/A,N/A,1874,1879,N/A,38,5
5,N/A,N/A,N/A,1869,1874,N/A,44,5
3,N/A,N/A,N/A,1866,1869,N/A,48,3
6,N/A,N/A,N/A,1860,1866,N/A,51,6
3,N/A,N/A,N/A,1857,1860,N/A,54,3
7,N/A,N/A,N/A,1850,1857,N/A,57,6
3,N/A,N/A,N/A,1847,1850,N/A,61,4
3,N/A,N/A,N/A,1844,1847,N/A,65,2
7,N/A,N/A,N/A,1837,1844,N/A,69,6
1,N/A,N/A,N/A,1836,1837,N/A,75,0
2,N/A,N/A,N/A,1834,1836,N/A,78,3
6,N/A,N/A,N/A,1828,1834,N/A,81,6
2,N/A,N/A,N/A,1826,1828,N/A,84,3
2,N/A,N/A,N/A,1824,1826,N/A,90,3
2,N/A,N/A,N/A,1822,1824,N/A,95,2
1,N/A,N/A,N/A,1821,1822,N/A,100,1
4,N/A,N/A,N/A,1817,1821,N/A,103,4
3,N/A,N/A,N/A,1814,1817,N/A,108,3
3,N/A,N/A,N/A,1811,1814,N/A,114,3
2,N/A,N/A,N/A,1809,1811,N/A,119,2
5,N/A,N/A,N/A,1804,1809,N/A,122,5
2,N/A,N/A,N/A,1802,1804,N/A,125,2
2,N/A,N/A,N/A,1800,1802,N/A,130,1
3,N/A,N/A,N/A,1797,1800,N/A,133,4
1,N/A,N/A,N/A,616,617,N/A,5,1
1,N/A,N/A,N/A,615,616,N/A,11,1
3,N/A,N/A,N/A,612,615,N/A,14,4
2,N/A,N/A,N/A,610,612,N/A,18,2
7,N/A,N/A,N/A,603,610,N/A,22,6
6,N/A,N/A,N/A,597,603,N/A,27,5
4,N/A,N/A,N/A,593,597,N/A,32,4
3,N/A,N/A,N/A,590,593,N/A,37,3
2,N/A,N/A,N/A,588,590,N/A,43,3
3,N/A,N/A,N/A,585,588,N/A,48,2
5,N/A,N/A,N/A,580,585,N/A,51,5
2,N/A,N/A,N/A,578,580,N/A,55,3
6,N/A,N/A,N/A,572,578,N/A,58,6
2,N/A,N/A,N/A,570,572,N/A,64,0
5,N/A,N/A,N/A,565,570,N/A,69,5
3,N/A,N/A,N/A,562,565,N/A,73,3
3,N/A,N/A,N/A,559,562,N/A,79,3
7,N/A,N/A,N/A,552,559,N/A,82,6
1,N/A,N/A,N/A,551,552,N/A,88,0
6,N/A,N/A,N/A,545,551,N/A,94,6
3,N/A,N/A,N/A,542,545,N/A,98,4
2,N/A,N/A,N/A,540,542,N/A,102,2
7,N/A,N/A,N/A,533,540,N/A,106,6
6,N/A,N/A,N/A,527,533,N/A,111,5
4,N/A,N/A,N/A,523,527,N/A,116,4
2,N/A,N/A,N/A,521,523,N/A,121,3
2,N/A,N/A,N/A,519,521,N/A,127,3
2,N/A,N/A,N/A,517,519,N/A,132,2
6,N/A,N/A,N/A,511,517,N/A,135,5
2,N/A,N/A,N/A,509,511,N/A,138,2
7,N/A,N/A,N/A,1959,1966,N/A,4,6
4,N/A,N/A,N/A,1955,1959,N/A,8,4
3,N/A,N/A,N/A,1952,1955,N/A,13,3
2,N/A,N/A,N/A,1950,1952,N/A,17,1
1,N/A,N/A,N/A,1949,1950,N/A,23,1
7,N/A,N/A,N/A,1942,1949,N/A,28,6
3,N/A,N/A,N/A,1939,1942,N/A,31,3
2,N/A,N/A,N/A,1937,1939,N/A,37,3
3,N/A,N/A,N/A,1934,1937,N/A,43,3
2,N/A,N/A,N/A,1932,1934,N/A,47,1
5,N/A,N/A,N/A,1927,1932,N/A,51,5
2,N/A,N/A,N/A,1925,1927,N/A,55,3
3,N/A,N/A,N/A,1922,1925,N/A,61,3
3,N/A,N/A,N/A,1919,1922,N/A,67,3
2,N/A,N/A,N/A,1917,1919,N/A,71,1
1,N/A,N/A,N/A,1916,1917,N/A,77,1
4,N/A,N/A,N/A,1912,1916,N/A,80,4
2,N/A,N/A,N/A,1910,1912,N/A,83,1
7,N/A,N/A,N/A,1903,1910,N/A,88,6
4,N/A,N/A,N/A,1899,1903,N/A,92,4
1,N/A,N/A,N/A,1898,1899,N/A,95,1
7,N/A,N/A,N/A,1891,1898,N/A,100,6
2,N/A,N/A,N/A,1889,1891,N/A,106,0
5,N/A,N/A,N/A,1884,1889,N/A,111,5
4,N/A,N/A,N/A,1880,1884,N/A,116,4
3,N/A,N/A,N/A,1877,1880,N/A,122,4
3,N/A,N/A,N/A,1874,1877,N/A,127,3
3,N/A,N/A,N/A,1871,1874,N/A,132,2
6,N/A,N/A,N/A,1865,1871,N/A,135,5
5,N/A,N/A,N/A,1860,1865,N/A,141,5
3,N/A,N/A,N/A,1051,1054,N/A,3,2
7,N/A,N/A,N/A,1044,1051,N/A,7,6
4,N/A,N/A,N/A,1040,1044,N/A,11,4
3,N/A,N/A,N/A,1037,1040,N/A,15,2
6,N/A,N/A,N/A,1031,1037,N/A,18,5
6,N/A,N/A,N/A,1025,1031,N/A,24,5
3,N/A,N/A,N/A,1022,1025,N/A,27,2
5,N/A,N/A,N/A,1017,1022,N/A,30,5
3,N/A,N/A,N/A,1014,1017,N/A,34,3
7,N/A,N/A,N/A,1007,1014,N/A,37,6
3,N/A,N/A,N/A,1004,1007,N/A,40,3
2,N/A,N/A,N/A,1002,1004,N/A,44,1
2,N/A,N/A,N/A,1000,1002,N/A,50,1
2,N/A,N/A,N/A,998,1000,N/A,56,1
3,N/A,N/A,N/A,995,998,N/A,59,4
3,N/A,N/A,N/A,992,995,N/A,64,3
6,N/A,N/A,N/A,986,992,N/A,67,6
3,N/A,N/A,N/A,983,986,N/A,71,4
2,N/A,N/A,N/A,981,983,N/A,76,3
6,N/A,N/A,N/A,975,981,N/A,79,6
6,N/A,N/A,N/A,969,975,N/A,84,5
2,N/A,N/A,N/A,967,969,N/A,87,2
6,N/A,N/A,N/A,961,967,N/A,91,6
3,N/A,N/A,N/A,958,961,N/A,94,3
2,N/A,N/A,N/A,956,958,N/A,99,2
6,N/A,N/A,N/A,950,956,N/A,103,6
3,N/A,N/A,N/A,947,950,N/A,106,3
3,N/A,N/A,N/A,944,947,N/A,112,3
7,N/A,N/A,N/A,937,944,N/A,115,6
3,N/A,N/A,N/A,934,937,N/A,119,4
4,N/A,N/A,N/A,1519,1523,N/A,4,4
3,N/A,N/A,N/A,1516,1519,N/A,9,3
3,N/A,N/A,N/A,1513,1516,N/A,15,3
6,N/A,N/A,N/A,1507,1513,N/A,18,6
5,N/A,N/A,N/A,1502,1507,N/A,23,5
5,N/A,N/A,N/A,1497,1502,N/A,29,5
3,N/A,N/A,N/A,1494,1497,N/A,32,2
3,N/A,N/A,N/A,1491,1494,N/A,38,2
5,N/A,N/A,N/A,1486,1491,N/A,41,5
6,N/A,N/A,N/A,1480,1486,N/A,47,5
3,N/A,N/A,N/A,1477,1480,N/A,51,3
2,N/A,N/A,N/A,1475,1477,N/A,56,2
6,N/A,N/A,N/A,1469,1475,N/A,59,5
5,N/A,N/A,N/A,1464,1469,N/A,65,5
6,N/A,N/A,N/A,1458,1464,N/A,71,5
2,N/A,N/A,N/A,1456,1458,N/A,75,3
2,N/A,N/A,N/A,1454,1456,N/A,80,2
6,N/A,N/A,N/A,1448,1454,N/A,84,6
2,N/A,N/A,N/A,1446,1448,N/A,90,0
4,N/A,N/A,N/A,1442,1446,N/A,94,4
2,N/A,N/A,N/A,1440,1442,N/A,98,2
3,N/A,N/A,N/A,1437,1440,N/A,104,2
3,N/A,N/A,N/A,1434,1437,N/A,110,2
2,N/A,N/A,N/A,1432,1434,N/A,116,2
5,N/A,N/A,N/A,1427,1432,N/A,119,5
5,N/A,N/A,N/A,1422,1427,N/A,125,5
5,N/A,N/A,N/A,1417,1422,N/A,131,5
5,N/A,N/A,N/A,1412,1417,N/A,137,5
3,N/A,N/A,N/A,1409,1412,N/A,142,4
1,N/A,N/A,N/A,1408,1409,N/A,145,1
3,N/A,N/A,N/A,945,948,N/A,4,4
2,N/A,N/A,N/A,943,945,N/A,9,3
2,N/A,N/A,N/A,941,943,N/A,14,2
2,N/A,N/A,N/A,939,941,N/A,19,1
5,N/A,N/A,N/A,934,939,N/A,23,5
3,N/A,N/A,N/A,931,934,N/A,27,3
3,N/A,N/A,N/A,928,931,N/A,32,2
6,N/A,N/A,N/A,922,928,N/A,36,6
5,N/A,N/A,N/A,917,922,N/A,41,5
4,N/A,N/A,N/A,913,917,N/A,46,4
3,N/A,N/A,N/A,910,913,N/A,51,3
3,N/A,N/A,N/A,907,910,N/A,57,3
2,N/A,N/A,N/A,905,907,N/A,63,3
7,N/A,N/A,N/A,898,905,N/A,66,6
4,N/A,N/A,N/A,894,898,N/A,70,4
1,N/A,N/A,N/A,893,894,N/A,73,1
4,N/A,N/A,N/A,889,893,N/A,76,4
2,N/A,N/A,N/A,887,889,N/A,81,3
7,N/A,N/A,N/A,880,887,N/A,84,6
6,N/A,N/A,N/A,874,880,N/A,89,5
2,N/A,N/A,N/A,872,874,N/A,93,3
2,N/A,N/A,N/A,870,872,N/A,98,2
6,N/A,N/A,N/A,864,870,N/A,102,6
2,N/A,N/A,N/A,862,864,N/A,108,0
2,N/A,N/A,N/A,860,862,N/A,111,3
3,N/A,N/A,N/A,857,860,N/A,117,3
3,N/A,N/A,N/A,854,857,N/A,122,2
3,N/A,N/A,N/A,851,854,N/A,128,2
3,N/A,N/A,N/A,848,851,N/A,134,2
3,N/A,N/A,N/A,845,848,N/A,140,2
1,N/A,N/A,N/A,1144,1145,N/A,4,1
6,N/A,N/A,N/A,1138,1144,N/A,8,5
2,N/A,N/A,N/A,1136,1138,N/A,12,3
3,N/A,N/A,N/A,1133,1136,N/A,17,2
3,N/A,N/A,N/A,1130,1133,N/A,23,2
6,N/A,N/A,N/A,1124,1130,N/A,26,5
6,N/A,N/A,N/A,1118,1124,N/A,32,5
6,N/A,N/A,N/A,1112,1118,N/A,38,5
3,N/A,N/A,N/A,1109,1112,N/A,41,2
3,N/A,N/A,N/A,1106,1109,N/A,47,2
1,N/A,N/A,N/A,1105,1106,N/A,52,1
1,N/A,N/A,N/A,1104,1105,N/A,58,1
1,N/A,N/A,N/A,1103,1104,N/A,64,1
3,N/A,N/A,N/A,1100,1103,N/A,67,4
2,N/A,N/A,N/A,1098,1100,N/A,70,1
4,N/A,N/A,N/A,1094,1098,N/A,73,4
3,N/A,N/A,N/A,1091,1094,N/A,79,4
4,N/A,N/A,N/A,1087,1091,N/A,85,4
3,N/A,N/A,N/A,1084,1087,N/A,91,4
3,N/A,N/A,N/A,1081,1084,N/A,96,3
2,N/A,N/A,N/A,1079,1081,N/A,102,3
2,N/A,N/A,N/A,1077,1079,N/A,106,1
1,N/A,N/A,N/A,1076,1077,N/A,112,1
2,N/A,N/A,N/A,1074,1076,N/A,118,1
4,N/A,N/A,N/A,1070,1074,N/A,121,4
3,N/A,N/A,N/A,1067,1070,N/A,125,2
2,N/A,N/A,N/A,1065,1067,N/A,131,2
6,N/A,N/A,N/A,1059,1065,N/A,134,5
6,N/A,N/A,N/A,1053,1059,N/A,140,5
6,N/A,N/A,N/A,1047,1053,N/A,146,5
6,N/A,N/A,N/A,1075,1081,N/A,4,5
3,N/A,N/A,N/A,1072,1075,N/A,7,2
2,N/A,N/A,N/A,1070,1072,N/A,13,2
6,N/A,N/A,N/A,1064,1070,N/A,17,6
3,N/A,N/A,N/A,1061,1064,N/A,20,3
2,N/A,N/A,N/A,1059,1061,N/A,26,3
2,N/A,N/A,N/A,1057,1059,N/A,32,3
1,N/A,N/A,N/A,1056,1057,N/A,36,1
6,N/A,N/A,N/A,1050,1056,N/A,41,6
4,N/A,N/A,N/A,1046,1050,N/A,45,4
1,N/A,N/A,N/A,1045,1046,N/A,48,1
6,N/A,N/A,N/A,1039,1045,N/A,53,6
3,N/A,N/A,N/A,1036,1039,N/A,56,3
7,N/A,N/A,N/A,1029,1036,N/A,59,6
3,N/A,N/A,N/A,1026,1029,N/A,62,3
3,N/A,N/A,N/A,1023,1026,N/A,67,2
3,N/A,N/A,N/A,1020,1023,N/A,73,2
7,N/A,N/A,N/A,1013,1020,N/A,77,6
3,N/A,N/A,N/A,1010,1013,N/A,81,4
3,N/A,N/A,N/A,1007,1010,N/A,86,3
1,N/A,N/A,N/A,1006,1007,N/A,90,1
5,N/A,N/A,N/A,1001,1006,N/A,94,5
3,N/A,N/A,N/A,998,1001,N/A,98,3
2,N/A,N/A,N/A,996,998,N/A,104,3
3,N/A,N/A,N/A,993,996,N/A,109,2
5,N/A,N/A,N/A,988,993,N/A,112,5
4,N/A,N/A,N/A,984,988,N/A,117,4
4,N/A,N/A,N/A,980,984,N/A,123,4
3,N/A,N/A,N/A,977,980,N/A,127,2
7,N/A,N/A,N/A,970,977,N/A,131,6
3,N/A,N/A,N/A,1990,1993,N/A,6,3
6,N/A,N/A,N/A,1984,1990,N/A,9,6
4,N/A,N/A,N/A,1980,1984,N/A,13,4
3,N/A,N/A,N/A,1977,1980,N/A,19,4
2,N/A,N/A,N/A,1975,1977,N/A,22,1
5,N/A,N/A,N/A,1970,1975,N/A,26,5
3,N/A,N/A,N/A,1967,1970,N/A,30,3
6,N/A,N/A,N/A,1961,1967,N/A,33,6
3,N/A,N/A,N/A,1958,1961,N/A,37,4
3,N/A,N/A,N/A,1955,1958,N/A,41,2
6,N/A,N/A,N/A,1949,1955,N/A,44,5
6,N/A,N/A,N/A,1943,1949,N/A,50,5
5,N/A,N/A,N/A,1938,1943,N/A,56,5
2,N/A,N/A,N/A,1936,1938,N/A,60,3
2,N/A,N/A,N/A,1934,1936,N/A,65,2
3,N/A,N/A,N/A,1931,1934,N/A,71,2
6,N/A,N/A,N/A,1925,1931,N/A,75,6
4,N/A,N/A,N/A,1921,1925,N/A,79,4
3,N/A,N/A,N/A,1918,1921,N/A,85,4
4,N/A,N/A,N/A,1914,1918,N/A,91,4
3,N/A,N/A,N/A,1911,1914,N/A,96,3
1,N/A,N/A,N/A,1910,1911,N/A,100,1
5,N/A,N/A,N/A,1905,1910,N/A,104,5
4,N/A,N/A,N/A,1901,1905,N/A,109,4
2,N/A,N/A,N/A,1899,1901,N/A,112,1
6,N/A,N/A,N/A,1893,1899,N/A,117,6
3,N/A,N/A,N/A,1890,1893,N/A,120,3
6,N/A,N/A,N/A,1884,1890,N/A,123,6
5,N/A,N/A,N/A,1879,1884,N/A,128,5
4,N/A,N/A,N/A,1875,1879,N/A,133,4
2,N/A,N/A,N/A,965,967,N/A,6,3
7,N/A,N/A,N/A,958,965,N/A,9,6
5,N/A,N/A,N/A,953,958,N/A,14,5
5,N/A,N/A,N/A,948,953,N/A,20,5
5,N/A,N/A,N/A,943,948,N/A,26,5
3,N/A,N/A,N/A,940,943,N/A,31,4
4,N/A,N/A,N/A,936,940,N/A,37,4
3,N/A,N/A,N/A,933,936,N/A,43,4
3,N/A,N/A,N/A,930,933,N/A,49,4
2,N/A,N/A,N/A,928,930,N/A,54,3
2,N/A,N/A,N/A,926,928,N/A,60,3
2,N/A,N/A,N/A,924,926,N/A,65,2
1,N/A,N/A,N/A,923,924,N/A,70,1
6,N/A,N/A,N/A,917,923,N/A,74,5
3,N/A,N/A,N/A,914,917,N/A,78,3
3,N/A,N/A,N/A,911,914,N/A,84,3
3,N/A,N/A,N/A,908,911,N/A,90,3
6,N/A,N/A,N/A,902,908,N/A,93,6
3,N/A,N/A,N/A,899,902,N/A,97,4
3,N/A,N/A,N/A,896,899,N/A,103,4
2,N/A,N/A,N/A,894,896,N/A,108,3
6,N/A,N/A,N/A,888,894,N/A,111,6
5,N/A,N/A,N/A,883,888,N/A,116,5
3,N/A,N/A,N/A,880,883,N/A,121,4
4,N/A,N/A,N/A,876,880,N/A,127,4
3,N/A,N/A,N/A,873,876,N/A,132,3
7,N/A,N/A,N/A,866,873,N/A,135,6
5,N/A,N/A,N/A,861,866,N/A,140,5
5,N/A,N/A,N/A,856,861,N/A,146,5
6,N/A,N/A,N/A,850,856,N/A,152,5
2,N/A,N/A,N/A,894,896,N/A,4,3
2,N/A,N/A,N/A,892,894,N/A,10,3
2,N/A,N/A,N/A,890,892,N/A,16,3
7,N/A,N/A,N/A,883,890,N/A,19,6
2,N/A,N/A,N/A,881,883,N/A,25,0
6,N/A,N/A,N/A,875,881,N/A,30,5
2,N/A,N/A,N/A,873,875,N/A,33,2
1,N/A,N/A,N/A,872,873,N/A,38,1
6,N/A,N/A,N/A,866,872,N/A,42,5
3,N/A,N/A,N/A,863,866,N/A,45,2
6,N/A,N/A,N/A,857,863,N/A,49,6
5,N/A,N/A,N/A,852,857,N/A,54,5
4,N/A,N/A,N/A,848,852,N/A,59,4
4,N/A,N/A,N/A,844,848,N/A,65,4
3,N/A,N/A,N/A,841,844,N/A,71,4
2,N/A,N/A,N/A,839,841,N/A,76,3
3,N/A,N/A,N/A,836,839,N/A,81,2
3,N/A,N/A,N/A,833,836,N/A,87,2
5,N/A,N/A,N/A,828,833,N/A,90,5
5,N/A,N/A,N/A,823,828,N/A,96,5
2,N/A,N/A,N/A,821,823,N/A,99,2
5,N/A,N/A,N/A,816,821,N/A,102,5
3,N/A,N/A,N/A,813,816,N/A,106,3
6,N/A,N/A,N/A,807,813,N/A,109,6
3,N/A,N/A,N/A,804,807,N/A,112,3
7,N/A,N/A,N/A,797,804,N/A,115,6
3,N/A,N/A,N/A,794,797,N/A,118,3
1,N/A,N/A,N/A,793,794,N/A,122,1
1,N/A,N/A,N/A,792,793,N/A,128,1
3,N/A,N/A,N/A,789,792,N/A,131,4
2,N/A,N/A,N/A,1612,1614,N/A,3,1
2,N/A,N/A,N/A,1610,1612,N/A,9,1
3,N/A,N/A,N/A,1607,1610,N/A,12,4
1,N/A,N/A,N/A,1606,1607,N/A,15,1
6,N/A,N/A,N/A,1600,1606,N/A,19,5
3,N/A,N/A,N/A,1597,1600,N/A,24,4
3,N/A,N/A,N/A,1594,1597,N/A,28,2
2,N/A,N/A,N/A,1592,1594,N/A,34,2
3,N/A,N/A,N/A,1589,1592,N/A,40,2
6,N/A,N/A,N/A,1583,1589,N/A,44,6
4,N/A,N/A,N/A,1579,1583,N/A,48,4
3,N/A,N/A,N/A,1576,1579,N/A,52,2
6,N/A,N/A,N/A,1570,1576,N/A,56,6
4,N/A,N/A,N/A,1566,1570,N/A,60,4
3,N/A,N/A,N/A,1563,1566,N/A,64,2
2,N/A,N/A,N/A,1561,1563,N/A,70,2
5,N/A,N/A,N/A,1556,1561,N/A,73,5
2,N/A,N/A,N/A,1554,1556,N/A,77,3
7,N/A,N/A,N/A,1547,1554,N/A,80,6
4,N/A,N/A,N/A,1543,1547,N/A,84,4
4,N/A,N/A,N/A,1539,1543,N/A,90,4
2,N/A,N/A,N/A,1537,1539,N/A,94,2
3,N/A,N/A,N/A,1534,1537,N/A,100,2
5,N/A,N/A,N/A,1529,1534,N/A,103,5
4,N/A,N/A,N/A,1525,1529,N/A,108,4
1,N/A,N/A,N/A,1524,1525,N/A,111,1
6,N/A,N/A,N/A,1518,1524,N/A,116,6
1,N/A,N/A,N/A,1517,1518,N/A,122,0
6,N/A,N/A,N/A,1511,1517,N/A,128,6
5,N/A,N/A,N/A,1506,1511,N/A,133,5
3,N/A,N/A,N/A,1420,1423,N/A,4,2
7,N/A,N/A,N/A,1413,1420,N/A,8,6
4,N/A,N/A,N/A,1409,1413,N/A,12,4
3,N/A,N/A,N/A,1406,1409,N/A,18,4
1,N/A,N/A,N/A,1405,1406,N/A,21,1
5,N/A,N/A,N/A,1400,1405,N/A,25,5
4,N/A,N/A,N/A,1396,1400,N/A,30,4
3,N/A,N/A,N/A,1393,1396,N/A,36,4
3,N/A,N/A,N/A,1390,1393,N/A,42,4
4,N/A,N/A,N/A,1386,1390,N/A,48,4
3,N/A,N/A,N/A,1383,1386,N/A,54,4
3,N/A,N/A,N/A,1380,1383,N/A,60,4
4,N/A,N/A,N/A,1376,1380,N/A,66,4
1,N/A,N/A,N/A,1375,1376,N/A,69,1
2,N/A,N/A,N/A,1373,1375,N/A,75,1
5,N/A,N/A,N/A,1368,1373,N/A,79,5
2,N/A,N/A,N/A,1366,1368,N/A,83,3
6,N/A,N/A,N/A,1360,1366,N/A,86,6
1,N/A,N/A,N/A,1359,1360,N/A,92,0
2,N/A,N/A,N/A,1357,1359,N/A,95,3
1,N/A,N/A,N/A,1356,1357,N/A,99,1
1,N/A,N/A,N/A,1355,1356,N/A,105,1
2,N/A,N/A,N/A,1353,1355,N/A,111,1
6,N/A,N/A,N/A,1347,1353,N/A,116,6
2,N/A,N/A,N/A,1345,1347,N/A,119,3
2,N/A,N/A,N/A,1343,1345,N/A,125,3
2,N/A,N/A,N/A,1341,1343,N/A,131,3
7,N/A,N/A,N/A,1334,1341,N/A,134,6
2,N/A,N/A,N/A,1332,1334,N/A,137,3
2,N/A,N/A,N/A,1330,1332,N/A,141,1
5,N/A,N/A,N/A,869,874,N/A,3,5
2,N/A,N/A,N/A,867,869,N/A,6,2
7,N/A,N/A,N/A,860,867,N/A,10,6
2,N/A,N/A,N/A,858,860,N/A,13,3
6,N/A,N/A,N/A,852,858,N/A,16,6
3,N/A,N/A,N/A,849,852,N/A,19,3
7,N/A,N/A,N/A,842,849,N/A,22,6
3,N/A,N/A,N/A,839,842,N/A,26,4
3,N/A,N/A,N/A,836,839,N/A,32,4
2,N/A,N/A,N/A,834,836,N/A,35,1
1,N/A,N/A,N/A,833,834,N/A,41,1
4,N/A,N/A,N/A,829,833,N/A,44,4
2,N/A,N/A,N/A,827,829,N/A,47,1
7,N/A,N/A,N/A,820,827,N/A,52,6
3,N/A,N/A,N/A,817,820,N/A,56,4
3,N/A,N/A,N/A,814,817,N/A,62,4
2,N/A,N/A,N/A,812,814,N/A,65,1
7,N/A,N/A,N/A,805,812,N/A,70,6
1,N/A,N/A,N/A,804,805,N/A,76,0
3,N/A,N/A,N/A,801,804,N/A,79,3
3,N/A,N/A,N/A,798,801,N/A,85,3
2,N/A,N/A,N/A,796,798,N/A,90,2
6,N/A,N/A,N/A,790,796,N/A,94,6
3,N/A,N/A,N/A,787,790,N/A,97,3
3,N/A,N/A,N/A,784,787,N/A,103,3
2,N/A,N/A,N/A,782,784,N/A,107,1
3,N/A,N/A,N/A,779,782,N/A,110,4
1,N/A,N/A,N/A,778,779,N/A,113,1
6,N/A,N/A,N/A,772,778,N/A,118,6
5,N/A,N/A,N/A,767,772,N/A,123,5
3,N/A,N/A,N/A,1285,1288,N/A,6,4
2,N/A,N/A,N/A,1283,1285,N/A,9,1
4,N/A,N/A,N/A,1279,1283,N/A,12,4
3,N/A,N/A,N/A,1276,1279,N/A,17,3
6,N/A,N/A,N/A,1270,1276,N/A,20,6
4,N/A,N/A,N/A,1266,1270,N/A,24,4
3,N/A,N/A,N/A,1263,1266,N/A,28,2
7,N/A,N/A,N/A,1256,1263,N/A,32,6
4,N/A,N/A,N/A,1252,1256,N/A,36,4
2,N/A,N/A,N/A,1250,1252,N/A,39,1
5,N/A,N/A,N/A,1245,1250,N/A,43,5
3,N/A,N/A,N/A,1242,1245,N/A,47,3
2,N/A,N/A,N/A,1240,1242,N/A,51,1
4,N/A,N/A,N/A,1236,1240,N/A,54,4
3,N/A,N/A,N/A,1233,1236,N/A,58,2
2,N/A,N/A,N/A,1231,1233,N/A,63,1
6,N/A,N/A,N/A,1225,1231,N/A,67,5
5,N/A,N/A,N/A,1220,1225,N/A,73,5
3,N/A,N/A,N/A,1217,1220,N/A,76,2
2,N/A,N/A,N/A,1215,1217,N/A,82,2
2,N/A,N/A,N/A,1213,1215,N/A,88,2
6,N/A,N/A,N/A,1207,1213,N/A,92,6
3,N/A,N/A,N/A,1204,1207,N/A,95,3
6,N/A,N/A,N/A,1198,1204,N/A,98,6
1,N/A,N/A,N/A,1197,1198,N/A,104,0
3,N/A,N/A,N/A,1194,1197,N/A,108,4
3,N/A,N/A,N/A,1191,1194,N/A,114,4
2,N/A,N/A,N/A,1189,1191,N/A,117,1
5,N/A,N/A,N/A,1184,1189,N/A,121,5
6,N/A,N/A,N/A,1178,1184,N/A,127,5
3,N/A,N/A,N/A,1567,1570,N/A,5,2
6,N/A,N/A,N/A,1561,1567,N/A,9,6
1,N/A,N/A,N/A,1560,1561,N/A,15,0
2,N/A,N/A,N/A,1558,1560,N/A,18,3
6,N/A,N/A,N/A,1552,1558,N/A,21,6
3,N/A,N/A,N/A,1549,1552,N/A,24,3
3,N/A,N/A,N/A,1546,1549,N/A,30,3
2,N/A,N/A,N/A,1544,1546,N/A,36,3
2,N/A,N/A,N/A,1542,1544,N/A,40,1
6,N/A,N/A,N/A,1536,1542,N/A,44,5
3,N/A,N/A,N/A,1533,1536,N/A,48,3
2,N/A,N/A,N/A,1531,1533,N/A,54,3
6,N/A,N/A,N/A,1525,1531,N/A,57,6
2,N/A,N/A,N/A,1523,1525,N/A,63,0
6,N/A,N/A,N/A,1517,1523,N/A,68,5
2,N/A,N/A,N/A,1515,1517,N/A,71,2
3,N/A,N/A,N/A,1512,1515,N/A,77,2
2,N/A,N/A,N/A,1510,1512,N/A,83,2
1,N/A,N/A,N/A,1509,1510,N/A,88,1
7,N/A,N/A,N/A,1502,1509,N/A,93,6
6,N/A,N/A,N/A,1496,1502,N/A,98,5
3,N/A,N/A,N/A,1493,1496,N/A,103,4
4,N/A,N/A,N/A,1489,1493,N/A,109,4
3,N/A,N/A,N/A,1486,1489,N/A,114,3
2,N/A,N/A,N/A,1484,1486,N/A,120,3
3,N/A,N/A,N/A,1481,1484,N/A,126,3
2,N/A,N/A,N/A,1479,1481,N/A,131,2
6,N/A,N/A,N/A,1473,1479,N/A,134,5
2,N/A,N/A,N/A,1471,1473,N/A,137,2
2,N/A,N/A,N/A,1469,1471,N/A,142,1
6,N/A,N/A,N/A,311,317,N/A,6,5
3,N/A,N/A,N/A,308,311,N/A,11,4
2,N/A,N/A,N/A,306,308,N/A,15,2
5,N/A,N/A,N/A,301,306,N/A,18,5
4,N/A,N/A,N/A,297,301,N/A,23,4
1,N/A,N/A,N/A,296,297,N/A,26,1
6,N/A,N/A,N/A,290,296,N/A,30,5
6,N/A,N/A,N/A,284,290,N/A,36,5
5,N/A,N/A,N/A,279,284,N/A,42,5
3,N/A,N/A,N/A,276,279,N/A,46,3
6,N/A,N/A,N/A,270,276,N/A,49,6
3,N/A,N/A,N/A,267,270,N/A,53,4
4,N/A,N/A,N/A,263,267,N/A,59,4
3,N/A,N/A,N/A,260,263,N/A,65,4
3,N/A,N/A,N/A,257,260,N/A,69,2
6,N/A,N/A,N/A,251,257,N/A,72,5
3,N/A,N/A,N/A,248,251,N/A,76,3
1,N/A,N/A,N/A,247,248,N/A,80,1
6,N/A,N/A,N/A,241,247,N/A,85,6
2,N/A,N/A,N/A,239,241,N/A,88,3
2,N/A,N/A,N/A,237,239,N/A,92,1
2,N/A,N/A,N/A,235,237,N/A,98,1
3,N/A,N/A,N/A,232,235,N/A,101,4
3,N/A,N/A,N/A,229,232,N/A,105,2
7,N/A,N/A,N/A,222,229,N/A,109,6
1,N/A,N/A,N/A,221,222,N/A,115,0
3,N/A,N/A,N/A,218,221,N/A,119,4
3,N/A,N/A,N/A,215,218,N/A,124,3
3,N/A,N/A,N/A,212,215,N/A,130,3
2,N/A,N/A,N/A,210,212,N/A,136,3
3,N/A,N/A,N/A,1149,1152,N/A,3,3
2,N/A,N/A,N/A,1147,1149,N/A,7,1
2,N/A,N/A,N/A,1145,1147,N/A,13,1
4,N/A,N/A,N/A,1141,1145,N/A,16,4
4,N/A,N/A,N/A,1137,1141,N/A,22,4
4,N/A,N/A,N/A,1133,1137,N/A,28,4
2,N/A,N/A,N/A,1131,1133,N/A,32,2
5,N/A,N/A,N/A,1126,1131,N/A,35,5
2,N/A,N/A,N/A,1124,1126,N/A,38,2
5,N/A,N/A,N/A,1119,1124,N/A,41,5
2,N/A,N/A,N/A,1117,1119,N/A,45,3
2,N/A,N/A,N/A,1115,1117,N/A,50,2
6,N/A,N/A,N/A,1109,1115,N/A,53,5
3,N/A,N/A,N/A,1106,1109,N/A,56,2
2,N/A,N/A,N/A,1104,1106,N/A,62,2
6,N/A,N/A,N/A,1098,1104,N/A,66,6
2,N/A,N/A,N/A,1096,1098,N/A,69,3
7,N/A,N/A,N/A,1089,1096,N/A,72,6
5,N/A,N/A,N/A,1084,1089,N/A,77,5
3,N/A,N/A,N/A,1081,1084,N/A,80,2
6,N/A,N/A,N/A,1075,1081,N/A,83,5
6,N/A,N/A,N/A,1069,1075,N/A,89,5
3,N/A,N/A,N/A,1066,1069,N/A,94,4
3,N/A,N/A,N/A,1063,1066,N/A,100,4
3,N/A,N/A,N/A,1060,1063,N/A,104,2
6,N/A,N/A,N/A,1054,1060,N/A,108,6
6,N/A,N/A,N/A,1048,1054,N/A,113,5
4,N/A,N/A,N/A,1044,1048,N/A,118,4
2,N/A,N/A,N/A,1042,1044,N/A,122,2
5,N/A,N/A,N/A,1037,1042,N/A,125,5
2,N/A,N/A,N/A,1167,1169,N/A,5,3
3,N/A,N/A,N/A,1164,1167,N/A,11,3
1,N/A,N/A,N/A,1163,1164,N/A,15,1
6,N/A,N/A,N/A,1157,1163,N/A,20,6
4,N/A,N/A,N/A,1153,1157,N/A,24,4
3,N/A,N/A,N/A,1150,1153,N/A,29,3
6,N/A,N/A,N/A,1144,1150,N/A,32,6
3,N/A,N/A,N/A,1141,1144,N/A,36,4
3,N/A,N/A,N/A,1138,1141,N/A,42,4
3,N/A,N/A,N/A,1135,1138,N/A,47,3
6,N/A,N/A,N/A,1129,1135,N/A,50,6
5,N/A,N/A,N/A,1124,1129,N/A,55,5
2,N/A,N/A,N/A,1122,1124,N/A,58,2
6,N/A,N/A,N/A,1116,1122,N/A,62,6
6,N/A,N/A,N/A,1110,1116,N/A,67,5
2,N/A,N/A,N/A,1108,1110,N/A,70,2
2,N/A,N/A,N/A,1106,1108,N/A,75,1
6,N/A,N/A,N/A,1100,1106,N/A,79,5
4,N/A,N/A,N/A,1096,1100,N/A,84,4
3,N/A,N/A,N/A,1093,1096,N/A,89,3
3,N/A,N/A,N/A,1090,1093,N/A,95,3
6,N/A,N/A,N/A,1084,1090,N/A,98,6
4,N/A,N/A,N/A,1080,1084,N/A,102,4
3,N/A,N/A,N/A,1077,1080,N/A,107,3
2,N/A,N/A,N/A,1075,1077,N/A,113,3
2,N/A,N/A,N/A,1073,1075,N/A,117,1
7,N/A,N/A,N/A,1066,1073,N/A,122,6
3,N/A,N/A,N/A,1063,1066,N/A,125,3
1,N/A,N/A,N/A,1062,1063,N/A,129,1
1,N/A,N/A,N/A,1061,1062,N/A,135,1
7,N/A,N/A,N/A,1803,1810,N/A,5,6
2,N/A,N/A,N/A,1801,1803,N/A,8,3
6,N/A,N/A,N/A,1795,1801,N/A,11,6
2,N/A,N/A,N/A,1793,1795,N/A,14,3
6,N/A,N/A,N/A,1787,1793,N/A,17,6
6,N/A,N/A,N/A,1781,1787,N/A,22,5
3,N/A,N/A,N/A,1778,1781,N/A,27,4
2,N/A,N/A,N/A,1776,1778,N/A,30,1
3,N/A,N/A,N/A,1773,1776,N/A,33,4
1,N/A,N/A,N/A,1772,1773,N/A,36,1
6,N/A,N/A,N/A,1766,1772,N/A,41,6
2,N/A,N/A,N/A,1764,1766,N/A,44,3
6,N/A,N/A,N/A,1758,1764,N/A,47,6
5,N/A,N/A,N/A,1753,1758,N/A,52,5
3,N/A,N/A,N/A,1750,1753,N/A,57,4
3,N/A,N/A,N/A,1747,1750,N/A,61,2
2,N/A,N/A,N/A,1745,1747,N/A,67,2
6,N/A,N/A,N/A,1739,1745,N/A,70,5
3,N/A,N/A,N/A,1736,1739,N/A,75,4
1,N/A,N/A,N/A,1735,1736,N/A,78,1
2,N/A,N/A,N/A,1733,1735,N/A,84,1
2,N/A,N/A,N/A,1731,1733,N/A,90,1
5,N/A,N/A,N/A,1726,1731,N/A,94,5
5,N/A,N/A,N/A,1721,1726,N/A,100,5
3,N/A,N/A,N/A,1718,1721,N/A,104,3
2,N/A,N/A,N/A,1716,1718,N/A,109,2
6,N/A,N/A,N/A,1710,1716,N/A,112,5
3,N/A,N/A,N/A,1707,1710,N/A,116,3
7,N/A,N/A,N/A,1700,1707,N/A,119,6
5,N/A,N/A,N/A,1695,1700,N/A,124,5
3,N/A,N/A,N/A,1562,1565,N/A,3,4
2,N/A,N/A,N/A,1560,1562,N/A,8,3
2,N/A,N/A,N/A,1558,1560,N/A,12,1
6,N/A,N/A,N/A,1552,1558,N/A,17,6
1,N/A,N/A,N/A,1551,1552,N/A,23,0
3,N/A,N/A,N/A,1548,1551,N/A,26,3
2,N/A,N/A,N/A,1546,1548,N/A,30,1
5,N/A,N/A,N/A,1541,1546,N/A,34,5
2,N/A,N/A,N/A,1539,1541,N/A,38,3
2,N/A,N/A,N/A,1537,1539,N/A,42,1
5,N/A,N/A,N/A,1532,1537,N/A,46,5
3,N/A,N/A,N/A,1529,1532,N/A,50,3
2,N/A,N/A,N/A,1527,1529,N/A,54,1
6,N/A,N/A,N/A,1521,1527,N/A,58,5
3,N/A,N/A,N/A,1518,1521,N/A,62,3
1,N/A,N/A,N/A,1517,1518,N/A,66,1
5,N/A,N/A,N/A,1512,1517,N/A,70,5
3,N/A,N/A,N/A,1509,1512,N/A,74,3
2,N/A,N/A,N/A,1507,1509,N/A,78,1
7,N/A,N/A,N/A,1500,1507,N/A,83,6
1,N/A,N/A,N/A,1499,1500,N/A,89,0
7,N/A,N/A,N/A,1492,1499,N/A,95,6
2,N/A,N/A,N/A,1490,1492,N/A,101,0
5,N/A,N/A,N/A,1485,1490,N/A,106,5
5,N/A,N/A,N/A,1480,1485,N/A,112,5
3,N/A,N/A,N/A,1477,1480,N/A,116,3
1,N/A,N/A,N/A,1476,1477,N/A,120,1
6,N/A,N/A,N/A,1470,1476,N/A,125,6
2,N/A,N/A,N/A,1468,1470,N/A,128,3
3,N/A,N/A,N/A,1465,1468,N/A,134,3
7,N/A,N/A,N/A,1109,1116,N/A,6,6
4,N/A,N/A,N/A,1105,1109,N/A,10,4
4,N/A,N/A,N/A,1101,1105,N/A,16,4
2,N/A,N/A,N/A,1099,1101,N/A,20,2
7,N/A,N/A,N/A,1092,1099,N/A,24,6
3,N/A,N/A,N/A,1089,1092,N/A,27,3
3,N/A,N/A,N/A,1086,1089,N/A,33,3
2,N/A,N/A,N/A,1084,1086,N/A,38,2
6,N/A,N/A,N/A,1078,1084,N/A,41,5
6,N/A,N/A,N/A,1072,1078,N/A,47,5
6,N/A,N/A,N/A,1066,1072,N/A,53,5
3,N/A,N/A,N/A,1063,1066,N/A,58,4
2,N/A,N/A,N/A,1061,1063,N/A,61,1
4,N/A,N/A,N/A,1057,1061,N/A,64,4
2,N/A,N/A,N/A,1055,1057,N/A,67,1
3,N/A,N/A,N/A,1052,1055,N/A,70,4
4,N/A,N/A,N/A,1048,1052,N/A,76,4
3,N/A,N/A,N/A,1045,1048,N/A,82,4
3,N/A,N/A,N/A,1042,1045,N/A,88,4
3,N/A,N/A,N/A,1039,1042,N/A,93,3
3,N/A,N/A,N/A,1036,1039,N/A,98,2
2,N/A,N/A,N/A,1034,1036,N/A,103,1
4,N/A,N/A,N/A,1030,1034,N/A,106,4
2,N/A,N/A,N/A,1028,1030,N/A,109,1
4,N/A,N/A,N/A,1024,1028,N/A,112,4
2,N/A,N/A,N/A,1022,1024,N/A,115,1
3,N/A,N/A,N/A,1019,1022,N/A,118,4
2,N/A,N/A,N/A,1017,1019,N/A,121,1
3,N/A,N/A,N/A,1014,1017,N/A,124,4
2,N/A,N/A,N/A,1012,1014,N/A,128,2
7,N/A,N/A,N/A,802,809,N/A,4,6
1,N/A,N/A,N/A,801,802,N/A,10,0
4,N/A,N/A,N/A,797,801,N/A,14,4
3,N/A,N/A,N/A,794,797,N/A,18,2
7,N/A,N/A,N/A,787,794,N/A,22,6
3,N/A,N/A,N/A,784,787,N/A,26,4
3,N/A,N/A,N/A,781,784,N/A,32,4
1,N/A,N/A,N/A,780,781,N/A,35,1
1,N/A,N/A,N/A,779,780,N/A,41,1
6,N/A,N/A,N/A,773,779,N/A,46,6
3,N/A,N/A,N/A,770,773,N/A,50,4
4,N/A,N/A,N/A,766,770,N/A,56,4
2,N/A,N/A,N/A,764,766,N/A,60,2
5,N/A,N/A,N/A,759,764,N/A,63,5
2,N/A,N/A,N/A,757,759,N/A,66,2
2,N/A,N/A,N/A,755,757,N/A,71,1
3,N/A,N/A,N/A,752,755,N/A,74,4
2,N/A,N/A,N/A,750,752,N/A,77,1
4,N/A,N/A,N/A,746,750,N/A,80,4
3,N/A,N/A,N/A,743,746,N/A,85,3
6,N/A,N/A,N/A,737,743,N/A,88,6
1,N/A,N/A,N/A,736,737,N/A,94,0
6,N/A,N/A,N/A,730,736,N/A,100,6
4,N/A,N/A,N/A,726,730,N/A,104,4
4,N/A,N/A,N/A,722,726,N/A,110,4
4,N/A,N/A,N/A,718,722,N/A,116,4
1,N/A,N/A,N/A,717,718,N/A,119,1
2,N/A,N/A,N/A,715,717,N/A,125,1
3,N/A,N/A,N/A,712,715,N/A,128,4
4,N/A,N/A,N/A,708,712,N/A,134,4
7,N/A,N/A,N/A,1923,1930,N/A,6,6
6,N/A,N/A,N/A,1917,1923,N/A,11,5
3,N/A,N/A,N/A,1914,1917,N/A,14,2
6,N/A,N/A,N/A,1908,1914,N/A,17,5
3,N/A,N/A,N/A,1905,1908,N/A,21,3
6,N/A,N/A,N/A,1899,1905,N/A,24,6
1,N/A,N/A,N/A,1898,1899,N/A,30,0
5,N/A,N/A,N/A,1893,1898,N/A,35,5
2,N/A,N/A,N/A,1891,1893,N/A,38,2
5,N/A,N/A,N/A,1886,1891,N/A,41,5
2,N/A,N/A,N/A,1884,1886,N/A,44,2
1,N/A,N/A,N/A,1883,1884,N/A,49,1
6,N/A,N/A,N/A,1877,1883,N/A,54,6
3,N/A,N/A,N/A,1874,1877,N/A,58,4
3,N/A,N/A,N/A,1871,1874,N/A,64,4
1,N/A,N/A,N/A,1870,1871,N/A,67,1
7,N/A,N/A,N/A,1863,1870,N/A,72,6
6,N/A,N/A,N/A,1857,1863,N/A,77,5
3,N/A,N/A,N/A,1854,1857,N/A,82,4
2,N/A,N/A,N/A,1852,1854,N/A,85,1
2,N/A,N/A,N/A,1850,1852,N/A,91,1
7,N/A,N/A,N/A,1843,1850,N/A,96,6
1,N/A,N/A,N/A,1842,1843,N/A,102,0
3,N/A,N/A,N/A,1839,1842,N/A,106,4
4,N/A,N/A,N/A,1835,1839,N/A,112,4
2,N/A,N/A,N/A,1833,1835,N/A,116,2
3,N/A,N/A,N/A,1830,1833,N/A,122,2
5,N/A,N/A,N/A,1825,1830,N/A,125,5
3,N/A,N/A,N/A,1822,1825,N/A,129,3
2,N/A,N/A,N/A,1820,1822,N/A,133,1
2,N/A,N/A,N/A,853,855,N/A,6,1
2,N/A,N/A,N/A,851,853,N/A,12,1
5,N/A,N/A,N/A,846,851,N/A,16,5
2,N/A,N/A,N/A,844,846,N/A,20,3
2,N/A,N/A,N/A,842,844,N/A,26,3
2,N/A,N/A,N/A,840,842,N/A,31,2
2,N/A,N/A,N/A,838,840,N/A,37,2
6,N/A,N/A,N/A,832,838,N/A,41,6
5,N/A,N/A,N/A,827,832,N/A,46,5
2,N/A,N/A,N/A,825,827,N/A,49,2
6,N/A,N/A,N/A,819,825,N/A,52,5
3,N/A,N/A,N/A,816,819,N/A,56,3
3,N/A,N/A,N/A,813,816,N/A,62,3
3,N/A,N/A,N/A,810,813,N/A,67,2
6,N/A,N/A,N/A,804,810,N/A,71,6
3,N/A,N/A,N/A,801,804,N/A,75,4
2,N/A,N/A,N/A,799,801,N/A,79,2
3,N/A,N/A,N/A,796,799,N/A,85,2
1,N/A,N/A,N/A,795,796,N/A,90,1
4,N/A,N/A,N/A,791,795,N/A,93,4
3,N/A,N/A,N/A,788,791,N/A,98,3
7,N/A,N/A,N/A,781,788,N/A,101,6
3,N/A,N/A,N/A,778,781,N/A,104,3
2,N/A,N/A,N/A,776,778,N/A,108,1
2,N/A,N/A,N/A,774,776,N/A,114,1
3,N/A,N/A,N/A,771,774,N/A,117,4
2,N/A,N/A,N/A,769,771,N/A,121,2
2,N/A,N/A,N/A,767,769,N/A,126,1
6,N/A,N/A,N/A,761,767,N/A,131,6
4,N/A,N/A,N/A,757,761,N/A,135,4
2,N/A,N/A,N/A,1356,1358,N/A,3,3
2,N/A,N/A,N/A,1354,1356,N/A,8,2
6,N/A,N/A,N/A,1348,1354,N/A,12,6
6,N/A,N/A,N/A,1342,1348,N/A,17,5
5,N/A,N/A,N/A,1337,1342,N/A,23,5
6,N/A,N/A,N/A,1331,1337,N/A,29,5
5,N/A,N/A,N/A,1326,1331,N/A,35,5
4,N/A,N/A,N/A,1322,1326,N/A,40,4
2,N/A,N/A,N/A,1320,1322,N/A,43,1
7,N/A,N/A,N/A,1313,1320,N/A,48,6
3,N/A,N/A,N/A,1310,1313,N/A,52,4
2,N/A,N/A,N/A,1308,1310,N/A,56,2
3,N/A,N/A,N/A,1305,1308,N/A,62,2
3,N/A,N/A,N/A,1302,1305,N/A,68,2
3,N/A,N/A,N/A,1299,1302,N/A,74,2
2,N/A,N/A,N/A,1297,1299,N/A,80,2
2,N/A,N/A,N/A,1295,1297,N/A,86,2
1,N/A,N/A,N/A,1294,1295,N/A,91,1
2,N/A,N/A,N/A,1292,1294,N/A,97,1
2,N/A,N/A,N/A,1290,1292,N/A,103,1
4,N/A,N/A,N/A,1286,1290,N/A,106,4
1,N/A,N/A,N/A,1285,1286,N/A,109,1
6,N/A,N/A,N/A,1279,1285,N/A,113,5
3,N/A,N/A,N/A,1276,1279,N/A,117,3
2,N/A,N/A,N/A,1274,1276,N/A,121,1
5,N/A,N/A,N/A,1269,1274,N/A,125,5
5,N/A,N/A,N/A,1264,1269,N/A,131,5
3,N/A,N/A,N/A,1261,1264,N/A,136,4
3,N/A,N/A,N/A,1258,1261,N/A,141,3
2,N/A,N/A,N/A,1256,1258,N/A,146,2
2,N/A,N/A,N/A,1955,1957,N/A,6,3
3,N/A,N/A,N/A,1952,1955,N/A,11,2
2,N/A,N/A,N/A,1950,1952,N/A,17,2
1,N/A,N/A,N/A,1949,1950,N/A,22,1
1,N/A,N/A,N/A,1948,1949,N/A,28,1
2,N/A,N/A,N/A,1946,1948,N/A,34,1
7,N/A,N/A,N/A,1939,1946,N/A,39,6
6,N/A,N/A,N/A,1933,1939,N/A,44,5
3,N/A,N/A,N/A,1930,1933,N/A,49,4
4,N/A,N/A,N/A,1926,1930,N/A,55,4
4,N/A,N/A,N/A,1922,1926,N/A,61,4
2,N/A,N/A,N/A,1920,1922,N/A,66,3
2,N/A,N/A,N/A,1918,1920,N/A,70,1
6,N/A,N/A,N/A,1912,1918,N/A,74,5
2,N/A,N/A,N/A,1910,1912,N/A,77,2
6,N/A,N/A,N/A,1904,1910,N/A,80,5
3,N/A,N/A,N/A,1901,1904,N/A,84,3
2,N/A,N/A,N/A,1899,1901,N/A,90,3
6,N/A,N/A,N/A,1893,1899,N/A,93,6
2,N/A,N/A,N/A,1891,1893,N/A,99,0
2,N/A,N/A,N/A,1889,1891,N/A,102,3
3,N/A,N/A,N/A,1886,1889,N/A,108,3
6,N/A,N/A,N/A,1880,1886,N/A,111,6
3,N/A,N/A,N/A,1877,1880,N/A,114,3
2,N/A,N/A,N/A,1875,1877,N/A,120,3
3,N/A,N/A,N/A,1872,1875,N/A,125,2
6,N/A,N/A,N/A,1866,1872,N/A,128,5
3,N/A,N/A,N/A,1863,1866,N/A,133,4
4,N/A,N/A,N/A,1859,1863,N/A,139,4
2,N/A,N/A,N/A,1857,1859,N/A,142,1
3,N/A,N/A,N/A,1779,1782,N/A,4,2
1,N/A,N/A,N/A,1778,1779,N/A,9,1
3,N/A,N/A,N/A,1775,1778,N/A,12,4
1,N/A,N/A,N/A,1774,1775,N/A,15,1
5,N/A,N/A,N/A,1769,1774,N/A,19,5
6,N/A,N/A,N/A,1763,1769,N/A,25,5
3,N/A,N/A,N/A,1760,1763,N/A,29,3
3,N/A,N/A,N/A,1757,1760,N/A,34,2
7,N/A,N/A,N/A,1750,1757,N/A,38,6
4,N/A,N/A,N/A,1746,1750,N/A,42,4
3,N/A,N/A,N/A,1743,1746,N/A,46,2
5,N/A,N/A,N/A,1738,1743,N/A,49,5
3,N/A,N/A,N/A,1735,1738,N/A,53,3
2,N/A,N/A,N/A,1733,1735,N/A,59,3
2,N/A,N/A,N/A,1731,1733,N/A,64,2
2,N/A,N/A,N/A,1729,1731,N/A,70,2
1,N/A,N/A,N/A,1728,1729,N/A,75,1
6,N/A,N/A,N/A,1722,1728,N/A,79,5
2,N/A,N/A,N/A,1720,1722,N/A,82,2
2,N/A,N/A,N/A,1718,1720,N/A,88,2
2,N/A,N/A,N/A,1716,1718,N/A,93,1
2,N/A,N/A,N/A,1714,1716,N/A,99,1
2,N/A,N/A,N/A,1712,1714,N/A,105,1
7,N/A,N/A,N/A,1705,1712,N/A,110,6
1,N/A,N/A,N/A,1704,1705,N/A,116,0
6,N/A,N/A,N/A,1698,1704,N/A,121,5
3,N/A,N/A,N/A,1695,1698,N/A,126,4
2,N/A,N/A,N/A,1693,1695,N/A,130,2
3,N/A,N/A,N/A,1690,1693,N/A,136,2
1,N/A,N/A,N/A,1689,1690,N/A,141,1
2,N/A,N/A,N/A,1918,1920,N/A,6,3
3,N/A,N/A,N/A,1915,1918,N/A,12,3
2,N/A,N/A,N/A,1913,1915,N/A,16,1
3,N/A,N/A,N/A,1910,1913,N/A,19,4
3,N/A,N/A,N/A,1907,1910,N/A,23,2
2,N/A,N/A,N/A,1905,1907,N/A,29,2
2,N/A,N/A,N/A,1903,1905,N/A,34,1
1,N/A,N/A,N/A,1902,1903,N/A,40,1
6,N/A,N/A,N/A,1896,1902,N/A,45,6
3,N/A,N/A,N/A,1893,1896,N/A,48,3
2,N/A,N/A,N/A,1891,1893,N/A,53,2
5,N/A,N/A,N/A,1886,1891,N/A,56,5
3,N/A,N/A,N/A,1883,1886,N/A,61,4
4,N/A,N/A,N/A,1879,1883,N/A,67,4
4,N/A,N/A,N/A,1875,1879,N/A,73,4
3,N/A,N/A,N/A,1872,1875,N/A,77,2
3,N/A,N/A,N/A,1869,1872,N/A,83,2
7,N/A,N/A,N/A,1862,1869,N/A,87,6
5,N/A,N/A,N/A,1857,1862,N/A,92,5
3,N/A,N/A,N/A,1854,1857,N/A,97,4
2,N/A,N/A,N/A,1852,1854,N/A,101,2
1,N/A,N/A,N/A,1851,1852,N/A,106,1
6,N/A,N/A,N/A,1845,1851,N/A,110,5
3,N/A,N/A,N/A,1842,1845,N/A,114,3
2,N/A,N/A,N/A,1840,1842,N/A,120,3
2,N/A,N/A,N/A,1838,1840,N/A,126,3
7,N/A,N/A,N/A,1831,1838,N/A,129,6
5,N/A,N/A,N/A,1826,1831,N/A,134,5
4,N/A,N/A,N/A,1822,1826,N/A,139,4
2,N/A,N/A,N/A,1820,1822,N/A,143,2
2,N/A,N/A,N/A,1459,1461,N/A,6,3
2,N/A,N/A,N/A,1457,1459,N/A,10,1
2,N/A,N/A,N/A,1455,1457,N/A,16,1
1,N/A,N/A,N/A,1454,1455,N/A,22,1
1,N/A,N/A,N/A,1453,1454,N/A,28,1
2,N/A,N/A,N/A,1451,1453,N/A,34,1
2,N/A,N/A,N/A,1449,1451,N/A,40,1
1,N/A,N/A,N/A,1448,1449,N/A,46,1
5,N/A,N/A,N/A,1443,1448,N/A,50,5
2,N/A,N/A,N/A,1441,1443,N/A,53,2
2,N/A,N/A,N/A,1439,1441,N/A,59,2
6,N/A,N/A,N/A,1433,1439,N/A,63,6
1,N/A,N/A,N/A,1432,1433,N/A,69,0
6,N/A,N/A,N/A,1426,1432,N/A,75,6
2,N/A,N/A,N/A,1424,1426,N/A,81,0
7,N/A,N/A,N/A,1417,1424,N/A,87,6
5,N/A,N/A,N/A,1412,1417,N/A,92,5
2,N/A,N/A,N/A,1410,1412,N/A,96,3
2,N/A,N/A,N/A,1408,1410,N/A,101,2
2,N/A,N/A,N/A,1406,1408,N/A,106,1
6,N/A,N/A,N/A,1400,1406,N/A,110,5
4,N/A,N/A,N/A,1396,1400,N/A,115,4
3,N/A,N/A,N/A,1393,1396,N/A,119,2
6,N/A,N/A,N/A,1387,1393,N/A,123,6
2,N/A,N/A,N/A,1385,1387,N/A,129,0
6,N/A,N/A,N/A,1379,1385,N/A,134,5
3,N/A,N/A,N/A,1376,1379,N/A,138,3
3,N/A,N/A,N/A,1373,1376,N/A,144,3
2,N/A,N/A,N/A,1371,1373,N/A,150,3
2,N/A,N/A,N/A,1369,1371,N/A,156,3
1,N/A,N/A,N/A,802,803,N/A,4,1
7,N/A,N/A,N/A,795,802,N/A,9,6
6,N/A,N/A,N/A,789,795,N/A,14,5
6,N/A,N/A,N/A,783,789,N/A,20,5
2,N/A,N/A,N/A,781,783,N/A,24,3
1,N/A,N/A,N/A,780,781,N/A,28,1
1,N/A,N/A,N/A,779,780,N/A,34,1
7,N/A,N/A,N/A,772,779,N/A,39,6
2,N/A,N/A,N/A,770,772,N/A,42,3
6,N/A,N/A,N/A,764,770,N/A,45,6
2,N/A,N/A,N/A,762,764,N/A,48,3
2,N/A,N/A,N/A,760,762,N/A,52,1
7,N/A,N/A,N/A,753,760,N/A,57,6
6,N/A,N/A,N/A,747,753,N/A,62,5
3,N/A,N/A,N/A,744,747,N/A,66,3
7,N/A,N/A,N/A,737,744,N/A,69,6
4,N/A,N/A,N/A,733,737,N/A,73,4
2,N/A,N/A,N/A,731,733,N/A,77,2
6,N/A,N/A,N/A,725,731,N/A,80,5
3,N/A,N/A,N/A,722,725,N/A,84,3
3,N/A,N/A,N/A,719,722,N/A,90,3
1,N/A,N/A,N/A,718,719,N/A,94,1
7,N/A,N/A,N/A,711,718,N/A,99,6
3,N/A,N/A,N/A,708,711,N/A,102,3
1,N/A,N/A,N/A,707,708,N/A,106,1
5,N/A,N/A,N/A,702,707,N/A,110,5
5,N/A,N/A,N/A,697,702,N/A,116,5
5,N/A,N/A,N/A,692,697,N/A,122,5
3,N/A,N/A,N/A,689,692,N/A,125,2
6,N/A,N/A,N/A,683,689,N/A,128,5
6,N/A,N/A,N/A,1472,1478,N/A,6,6
5,N/A,N/A,N/A,1467,1472,N/A,11,5
5,N/A,N/A,N/A,1462,1467,N/A,17,5
3,N/A,N/A,N/A,1459,1462,N/A,21,3
2,N/A,N/A,N/A,1457,1459,N/A,26,2
6,N/A,N/A,N/A,1451,1457,N/A,30,6
2,N/A,N/A,N/A,1449,1451,N/A,36,0
7,N/A,N/A,N/A,1442,1449,N/A,42,6
1,N/A,N/A,N/A,1441,1442,N/A,48,0
3,N/A,N/A,N/A,1438,1441,N/A,52,4
3,N/A,N/A,N/A,1435,1438,N/A,58,4
1,N/A,N/A,N/A,1434,1435,N/A,61,1
3,N/A,N/A,N/A,1431,1434,N/A,64,4
3,N/A,N/A,N/A,1428,1431,N/A,68,2
6,N/A,N/A,N/A,1422,1428,N/A,71,5
3,N/A,N/A,N/A,1419,1422,N/A,75,3
6,N/A,N/A,N/A,1413,1419,N/A,78,6
5,N/A,N/A,N/A,1408,1413,N/A,83,5
2,N/A,N/A,N/A,1406,1408,N/A,86,2
3,N/A,N/A,N/A,1403,1406,N/A,92,2
7,N/A,N/A,N/A,1396,1403,N/A,96,6
1,N/A,N/A,N/A,1395,1396,N/A,102,0
4,N/A,N/A,N/A,1391,1395,N/A,106,4
2,N/A,N/A,N/A,1389,1391,N/A,109,1
6,N/A,N/A,N/A,1383,1389,N/A,113,5
2,N/A,N/A,N/A,1381,1383,N/A,116,2
6,N/A,N/A,N/A,1375,1381,N/A,120,6
3,N/A,N/A,N/A,1372,1375,N/A,124,4
2,N/A,N/A,N/A,1370,1372,N/A,129,3
3,N/A,N/A,N/A,1367,1370,N/A,134,2
3,N/A,N/A,N/A,1478,1481,N/A,4,4
4,N/A,N/A,N/A,1474,1478,N/A,10,4
4,N/A,N/A,N/A,1470,1474,N/A,16,4
2,N/A,N/A,N/A,1468,1470,N/A,21,3
6,N/A,N/A,N/A,1462,1468,N/A,24,6
6,N/A,N/A,N/A,1456,1462,N/A,29,5
4,N/A,N/A,N/A,1452,1456,N/A,34,4
2,N/A,N/A,N/A,1450,1452,N/A,39,3
2,N/A,N/A,N/A,1448,1450,N/A,45,3
6,N/A,N/A,N/A,1442,1448,N/A,48,6
2,N/A,N/A,N/A,1440,1442,N/A,51,3
3,N/A,N/A,N/A,1437,1440,N/A,57,3
2,N/A,N/A,N/A,1435,1437,N/A,62,2
6,N/A,N/A,N/A,1429,1435,N/A,65,5
3,N/A,N/A,N/A,1426,1429,N/A,68,2
2,N/A,N/A,N/A,1424,1426,N/A,74,2
2,N/A,N/A,N/A,1422,1424,N/A,80,2
3,N/A,N/A,N/A,1419,1422,N/A,86,2
2,N/A,N/A,N/A,1417,1419,N/A,91,1
6,N/A,N/A,N/A,1411,1417,N/A,95,5
3,N/A,N/A,N/A,1408,1411,N/A,98,2
2,N/A,N/A,N/A,1406,1408,N/A,103,1
1,N/A,N/A,N/A,1405,1406,N/A,109,1
2,N/A,N/A,N/A,1403,1405,N/A,115,1
4,N/A,N/A,N/A,1399,1403,N/A,118,4
2,N/A,N/A,N/A,1397,1399,N/A,123,3
7,N/A,N/A,N/A,1390,1397,N/A,126,6
2,N/A,N/A,N/A,1388,1390,N/A,129,3
2,N/A,N/A,N/A,1386,1388,N/A,133,1
6,N/A,N/A,N/A,1380,1386,N/A,138,6
2,N/A,N/A,N/A,1027,1029,N/A,6,3
6,N/A,N/A,N/A,1021,1027,N/A,9,6
4,N/A,N/A,N/A,1017,1021,N/A,13,4
3,N/A,N/A,N/A,1014,1017,N/A,18,3
3,N/A,N/A,N/A,1011,1014,N/A,23,2
3,N/A,N/A,N/A,1008,1011,N/A,29,2
2,N/A,N/A,N/A,1006,1008,N/A,35,2
5,N/A,N/A,N/A,1001,1006,N/A,38,5
2,N/A,N/A,N/A,999,1001,N/A,42,3
2,N/A,N/A,N/A,997,999,N/A,47,2
2,N/A,N/A,N/A,995,997,N/A,53,2
3,N/A,N/A,N/A,992,995,N/A,59,2
1,N/A,N/A,N/A,991,992,N/A,64,1
4,N/A,N/A,N/A,987,991,N/A,67,4
3,N/A,N/A,N/A,984,987,N/A,72,3
6,N/A,N/A,N/A,978,984,N/A,75,6
5,N/A,N/A,N/A,973,978,N/A,80,5
6,N/A,N/A,N/A,967,973,N/A,86,5
3,N/A,N/A,N/A,964,967,N/A,91,4
1,N/A,N/A,N/A,963,964,N/A,94,1
6,N/A,N/A,N/A,957,963,N/A,99,6
5,N/A,N/A,N/A,952,957,N/A,104,5
2,N/A,N/A,N/A,950,952,N/A,107,2
3,N/A,N/A,N/A,947,950,N/A,113,2
3,N/A,N/A,N/A,944,947,N/A,119,2
6,N/A,N/A,N/A,938,944,N/A,123,6
2,N/A,N/A,N/A,936,938,N/A,126,3
2,N/A,N/A,N/A,934,936,N/A,132,3
3,N/A,N/A,N/A,931,934,N/A,137,2
7,N/A,N/A,N/A,924,931,N/A,141,6
3,N/A,N/A,N/A,828,831,N/A,4,3
2,N/A,N/A,N/A,826,828,N/A,10,3
6,N/A,N/A,N/A,820,826,N/A,13,6
2,N/A,N/A,N/A,818,820,N/A,19,0
7,N/A,N/A,N/A,811,818,N/A,25,6
2,N/A,N/A,N/A,809,811,N/A,31,0
7,N/A,N/A,N/A,802,809,N/A,37,6
3,N/A,N/A,N/A,799,802,N/A,40,3
7,N/A,N/A,N/A,792,799,N/A,43,6
2,N/A,N/A,N/A,790,792,N/A,46,3
3,N/A,N/A,N/A,787,790,N/A,52,3
3,N/A,N/A,N/A,784,787,N/A,58,3
1,N/A,N/A,N/A,783,784,N/A,62,1
7,N/A,N/A,N/A,776,783,N/A,67,6
3,N/A,N/A,N/A,773,776,N/A,71,4
1,N/A,N/A,N/A,772,773,N/A,74,1
7,N/A,N/A,N/A,765,772,N/A,79,6
4,N/A,N/A,N/A,761,765,N/A,83,4
4,N/A,N/A,N/A,757,761,N/A,89,4
2,N/A,N/A,N/A,755,757,N/A,94,3
2,N/A,N/A,N/A,753,755,N/A,99,2
5,N/A,N/A,N/A,748,753,N/A,102,5
3,N/A,N/A,N/A,745,748,N/A,105,2
1,N/A,N/A,N/A,744,745,N/A,110,1
2,N/A,N/A,N/A,742,744,N/A,116,1
1,N/A,N/A,N/A,741,742,N/A,122,1
3,N/A,N/A,N/A,738,741,N/A,125,4
2,N/A,N/A,N/A,736,738,N/A,130,3
2,N/A,N/A,N/A,734,736,N/A,136,3
1,N/A,N/A,N/A,733,734,N/A,140,1
4,N/A,N/A,N/A,1527,1531,N/A,4,4
1,N/A,N/A,N/A,1526,1527,N/A,7,1
5,N/A,N/A,N/A,1521,1526,N/A,11,5
3,N/A,N/A,N/A,1518,1521,N/A,16,4
2,N/A,N/A,N/A,1516,1518,N/A,20,2
2,N/A,N/A,N/A,1514,1516,N/A,25,1
6,N/A,N/A,N/A,1508,1514,N/A,30,6
3,N/A,N/A,N/A,1505,1508,N/A,33,3
2,N/A,N/A,N/A,1503,1505,N/A,39,3
6,N/A,N/A,N/A,1497,1503,N/A,42,6
2,N/A,N/A,N/A,1495,1497,N/A,48,0
6,N/A,N/A,N/A,1489,1495,N/A,54,6
4,N/A,N/A,N/A,1485,1489,N/A,58,4
2,N/A,N/A,N/A,1483,1485,N/A,63,3
1,N/A,N/A,N/A,1482,1483,N/A,67,1
6,N/A,N/A,N/A,1476,1482,N/A,72,6
3,N/A,N/A,N/A,1473,1476,N/A,75,3
6,N/A,N/A,N/A,1467,1473,N/A,78,6
2,N/A,N/A,N/A,1465,1467,N/A,81,3
6,N/A,N/A,N/A,1459,1465,N/A,84,6
1,N/A,N/A,N/A,1458,1459,N/A,90,0
5,N/A,N/A,N/A,1453,1458,N/A,95,5
4,N/A,N/A,N/A,1449,1453,N/A,100,4
2,N/A,N/A,N/A,1447,1449,N/A,103,1
6,N/A,N/A,N/A,1441,1447,N/A,108,6
1,N/A,N/A,N/A,1440,1441,N/A,114,0
7,N/A,N/A,N/A,1433,1440,N/A,120,6
1,N/A,N/A,N/A,1432,1433,N/A,126,0
7,N/A,N/A,N/A,1425,1432,N/A,132,6
5,N/A,N/A,N/A,1420,1425,N/A,137,5
1,N/A,N/A,N/A,1094,1095,N/A,4,1
1,N/A,N/A,N/A,1093,1094,N/A,10,1
5,N/A,N/A,N/A,1088,1093,N/A,14,5
3,N/A,N/A,N/A,1085,1088,N/A,17,2
3,N/A,N/A,N/A,1082,1085,N/A,23,2
5,N/A,N/A,N/A,1077,1082,N/A,26,5
3,N/A,N/A,N/A,1074,1077,N/A,30,3
7,N/A,N/A,N/A,1067,1074,N/A,33,6
3,N/A,N/A,N/A,1064,1067,N/A,36,3
2,N/A,N/A,N/A,1062,1064,N/A,42,3
2,N/A,N/A,N/A,1060,1062,N/A,47,2
6,N/A,N/A,N/A,1054,1060,N/A,50,5
3,N/A,N/A,N/A,1051,1054,N/A,54,3
2,N/A,N/A,N/A,1049,1051,N/A,58,1
5,N/A,N/A,N/A,1044,1049,N/A,62,5
3,N/A,N/A,N/A,1041,1044,N/A,65,2
7,N/A,N/A,N/A,1034,1041,N/A,69,6
2,N/A,N/A,N/A,1032,1034,N/A,72,3
7,N/A,N/A,N/A,1025,1032,N/A,75,6
2,N/A,N/A,N/A,1023,1025,N/A,78,3
6,N/A,N/A,N/A,1017,1023,N/A,81,6
6,N/A,N/A,N/A,1011,1017,N/A,86,5
5,N/A,N/A,N/A,1006,1011,N/A,92,5
4,N/A,N/A,N/A,1002,1006,N/A,97,4
2,N/A,N/A,N/A,1000,1002,N/A,102,3
2,N/A,N/A,N/A,998,1000,N/A,108,3
2,N/A,N/A,N/A,996,998,N/A,114,3
2,N/A,N/A,N/A,994,996,N/A,119,2
3,N/A,N/A,N/A,991,994,N/A,125,2
5,N/A,N/A,N/A,986,991,N/A,128,5
6,N/A,N/A,N/A,1456,1462,N/A,4,5
3,N/A,N/A,N/A,1453,1456,N/A,7,2
6,N/A,N/A,N/A,1447,1453,N/A,10,5
5,N/A,N/A,N/A,1442,1447,N/A,16,5
5,N/A,N/A,N/A,1437,1442,N/A,22,5
2,N/A,N/A,N/A,1435,1437,N/A,25,2
2,N/A,N/A,N/A,1433,1435,N/A,30,1
1,N/A,N/A,N/A,1432,1433,N/A,36,1
5,N/A,N/A,N/A,1427,1432,N/A,40,5
4,N/A,N/A,N/A,1423,1427,N/A,45,4
3,N/A,N/A,N/A,1420,1423,N/A,51,4
4,N/A,N/A,N/A,1416,1420,N/A,57,4
2,N/A,N/A,N/A,1414,1416,N/A,62,3
3,N/A,N/A,N/A,1411,1414,N/A,67,2
2,N/A,N/A,N/A,1409,1411,N/A,72,1
7,N/A,N/A,N/A,1402,1409,N/A,77,6
1,N/A,N/A,N/A,1401,1402,N/A,83,0
3,N/A,N/A,N/A,1398,1401,N/A,87,4
3,N/A,N/A,N/A,1395,1398,N/A,92,3
3,N/A,N/A,N/A,1392,1395,N/A,97,2
1,N/A,N/A,N/A,1391,1392,N/A,102,1
3,N/A,N/A,N/A,1388,1391,N/A,105,4
4,N/A,N/A,N/A,1384,1388,N/A,111,4
3,N/A,N/A,N/A,1381,1384,N/A,115,2
6,N/A,N/A,N/A,1375,1381,N/A,119,6
6,N/A,N/A,N/A,1369,1375,N/A,124,5
2,N/A,N/A,N/A,1367,1369,N/A,128,3
3,N/A,N/A,N/A,1364,1367,N/A,133,2
1,N/A,N/A,N/A,1363,1364,N/A,138,1
4,N/A,N/A,N/A,1359,1363,N/A,141,4
4,N/A,N/A,N/A,928,932,N/A,4,4
3,N/A,N/A,N/A,925,928,N/A,8,2
6,N/A,N/A,N/A,919,925,N/A,11,5
3,N/A,N/A,N/A,916,919,N/A,15,3
7,N/A,N/A,N/A,909,916,N/A,18,6
2,N/A,N/A,N/A,907,909,N/A,24,0
6,N/A,N/A,N/A,901,907,N/A,30,6
5,N/A,N/A,N/A,896,901,N/A,35,5
3,N/A,N/A,N/A,893,896,N/A,39,3
6,N/A,N/A,N/A,887,893,N/A,42,6
6,N/A,N/A,N/A,881,887,N/A,47,5
5,N/A,N/A,N/A,876,881,N/A,53,5
4,N/A,N/A,N/A,872,876,N/A,58,4
1,N/A,N/A,N/A,871,872,N/A,61,1
5,N/A,N/A,N/A,866,871,N/A,65,5
2,N/A,N/A,N/A,864,866,N/A,69,3
7,N/A,N/A,N/A,857,864,N/A,72,6
2,N/A,N/A,N/A,855,857,N/A,75,3
7,N/A,N/A,N/A,848,855,N/A,78,6
6,N/A,N/A,N/A,842,848,N/A,83,5
3,N/A,N/A,N/A,839,842,N/A,87,3
2,N/A,N/A,N/A,837,839,N/A,93,3
6,N/A,N/A,N/A,831,837,N/A,96,6
4,N/A,N/A,N/A,827,831,N/A,100,4
4,N/A,N/A,N/A,823,827,N/A,106,4
3,N/A,N/A,N/A,820,823,N/A,110,2
3,N/A,N/A,N/A,817,820,N/A,116,2
1,N/A,N/A,N/A,816,817,N/A,121,1
4,N/A,N/A,N/A,812,816,N/A,124,4
2,N/A,N/A,N/A,810,812,N/A,129,3
1,N/A,N/A,N/A,1291,1292,N/A,6,1
7,N/A,N/A,N/A,1284,1291,N/A,11,6
2,N/A,N/A,N/A,1282,1284,N/A,14,3
6,N/A,N/A,N/A,1276,1282,N/A,17,6
2,N/A,N/A,N/A,1274,1276,N/A,20,3
2,N/A,N/A,N/A,1272,1274,N/A,26,3
2,N/A,N/A,N/A,1270,1272,N/A,30,1
6,N/A,N/A,N/A,1264,1270,N/A,34,5
3,N/A,N/A,N/A,1261,1264,N/A,39,4
1,N/A,N/A,N/A,1260,1261,N/A,42,1
5,N/A,N/A,N/A,1255,1260,N/A,46,5
5,N/A,N/A,N/A,1250,1255,N/A,52,5
3,N/A,N/A,N/A,1247,1250,N/A,57,4
2,N/A,N/A,N/A,1245,1247,N/A,62,3
6,N/A,N/A,N/A,1239,1245,N/A,65,6
1,N/A,N/A,N/A,1238,1239,N/A,71,0
3,N/A,N/A,N/A,1235,1238,N/A,75,4
3,N/A,N/A,N/A,1232,1235,N/A,79,2
6,N/A,N/A,N/A,1226,1232,N/A,83,6
6,N/A,N/A,N/A,1220,1226,N/A,88,5
5,N/A,N/A,N/A,1215,1220,N/A,94,5
5,N/A,N/A,N/A,1210,1215,N/A,100,5
3,N/A,N/A,N/A,1207,1210,N/A,105,4
2,N/A,N/A,N/A,1205,1207,N/A,110,3
6,N/A,N/A,N/A,1199,1205,N/A,113,6
6,N/A,N/A,N/A,1193,1199,N/A,118,5
2,N/A,N/A,N/A,1191,1193,N/A,122,3
1,N/A,N/A,N/A,1190,1191,N/A,126,1
3,N/A,N/A,N/A,1187,1190,N/A,129,4
3,N/A,N/A,N/A,1184,1187,N/A,134,3
6,N/A,N/A,N/A,826,832,N/A,4,6
4,N/A,N/A,N/A,822,826,N/A,8,4
2,N/A,N/A,N/A,820,822,N/A,13,3
6,N/A,N/A,N/A,814,820,N/A,16,6
1,N/A,N/A,N/A,813,814,N/A,22,0
6,N/A,N/A,N/A,807,813,N/A,27,5
2,N/A,N/A,N/A,805,807,N/A,31,3
1,N/A,N/A,N/A,804,805,N/A,35,1
5,N/A,N/A,N/A,799,804,N/A,39,5
2,N/A,N/A,N/A,797,799,N/A,42,2
6,N/A,N/A,N/A,791,797,N/A,46,6
1,N/A,N/A,N/A,790,791,N/A,52,0
7,N/A,N/A,N/A,783,790,N/A,58,6
3,N/A,N/A,N/A,780,783,N/A,62,4
2,N/A,N/A,N/A,778,780,N/A,66,2
2,N/A,N/A,N/A,776,778,N/A,71,1
2,N/A,N/A,N/A,774,776,N/A,77,1
7,N/A,N/A,N/A,767,774,N/A,82,6
3,N/A,N/A,N/A,764,767,N/A,85,3
2,N/A,N/A,N/A,762,764,N/A,91,3
3,N/A,N/A,N/A,759,762,N/A,97,3
2,N/A,N/A,N/A,757,759,N/A,102,2
1,N/A,N/A,N/A,756,757,N/A,107,1
3,N/A,N/A,N/A,753,756,N/A,110,4
2,N/A,N/A,N/A,751,753,N/A,113,1
5,N/A,N/A,N/A,746,751,N/A,117,5
2,N/A,N/A,N/A,744,746,N/A,120,2
6,N/A,N/A,N/A,738,744,N/A,124,6
3,N/A,N/A,N/A,735,738,N/A,127,3
3,N/A,N/A,N/A,732,735,N/A,133,3
3,N/A,N/A,N/A,1100,1103,N/A,6,2
2,N/A,N/A,N/A,1098,1100,N/A,11,1
3,N/A,N/A,N/A,1095,1098,N/A,14,4
2,N/A,N/A,N/A,1093,1095,N/A,19,3
3,N/A,N/A,N/A,1090,1093,N/A,24,2
1,N/A,N/A,N/A,1089,1090,N/A,29,1
1,N/A,N/A,N/A,1088,1089,N/A,35,1
2,N/A,N/A,N/A,1086,1088,N/A,41,1
2,N/A,N/A,N/A,1084,1086,N/A,47,1
5,N/A,N/A,N/A,1079,1084,N/A,51,5
6,N/A,N/A,N/A,1073,1079,N/A,57,5
3,N/A,N/A,N/A,1070,1073,N/A,61,3
2,N/A,N/A,N/A,1068,1070,N/A,67,3
2,N/A,N/A,N/A,1066,1068,N/A,73,3
7,N/A,N/A,N/A,1059,1066,N/A,76,6
3,N/A,N/A,N/A,1056,1059,N/A,79,3
2,N/A,N/A,N/A,1054,1056,N/A,83,1
6,N/A,N/A,N/A,1048,1054,N/A,88,6
4,N/A,N/A,N/A,1044,1048,N/A,92,4
3,N/A,N/A,N/A,1041,1044,N/A,96,2
6,N/A,N/A,N/A,1035,1041,N/A,100,6
3,N/A,N/A,N/A,1032,1035,N/A,103,3
7,N/A,N/A,N/A,1025,1032,N/A,106,6
5,N/A,N/A,N/A,1020,1025,N/A,111,5
6,N/A,N/A,N/A,1014,1020,N/A,117,5
3,N/A,N/A,N/A,1011,1014,N/A,122,4
2,N/A,N/A,N/A,1009,1011,N/A,127,3
2,N/A,N/A,N/A,1007,1009,N/A,133,3
3,N/A,N/A,N/A,1004,1007,N/A,138,2
2,N/A,N/A,N/A,1002,1004,N/A,143,1
7,N/A,N/A,N/A,958,965,N/A,5,6
5,N/A,N/A,N/A,953,958,N/A,10,5
2,N/A,N/A,N/A,951,953,N/A,13,2
1,N/A,N/A,N/A,950,951,N/A,18,1
5,N/A,N/A,N/A,945,950,N/A,22,5
4,N/A,N/A,N/A,941,945,N/A,27,4
2,N/A,N/A,N/A,939,941,N/A,31,2
3,N/A,N/A,N/A,936,939,N/A,37,2
6,N/A,N/A,N/A,930,936,N/A,40,5
3,N/A,N/A,N/A,927,930,N/A,45,4
2,N/A,N/A,N/A,925,927,N/A,49,2
6,N/A,N/A,N/A,919,925,N/A,53,6
2,N/A,N/A,N/A,917,919,N/A,56,3
2,N/A,N/A,N/A,915,917,N/A,62,3
3,N/A,N/A,N/A,912,915,N/A,67,2
2,N/A,N/A,N/A,910,912,N/A,72,1
2,N/A,N/A,N/A,908,910,N/A,78,1
4,N/A,N/A,N/A,904,908,N/A,81,4
4,N/A,N/A,N/A,900,904,N/A,87,4
1,N/A,N/A,N/A,899,900,N/A,90,1
5,N/A,N/A,N/A,894,899,N/A,94,5
6,N/A,N/A,N/A,888,894,N/A,100,5
4,N/A,N/A,N/A,884,888,N/A,105,4
4,N/A,N/A,N/A,880,884,N/A,111,4
1,N/A,N/A,N/A,879,880,N/A,114,1
2,N/A,N/A,N/A,877,879,N/A,120,1
7,N/A,N/A,N/A,870,877,N/A,125,6
2,N/A,N/A,N/A,868,870,N/A,128,3
3,N/A,N/A,N/A,865,868,N/A,134,3
3,N/A,N/A,N/A,862,865,N/A,139,2
1,N/A,N/A,N/A,1637,1638,N/A,5,1
2,N/A,N/A,N/A,1635,1637,N/A,11,1
6,N/A,N/A,N/A,1629,1635,N/A,16,6
6,N/A,N/A,N/A,1623,1629,N/A,21,5
3,N/A,N/A,N/A,1620,1623,N/A,24,2
1,N/A,N/A,N/A,1619,1620,N/A,29,1
2,N/A,N/A,N/A,1617,1619,N/A,35,1
6,N/A,N/A,N/A,1611,1617,N/A,39,5
4,N/A,N/A,N/A,1607,1611,N/A,44,4
2,N/A,N/A,N/A,1605,1607,N/A,47,1
3,N/A,N/A,N/A,1602,1605,N/A,50,4
3,N/A,N/A,N/A,1599,1602,N/A,56,4
3,N/A,N/A,N/A,1596,1599,N/A,60,2
5,N/A,N/A,N/A,1591,1596,N/A,63,5
6,N/A,N/A,N/A,1585,1591,N/A,69,5
4,N/A,N/A,N/A,1581,1585,N/A,74,4
4,N/A,N/A,N/A,1577,1581,N/A,80,4
2,N/A,N/A,N/A,1575,1577,N/A,85,3
7,N/A,N/A,N/A,1568,1575,N/A,88,6
3,N/A,N/A,N/A,1565,1568,N/A,92,4
3,N/A,N/A,N/A,1562,1565,N/A,96,2
6,N/A,N/A,N/A,1556,1562,N/A,99,5
5,N/A,N/A,N/A,1551,1556,N/A,105,5
2,N/A,N/A,N/A,1549,1551,N/A,109,3
3,N/A,N/A,N/A,1546,1549,N/A,114,2
1,N/A,N/A,N/A,1545,1546,N/A,119,1
4,N/A,N/A,N/A,1541,1545,N/A,122,4
3,N/A,N/A,N/A,1538,1541,N/A,126,2
1,N/A,N/A,N/A,1537,1538,N/A,131,1
2,N/A,N/A,N/A,1535,1537,N/A,137,1
2,N/A,N/A,N/A,369,371,N/A,5,3
3,N/A,N/A,N/A,366,369,N/A,10,2
7,N/A,N/A,N/A,359,366,N/A,14,6
5,N/A,N/A,N/A,354,359,N/A,19,5
3,N/A,N/A,N/A,351,354,N/A,24,4
2,N/A,N/A,N/A,349,351,N/A,29,3
6,N/A,N/A,N/A,343,349,N/A,32,6
4,N/A,N/A,N/A,339,343,N/A,36,4
4,N/A,N/A,N/A,335,339,N/A,42,4
3,N/A,N/A,N/A,332,335,N/A,47,3
3,N/A,N/A,N/A,329,332,N/A,53,3
1,N/A,N/A,N/A,328,329,N/A,57,1
1,N/A,N/A,N/A,327,328,N/A,63,1
1,N/A,N/A,N/A,326,327,N/A,69,1
7,N/A,N/A,N/A,319,326,N/A,74,6
5,N/A,N/A,N/A,314,319,N/A,79,5
2,N/A,N/A,N/A,312,314,N/A,83,3
2,N/A,N/A,N/A,310,312,N/A,87,1
5,N/A,N/A,N/A,305,310,N/A,91,5
6,N/A,N/A,N/A,299,305,N/A,97,5
3,N/A,N/A,N/A,296,299,N/A,100,2
6,N/A,N/A,N/A,290,296,N/A,104,6
5,N/A,N/A,N/A,285,290,N/A,109,5
2,N/A,N/A,N/A,283,285,N/A,112,2
2,N/A,N/A,N/A,281,283,N/A,118,2
3,N/A,N/A,N/A,278,281,N/A,124,2
5,N/A,N/A,N/A,273,278,N/A,127,5
3,N/A,N/A,N/A,270,273,N/A,130,2
6,N/A,N/A,N/A,264,270,N/A,134,6
3,N/A,N/A,N/A,261,264,N/A,137,3
2,N/A,N/A,N/A,1893,1895,N/A,3,3
3,N/A,N/A,N/A,1890,1893,N/A,9,3
2,N/A,N/A,N/A,1888,1890,N/A,15,3
3,N/A,N/A,N/A,1885,1888,N/A,20,2
5,N/A,N/A,N/A,1880,1885,N/A,23,5
2,N/A,N/A,N/A,1878,1880,N/A,26,2
2,N/A,N/A,N/A,1876,1878,N/A,32,2
2,N/A,N/A,N/A,1874,1876,N/A,37,1
6,N/A,N/A,N/A,1868,1874,N/A,42,6
4,N/A,N/A,N/A,1864,1868,N/A,46,4
2,N/A,N/A,N/A,1862,1864,N/A,51,3
3,N/A,N/A,N/A,1859,1862,N/A,57,3
3,N/A,N/A,N/A,1856,1859,N/A,62,2
2,N/A,N/A,N/A,1854,1856,N/A,67,1
6,N/A,N/A,N/A,1848,1854,N/A,71,5
4,N/A,N/A,N/A,1844,1848,N/A,76,4
3,N/A,N/A,N/A,1841,1844,N/A,80,2
5,N/A,N/A,N/A,1836,1841,N/A,83,5
6,N/A,N/A,N/A,1830,1836,N/A,89,5
4,N/A,N/A,N/A,1826,1830,N/A,94,4
2,N/A,N/A,N/A,1824,1826,N/A,99,3
2,N/A,N/A,N/A,1822,1824,N/A,105,3
3,N/A,N/A,N/A,1819,1822,N/A,110,2
1,N/A,N/A,N/A,1818,1819,N/A,115,1
6,N/A,N/A,N/A,1812,1818,N/A,120,6
6,N/A,N/A,N/A,1806,1812,N/A,125,5
4,N/A,N/A,N/A,1802,1806,N/A,130,4
3,N/A,N/A,N/A,1799,1802,N/A,135,3
3,N/A,N/A,N/A,1796,1799,N/A,141,3
3,N/A,N/A,N/A,1793,1796,N/A,147,3
7,N/A,N/A,N/A,602,609,N/A,3,6
3,N/A,N/A,N/A,599,602,N/A,6,3
3,N/A,N/A,N/A,596,599,N/A,11,2
6,N/A,N/A,N/A,590,596,N/A,15,6
4,N/A,N/A,N/A,586,590,N/A,19,4
3,N/A,N/A,N/A,583,586,N/A,23,2
1,N/A,N/A,N/A,582,583,N/A,28,1
4,N/A,N/A,N/A,578,582,N/A,31,4
4,N/A,N/A,N/A,574,578,N/A,37,4
3,N/A,N/A,N/A,571,574,N/A,42,3
2,N/A,N/A,N/A,569,571,N/A,48,3
3,N/A,N/A,N/A,566,569,N/A,53,2
7,N/A,N/A,N/A,559,566,N/A,57,6
2,N/A,N/A,N/A,557,559,N/A,60,3
6,N/A,N/A,N/A,551,557,N/A,63,6
1,N/A,N/A,N/A,550,551,N/A,69,0
6,N/A,N/A,N/A,544,550,N/A,74,5
4,N/A,N/A,N/A,540,544,N/A,79,4
2,N/A,N/A,N/A,538,540,N/A,82,1
6,N/A,N/A,N/A,532,538,N/A,86,5
5,N/A,N/A,N/A,527,532,N/A,92,5
3,N/A,N/A,N/A,524,527,N/A,96,3
3,N/A,N/A,N/A,521,524,N/A,101,2
2,N/A,N/A,N/A,519,521,N/A,107,2
1,N/A,N/A,N/A,518,519,N/A,112,1
5,N/A,N/A,N/A,513,518,N/A,116,5
5,N/A,N/A,N/A,508,513,N/A,122,5
4,N/A,N/A,N/A,504,508,N/A,127,4
3,N/A,N/A,N/A,501,504,N/A,133,4
3,N/A,N/A,N/A,498,501,N/A,139,4
5,N/A,N/A,N/A,579,584,N/A,3,5
3,N/A,N/A,N/A,576,579,N/A,6,2
5,N/A,N/A,N/A,571,576,N/A,9,5
2,N/A,N/A,N/A,569,571,N/A,12,2
7,N/A,N/A,N/A,562,569,N/A,16,6
4,N/A,N/A,N/A,558,562,N/A,20,4
3,N/A,N/A,N/A,555,558,N/A,24,2
2,N/A,N/A,N/A,553,555,N/A,29,1
7,N/A,N/A,N/A,546,553,N/A,34,6
6,N/A,N/A,N/A,540,546,N/A,39,5
2,N/A,N/A,N/A,538,540,N/A,43,3
3,N/A,N/A,N/A,535,538,N/A,49,3
2,N/A,N/A,N/A,533,535,N/A,54,2
5,N/A,N/A,N/A,528,533,N/A,57,5
2,N/A,N/A,N/A,526,528,N/A,61,3
2,N/A,N/A,N/A,524,526,N/A,67,3
3,N/A,N/A,N/A,521,524,N/A,72,2
1,N/A,N/A,N/A,520,521,N/A,77,1
2,N/A,N/A,N/A,518,520,N/A,83,1
6,N/A,N/A,N/A,512,518,N/A,88,6
1,N/A,N/A,N/A,511,512,N/A,94,0
4,N/A,N/A,N/A,507,511,N/A,98,4
2,N/A,N/A,N/A,505,507,N/A,103,3
2,N/A,N/A,N/A,503,505,N/A,108,2
2,N/A,N/A,N/A,501,503,N/A,113,1
5,N/A,N/A,N/A,496,501,N/A,117,5
3,N/A,N/A,N/A,493,496,N/A,121,3
7,N/A,N/A,N/A,486,493,N/A,124,6
5,N/A,N/A,N/A,481,486,N/A,129,5
3,N/A,N/A,N/A,478,481,N/A,134,4
2,N/A,N/A,N/A,1342,1344,N/A,5,2
6,N/A,N/A,N/A,1336,1342,N/A,9,6
1,N/A,N/A,N/A,1335,1336,N/A,15,0
7,N/A,N/A,N/A,1328,1335,N/A,21,6
5,N/A,N/A,N/A,1323,1328,N/A,26,5
3,N/A,N/A,N/A,1320,1323,N/A,29,2
7,N/A,N/A,N/A,1313,1320,N/A,33,6
2,N/A,N/A,N/A,1311,1313,N/A,36,3
3,N/A,N/A,N/A,1308,1311,N/A,41,2
2,N/A,N/A,N/A,1306,1308,N/A,47,2
6,N/A,N/A,N/A,1300,1306,N/A,51,6
4,N/A,N/A,N/A,1296,1300,N/A,55,4
4,N/A,N/A,N/A,1292,1296,N/A,61,4
3,N/A,N/A,N/A,1289,1292,N/A,65,2
2,N/A,N/A,N/A,1287,1289,N/A,70,1
7,N/A,N/A,N/A,1280,1287,N/A,75,6
1,N/A,N/A,N/A,1279,1280,N/A,81,0
4,N/A,N/A,N/A,1275,1279,N/A,85,4
4,N/A,N/A,N/A,1271,1275,N/A,91,4
2,N/A,N/A,N/A,1269,1271,N/A,95,2
6,N/A,N/A,N/A,1263,1269,N/A,98,5
2,N/A,N/A,N/A,1261,1263,N/A,101,2
5,N/A,N/A,N/A,1256,1261,N/A,104,5
2,N/A,N/A,N/A,1254,1256,N/A,108,3
7,N/A,N/A,N/A,1247,1254,N/A,111,6
1,N/A,N/A,N/A,1246,1247,N/A,117,0
6,N/A,N/A,N/A,1240,1246,N/A,123,6
2,N/A,N/A,N/A,1238,1240,N/A,129,0
7,N/A,N/A,N/A,1231,1238,N/A,135,6
2,N/A,N/A,N/A,1229,1231,N/A,141,0
2,N/A,N/A,N/A,639,641,N/A,3,3
3,N/A,N/A,N/A,636,639,N/A,8,2
6,N/A,N/A,N/A,630,636,N/A,11,5
3,N/A,N/A,N/A,627,630,N/A,15,3
2,N/A,N/A,N/A,625,627,N/A,20,2
6,N/A,N/A,N/A,619,625,N/A,24,6
3,N/A,N/A,N/A,616,619,N/A,27,3
7,N/A,N/A,N/A,609,616,N/A,30,6
6,N/A,N/A,N/A,603,609,N/A,35,5
5,N/A,N/A,N/A,598,603,N/A,41,5
2,N/A,N/A,N/A,596,598,N/A,44,2
6,N/A,N/A,N/A,590,596,N/A,48,6
5,N/A,N/A,N/A,585,590,N/A,53,5
6,N/A,N/A,N/A,579,585,N/A,59,5
2,N/A,N/A,N/A,577,579,N/A,62,2
5,N/A,N/A,N/A,572,577,N/A,65,5
3,N/A,N/A,N/A,569,572,N/A,69,3
6,N/A,N/A,N/A,563,569,N/A,72,6
3,N/A,N/A,N/A,560,563,N/A,75,3
3,N/A,N/A,N/A,557,560,N/A,81,3
2,N/A,N/A,N/A,555,557,N/A,87,3
7,N/A,N/A,N/A,548,555,N/A,90,6
2,N/A,N/A,N/A,546,548,N/A,96,0
2,N/A,N/A,N/A,544,546,N/A,99,3
1,N/A,N/A,N/A,543,544,N/A,103,1
7,N/A,N/A,N/A,536,543,N/A,108,6
1,N/A,N/A,N/A,535,536,N/A,114,0
7,N/A,N/A,N/A,528,535,N/A,120,6
1,N/A,N/A,N/A,527,528,N/A,126,0
3,N/A,N/A,N/A,524,527,N/A,129,3
4,N/A,N/A,N/A,1175,1179,N/A,6,4
3,N/A,N/A,N/A,1172,1175,N/A,12,4
2,N/A,N/A,N/A,1170,1172,N/A,16,2
2,N/A,N/A,N/A,1168,1170,N/A,22,2
2,N/A,N/A,N/A,1166,1168,N/A,27,1
3,N/A,N/A,N/A,1163,1166,N/A,30,4
2,N/A,N/A,N/A,1161,1163,N/A,33,1
3,N/A,N/A,N/A,1158,1161,N/A,36,4
2,N/A,N/A,N/A,1156,1158,N/A,40,2
7,N/A,N/A,N/A,1149,1156,N/A,44,6
1,N/A,N/A,N/A,1148,1149,N/A,50,0
4,N/A,N/A,N/A,1144,1148,N/A,54,4
1,N/A,N/A,N/A,1143,1144,N/A,57,1
7,N/A,N/A,N/A,1136,1143,N/A,62,6
4,N/A,N/A,N/A,1132,1136,N/A,66,4
4,N/A,N/A,N/A,1128,1132,N/A,72,4
2,N/A,N/A,N/A,1126,1128,N/A,75,1
5,N/A,N/A,N/A,1121,1126,N/A,79,5
2,N/A,N/A,N/A,1119,1121,N/A,83,3
2,N/A,N/A,N/A,1117,1119,N/A,88,2
3,N/A,N/A,N/A,1114,1117,N/A,94,2
2,N/A,N/A,N/A,1112,1114,N/A,99,1
6,N/A,N/A,N/A,1106,1112,N/A,104,6
2,N/A,N/A,N/A,1104,1106,N/A,110,0
4,N/A,N/A,N/A,1100,1104,N/A,114,4
1,N/A,N/A,N/A,1099,1100,N/A,117,1
4,N/A,N/A,N/A,1095,1099,N/A,120,4
1,N/A,N/A,N/A,1094,1095,N/A,123,1
7,N/A,N/A,N/A,1087,1094,N/A,128,6
2,N/A,N/A,N/A,1085,1087,N/A,134,0
2,N/A,N/A,N/A,1641,1643,N/A,6,2
6,N/A,N/A,N/A,1635,1641,N/A,9,5
6,N/A,N/A,N/A,1629,1635,N/A,15,5
2,N/A,N/A,N/A,1627,1629,N/A,18,2
5,N/A,N/A,N/A,1622,1627,N/A,21,5
2,N/A,N/A,N/A,1620,1622,N/A,24,2
6,N/A,N/A,N/A,1614,1620,N/A,28,6
4,N/A,N/A,N/A,1610,1614,N/A,32,4
2,N/A,N/A,N/A,1608,1610,N/A,35,1
3,N/A,N/A,N/A,1605,1608,N/A,38,4
4,N/A,N/A,N/A,1601,1605,N/A,44,4
2,N/A,N/A,N/A,1599,1601,N/A,49,3
2,N/A,N/A,N/A,1597,1599,N/A,53,1
3,N/A,N/A,N/A,1594,1597,N/A,56,4
3,N/A,N/A,N/A,1591,1594,N/A,60,2
3,N/A,N/A,N/A,1588,1591,N/A,66,2
5,N/A,N/A,N/A,1583,1588,N/A,69,5
2,N/A,N/A,N/A,1581,1583,N/A,72,2
7,N/A,N/A,N/A,1574,1581,N/A,76,6
4,N/A,N/A,N/A,1570,1574,N/A,80,4
2,N/A,N/A,N/A,1568,1570,N/A,84,2
3,N/A,N/A,N/A,1565,1568,N/A,90,2
5,N/A,N/A,N/A,1560,1565,N/A,93,5
2,N/A,N/A,N/A,1558,1560,N/A,96,2
2,N/A,N/A,N/A,1556,1558,N/A,101,1
7,N/A,N/A,N/A,1549,1556,N/A,106,6
1,N/A,N/A,N/A,1548,1549,N/A,112,0
4,N/A,N/A,N/A,1544,1548,N/A,116,4
3,N/A,N/A,N/A,1541,1544,N/A,120,2
5,N/A,N/A,N/A,1536,1541,N/A,123,5
3,N/A,N/A,N/A,793,796,N/A,5,3
2,N/A,N/A,N/A,791,793,N/A,11,3
6,N/A,N/A,N/A,785,791,N/A,14,6
6,N/A,N/A,N/A,779,785,N/A,19,5
2,N/A,N/A,N/A,777,779,N/A,23,3
3,N/A,N/A,N/A,774,777,N/A,29,3
2,N/A,N/A,N/A,772,774,N/A,34,2
2,N/A,N/A,N/A,770,772,N/A,40,2
6,N/A,N/A,N/A,764,770,N/A,44,6
5,N/A,N/A,N/A,759,764,N/A,49,5
3,N/A,N/A,N/A,756,759,N/A,53,3
2,N/A,N/A,N/A,754,756,N/A,57,1
2,N/A,N/A,N/A,752,754,N/A,63,1
7,N/A,N/A,N/A,745,752,N/A,68,6
2,N/A,N/A,N/A,743,745,N/A,71,3
2,N/A,N/A,N/A,741,743,N/A,77,3
2,N/A,N/A,N/A,739,741,N/A,82,2
6,N/A,N/A,N/A,733,739,N/A,86,6
4,N/A,N/A,N/A,729,733,N/A,90,4
2,N/A,N/A,N/A,727,729,N/A,93,1
2,N/A,N/A,N/A,725,727,N/A,99,1
1,N/A,N/A,N/A,724,725,N/A,105,1
4,N/A,N/A,N/A,720,724,N/A,108,4
2,N/A,N/A,N/A,718,720,N/A,111,1
6,N/A,N/A,N/A,712,718,N/A,115,5
3,N/A,N/A,N/A,709,712,N/A,120,4
4,N/A,N/A,N/A,705,709,N/A,126,4
2,N/A,N/A,N/A,703,705,N/A,131,3
6,N/A,N/A,N/A,697,703,N/A,134,6
2,N/A,N/A,N/A,695,697,N/A,137,3
7,N/A,N/A,N/A,550,557,N/A,6,6
3,N/A,N/A,N/A,547,550,N/A,10,4
2,N/A,N/A,N/A,545,547,N/A,15,3
3,N/A,N/A,N/A,542,545,N/A,21,3
1,N/A,N/A,N/A,541,542,N/A,25,1
2,N/A,N/A,N/A,539,541,N/A,31,1
6,N/A,N/A,N/A,533,539,N/A,36,6
4,N/A,N/A,N/A,529,533,N/A,40,4
2,N/A,N/A,N/A,527,529,N/A,44,2
1,N/A,N/A,N/A,526,527,N/A,49,1
5,N/A,N/A,N/A,521,526,N/A,53,5
3,N/A,N/A,N/A,518,521,N/A,56,2
2,N/A,N/A,N/A,516,518,N/A,62,2
3,N/A,N/A,N/A,513,516,N/A,68,2
1,N/A,N/A,N/A,512,513,N/A,73,1
5,N/A,N/A,N/A,507,512,N/A,77,5
6,N/A,N/A,N/A,501,507,N/A,83,5
6,N/A,N/A,N/A,495,501,N/A,89,5
3,N/A,N/A,N/A,492,495,N/A,92,2
5,N/A,N/A,N/A,487,492,N/A,95,5
3,N/A,N/A,N/A,484,487,N/A,99,3
3,N/A,N/A,N/A,481,484,N/A,104,2
5,N/A,N/A,N/A,476,481,N/A,107,5
6,N/A,N/A,N/A,470,476,N/A,113,5
2,N/A,N/A,N/A,468,470,N/A,116,2
3,N/A,N/A,N/A,465,468,N/A,122,2
2,N/A,N/A,N/A,463,465,N/A,127,1
2,N/A,N/A,N/A,461,463,N/A,133,1
6,N/A,N/A,N/A,455,461,N/A,138,6
2,N/A,N/A,N/A,453,455,N/A,144,0
5,N/A,N/A,N/A,1691,1696,N/A,5,5
2,N/A,N/A,N/A,1689,1691,N/A,8,2
5,N/A,N/A,N/A,1684,1689,N/A,11,5
3,N/A,N/A,N/A,1681,1684,N/A,15,3
2,N/A,N/A,N/A,1679,1681,N/A,21,3
2,N/A,N/A,N/A,1677,1679,N/A,27,3
7,N/A,N/A,N/A,1670,1677,N/A,30,6
2,N/A,N/A,N/A,1668,1670,N/A,33,3
2,N/A,N/A,N/A,1666,1668,N/A,37,1
6,N/A,N/A,N/A,1660,1666,N/A,41,5
2,N/A,N/A,N/A,1658,1660,N/A,45,3
6,N/A,N/A,N/A,1652,1658,N/A,48,6
3,N/A,N/A,N/A,1649,1652,N/A,52,4
4,N/A,N/A,N/A,1645,1649,N/A,58,4
3,N/A,N/A,N/A,1642,1645,N/A,64,4
1,N/A,N/A,N/A,1641,1642,N/A,67,1
3,N/A,N/A,N/A,1638,1641,N/A,70,4
1,N/A,N/A,N/A,1637,1638,N/A,73,1
5,N/A,N/A,N/A,1632,1637,N/A,77,5
3,N/A,N/A,N/A,1629,1632,N/A,82,4
2,N/A,N/A,N/A,1627,1629,N/A,86,2
6,N/A,N/A,N/A,1621,1627,N/A,90,6
5,N/A,N/A,N/A,1616,1621,N/A,95,5
5,N/A,N/A,N/A,1611,1616,N/A,101,5
3,N/A,N/A,N/A,1608,1611,N/A,105,3
2,N/A,N/A,N/A,1606,1608,N/A,109,1
6,N/A,N/A,N/A,1600,1606,N/A,113,5
2,N/A,N/A,N/A,1598,1600,N/A,116,2
7,N/A,N/A,N/A,1591,1598,N/A,120,6
2,N/A,N/A,N/A,1589,1591,N/A,126,0
3,N/A,N/A,N/A,1018,1021,N/A,3,2
2,N/A,N/A,N/A,1016,1018,N/A,8,1
3,N/A,N/A,N/A,1013,1016,N/A,11,4
4,N/A,N/A,N/A,1009,1013,N/A,17,4
4,N/A,N/A,N/A,1005,1009,N/A,23,4
1,N/A,N/A,N/A,1004,1005,N/A,26,1
7,N/A,N/A,N/A,997,1004,N/A,31,6
4,N/A,N/A,N/A,993,997,N/A,35,4
3,N/A,N/A,N/A,990,993,N/A,41,4
3,N/A,N/A,N/A,987,990,N/A,47,4
3,N/A,N/A,N/A,984,987,N/A,51,2
3,N/A,N/A,N/A,981,984,N/A,57,2
7,N/A,N/A,N/A,974,981,N/A,61,6
3,N/A,N/A,N/A,971,974,N/A,64,3
7,N/A,N/A,N/A,964,971,N/A,67,6
5,N/A,N/A,N/A,959,964,N/A,72,5
5,N/A,N/A,N/A,954,959,N/A,78,5
3,N/A,N/A,N/A,951,954,N/A,82,3
2,N/A,N/A,N/A,949,951,N/A,87,2
2,N/A,N/A,N/A,947,949,N/A,93,2
3,N/A,N/A,N/A,944,947,N/A,99,2
7,N/A,N/A,N/A,937,944,N/A,103,6
2,N/A,N/A,N/A,935,937,N/A,106,3
2,N/A,N/A,N/A,933,935,N/A,111,2
2,N/A,N/A,N/A,931,933,N/A,116,1
2,N/A,N/A,N/A,929,931,N/A,122,1
7,N/A,N/A,N/A,922,929,N/A,127,6
6,N/A,N/A,N/A,916,922,N/A,132,5
3,N/A,N/A,N/A,913,916,N/A,136,3
6,N/A,N/A,N/A,907,913,N/A,139,6
3,N/A,N/A,N/A,1052,1055,N/A,5,2
7,N/A,N/A,N/A,1045,1052,N/A,9,6
5,N/A,N/A,N/A,1040,1045,N/A,14,5
3,N/A,N/A,N/A,1037,1040,N/A,19,4
2,N/A,N/A,N/A,1035,1037,N/A,22,1
2,N/A,N/A,N/A,1033,1035,N/A,28,1
6,N/A,N/A,N/A,1027,1033,N/A,32,5
5,N/A,N/A,N/A,1022,1027,N/A,38,5
2,N/A,N/A,N/A,1020,1022,N/A,42,3
6,N/A,N/A,N/A,1014,1020,N/A,45,6
6,N/A,N/A,N/A,1008,1014,N/A,50,5
3,N/A,N/A,N/A,1005,1008,N/A,54,3
2,N/A,N/A,N/A,1003,1005,N/A,59,2
5,N/A,N/A,N/A,998,1003,N/A,62,5
3,N/A,N/A,N/A,995,998,N/A,67,4
3,N/A,N/A,N/A,992,995,N/A,71,2
3,N/A,N/A,N/A,989,992,N/A,77,2
5,N/A,N/A,N/A,984,989,N/A,80,5
3,N/A,N/A,N/A,981,984,N/A,83,2
6,N/A,N/A,N/A,975,981,N/A,86,5
2,N/A,N/A,N/A,973,975,N/A,90,3
7,N/A,N/A,N/A,966,973,N/A,93,6
2,N/A,N/A,N/A,964,966,N/A,99,0
2,N/A,N/A,N/A,962,964,N/A,102,3
2,N/A,N/A,N/A,960,962,N/A,108,3
3,N/A,N/A,N/A,957,960,N/A,114,3
2,N/A,N/A,N/A,955,957,N/A,119,2
2,N/A,N/A,N/A,953,955,N/A,125,2
7,N/A,N/A,N/A,946,953,N/A,129,6
3,N/A,N/A,N/A,943,946,N/A,133,4
1,N/A,N/A,N/A,1800,1801,N/A,6,1
4,N/A,N/A,N/A,1796,1800,N/A,9,4
1,N/A,N/A,N/A,1795,1796,N/A,12,1
1,N/A,N/A,N/A,1794,1795,N/A,18,1
4,N/A,N/A,N/A,1790,1794,N/A,21,4
3,N/A,N/A,N/A,1787,1790,N/A,25,2
3,N/A,N/A,N/A,1784,1787,N/A,31,2
6,N/A,N/A,N/A,1778,1784,N/A,34,5
3,N/A,N/A,N/A,1775,1778,N/A,39,4
2,N/A,N/A,N/A,1773,1775,N/A,44,3
2,N/A,N/A,N/A,1771,1773,N/A,48,1
5,N/A,N/A,N/A,1766,1771,N/A,52,5
2,N/A,N/A,N/A,1764,1766,N/A,55,2
2,N/A,N/A,N/A,1762,1764,N/A,60,1
6,N/A,N/A,N/A,1756,1762,N/A,64,5
3,N/A,N/A,N/A,1753,1756,N/A,67,2
2,N/A,N/A,N/A,1751,1753,N/A,73,2
6,N/A,N/A,N/A,1745,1751,N/A,76,5
2,N/A,N/A,N/A,1743,1745,N/A,80,3
1,N/A,N/A,N/A,1742,1743,N/A,84,1
6,N/A,N/A,N/A,1736,1742,N/A,89,6
2,N/A,N/A,N/A,1734,1736,N/A,92,3
1,N/A,N/A,N/A,1733,1734,N/A,96,1
6,N/A,N/A,N/A,1727,1733,N/A,101,6
3,N/A,N/A,N/A,1724,1727,N/A,104,3
2,N/A,N/A,N/A,1722,1724,N/A,109,2
7,N/A,N/A,N/A,1715,1722,N/A,113,6
3,N/A,N/A,N/A,1712,1715,N/A,117,4
3,N/A,N/A,N/A,1709,1712,N/A,121,2
3,N/A,N/A,N/A,1706,1709,N/A,127,2
6,N/A,N/A,N/A,330,336,N/A,3,5
6,N/A,N/A,N/A,324,330,N/A,9,5
2,N/A,N/A,N/A,322,324,N/A,13,3
3,N/A,N/A,N/A,319,322,N/A,18,2
7,N/A,N/A,N/A,312,319,N/A,22,6
3,N/A,N/A,N/A,309,312,N/A,25,3
2,N/A,N/A,N/A,307,309,N/A,29,1
6,N/A,N/A,N/A,301,307,N/A,33,5
3,N/A,N/A,N/A,298,301,N/A,38,4
1,N/A,N/A,N/A,297,298,N/A,41,1
6,N/A,N/A,N/A,291,297,N/A,45,5
3,N/A,N/A,N/A,288,291,N/A,48,2
3,N/A,N/A,N/A,285,288,N/A,54,2
2,N/A,N/A,N/A,283,285,N/A,60,2
7,N/A,N/A,N/A,276,283,N/A,64,6
2,N/A,N/A,N/A,274,276,N/A,67,3
2,N/A,N/A,N/A,272,274,N/A,73,3
1,N/A,N/A,N/A,271,272,N/A,77,1
3,N/A,N/A,N/A,268,271,N/A,80,4
1,N/A,N/A,N/A,267,268,N/A,83,1
4,N/A,N/A,N/A,263,267,N/A,86,4
1,N/A,N/A,N/A,262,263,N/A,89,1
5,N/A,N/A,N/A,257,262,N/A,93,5
6,N/A,N/A,N/A,251,257,N/A,99,5
4,N/A,N/A,N/A,247,251,N/A,104,4
4,N/A,N/A,N/A,243,247,N/A,110,4
2,N/A,N/A,N/A,241,243,N/A,113,1
4,N/A,N/A,N/A,237,241,N/A,116,4
2,N/A,N/A,N/A,235,237,N/A,121,3
6,N/A,N/A,N/A,229,235,N/A,124,6
2,N/A,N/A,N/A,803,805,N/A,4,2
2,N/A,N/A,N/A,801,803,N/A,10,2
3,N/A,N/A,N/A,798,801,N/A,16,2
2,N/A,N/A,N/A,796,798,N/A,22,2
7,N/A,N/A,N/A,789,796,N/A,26,6
4,N/A,N/A,N/A,785,789,N/A,30,4
2,N/A,N/A,N/A,783,785,N/A,33,1
7,N/A,N/A,N/A,776,783,N/A,38,6
6,N/A,N/A,N/A,770,776,N/A,43,5
4,N/A,N/A,N/A,766,770,N/A,48,4
2,N/A,N/A,N/A,764,766,N/A,51,1
3,N/A,N/A,N/A,761,764,N/A,54,4
2,N/A,N/A,N/A,759,761,N/A,59,3
2,N/A,N/A,N/A,757,759,N/A,65,3
1,N/A,N/A,N/A,756,757,N/A,69,1
6,N/A,N/A,N/A,750,756,N/A,74,6
3,N/A,N/A,N/A,747,750,N/A,78,4
1,N/A,N/A,N/A,746,747,N/A,81,1
3,N/A,N/A,N/A,743,746,N/A,84,4
3,N/A,N/A,N/A,740,743,N/A,89,3
2,N/A,N/A,N/A,738,740,N/A,95,3
2,N/A,N/A,N/A,736,738,N/A,101,3
1,N/A,N/A,N/A,735,736,N/A,105,1
3,N/A,N/A,N/A,732,735,N/A,108,4
3,N/A,N/A,N/A,729,732,N/A,113,3
3,N/A,N/A,N/A,726,729,N/A,119,3
1,N/A,N/A,N/A,725,726,N/A,123,1
4,N/A,N/A,N/A,721,725,N/A,126,4
4,N/A,N/A,N/A,717,721,N/A,132,4
2,N/A,N/A,N/A,715,717,N/A,136,2
6,N/A,N/A,N/A,327,333,N/A,5,6
4,N/A,N/A,N/A,323,327,N/A,9,4
2,N/A,N/A,N/A,321,323,N/A,14,3
2,N/A,N/A,N/A,319,321,N/A,18,1
4,N/A,N/A,N/A,315,319,N/A,21,4
3,N/A,N/A,N/A,312,315,N/A,27,4
3,N/A,N/A,N/A,309,312,N/A,33,4
2,N/A,N/A,N/A,307,309,N/A,38,3
3,N/A,N/A,N/A,304,307,N/A,44,3
2,N/A,N/A,N/A,302,304,N/A,50,3
1,N/A,N/A,N/A,301,302,N/A,54,1
3,N/A,N/A,N/A,298,301,N/A,57,4
3,N/A,N/A,N/A,295,298,N/A,62,3
3,N/A,N/A,N/A,292,295,N/A,67,2
3,N/A,N/A,N/A,289,292,N/A,73,2
6,N/A,N/A,N/A,283,289,N/A,77,6
3,N/A,N/A,N/A,280,283,N/A,80,3
7,N/A,N/A,N/A,273,280,N/A,83,6
2,N/A,N/A,N/A,271,273,N/A,86,3
3,N/A,N/A,N/A,268,271,N/A,92,3
6,N/A,N/A,N/A,262,268,N/A,95,6
4,N/A,N/A,N/A,258,262,N/A,99,4
3,N/A,N/A,N/A,255,258,N/A,104,3
2,N/A,N/A,N/A,253,255,N/A,108,1
7,N/A,N/A,N/A,246,253,N/A,113,6
4,N/A,N/A,N/A,242,246,N/A,117,4
2,N/A,N/A,N/A,240,242,N/A,120,1
2,N/A,N/A,N/A,238,240,N/A,126,1
3,N/A,N/A,N/A,235,238,N/A,129,4
1,N/A,N/A,N/A,234,235,N/A,132,1
3,N/A,N/A,N/A,1257,1260,N/A,4,3
3,N/A,N/A,N/A,1254,1257,N/A,10,3
7,N/A,N/A,N/A,1247,1254,N/A,13,6
4,N/A,N/A,N/A,1243,1247,N/A,17,4
2,N/A,N/A,N/A,1241,1243,N/A,21,2
6,N/A,N/A,N/A,1235,1241,N/A,25,6
6,N/A,N/A,N/A,1229,1235,N/A,30,5
4,N/A,N/A,N/A,1225,1229,N/A,35,4
4,N/A,N/A,N/A,1221,1225,N/A,41,4
3,N/A,N/A,N/A,1218,1221,N/A,45,2
2,N/A,N/A,N/A,1216,1218,N/A,50,1
1,N/A,N/A,N/A,1215,1216,N/A,56,1
2,N/A,N/A,N/A,1213,1215,N/A,62,1
4,N/A,N/A,N/A,1209,1213,N/A,65,4
2,N/A,N/A,N/A,1207,1209,N/A,69,2
2,N/A,N/A,N/A,1205,1207,N/A,75,2
2,N/A,N/A,N/A,1203,1205,N/A,80,1
2,N/A,N/A,N/A,1201,1203,N/A,86,1
2,N/A,N/A,N/A,1199,1201,N/A,92,1
2,N/A,N/A,N/A,1197,1199,N/A,98,1
6,N/A,N/A,N/A,1191,1197,N/A,103,6
6,N/A,N/A,N/A,1185,1191,N/A,108,5
3,N/A,N/A,N/A,1182,1185,N/A,111,2
5,N/A,N/A,N/A,1177,1182,N/A,114,5
2,N/A,N/A,N/A,1175,1177,N/A,117,2
5,N/A,N/A,N/A,1170,1175,N/A,120,5
3,N/A,N/A,N/A,1167,1170,N/A,125,4
4,N/A,N/A,N/A,1163,1167,N/A,131,4
1,N/A,N/A,N/A,1162,1163,N/A,134,1
2,N/A,N/A,N/A,1160,1162,N/A,140,1
2,N/A,N/A,N/A,644,646,N/A,3,1
6,N/A,N/A,N/A,638,644,N/A,8,6
3,N/A,N/A,N/A,635,638,N/A,11,3
3,N/A,N/A,N/A,632,635,N/A,17,3
2,N/A,N/A,N/A,630,632,N/A,23,3
7,N/A,N/A,N/A,623,630,N/A,26,6
2,N/A,N/A,N/A,621,623,N/A,32,0
3,N/A,N/A,N/A,618,621,N/A,36,4
2,N/A,N/A,N/A,616,618,N/A,40,2
2,N/A,N/A,N/A,614,616,N/A,45,1
1,N/A,N/A,N/A,613,614,N/A,51,1
4,N/A,N/A,N/A,609,613,N/A,54,4
2,N/A,N/A,N/A,607,609,N/A,59,3
3,N/A,N/A,N/A,604,607,N/A,64,2
5,N/A,N/A,N/A,599,604,N/A,67,5
6,N/A,N/A,N/A,593,599,N/A,73,5
5,N/A,N/A,N/A,588,593,N/A,79,5
2,N/A,N/A,N/A,586,588,N/A,82,2
2,N/A,N/A,N/A,584,586,N/A,88,2
2,N/A,N/A,N/A,582,584,N/A,93,1
1,N/A,N/A,N/A,581,582,N/A,99,1
4,N/A,N/A,N/A,577,581,N/A,102,4
3,N/A,N/A,N/A,574,577,N/A,108,4
2,N/A,N/A,N/A,572,574,N/A,112,2
3,N/A,N/A,N/A,569,572,N/A,118,2
6,N/A,N/A,N/A,563,569,N/A,122,6
2,N/A,N/A,N/A,561,563,N/A,128,0
3,N/A,N/A,N/A,558,561,N/A,132,4
2,N/A,N/A,N/A,556,558,N/A,135,1
1,N/A,N/A,N/A,555,556,N/A,141,1
6,N/A,N/A,N/A,510,516,N/A,4,6
5,N/A,N/A,N/A,505,510,N/A,9,5
4,N/A,N/A,N/A,501,505,N/A,14,4
4,N/A,N/A,N/A,497,501,N/A,20,4
2,N/A,N/A,N/A,495,497,N/A,25,3
2,N/A,N/A,N/A,493,495,N/A,30,2
3,N/A,N/A,N/A,490,493,N/A,36,2
3,N/A,N/A,N/A,487,490,N/A,42,2
2,N/A,N/A,N/A,485,487,N/A,47,1
1,N/A,N/A,N/A,484,485,N/A,53,1
6,N/A,N/A,N/A,478,484,N/A,57,5
3,N/A,N/A,N/A,475,478,N/A,61,3
2,N/A,N/A,N/A,473,475,N/A,65,1
5,N/A,N/A,N/A,468,473,N/A,69,5
3,N/A,N/A,N/A,465,468,N/A,73,3
2,N/A,N/A,N/A,463,465,N/A,79,3
2,N/A,N/A,N/A,461,463,N/A,84,2
5,N/A,N/A,N/A,456,461,N/A,87,5
3,N/A,N/A,N/A,453,456,N/A,92,4
4,N/A,N/A,N/A,449,453,N/A,98,4
3,N/A,N/A,N/A,446,449,N/A,104,4
2,N/A,N/A,N/A,444,446,N/A,109,3
1,N/A,N/A,N/A,443,444,N/A,113,1
1,N/A,N/A,N/A,442,443,N/A,119,1
1,N/A,N/A,N/A,441,442,N/A,125,1
2,N/A,N/A,N/A,439,441,N/A,131,1
6,N/A,N/A,N/A,433,439,N/A,135,5
3,N/A,N/A,N/A,430,433,N/A,138,2
7,N/A,N/A,N/A,423,430,N/A,142,6
1,N/A,N/A,N/A,422,423,N/A,148,0
2,N/A,N/A,N/A,1832,1834,N/A,6,3
3,N/A,N/A,N/A,1829,1832,N/A,12,3
6,N/A,N/A,N/A,1823,1829,N/A,15,6
5,N/A,N/A,N/A,1818,1823,N/A,20,5
5,N/A,N/A,N/A,1813,1818,N/A,26,5
3,N/A,N/A,N/A,1810,1813,N/A,29,2
2,N/A,N/A,N/A,1808,1810,N/A,34,1
4,N/A,N/A,N/A,1804,1808,N/A,37,4
3,N/A,N/A,N/A,1801,1804,N/A,43,4
3,N/A,N/A,N/A,1798,1801,N/A,47,2
2,N/A,N/A,N/A,1796,1798,N/A,52,1
4,N/A,N/A,N/A,1792,1796,N/A,55,4
3,N/A,N/A,N/A,1789,1792,N/A,59,2
2,N/A,N/A,N/A,1787,1789,N/A,64,1
4,N/A,N/A,N/A,1783,1787,N/A,67,4
2,N/A,N/A,N/A,1781,1783,N/A,71,2
2,N/A,N/A,N/A,1779,1781,N/A,76,1
1,N/A,N/A,N/A,1778,1779,N/A,82,1
3,N/A,N/A,N/A,1775,1778,N/A,85,4
2,N/A,N/A,N/A,1773,1775,N/A,88,1
6,N/A,N/A,N/A,1767,1773,N/A,93,6
2,N/A,N/A,N/A,1765,1767,N/A,96,3
7,N/A,N/A,N/A,1758,1765,N/A,99,6
3,N/A,N/A,N/A,1755,1758,N/A,103,4
2,N/A,N/A,N/A,1753,1755,N/A,107,2
1,N/A,N/A,N/A,1752,1753,N/A,112,1
3,N/A,N/A,N/A,1749,1752,N/A,115,4
3,N/A,N/A,N/A,1746,1749,N/A,119,2
3,N/A,N/A,N/A,1743,1746,N/A,125,2
5,N/A,N/A,N/A,1738,1743,N/A,128,5
6,N/A,N/A,N/A,356,362,N/A,5,5
3,N/A,N/A,N/A,353,356,N/A,10,4
3,N/A,N/A,N/A,350,353,N/A,16,4
3,N/A,N/A,N/A,347,350,N/A,21,3
3,N/A,N/A,N/A,344,347,N/A,26,2
7,N/A,N/A,N/A,337,344,N/A,30,6
1,N/A,N/A,N/A,336,337,N/A,36,0
7,N/A,N/A,N/A,329,336,N/A,42,6
2,N/A,N/A,N/A,327,329,N/A,48,0
2,N/A,N/A,N/A,325,327,N/A,51,3
7,N/A,N/A,N/A,318,325,N/A,54,6
4,N/A,N/A,N/A,314,318,N/A,58,4
2,N/A,N/A,N/A,312,314,N/A,62,2
6,N/A,N/A,N/A,306,312,N/A,66,6
2,N/A,N/A,N/A,304,306,N/A,72,0
6,N/A,N/A,N/A,298,304,N/A,78,6
4,N/A,N/A,N/A,294,298,N/A,82,4
4,N/A,N/A,N/A,290,294,N/A,88,4
3,N/A,N/A,N/A,287,290,N/A,93,3
6,N/A,N/A,N/A,281,287,N/A,96,6
2,N/A,N/A,N/A,279,281,N/A,102,0
7,N/A,N/A,N/A,272,279,N/A,108,6
5,N/A,N/A,N/A,267,272,N/A,113,5
3,N/A,N/A,N/A,264,267,N/A,117,3
2,N/A,N/A,N/A,262,264,N/A,122,2
3,N/A,N/A,N/A,259,262,N/A,128,2
2,N/A,N/A,N/A,257,259,N/A,134,2
7,N/A,N/A,N/A,250,257,N/A,138,6
4,N/A,N/A,N/A,246,250,N/A,142,4
1,N/A,N/A,N/A,245,246,N/A,145,1
3,N/A,N/A,N/A,1609,1612,N/A,6,4
2,N/A,N/A,N/A,1607,1609,N/A,9,1
2,N/A,N/A,N/A,1605,1607,N/A,15,1
7,N/A,N/A,N/A,1598,1605,N/A,20,6
3,N/A,N/A,N/A,1595,1598,N/A,24,4
1,N/A,N/A,N/A,1594,1595,N/A,27,1
5,N/A,N/A,N/A,1589,1594,N/A,31,5
6,N/A,N/A,N/A,1583,1589,N/A,37,5
3,N/A,N/A,N/A,1580,1583,N/A,42,4
2,N/A,N/A,N/A,1578,1580,N/A,45,1
2,N/A,N/A,N/A,1576,1578,N/A,51,1
5,N/A,N/A,N/A,1571,1576,N/A,55,5
2,N/A,N/A,N/A,1569,1571,N/A,58,2
2,N/A,N/A,N/A,1567,1569,N/A,64,2
7,N/A,N/A,N/A,1560,1567,N/A,68,6
4,N/A,N/A,N/A,1556,1560,N/A,72,4
3,N/A,N/A,N/A,1553,1556,N/A,76,2
2,N/A,N/A,N/A,1551,1553,N/A,81,1
2,N/A,N/A,N/A,1549,1551,N/A,87,1
1,N/A,N/A,N/A,1548,1549,N/A,93,1
6,N/A,N/A,N/A,1542,1548,N/A,97,5
5,N/A,N/A,N/A,1537,1542,N/A,103,5
3,N/A,N/A,N/A,1534,1537,N/A,107,3
2,N/A,N/A,N/A,1532,1534,N/A,112,2
6,N/A,N/A,N/A,1526,1532,N/A,115,5
6,N/A,N/A,N/A,1520,1526,N/A,121,5
2,N/A,N/A,N/A,1518,1520,N/A,124,2
7,N/A,N/A,N/A,1511,1518,N/A,128,6
5,N/A,N/A,N/A,1506,1511,N/A,133,5
2,N/A,N/A,N/A,1504,1506,N/A,137,3
6,N/A,N/A,N/A,419,425,N/A,6,5
3,N/A,N/A,N/A,416,419,N/A,9,2
3,N/A,N/A,N/A,413,416,N/A,15,2
6,N/A,N/A,N/A,407,413,N/A,19,6
4,N/A,N/A,N/A,403,407,N/A,23,4
2,N/A,N/A,N/A,401,403,N/A,28,3
1,N/A,N/A,N/A,400,401,N/A,32,1
7,N/A,N/A,N/A,393,400,N/A,37,6
3,N/A,N/A,N/A,390,393,N/A,41,4
3,N/A,N/A,N/A,387,390,N/A,47,4
2,N/A,N/A,N/A,385,387,N/A,50,1
5,N/A,N/A,N/A,380,385,N/A,54,5
6,N/A,N/A,N/A,374,380,N/A,60,5
3,N/A,N/A,N/A,371,374,N/A,64,3
2,N/A,N/A,N/A,369,371,N/A,70,3
1,N/A,N/A,N/A,368,369,N/A,74,1
5,N/A,N/A,N/A,363,368,N/A,78,5
3,N/A,N/A,N/A,360,363,N/A,82,3
3,N/A,N/A,N/A,357,360,N/A,88,3
3,N/A,N/A,N/A,354,357,N/A,94,3
2,N/A,N/A,N/A,352,354,N/A,99,2
2,N/A,N/A,N/A,350,352,N/A,104,1
6,N/A,N/A,N/A,344,350,N/A,109,6
3,N/A,N/A,N/A,341,344,N/A,112,3
3,N/A,N/A,N/A,338,341,N/A,118,3
3,N/A,N/A,N/A,335,338,N/A,124,3
3,N/A,N/A,N/A,332,335,N/A,130,3
1,N/A,N/A,N/A,331,332,N/A,134,1
6,N/A,N/A,N/A,325,331,N/A,138,5
6,N/A,N/A,N/A,319,325,N/A,144,5
4,N/A,N/A,N/A,1087,1091,N/A,3,4
2,N/A,N/A,N/A,1085,1087,N/A,6,1
5,N/A,N/A,N/A,1080,1085,N/A,10,5
6,N/A,N/A,N/A,1074,1080,N/A,16,5
3,N/A,N/A,N/A,1071,1074,N/A,19,2
7,N/A,N/A,N/A,1064,1071,N/A,23,6
1,N/A,N/A,N/A,1063,1064,N/A,29,0
5,N/A,N/A,N/A,1058,1063,N/A,34,5
2,N/A,N/A,N/A,1056,1058,N/A,37,2
6,N/A,N/A,N/A,1050,1056,N/A,40,5
2,N/A,N/A,N/A,1048,1050,N/A,44,3
1,N/A,N/A,N/A,1047,1048,N/A,48,1
4,N/A,N/A,N/A,1043,1047,N/A,51,4
4,N/A,N/A,N/A,1039,1043,N/A,57,4
3,N/A,N/A,N/A,1036,1039,N/A,61,2
1,N/A,N/A,N/A,1035,1036,N/A,66,1
5,N/A,N/A,N/A,1030,1035,N/A,70,5
6,N/A,N/A,N/A,1024,1030,N/A,76,5
2,N/A,N/A,N/A,1022,1024,N/A,80,3
1,N/A,N/A,N/A,1021,1022,N/A,84,1
6,N/A,N/A,N/A,1015,1021,N/A,88,5
3,N/A,N/A,N/A,1012,1015,N/A,92,3
2,N/A,N/A,N/A,1010,1012,N/A,96,1
5,N/A,N/A,N/A,1005,1010,N/A,100,5
5,N/A,N/A,N/A,1000,1005,N/A,106,5
3,N/A,N/A,N/A,997,1000,N/A,111,4
4,N/A,N/A,N/A,993,997,N/A,117,4
2,N/A,N/A,N/A,991,993,N/A,120,1
1,N/A,N/A,N/A,990,991,N/A,126,1
3,N/A,N/A,N/A,987,990,N/A,129,4
3,N/A,N/A,N/A,1738,1741,N/A,6,4
1,N/A,N/A,N/A,1737,1738,N/A,9,1
7,N/A,N/A,N/A,1730,1737,N/A,14,6
1,N/A,N/A,N/A,1729,1730,N/A,20,0
2,N/A,N/A,N/A,1727,1729,N/A,23,3
1,N/A,N/A,N/A,1726,1727,N/A,27,1
3,N/A,N/A,N/A,1723,1726,N/A,30,4
3,N/A,N/A,N/A,1720,1723,N/A,34,2
5,N/A,N/A,N/A,1715,1720,N/A,37,5
2,N/A,N/A,N/A,1713,1715,N/A,41,3
3,N/A,N/A,N/A,1710,1713,N/A,46,2
2,N/A,N/A,N/A,1708,1710,N/A,52,2
6,N/A,N/A,N/A,1702,1708,N/A,56,6
1,N/A,N/A,N/A,1701,1702,N/A,62,0
6,N/A,N/A,N/A,1695,1701,N/A,68,6
6,N/A,N/A,N/A,1689,1695,N/A,73,5
3,N/A,N/A,N/A,1686,1689,N/A,78,4
2,N/A,N/A,N/A,1684,1686,N/A,83,3
7,N/A,N/A,N/A,1677,1684,N/A,86,6
4,N/A,N/A,N/A,1673,1677,N/A,90,4
3,N/A,N/A,N/A,1670,1673,N/A,94,2
2,N/A,N/A,N/A,1668,1670,N/A,100,2
6,N/A,N/A,N/A,1662,1668,N/A,103,5
6,N/A,N/A,N/A,1656,1662,N/A,109,5
3,N/A,N/A,N/A,1653,1656,N/A,112,2
7,N/A,N/A,N/A,1646,1653,N/A,116,6
3,N/A,N/A,N/A,1643,1646,N/A,119,3
7,N/A,N/A,N/A,1636,1643,N/A,122,6
4,N/A,N/A,N/A,1632,1636,N/A,126,4
3,N/A,N/A,N/A,1629,1632,N/A,130,2
2,N/A,N/A,N/A,692,694,N/A,4,3
7,N/A,N/A,N/A,685,692,N/A,7,6
4,N/A,N/A,N/A,681,685,N/A,11,4
3,N/A,N/A,N/A,678,681,N/A,15,2
5,N/A,N/A,N/A,673,678,N/A,18,5
4,N/A,N/A,N/A,669,673,N/A,23,4
3,N/A,N/A,N/A,666,669,N/A,27,2
6,N/A,N/A,N/A,660,666,N/A,30,5
2,N/A,N/A,N/A,658,660,N/A,33,2
2,N/A,N/A,N/A,656,658,N/A,38,1
5,N/A,N/A,N/A,651,656,N/A,42,5
2,N/A,N/A,N/A,649,651,N/A,46,3
2,N/A,N/A,N/A,647,649,N/A,52,3
6,N/A,N/A,N/A,641,647,N/A,55,6
3,N/A,N/A,N/A,638,641,N/A,58,3
3,N/A,N/A,N/A,635,638,N/A,64,3
3,N/A,N/A,N/A,632,635,N/A,70,3
2,N/A,N/A,N/A,630,632,N/A,75,2
7,N/A,N/A,N/A,623,630,N/A,79,6
4,N/A,N/A,N/A,619,623,N/A,83,4
1,N/A,N/A,N/A,618,619,N/A,86,1
7,N/A,N/A,N/A,611,618,N/A,91,6
6,N/A,N/A,N/A,605,611,N/A,96,5
6,N/A,N/A,N/A,599,605,N/A,102,5
2,N/A,N/A,N/A,597,599,N/A,105,2
5,N/A,N/A,N/A,592,597,N/A,108,5
3,N/A,N/A,N/A,589,592,N/A,112,3
6,N/A,N/A,N/A,583,589,N/A,115,6
6,N/A,N/A,N/A,577,583,N/A,120,5
5,N/A,N/A,N/A,572,577,N/A,126,5
4,N/A,N/A,N/A,726,730,N/A,5,4
2,N/A,N/A,N/A,724,726,N/A,8,1
2,N/A,N/A,N/A,722,724,N/A,14,1
4,N/A,N/A,N/A,718,722,N/A,17,4
4,N/A,N/A,N/A,714,718,N/A,23,4
3,N/A,N/A,N/A,711,714,N/A,28,3
3,N/A,N/A,N/A,708,711,N/A,33,2
6,N/A,N/A,N/A,702,708,N/A,37,6
2,N/A,N/A,N/A,700,702,N/A,40,3
3,N/A,N/A,N/A,697,700,N/A,46,3
6,N/A,N/A,N/A,691,697,N/A,49,6
2,N/A,N/A,N/A,689,691,N/A,52,3
2,N/A,N/A,N/A,687,689,N/A,57,2
2,N/A,N/A,N/A,685,687,N/A,63,2
3,N/A,N/A,N/A,682,685,N/A,69,2
2,N/A,N/A,N/A,680,682,N/A,75,2
6,N/A,N/A,N/A,674,680,N/A,78,5
3,N/A,N/A,N/A,671,674,N/A,83,4
3,N/A,N/A,N/A,668,671,N/A,89,4
3,N/A,N/A,N/A,665,668,N/A,95,4
3,N/A,N/A,N/A,662,665,N/A,99,2
2,N/A,N/A,N/A,660,662,N/A,105,2
5,N/A,N/A,N/A,655,660,N/A,108,5
4,N/A,N/A,N/A,651,655,N/A,113,4
2,N/A,N/A,N/A,649,651,N/A,117,2
2,N/A,N/A,N/A,647,649,N/A,122,1
6,N/A,N/A,N/A,641,647,N/A,126,5
4,N/A,N/A,N/A,637,641,N/A,131,4
3,N/A,N/A,N/A,634,637,N/A,136,3
2,N/A,N/A,N/A,632,634,N/A,142,3
7,N/A,N/A,N/A,562,569,N/A,4,6
3,N/A,N/A,N/A,559,562,N/A,7,3
3,N/A,N/A,N/A,556,559,N/A,12,2
2,N/A,N/A,N/A,554,556,N/A,18,2
2,N/A,N/A,N/A,552,554,N/A,23,1
5,N/A,N/A,N/A,547,552,N/A,27,5
4,N/A,N/A,N/A,543,547,N/A,32,4
3,N/A,N/A,N/A,540,543,N/A,37,3
2,N/A,N/A,N/A,538,540,N/A,41,1
6,N/A,N/A,N/A,532,538,N/A,45,5
5,N/A,N/A,N/A,527,532,N/A,51,5
2,N/A,N/A,N/A,525,527,N/A,55,3
2,N/A,N/A,N/A,523,525,N/A,59,1
6,N/A,N/A,N/A,517,523,N/A,63,5
2,N/A,N/A,N/A,515,517,N/A,66,2
1,N/A,N/A,N/A,514,515,N/A,71,1
5,N/A,N/A,N/A,509,514,N/A,75,5
5,N/A,N/A,N/A,504,509,N/A,81,5
3,N/A,N/A,N/A,501,504,N/A,84,2
7,N/A,N/A,N/A,494,501,N/A,88,6
4,N/A,N/A,N/A,490,494,N/A,92,4
2,N/A,N/A,N/A,488,490,N/A,95,1
7,N/A,N/A,N/A,481,488,N/A,100,6
1,N/A,N/A,N/A,480,481,N/A,106,0
4,N/A,N/A,N/A,476,480,N/A,110,4
4,N/A,N/A,N/A,472,476,N/A,116,4
2,N/A,N/A,N/A,470,472,N/A,121,3
7,N/A,N/A,N/A,463,470,N/A,124,6
2,N/A,N/A,N/A,461,463,N/A,130,0
6,N/A,N/A,N/A,455,461,N/A,136,6
2,N/A,N/A,N/A,1448,1450,N/A,6,2
1,N/A,N/A,N/A,1447,1448,N/A,11,1
5,N/A,N/A,N/A,1442,1447,N/A,15,5
2,N/A,N/A,N/A,1440,1442,N/A,18,2
1,N/A,N/A,N/A,1439,1440,N/A,23,1
5,N/A,N/A,N/A,1434,1439,N/A,27,5
2,N/A,N/A,N/A,1432,1434,N/A,31,3
6,N/A,N/A,N/A,1426,1432,N/A,34,6
2,N/A,N/A,N/A,1424,1426,N/A,40,0
3,N/A,N/A,N/A,1421,1424,N/A,43,3
2,N/A,N/A,N/A,1419,1421,N/A,49,3
2,N/A,N/A,N/A,1417,1419,N/A,53,1
6,N/A,N/A,N/A,1411,1417,N/A,57,5
4,N/A,N/A,N/A,1407,1411,N/A,62,4
3,N/A,N/A,N/A,1404,1407,N/A,67,3
1,N/A,N/A,N/A,1403,1404,N/A,71,1
6,N/A,N/A,N/A,1397,1403,N/A,75,5
4,N/A,N/A,N/A,1393,1397,N/A,80,4
2,N/A,N/A,N/A,1391,1393,N/A,84,2
2,N/A,N/A,N/A,1389,1391,N/A,90,2
5,N/A,N/A,N/A,1384,1389,N/A,93,5
6,N/A,N/A,N/A,1378,1384,N/A,99,5
3,N/A,N/A,N/A,1375,1378,N/A,104,4
2,N/A,N/A,N/A,1373,1375,N/A,107,1
2,N/A,N/A,N/A,1371,1373,N/A,113,1
4,N/A,N/A,N/A,1367,1371,N/A,116,4
3,N/A,N/A,N/A,1364,1367,N/A,120,2
2,N/A,N/A,N/A,1362,1364,N/A,125,1
5,N/A,N/A,N/A,1357,1362,N/A,129,5
2,N/A,N/A,N/A,1355,1357,N/A,133,3
3,N/A,N/A,N/A,612,615,N/A,3,2
5,N/A,N/A,N/A,607,612,N/A,6,5
3,N/A,N/A,N/A,604,607,N/A,9,2
1,N/A,N/A,N/A,603,604,N/A,14,1
1,N/A,N/A,N/A,602,603,N/A,20,1
7,N/A,N/A,N/A,595,602,N/A,25,6
5,N/A,N/A,N/A,590,595,N/A,30,5
2,N/A,N/A,N/A,588,590,N/A,33,2
6,N/A,N/A,N/A,582,588,N/A,37,6
3,N/A,N/A,N/A,579,582,N/A,41,4
2,N/A,N/A,N/A,577,579,N/A,45,2
7,N/A,N/A,N/A,570,577,N/A,49,6
2,N/A,N/A,N/A,568,570,N/A,52,3
7,N/A,N/A,N/A,561,568,N/A,55,6
1,N/A,N/A,N/A,560,561,N/A,61,0
4,N/A,N/A,N/A,556,560,N/A,65,4
3,N/A,N/A,N/A,553,556,N/A,69,2
2,N/A,N/A,N/A,551,553,N/A,74,1
5,N/A,N/A,N/A,546,551,N/A,78,5
3,N/A,N/A,N/A,543,546,N/A,83,4
2,N/A,N/A,N/A,541,543,N/A,86,1
1,N/A,N/A,N/A,540,541,N/A,92,1
4,N/A,N/A,N/A,536,540,N/A,95,4
3,N/A,N/A,N/A,533,536,N/A,101,4
2,N/A,N/A,N/A,531,533,N/A,104,1
5,N/A,N/A,N/A,526,531,N/A,108,5
3,N/A,N/A,N/A,523,526,N/A,112,3
3,N/A,N/A,N/A,520,523,N/A,118,3
2,N/A,N/A,N/A,518,520,N/A,124,3
7,N/A,N/A,N/A,511,518,N/A,127,6
2,N/A,N/A,N/A,1154,1156,N/A,5,2
6,N/A,N/A,N/A,1148,1154,N/A,8,5
2,N/A,N/A,N/A,1146,1148,N/A,12,3
3,N/A,N/A,N/A,1143,1146,N/A,18,3
7,N/A,N/A,N/A,1136,1143,N/A,21,6
6,N/A,N/A,N/A,1130,1136,N/A,26,5
5,N/A,N/A,N/A,1125,1130,N/A,32,5
2,N/A,N/A,N/A,1123,1125,N/A,35,2
3,N/A,N/A,N/A,1120,1123,N/A,41,2
1,N/A,N/A,N/A,1119,1120,N/A,46,1
6,N/A,N/A,N/A,1113,1119,N/A,51,6
2,N/A,N/A,N/A,1111,1113,N/A,57,0
3,N/A,N/A,N/A,1108,1111,N/A,60,3
2,N/A,N/A,N/A,1106,1108,N/A,64,1
3,N/A,N/A,N/A,1103,1106,N/A,67,4
3,N/A,N/A,N/A,1100,1103,N/A,71,2
6,N/A,N/A,N/A,1094,1100,N/A,75,6
3,N/A,N/A,N/A,1091,1094,N/A,78,3
3,N/A,N/A,N/A,1088,1091,N/A,83,2
6,N/A,N/A,N/A,1082,1088,N/A,86,5
6,N/A,N/A,N/A,1076,1082,N/A,92,5
6,N/A,N/A,N/A,1070,1076,N/A,98,5
4,N/A,N/A,N/A,1066,1070,N/A,103,4
2,N/A,N/A,N/A,1064,1066,N/A,107,2
6,N/A,N/A,N/A,1058,1064,N/A,110,5
3,N/A,N/A,N/A,1055,1058,N/A,113,2
6,N/A,N/A,N/A,1049,1055,N/A,117,6
5,N/A,N/A,N/A,1044,1049,N/A,122,5
4,N/A,N/A,N/A,1040,1044,N/A,127,4
2,N/A,N/A,N/A,1038,1040,N/A,130,1
7,N/A,N/A,N/A,1614,1621,N/A,6,6
6,N/A,N/A,N/A,1608,1614,N/A,11,5
5,N/A,N/A,N/A,1603,1608,N/A,17,5
5,N/A,N/A,N/A,1598,1603,N/A,23,5
3,N/A,N/A,N/A,1595,1598,N/A,27,3
6,N/A,N/A,N/A,1589,1595,N/A,30,6
6,N/A,N/A,N/A,1583,1589,N/A,35,5
3,N/A,N/A,N/A,1580,1583,N/A,38,2
1,N/A,N/A,N/A,1579,1580,N/A,43,1
7,N/A,N/A,N/A,1572,1579,N/A,48,6
3,N/A,N/A,N/A,1569,1572,N/A,52,4
2,N/A,N/A,N/A,1567,1569,N/A,55,1
4,N/A,N/A,N/A,1563,1567,N/A,58,4
3,N/A,N/A,N/A,1560,1563,N/A,62,2
6,N/A,N/A,N/A,1554,1560,N/A,65,5
3,N/A,N/A,N/A,1551,1554,N/A,69,3
1,N/A,N/A,N/A,1550,1551,N/A,73,1
1,N/A,N/A,N/A,1549,1550,N/A,79,1
1,N/A,N/A,N/A,1548,1549,N/A,85,1
7,N/A,N/A,N/A,1541,1548,N/A,90,6
3,N/A,N/A,N/A,1538,1541,N/A,93,3
2,N/A,N/A,N/A,1536,1538,N/A,99,3
3,N/A,N/A,N/A,1533,1536,N/A,104,2
7,N/A,N/A,N/A,1526,1533,N/A,108,6
2,N/A,N/A,N/A,1524,1526,N/A,114,0
3,N/A,N/A,N/A,1521,1524,N/A,118,4
4,N/A,N/A,N/A,1517,1521,N/A,124,4
4,N/A,N/A,N/A,1513,1517,N/A,130,4
2,N/A,N/A,N/A,1511,1513,N/A,134,2
3,N/A,N/A,N/A,1508,1511,N/A,140,2
6,N/A,N/A,N/A,611,617,N/A,6,5
6,N/A,N/A,N/A,605,611,N/A,12,5
3,N/A,N/A,N/A,602,605,N/A,17,4
1,N/A,N/A,N/A,601,602,N/A,20,1
4,N/A,N/A,N/A,597,601,N/A,23,4
3,N/A,N/A,N/A,594,597,N/A,28,3
3,N/A,N/A,N/A,591,594,N/A,33,2
3,N/A,N/A,N/A,588,591,N/A,39,2
3,N/A,N/A,N/A,585,588,N/A,45,2
2,N/A,N/A,N/A,583,585,N/A,50,1
3,N/A,N/A,N/A,580,583,N/A,53,4
3,N/A,N/A,N/A,577,580,N/A,58,3
3,N/A,N/A,N/A,574,577,N/A,64,3
2,N/A,N/A,N/A,572,574,N/A,68,1
1,N/A,N/A,N/A,571,572,N/A,74,1
6,N/A,N/A,N/A,565,571,N/A,79,6
1,N/A,N/A,N/A,564,565,N/A,85,0
6,N/A,N/A,N/A,558,564,N/A,91,6
6,N/A,N/A,N/A,552,558,N/A,96,5
5,N/A,N/A,N/A,547,552,N/A,102,5
2,N/A,N/A,N/A,545,547,N/A,105,2
1,N/A,N/A,N/A,544,545,N/A,110,1
1,N/A,N/A,N/A,543,544,N/A,116,1
6,N/A,N/A,N/A,537,543,N/A,121,6
6,N/A,N/A,N/A,531,537,N/A,126,5
5,N/A,N/A,N/A,526,531,N/A,132,5
5,N/A,N/A,N/A,521,526,N/A,138,5
2,N/A,N/A,N/A,519,521,N/A,141,2
7,N/A,N/A,N/A,512,519,N/A,145,6
1,N/A,N/A,N/A,511,512,N/A,151,0
3,N/A,N/A,N/A,1165,1168,N/A,5,2
6,N/A,N/A,N/A,1159,1165,N/A,8,5
5,N/A,N/A,N/A,1154,1159,N/A,14,5
3,N/A,N/A,N/A,1151,1154,N/A,19,4
4,N/A,N/A,N/A,1147,1151,N/A,25,4
3,N/A,N/A,N/A,1144,1147,N/A,31,4
3,N/A,N/A,N/A,1141,1144,N/A,37,4
3,N/A,N/A,N/A,1138,1141,N/A,42,3
6,N/A,N/A,N/A,1132,1138,N/A,45,6
6,N/A,N/A,N/A,1126,1132,N/A,50,5
3,N/A,N/A,N/A,1123,1126,N/A,53,2
6,N/A,N/A,N/A,1117,1123,N/A,57,6
1,N/A,N/A,N/A,1116,1117,N/A,63,0
7,N/A,N/A,N/A,1109,1116,N/A,69,6
1,N/A,N/A,N/A,1108,1109,N/A,75,0
7,N/A,N/A,N/A,1101,1108,N/A,81,6
1,N/A,N/A,N/A,1100,1101,N/A,87,0
7,N/A,N/A,N/A,1093,1100,N/A,93,6
1,N/A,N/A,N/A,1092,1093,N/A,99,0
6,N/A,N/A,N/A,1086,1092,N/A,104,5
3,N/A,N/A,N/A,1083,1086,N/A,108,3
6,N/A,N/A,N/A,1077,1083,N/A,111,6
2,N/A,N/A,N/A,1075,1077,N/A,114,3
6,N/A,N/A,N/A,1069,1075,N/A,117,6
3,N/A,N/A,N/A,1066,1069,N/A,120,3
6,N/A,N/A,N/A,1060,1066,N/A,123,6
2,N/A,N/A,N/A,1058,1060,N/A,126,3
7,N/A,N/A,N/A,1051,1058,N/A,129,6
2,N/A,N/A,N/A,1049,1051,N/A,132,3
2,N/A,N/A,N/A,1047,1049,N/A,136,1
3,N/A,N/A,N/A,919,922,N/A,4,2
6,N/A,N/A,N/A,913,919,N/A,8,6
4,N/A,N/A,N/A,909,913,N/A,12,4
3,N/A,N/A,N/A,906,909,N/A,16,2
1,N/A,N/A,N/A,905,906,N/A,21,1
6,N/A,N/A,N/A,899,905,N/A,25,5
2,N/A,N/A,N/A,897,899,N/A,28,2
6,N/A,N/A,N/A,891,897,N/A,32,6
2,N/A,N/A,N/A,889,891,N/A,38,0
6,N/A,N/A,N/A,883,889,N/A,44,6
3,N/A,N/A,N/A,880,883,N/A,47,3
7,N/A,N/A,N/A,873,880,N/A,50,6
3,N/A,N/A,N/A,870,873,N/A,54,4
2,N/A,N/A,N/A,868,870,N/A,57,1
3,N/A,N/A,N/A,865,868,N/A,60,4
2,N/A,N/A,N/A,863,865,N/A,63,1
1,N/A,N/A,N/A,862,863,N/A,69,1
7,N/A,N/A,N/A,855,862,N/A,74,6
4,N/A,N/A,N/A,851,855,N/A,78,4
4,N/A,N/A,N/A,847,851,N/A,84,4
3,N/A,N/A,N/A,844,847,N/A,88,2
7,N/A,N/A,N/A,837,844,N/A,92,6
5,N/A,N/A,N/A,832,837,N/A,97,5
5,N/A,N/A,N/A,827,832,N/A,103,5
5,N/A,N/A,N/A,822,827,N/A,109,5
3,N/A,N/A,N/A,819,822,N/A,114,4
3,N/A,N/A,N/A,816,819,N/A,119,3
7,N/A,N/A,N/A,809,816,N/A,122,6
3,N/A,N/A,N/A,806,809,N/A,126,4
4,N/A,N/A,N/A,802,806,N/A,132,4
1,N/A,N/A,N/A,1013,1014,N/A,4,1
6,N/A,N/A,N/A,1007,1013,N/A,9,6
4,N/A,N/A,N/A,1003,1007,N/A,13,4
4,N/A,N/A,N/A,999,1003,N/A,19,4
3,N/A,N/A,N/A,996,999,N/A,23,2
1,N/A,N/A,N/A,995,996,N/A,28,1
4,N/A,N/A,N/A,991,995,N/A,31,4
1,N/A,N/A,N/A,990,991,N/A,34,1
4,N/A,N/A,N/A,986,990,N/A,37,4
1,N/A,N/A,N/A,985,986,N/A,40,1
3,N/A,N/A,N/A,982,985,N/A,43,4
3,N/A,N/A,N/A,979,982,N/A,48,3
6,N/A,N/A,N/A,973,979,N/A,51,6
6,N/A,N/A,N/A,967,973,N/A,56,5
6,N/A,N/A,N/A,961,967,N/A,62,5
2,N/A,N/A,N/A,959,961,N/A,65,2
3,N/A,N/A,N/A,956,959,N/A,71,2
5,N/A,N/A,N/A,951,956,N/A,74,5
2,N/A,N/A,N/A,949,951,N/A,78,3
2,N/A,N/A,N/A,947,949,N/A,84,3
2,N/A,N/A,N/A,945,947,N/A,89,2
6,N/A,N/A,N/A,939,945,N/A,93,6
2,N/A,N/A,N/A,937,939,N/A,99,0
3,N/A,N/A,N/A,934,937,N/A,103,4
3,N/A,N/A,N/A,931,934,N/A,109,4
4,N/A,N/A,N/A,927,931,N/A,115,4
3,N/A,N/A,N/A,924,927,N/A,119,2
1,N/A,N/A,N/A,923,924,N/A,124,1
6,N/A,N/A,N/A,917,923,N/A,128,5
5,N/A,N/A,N/A,912,917,N/A,134,5
2,N/A,N/A,N/A,1535,1537,N/A,4,3
2,N/A,N/A,N/A,1533,1535,N/A,10,3
2,N/A,N/A,N/A,1531,1533,N/A,14,1
5,N/A,N/A,N/A,1526,1531,N/A,18,5
3,N/A,N/A,N/A,1523,1526,N/A,23,4
4,N/A,N/A,N/A,1519,1523,N/A,29,4
2,N/A,N/A,N/A,1517,1519,N/A,33,2
2,N/A,N/A,N/A,1515,1517,N/A,39,2
7,N/A,N/A,N/A,1508,1515,N/A,43,6
1,N/A,N/A,N/A,1507,1508,N/A,49,0
6,N/A,N/A,N/A,1501,1507,N/A,55,6
4,N/A,N/A,N/A,1497,1501,N/A,59,4
3,N/A,N/A,N/A,1494,1497,N/A,64,3
3,N/A,N/A,N/A,1491,1494,N/A,69,2
2,N/A,N/A,N/A,1489,1491,N/A,74,1
4,N/A,N/A,N/A,1485,1489,N/A,77,4
2,N/A,N/A,N/A,1483,1485,N/A,82,3
2,N/A,N/A,N/A,1481,1483,N/A,86,1
1,N/A,N/A,N/A,1480,1481,N/A,92,1
5,N/A,N/A,N/A,1475,1480,N/A,96,5
3,N/A,N/A,N/A,1472,1475,N/A,99,2
6,N/A,N/A,N/A,1466,1472,N/A,102,5
4,N/A,N/A,N/A,1462,1466,N/A,107,4
2,N/A,N/A,N/A,1460,1462,N/A,112,3
6,N/A,N/A,N/A,1454,1460,N/A,115,6
1,N/A,N/A,N/A,1453,1454,N/A,121,0
2,N/A,N/A,N/A,1451,1453,N/A,124,3
3,N/A,N/A,N/A,1448,1451,N/A,129,2
1,N/A,N/A,N/A,1447,1448,N/A,134,1
6,N/A,N/A,N/A,1441,1447,N/A,139,6
3,N/A,N/A,N/A,862,865,N/A,6,2
6,N/A,N/A,N/A,856,862,N/A,9,5
4,N/A,N/A,N/A,852,856,N/A,14,4
4,N/A,N/A,N/A,848,852,N/A,20,4
3,N/A,N/A,N/A,845,848,N/A,26,4
3,N/A,N/A,N/A,842,845,N/A,32,4
3,N/A,N/A,N/A,839,842,N/A,36,2
1,N/A,N/A,N/A,838,839,N/A,41,1
2,N/A,N/A,N/A,836,838,N/A,47,1
5,N/A,N/A,N/A,831,836,N/A,51,5
3,N/A,N/A,N/A,828,831,N/A,55,3
2,N/A,N/A,N/A,826,828,N/A,60,2
2,N/A,N/A,N/A,824,826,N/A,65,1
1,N/A,N/A,N/A,823,824,N/A,71,1
3,N/A,N/A,N/A,820,823,N/A,74,4
3,N/A,N/A,N/A,817,820,N/A,80,4
3,N/A,N/A,N/A,814,817,N/A,84,2
1,N/A,N/A,N/A,813,814,N/A,89,1
6,N/A,N/A,N/A,807,813,N/A,94,6
3,N/A,N/A,N/A,804,807,N/A,98,4
2,N/A,N/A,N/A,802,804,N/A,102,2
6,N/A,N/A,N/A,796,802,N/A,105,5
3,N/A,N/A,N/A,793,796,N/A,109,3
3,N/A,N/A,N/A,790,793,N/A,115,3
7,N/A,N/A,N/A,783,790,N/A,118,6
2,N/A,N/A,N/A,781,783,N/A,124,0
4,N/A,N/A,N/A,777,781,N/A,128,4
2,N/A,N/A,N/A,775,777,N/A,133,3
2,N/A,N/A,N/A,773,775,N/A,139,3
3,N/A,N/A,N/A,770,773,N/A,145,3
6,N/A,N/A,N/A,1038,1044,N/A,6,6
1,N/A,N/A,N/A,1037,1038,N/A,12,0
4,N/A,N/A,N/A,1033,1037,N/A,16,4
3,N/A,N/A,N/A,1030,1033,N/A,21,3
7,N/A,N/A,N/A,1023,1030,N/A,24,6
2,N/A,N/A,N/A,1021,1023,N/A,27,3
2,N/A,N/A,N/A,1019,1021,N/A,32,2
2,N/A,N/A,N/A,1017,1019,N/A,38,2
5,N/A,N/A,N/A,1012,1017,N/A,41,5
4,N/A,N/A,N/A,1008,1012,N/A,46,4
2,N/A,N/A,N/A,1006,1008,N/A,49,1
5,N/A,N/A,N/A,1001,1006,N/A,53,5
6,N/A,N/A,N/A,995,1001,N/A,59,5
3,N/A,N/A,N/A,992,995,N/A,64,4
1,N/A,N/A,N/A,991,992,N/A,67,1
4,N/A,N/A,N/A,987,991,N/A,70,4
4,N/A,N/A,N/A,983,987,N/A,76,4
3,N/A,N/A,N/A,980,983,N/A,80,2
3,N/A,N/A,N/A,977,980,N/A,86,2
7,N/A,N/A,N/A,970,977,N/A,90,6
2,N/A,N/A,N/A,968,970,N/A,96,0
3,N/A,N/A,N/A,965,968,N/A,99,3
2,N/A,N/A,N/A,963,965,N/A,105,3
3,N/A,N/A,N/A,960,963,N/A,111,3
1,N/A,N/A,N/A,959,960,N/A,115,1
1,N/A,N/A,N/A,958,959,N/A,121,1
1,N/A,N/A,N/A,957,958,N/A,127,1
4,N/A,N/A,N/A,953,957,N/A,130,4
2,N/A,N/A,N/A,951,953,N/A,135,3
2,N/A,N/A,N/A,949,951,N/A,141,3
6,N/A,N/A,N/A,883,889,N/A,3,5
6,N/A,N/A,N/A,877,883,N/A,9,5
3,N/A,N/A,N/A,874,877,N/A,12,2
6,N/A,N/A,N/A,868,874,N/A,15,5
4,N/A,N/A,N/A,864,868,N/A,20,4
3,N/A,N/A,N/A,861,864,N/A,25,3
3,N/A,N/A,N/A,858,861,N/A,31,3
6,N/A,N/A,N/A,852,858,N/A,34,6
1,N/A,N/A,N/A,851,852,N/A,40,0
6,N/A,N/A,N/A,845,851,N/A,45,5
3,N/A,N/A,N/A,842,845,N/A,50,4
3,N/A,N/A,N/A,839,842,N/A,55,3
3,N/A,N/A,N/A,836,839,N/A,61,3
6,N/A,N/A,N/A,830,836,N/A,64,6
4,N/A,N/A,N/A,826,830,N/A,68,4
3,N/A,N/A,N/A,823,826,N/A,72,2
6,N/A,N/A,N/A,817,823,N/A,76,6
2,N/A,N/A,N/A,815,817,N/A,82,0
3,N/A,N/A,N/A,812,815,N/A,86,4
3,N/A,N/A,N/A,809,812,N/A,90,2
2,N/A,N/A,N/A,807,809,N/A,95,1
7,N/A,N/A,N/A,800,807,N/A,100,6
1,N/A,N/A,N/A,799,800,N/A,106,0
7,N/A,N/A,N/A,792,799,N/A,112,6
2,N/A,N/A,N/A,790,792,N/A,115,3
7,N/A,N/A,N/A,783,790,N/A,118,6
3,N/A,N/A,N/A,780,783,N/A,121,3
6,N/A,N/A,N/A,774,780,N/A,124,6
4,N/A,N/A,N/A,770,774,N/A,128,4
4,N/A,N/A,N/A,766,770,N/A,134,4
5,N/A,N/A,N/A,1166,1171,N/A,6,5
6,N/A,N/A,N/A,1160,1166,N/A,12,5
3,N/A,N/A,N/A,1157,1160,N/A,15,2
2,N/A,N/A,N/A,1155,1157,N/A,20,1
4,N/A,N/A,N/A,1151,1155,N/A,23,4
1,N/A,N/A,N/A,1150,1151,N/A,26,1
7,N/A,N/A,N/A,1143,1150,N/A,31,6
5,N/A,N/A,N/A,1138,1143,N/A,36,5
4,N/A,N/A,N/A,1134,1138,N/A,41,4
3,N/A,N/A,N/A,1131,1134,N/A,45,2
5,N/A,N/A,N/A,1126,1131,N/A,48,5
3,N/A,N/A,N/A,1123,1126,N/A,53,4
2,N/A,N/A,N/A,1121,1123,N/A,58,3
2,N/A,N/A,N/A,1119,1121,N/A,63,2
3,N/A,N/A,N/A,1116,1119,N/A,69,2
6,N/A,N/A,N/A,1110,1116,N/A,73,6
3,N/A,N/A,N/A,1107,1110,N/A,76,3
2,N/A,N/A,N/A,1105,1107,N/A,81,2
5,N/A,N/A,N/A,1100,1105,N/A,84,5
2,N/A,N/A,N/A,1098,1100,N/A,88,3
2,N/A,N/A,N/A,1096,1098,N/A,93,2
6,N/A,N/A,N/A,1090,1096,N/A,97,6
6,N/A,N/A,N/A,1084,1090,N/A,102,5
3,N/A,N/A,N/A,1081,1084,N/A,105,2
6,N/A,N/A,N/A,1075,1081,N/A,108,5
5,N/A,N/A,N/A,1070,1075,N/A,114,5
2,N/A,N/A,N/A,1068,1070,N/A,118,3
2,N/A,N/A,N/A,1066,1068,N/A,123,2
6,N/A,N/A,N/A,1060,1066,N/A,126,5
4,N/A,N/A,N/A,1056,1060,N/A,131,4
3,N/A,N/A,N/A,1282,1285,N/A,6,3
1,N/A,N/A,N/A,1281,1282,N/A,10,1
3,N/A,N/A,N/A,1278,1281,N/A,13,4
4,N/A,N/A,N/A,1274,1278,N/A,19,4
3,N/A,N/A,N/A,1271,1274,N/A,23,2
6,N/A,N/A,N/A,1265,1271,N/A,26,5
2,N/A,N/A,N/A,1263,1265,N/A,30,3
3,N/A,N/A,N/A,1260,1263,N/A,36,3
2,N/A,N/A,N/A,1258,1260,N/A,41,2
5,N/A,N/A,N/A,1253,1258,N/A,44,5
3,N/A,N/A,N/A,1250,1253,N/A,49,4
2,N/A,N/A,N/A,1248,1250,N/A,54,3
1,N/A,N/A,N/A,1247,1248,N/A,58,1
5,N/A,N/A,N/A,1242,1247,N/A,62,5
2,N/A,N/A,N/A,1240,1242,N/A,65,2
5,N/A,N/A,N/A,1235,1240,N/A,68,5
3,N/A,N/A,N/A,1232,1235,N/A,73,4
4,N/A,N/A,N/A,1228,1232,N/A,79,4
2,N/A,N/A,N/A,1226,1228,N/A,84,3
3,N/A,N/A,N/A,1223,1226,N/A,89,2
2,N/A,N/A,N/A,1221,1223,N/A,95,2
6,N/A,N/A,N/A,1215,1221,N/A,99,6
5,N/A,N/A,N/A,1210,1215,N/A,104,5
3,N/A,N/A,N/A,1207,1210,N/A,107,2
1,N/A,N/A,N/A,1206,1207,N/A,112,1
6,N/A,N/A,N/A,1200,1206,N/A,117,6
1,N/A,N/A,N/A,1199,1200,N/A,123,0
3,N/A,N/A,N/A,1196,1199,N/A,127,4
3,N/A,N/A,N/A,1193,1196,N/A,132,3
1,N/A,N/A,N/A,1192,1193,N/A,136,1
3,N/A,N/A,N/A,1216,1219,N/A,3,4
2,N/A,N/A,N/A,1214,1216,N/A,7,2
3,N/A,N/A,N/A,1211,1214,N/A,13,2
7,N/A,N/A,N/A,1204,1211,N/A,17,6
3,N/A,N/A,N/A,1201,1204,N/A,20,3
7,N/A,N/A,N/A,1194,1201,N/A,23,6
3,N/A,N/A,N/A,1191,1194,N/A,27,4
2,N/A,N/A,N/A,1189,1191,N/A,31,2
3,N/A,N/A,N/A,1186,1189,N/A,37,2
6,N/A,N/A,N/A,1180,1186,N/A,41,6
4,N/A,N/A,N/A,1176,1180,N/A,45,4
2,N/A,N/A,N/A,1174,1176,N/A,50,3
3,N/A,N/A,N/A,1171,1174,N/A,56,3
7,N/A,N/A,N/A,1164,1171,N/A,59,6
3,N/A,N/A,N/A,1161,1164,N/A,62,3
2,N/A,N/A,N/A,1159,1161,N/A,67,2
2,N/A,N/A,N/A,1157,1159,N/A,72,1
4,N/A,N/A,N/A,1153,1157,N/A,75,4
3,N/A,N/A,N/A,1150,1153,N/A,80,3
2,N/A,N/A,N/A,1148,1150,N/A,85,2
5,N/A,N/A,N/A,1143,1148,N/A,88,5
2,N/A,N/A,N/A,1141,1143,N/A,92,3
3,N/A,N/A,N/A,1138,1141,N/A,98,3
3,N/A,N/A,N/A,1135,1138,N/A,104,3
2,N/A,N/A,N/A,1133,1135,N/A,108,1
5,N/A,N/A,N/A,1128,1133,N/A,112,5
2,N/A,N/A,N/A,1126,1128,N/A,115,2
1,N/A,N/A,N/A,1125,1126,N/A,120,1
6,N/A,N/A,N/A,1119,1125,N/A,125,6
3,N/A,N/A,N/A,1116,1119,N/A,129,4
2,N/A,N/A,N/A,1035,1037,N/A,3,3
2,N/A,N/A,N/A,1033,1035,N/A,7,1
3,N/A,N/A,N/A,1030,1033,N/A,10,4
2,N/A,N/A,N/A,1028,1030,N/A,13,1
6,N/A,N/A,N/A,1022,1028,N/A,18,6
2,N/A,N/A,N/A,1020,1022,N/A,21,3
3,N/A,N/A,N/A,1017,1020,N/A,26,2
1,N/A,N/A,N/A,1016,1017,N/A,31,1
7,N/A,N/A,N/A,1009,1016,N/A,36,6
3,N/A,N/A,N/A,1006,1009,N/A,39,3
1,N/A,N/A,N/A,1005,1006,N/A,43,1
5,N/A,N/A,N/A,1000,1005,N/A,47,5
6,N/A,N/A,N/A,994,1000,N/A,53,5
5,N/A,N/A,N/A,989,994,N/A,59,5
2,N/A,N/A,N/A,987,989,N/A,63,3
2,N/A,N/A,N/A,985,987,N/A,69,3
2,N/A,N/A,N/A,983,985,N/A,75,3
2,N/A,N/A,N/A,981,983,N/A,80,2
6,N/A,N/A,N/A,975,981,N/A,83,5
3,N/A,N/A,N/A,972,975,N/A,87,3
6,N/A,N/A,N/A,966,972,N/A,90,6
6,N/A,N/A,N/A,960,966,N/A,95,5
6,N/A,N/A,N/A,954,960,N/A,101,5
3,N/A,N/A,N/A,951,954,N/A,105,3
2,N/A,N/A,N/A,949,951,N/A,111,3
3,N/A,N/A,N/A,946,949,N/A,116,2
5,N/A,N/A,N/A,941,946,N/A,119,5
5,N/A,N/A,N/A,936,941,N/A,125,5
3,N/A,N/A,N/A,933,936,N/A,128,2
2,N/A,N/A,N/A,931,933,N/A,134,2
5,N/A,N/A,N/A,413,418,N/A,3,5
3,N/A,N/A,N/A,410,413,N/A,8,4
2,N/A,N/A,N/A,408,410,N/A,13,3
2,N/A,N/A,N/A,406,408,N/A,17,1
5,N/A,N/A,N/A,401,406,N/A,21,5
5,N/A,N/A,N/A,396,401,N/A,27,5
3,N/A,N/A,N/A,393,396,N/A,31,3
3,N/A,N/A,N/A,390,393,N/A,36,2
3,N/A,N/A,N/A,387,390,N/A,42,2
1,N/A,N/A,N/A,386,387,N/A,47,1
7,N/A,N/A,N/A,379,386,N/A,52,6
2,N/A,N/A,N/A,377,379,N/A,58,0
4,N/A,N/A,N/A,373,377,N/A,62,4
3,N/A,N/A,N/A,370,373,N/A,67,3
2,N/A,N/A,N/A,368,370,N/A,73,3
7,N/A,N/A,N/A,361,368,N/A,76,6
1,N/A,N/A,N/A,360,361,N/A,82,0
7,N/A,N/A,N/A,353,360,N/A,88,6
1,N/A,N/A,N/A,352,353,N/A,94,0
2,N/A,N/A,N/A,350,352,N/A,97,3
1,N/A,N/A,N/A,349,350,N/A,101,1
4,N/A,N/A,N/A,345,349,N/A,104,4
3,N/A,N/A,N/A,342,345,N/A,108,2
7,N/A,N/A,N/A,335,342,N/A,112,6
2,N/A,N/A,N/A,333,335,N/A,118,0
6,N/A,N/A,N/A,327,333,N/A,124,6
4,N/A,N/A,N/A,323,327,N/A,128,4
2,N/A,N/A,N/A,321,323,N/A,133,3
6,N/A,N/A,N/A,315,321,N/A,136,6
5,N/A,N/A,N/A,310,315,N/A,141,5
1,N/A,N/A,N/A,784,785,N/A,3,1
1,N/A,N/A,N/A,783,784,N/A,9,1
2,N/A,N/A,N/A,781,783,N/A,15,1
6,N/A,N/A,N/A,775,781,N/A,20,6
4,N/A,N/A,N/A,771,775,N/A,24,4
4,N/A,N/A,N/A,767,771,N/A,30,4
1,N/A,N/A,N/A,766,767,N/A,33,1
3,N/A,N/A,N/A,763,766,N/A,36,4
3,N/A,N/A,N/A,760,763,N/A,41,3
2,N/A,N/A,N/A,758,760,N/A,45,1
1,N/A,N/A,N/A,757,758,N/A,51,1
2,N/A,N/A,N/A,755,757,N/A,57,1
6,N/A,N/A,N/A,749,755,N/A,62,6
5,N/A,N/A,N/A,744,749,N/A,67,5
3,N/A,N/A,N/A,741,744,N/A,71,3
3,N/A,N/A,N/A,738,741,N/A,77,3
7,N/A,N/A,N/A,731,738,N/A,80,6
3,N/A,N/A,N/A,728,731,N/A,83,3
3,N/A,N/A,N/A,725,728,N/A,89,3
1,N/A,N/A,N/A,724,725,N/A,93,1
7,N/A,N/A,N/A,717,724,N/A,98,6
2,N/A,N/A,N/A,715,717,N/A,101,3
6,N/A,N/A,N/A,709,715,N/A,104,6
3,N/A,N/A,N/A,706,709,N/A,107,3
3,N/A,N/A,N/A,703,706,N/A,112,2
2,N/A,N/A,N/A,701,703,N/A,118,2
5,N/A,N/A,N/A,696,701,N/A,121,5
6,N/A,N/A,N/A,690,696,N/A,127,5
5,N/A,N/A,N/A,685,690,N/A,133,5
2,N/A,N/A,N/A,683,685,N/A,136,2
3,N/A,N/A,N/A,1867,1870,N/A,6,4
1,N/A,N/A,N/A,1866,1867,N/A,9,1
7,N/A,N/A,N/A,1859,1866,N/A,14,6
6,N/A,N/A,N/A,1853,1859,N/A,19,5
4,N/A,N/A,N/A,1849,1853,N/A,24,4
2,N/A,N/A,N/A,1847,1849,N/A,29,3
3,N/A,N/A,N/A,1844,1847,N/A,34,2
7,N/A,N/A,N/A,1837,1844,N/A,38,6
6,N/A,N/A,N/A,1831,1837,N/A,43,5
3,N/A,N/A,N/A,1828,1831,N/A,48,4
2,N/A,N/A,N/A,1826,1828,N/A,52,2
6,N/A,N/A,N/A,1820,1826,N/A,55,5
3,N/A,N/A,N/A,1817,1820,N/A,60,4
3,N/A,N/A,N/A,1814,1817,N/A,66,4
1,N/A,N/A,N/A,1813,1814,N/A,69,1
7,N/A,N/A,N/A,1806,1813,N/A,74,6
4,N/A,N/A,N/A,1802,1806,N/A,78,4
1,N/A,N/A,N/A,1801,1802,N/A,81,1
5,N/A,N/A,N/A,1796,1801,N/A,85,5
3,N/A,N/A,N/A,1793,1796,N/A,88,2
3,N/A,N/A,N/A,1790,1793,N/A,94,2
2,N/A,N/A,N/A,1788,1790,N/A,100,2
1,N/A,N/A,N/A,1787,1788,N/A,105,1
1,N/A,N/A,N/A,1786,1787,N/A,111,1
1,N/A,N/A,N/A,1785,1786,N/A,117,1
4,N/A,N/A,N/A,1781,1785,N/A,120,4
2,N/A,N/A,N/A,1779,1781,N/A,124,2
6,N/A,N/A,N/A,1773,1779,N/A,127,5
3,N/A,N/A,N/A,1770,1773,N/A,132,4
3,N/A,N/A,N/A,1767,1770,N/A,137,3
5,N/A,N/A,N/A,330,335,N/A,4,5
6,N/A,N/A,N/A,324,330,N/A,10,5
3,N/A,N/A,N/A,321,324,N/A,15,4
2,N/A,N/A,N/A,319,321,N/A,20,3
2,N/A,N/A,N/A,317,319,N/A,26,3
6,N/A,N/A,N/A,311,317,N/A,29,6
4,N/A,N/A,N/A,307,311,N/A,33,4
4,N/A,N/A,N/A,303,307,N/A,39,4
2,N/A,N/A,N/A,301,303,N/A,44,3
3,N/A,N/A,N/A,298,301,N/A,50,3
6,N/A,N/A,N/A,292,298,N/A,53,6
2,N/A,N/A,N/A,290,292,N/A,59,0
2,N/A,N/A,N/A,288,290,N/A,62,3
1,N/A,N/A,N/A,287,288,N/A,66,1
6,N/A,N/A,N/A,281,287,N/A,70,5
4,N/A,N/A,N/A,277,281,N/A,75,4
2,N/A,N/A,N/A,275,277,N/A,79,2
6,N/A,N/A,N/A,269,275,N/A,82,5
5,N/A,N/A,N/A,264,269,N/A,88,5
4,N/A,N/A,N/A,260,264,N/A,93,4
3,N/A,N/A,N/A,257,260,N/A,98,3
6,N/A,N/A,N/A,251,257,N/A,101,6
2,N/A,N/A,N/A,249,251,N/A,104,3
2,N/A,N/A,N/A,247,249,N/A,109,2
6,N/A,N/A,N/A,241,247,N/A,113,6
2,N/A,N/A,N/A,239,241,N/A,119,0
3,N/A,N/A,N/A,236,239,N/A,123,4
4,N/A,N/A,N/A,232,236,N/A,129,4
2,N/A,N/A,N/A,230,232,N/A,133,2
1,N/A,N/A,N/A,229,230,N/A,138,1
3,N/A,N/A,N/A,1949,1952,N/A,3,4
3,N/A,N/A,N/A,1946,1949,N/A,7,2
6,N/A,N/A,N/A,1940,1946,N/A,11,6
6,N/A,N/A,N/A,1934,1940,N/A,16,5
2,N/A,N/A,N/A,1932,1934,N/A,20,3
7,N/A,N/A,N/A,1925,1932,N/A,23,6
2,N/A,N/A,N/A,1923,1925,N/A,26,3
2,N/A,N/A,N/A,1921,1923,N/A,31,2
2,N/A,N/A,N/A,1919,1921,N/A,37,2
1,N/A,N/A,N/A,1918,1919,N/A,42,1
4,N/A,N/A,N/A,1914,1918,N/A,45,4
3,N/A,N/A,N/A,1911,1914,N/A,49,2
3,N/A,N/A,N/A,1908,1911,N/A,55,2
2,N/A,N/A,N/A,1906,1908,N/A,61,2
6,N/A,N/A,N/A,1900,1906,N/A,65,6
1,N/A,N/A,N/A,1899,1900,N/A,71,0
6,N/A,N/A,N/A,1893,1899,N/A,77,6
6,N/A,N/A,N/A,1887,1893,N/A,82,5
3,N/A,N/A,N/A,1884,1887,N/A,87,4
3,N/A,N/A,N/A,1881,1884,N/A,91,2
7,N/A,N/A,N/A,1874,1881,N/A,95,6
3,N/A,N/A,N/A,1871,1874,N/A,99,4
2,N/A,N/A,N/A,1869,1871,N/A,103,2
6,N/A,N/A,N/A,1863,1869,N/A,106,5
4,N/A,N/A,N/A,1859,1863,N/A,111,4
3,N/A,N/A,N/A,1856,1859,N/A,116,3
2,N/A,N/A,N/A,1854,1856,N/A,120,1
6,N/A,N/A,N/A,1848,1854,N/A,124,5
6,N/A,N/A,N/A,1842,1848,N/A,130,5
2,N/A,N/A,N/A,1840,1842,N/A,134,3
6,N/A,N/A,N/A,1898,1904,N/A,4,5
6,N/A,N/A,N/A,1892,1898,N/A,10,5
3,N/A,N/A,N/A,1889,1892,N/A,14,3
3,N/A,N/A,N/A,1886,1889,N/A,20,3
3,N/A,N/A,N/A,1883,1886,N/A,25,2
1,N/A,N/A,N/A,1882,1883,N/A,30,1
5,N/A,N/A,N/A,1877,1882,N/A,34,5
2,N/A,N/A,N/A,1875,1877,N/A,37,2
3,N/A,N/A,N/A,1872,1875,N/A,43,2
2,N/A,N/A,N/A,1870,1872,N/A,49,2
3,N/A,N/A,N/A,1867,1870,N/A,55,2
6,N/A,N/A,N/A,1861,1867,N/A,58,5
4,N/A,N/A,N/A,1857,1861,N/A,63,4
2,N/A,N/A,N/A,1855,1857,N/A,66,1
6,N/A,N/A,N/A,1849,1855,N/A,70,5
2,N/A,N/A,N/A,1847,1849,N/A,74,3
2,N/A,N/A,N/A,1845,1847,N/A,79,2
6,N/A,N/A,N/A,1839,1845,N/A,83,6
2,N/A,N/A,N/A,1837,1839,N/A,86,3
2,N/A,N/A,N/A,1835,1837,N/A,90,1
1,N/A,N/A,N/A,1834,1835,N/A,96,1
6,N/A,N/A,N/A,1828,1834,N/A,101,6
4,N/A,N/A,N/A,1824,1828,N/A,105,4
2,N/A,N/A,N/A,1822,1824,N/A,108,1
2,N/A,N/A,N/A,1820,1822,N/A,114,1
5,N/A,N/A,N/A,1815,1820,N/A,118,5
4,N/A,N/A,N/A,1811,1815,N/A,123,4
2,N/A,N/A,N/A,1809,1811,N/A,128,3
6,N/A,N/A,N/A,1803,1809,N/A,131,6
6,N/A,N/A,N/A,1797,1803,N/A,136,5
3,N/A,N/A,N/A,1993,1996,N/A,5,2
6,N/A,N/A,N/A,1987,1993,N/A,9,6
4,N/A,N/A,N/A,1983,1987,N/A,13,4
2,N/A,N/A,N/A,1981,1983,N/A,17,2
5,N/A,N/A,N/A,1976,1981,N/A,20,5
4,N/A,N/A,N/A,1972,1976,N/A,25,4
2,N/A,N/A,N/A,1970,1972,N/A,29,2
6,N/A,N/A,N/A,1964,1970,N/A,32,5
2,N/A,N/A,N/A,1962,1964,N/A,36,3
2,N/A,N/A,N/A,1960,1962,N/A,41,2
1,N/A,N/A,N/A,1959,1960,N/A,46,1
5,N/A,N/A,N/A,1954,1959,N/A,50,5
3,N/A,N/A,N/A,1951,1954,N/A,53,2
5,N/A,N/A,N/A,1946,1951,N/A,56,5
3,N/A,N/A,N/A,1943,1946,N/A,61,4
2,N/A,N/A,N/A,1941,1943,N/A,64,1
6,N/A,N/A,N/A,1935,1941,N/A,69,6
2,N/A,N/A,N/A,1933,1935,N/A,75,0
7,N/A,N/A,N/A,1926,1933,N/A,81,6
3,N/A,N/A,N/A,1923,1926,N/A,84,3
7,N/A,N/A,N/A,1916,1923,N/A,87,6
4,N/A,N/A,N/A,1912,1916,N/A,91,4
3,N/A,N/A,N/A,1909,1912,N/A,97,4
2,N/A,N/A,N/A,1907,1909,N/A,100,1
2,N/A,N/A,N/A,1905,1907,N/A,106,1
4,N/A,N/A,N/A,1901,1905,N/A,109,4
2,N/A,N/A,N/A,1899,1901,N/A,112,1
2,N/A,N/A,N/A,1897,1899,N/A,118,1
3,N/A,N/A,N/A,1894,1897,N/A,121,4
2,N/A,N/A,N/A,1892,1894,N/A,125,2
3,N/A,N/A,N/A,793,796,N/A,5,3
3,N/A,N/A,N/A,790,793,N/A,11,3
6,N/A,N/A,N/A,784,790,N/A,14,6
1,N/A,N/A,N/A,783,784,N/A,20,0
3,N/A,N/A,N/A,780,783,N/A,23,3
2,N/A,N/A,N/A,778,780,N/A,28,2
6,N/A,N/A,N/A,772,778,N/A,31,5
3,N/A,N/A,N/A,769,772,N/A,35,3
7,N/A,N/A,N/A,762,769,N/A,38,6
2,N/A,N/A,N/A,760,762,N/A,41,3
6,N/A,N/A,N/A,754,760,N/A,44,6
6,N/A,N/A,N/A,748,754,N/A,49,5
5,N/A,N/A,N/A,743,748,N/A,55,5
3,N/A,N/A,N/A,740,743,N/A,59,3
3,N/A,N/A,N/A,737,740,N/A,65,3
3,N/A,N/A,N/A,734,737,N/A,71,3
6,N/A,N/A,N/A,728,734,N/A,74,6
3,N/A,N/A,N/A,725,728,N/A,78,4
3,N/A,N/A,N/A,722,725,N/A,84,4
3,N/A,N/A,N/A,719,722,N/A,90,4
3,N/A,N/A,N/A,716,719,N/A,94,2
6,N/A,N/A,N/A,710,716,N/A,98,6
3,N/A,N/A,N/A,707,710,N/A,102,4
3,N/A,N/A,N/A,704,707,N/A,106,2
6,N/A,N/A,N/A,698,704,N/A,110,6
3,N/A,N/A,N/A,695,698,N/A,113,3
3,N/A,N/A,N/A,692,695,N/A,119,3
2,N/A,N/A,N/A,690,692,N/A,125,3
7,N/A,N/A,N/A,683,690,N/A,128,6
2,N/A,N/A,N/A,681,683,N/A,134,0
2,N/A,N/A,N/A,1450,1452,N/A,3,3
7,N/A,N/A,N/A,1443,1450,N/A,6,6
5,N/A,N/A,N/A,1438,1443,N/A,11,5
4,N/A,N/A,N/A,1434,1438,N/A,16,4
3,N/A,N/A,N/A,1431,1434,N/A,20,2
6,N/A,N/A,N/A,1425,1431,N/A,23,5
3,N/A,N/A,N/A,1422,1425,N/A,28,4
3,N/A,N/A,N/A,1419,1422,N/A,33,3
2,N/A,N/A,N/A,1417,1419,N/A,37,1
6,N/A,N/A,N/A,1411,1417,N/A,41,5
6,N/A,N/A,N/A,1405,1411,N/A,47,5
2,N/A,N/A,N/A,1403,1405,N/A,51,3
1,N/A,N/A,N/A,1402,1403,N/A,55,1
5,N/A,N/A,N/A,1397,1402,N/A,59,5
5,N/A,N/A,N/A,1392,1397,N/A,65,5
2,N/A,N/A,N/A,1390,1392,N/A,68,2
5,N/A,N/A,N/A,1385,1390,N/A,71,5
3,N/A,N/A,N/A,1382,1385,N/A,74,2
2,N/A,N/A,N/A,1380,1382,N/A,79,1
6,N/A,N/A,N/A,1374,1380,N/A,84,6
2,N/A,N/A,N/A,1372,1374,N/A,87,3
2,N/A,N/A,N/A,1370,1372,N/A,92,2
7,N/A,N/A,N/A,1363,1370,N/A,96,6
6,N/A,N/A,N/A,1357,1363,N/A,101,5
2,N/A,N/A,N/A,1355,1357,N/A,104,2
6,N/A,N/A,N/A,1349,1355,N/A,108,6
1,N/A,N/A,N/A,1348,1349,N/A,114,0
2,N/A,N/A,N/A,1346,1348,N/A,117,3
2,N/A,N/A,N/A,1344,1346,N/A,122,2
2,N/A,N/A,N/A,1342,1344,N/A,128,2
3,N/A,N/A,N/A,1217,1220,N/A,6,3
3,N/A,N/A,N/A,1214,1217,N/A,11,2
5,N/A,N/A,N/A,1209,1214,N/A,14,5
4,N/A,N/A,N/A,1205,1209,N/A,19,4
4,N/A,N/A,N/A,1201,1205,N/A,25,4
2,N/A,N/A,N/A,1199,1201,N/A,28,1
4,N/A,N/A,N/A,1195,1199,N/A,31,4
4,N/A,N/A,N/A,1191,1195,N/A,37,4
3,N/A,N/A,N/A,1188,1191,N/A,42,3
7,N/A,N/A,N/A,1181,1188,N/A,45,6
2,N/A,N/A,N/A,1179,1181,N/A,51,0
7,N/A,N/A,N/A,1172,1179,N/A,57,6
5,N/A,N/A,N/A,1167,1172,N/A,62,5
3,N/A,N/A,N/A,1164,1167,N/A,66,3
1,N/A,N/A,N/A,1163,1164,N/A,70,1
3,N/A,N/A,N/A,1160,1163,N/A,73,4
4,N/A,N/A,N/A,1156,1160,N/A,79,4
2,N/A,N/A,N/A,1154,1156,N/A,83,2
2,N/A,N/A,N/A,1152,1154,N/A,89,2
2,N/A,N/A,N/A,1150,1152,N/A,95,2
2,N/A,N/A,N/A,1148,1150,N/A,100,1
1,N/A,N/A,N/A,1147,1148,N/A,106,1
7,N/A,N/A,N/A,1140,1147,N/A,111,6
2,N/A,N/A,N/A,1138,1140,N/A,117,0
3,N/A,N/A,N/A,1135,1138,N/A,121,4
3,N/A,N/A,N/A,1132,1135,N/A,127,4
3,N/A,N/A,N/A,1129,1132,N/A,131,2
6,N/A,N/A,N/A,1123,1129,N/A,134,5
4,N/A,N/A,N/A,1119,1123,N/A,139,4
2,N/A,N/A,N/A,1117,1119,N/A,144,3
2,N/A,N/A,N/A,1329,1331,N/A,6,3
3,N/A,N/A,N/A,1326,1329,N/A,11,2
1,N/A,N/A,N/A,1325,1326,N/A,16,1
2,N/A,N/A,N/A,1323,1325,N/A,22,1
6,N/A,N/A,N/A,1317,1323,N/A,27,6
3,N/A,N/A,N/A,1314,1317,N/A,30,3
2,N/A,N/A,N/A,1312,1314,N/A,36,3
7,N/A,N/A,N/A,1305,1312,N/A,39,6
6,N/A,N/A,N/A,1299,1305,N/A,44,5
3,N/A,N/A,N/A,1296,1299,N/A,48,3
7,N/A,N/A,N/A,1289,1296,N/A,51,6
3,N/A,N/A,N/A,1286,1289,N/A,54,3
2,N/A,N/A,N/A,1284,1286,N/A,60,3
6,N/A,N/A,N/A,1278,1284,N/A,63,6
6,N/A,N/A,N/A,1272,1278,N/A,68,5
2,N/A,N/A,N/A,1270,1272,N/A,72,3
3,N/A,N/A,N/A,1267,1270,N/A,77,2
5,N/A,N/A,N/A,1262,1267,N/A,80,5
4,N/A,N/A,N/A,1258,1262,N/A,85,4
2,N/A,N/A,N/A,1256,1258,N/A,88,1
7,N/A,N/A,N/A,1249,1256,N/A,93,6
1,N/A,N/A,N/A,1248,1249,N/A,99,0
4,N/A,N/A,N/A,1244,1248,N/A,103,4
4,N/A,N/A,N/A,1240,1244,N/A,109,4
3,N/A,N/A,N/A,1237,1240,N/A,115,4
3,N/A,N/A,N/A,1234,1237,N/A,121,4
4,N/A,N/A,N/A,1230,1234,N/A,127,4
2,N/A,N/A,N/A,1228,1230,N/A,131,2
6,N/A,N/A,N/A,1222,1228,N/A,134,5
5,N/A,N/A,N/A,1217,1222,N/A,140,5
2,N/A,N/A,N/A,1884,1886,N/A,5,1
1,N/A,N/A,N/A,1883,1884,N/A,11,1
5,N/A,N/A,N/A,1878,1883,N/A,15,5
5,N/A,N/A,N/A,1873,1878,N/A,21,5
3,N/A,N/A,N/A,1870,1873,N/A,25,3
7,N/A,N/A,N/A,1863,1870,N/A,28,6
2,N/A,N/A,N/A,1861,1863,N/A,31,3
1,N/A,N/A,N/A,1860,1861,N/A,35,1
5,N/A,N/A,N/A,1855,1860,N/A,39,5
6,N/A,N/A,N/A,1849,1855,N/A,45,5
3,N/A,N/A,N/A,1846,1849,N/A,48,2
1,N/A,N/A,N/A,1845,1846,N/A,53,1
5,N/A,N/A,N/A,1840,1845,N/A,57,5
3,N/A,N/A,N/A,1837,1840,N/A,60,2
6,N/A,N/A,N/A,1831,1837,N/A,64,6
1,N/A,N/A,N/A,1830,1831,N/A,70,0
3,N/A,N/A,N/A,1827,1830,N/A,74,4
1,N/A,N/A,N/A,1826,1827,N/A,77,1
6,N/A,N/A,N/A,1820,1826,N/A,81,5
4,N/A,N/A,N/A,1816,1820,N/A,86,4
2,N/A,N/A,N/A,1814,1816,N/A,90,2
3,N/A,N/A,N/A,1811,1814,N/A,96,2
6,N/A,N/A,N/A,1805,1811,N/A,100,6
3,N/A,N/A,N/A,1802,1805,N/A,104,4
2,N/A,N/A,N/A,1800,1802,N/A,108,2
2,N/A,N/A,N/A,1798,1800,N/A,114,2
1,N/A,N/A,N/A,1797,1798,N/A,119,1
2,N/A,N/A,N/A,1795,1797,N/A,125,1
3,N/A,N/A,N/A,1792,1795,N/A,128,4
2,N/A,N/A,N/A,1790,1792,N/A,131,1
2,N/A,N/A,N/A,527,529,N/A,5,3
2,N/A,N/A,N/A,525,527,N/A,9,1
1,N/A,N/A,N/A,524,525,N/A,15,1
6,N/A,N/A,N/A,518,524,N/A,20,6
4,N/A,N/A,N/A,514,518,N/A,24,4
1,N/A,N/A,N/A,513,514,N/A,27,1
1,N/A,N/A,N/A,512,513,N/A,33,1
7,N/A,N/A,N/A,505,512,N/A,38,6
5,N/A,N/A,N/A,500,505,N/A,43,5
3,N/A,N/A,N/A,497,500,N/A,46,2
3,N/A,N/A,N/A,494,497,N/A,52,2
3,N/A,N/A,N/A,491,494,N/A,58,2
2,N/A,N/A,N/A,489,491,N/A,64,2
3,N/A,N/A,N/A,486,489,N/A,70,2
6,N/A,N/A,N/A,480,486,N/A,74,6
2,N/A,N/A,N/A,478,480,N/A,80,0
3,N/A,N/A,N/A,475,478,N/A,83,3
1,N/A,N/A,N/A,474,475,N/A,87,1
6,N/A,N/A,N/A,468,474,N/A,92,6
5,N/A,N/A,N/A,463,468,N/A,97,5
6,N/A,N/A,N/A,457,463,N/A,103,5
5,N/A,N/A,N/A,452,457,N/A,109,5
2,N/A,N/A,N/A,450,452,N/A,112,2
1,N/A,N/A,N/A,449,450,N/A,117,1
2,N/A,N/A,N/A,447,449,N/A,123,1
7,N/A,N/A,N/A,440,447,N/A,128,6
1,N/A,N/A,N/A,439,440,N/A,134,0
5,N/A,N/A,N/A,434,439,N/A,139,5
3,N/A,N/A,N/A,431,434,N/A,142,2
3,N/A,N/A,N/A,428,431,N/A,148,2
3,N/A,N/A,N/A,843,846,N/A,6,2
3,N/A,N/A,N/A,840,843,N/A,12,2
6,N/A,N/A,N/A,834,840,N/A,16,6
2,N/A,N/A,N/A,832,834,N/A,19,3
2,N/A,N/A,N/A,830,832,N/A,23,1
1,N/A,N/A,N/A,829,830,N/A,29,1
6,N/A,N/A,N/A,823,829,N/A,33,5
6,N/A,N/A,N/A,817,823,N/A,39,5
3,N/A,N/A,N/A,814,817,N/A,42,2
6,N/A,N/A,N/A,808,814,N/A,46,6
1,N/A,N/A,N/A,807,808,N/A,52,0
5,N/A,N/A,N/A,802,807,N/A,57,5
3,N/A,N/A,N/A,799,802,N/A,60,2
6,N/A,N/A,N/A,793,799,N/A,63,5
3,N/A,N/A,N/A,790,793,N/A,68,4
3,N/A,N/A,N/A,787,790,N/A,73,3
1,N/A,N/A,N/A,786,787,N/A,77,1
2,N/A,N/A,N/A,784,786,N/A,83,1
2,N/A,N/A,N/A,782,784,N/A,89,1
1,N/A,N/A,N/A,781,782,N/A,95,1
6,N/A,N/A,N/A,775,781,N/A,99,5
2,N/A,N/A,N/A,773,775,N/A,103,3
2,N/A,N/A,N/A,771,773,N/A,109,3
3,N/A,N/A,N/A,768,771,N/A,114,2
2,N/A,N/A,N/A,766,768,N/A,120,2
2,N/A,N/A,N/A,764,766,N/A,125,1
5,N/A,N/A,N/A,759,764,N/A,129,5
6,N/A,N/A,N/A,753,759,N/A,135,5
2,N/A,N/A,N/A,751,753,N/A,139,3
2,N/A,N/A,N/A,749,751,N/A,144,2
3,N/A,N/A,N/A,1975,1978,N/A,5,2
2,N/A,N/A,N/A,1973,1975,N/A,10,1
7,N/A,N/A,N/A,1966,1973,N/A,15,6
2,N/A,N/A,N/A,1964,1966,N/A,18,3
6,N/A,N/A,N/A,1958,1964,N/A,21,6
6,N/A,N/A,N/A,1952,1958,N/A,26,5
6,N/A,N/A,N/A,1946,1952,N/A,32,5
4,N/A,N/A,N/A,1942,1946,N/A,37,4
2,N/A,N/A,N/A,1940,1942,N/A,42,3
7,N/A,N/A,N/A,1933,1940,N/A,45,6
5,N/A,N/A,N/A,1928,1933,N/A,50,5
3,N/A,N/A,N/A,1925,1928,N/A,55,4
1,N/A,N/A,N/A,1924,1925,N/A,58,1
1,N/A,N/A,N/A,1923,1924,N/A,64,1
7,N/A,N/A,N/A,1916,1923,N/A,69,6
4,N/A,N/A,N/A,1912,1916,N/A,73,4
2,N/A,N/A,N/A,1910,1912,N/A,78,3
6,N/A,N/A,N/A,1904,1910,N/A,81,6
2,N/A,N/A,N/A,1902,1904,N/A,87,0
3,N/A,N/A,N/A,1899,1902,N/A,91,4
2,N/A,N/A,N/A,1897,1899,N/A,94,1
6,N/A,N/A,N/A,1891,1897,N/A,98,5
3,N/A,N/A,N/A,1888,1891,N/A,101,2
6,N/A,N/A,N/A,1882,1888,N/A,104,5
4,N/A,N/A,N/A,1878,1882,N/A,109,4
2,N/A,N/A,N/A,1876,1878,N/A,113,2
2,N/A,N/A,N/A,1874,1876,N/A,119,2
7,N/A,N/A,N/A,1867,1874,N/A,123,6
5,N/A,N/A,N/A,1862,1867,N/A,128,5
3,N/A,N/A,N/A,1859,1862,N/A,132,3
3,N/A,N/A,N/A,385,388,N/A,3,4
3,N/A,N/A,N/A,382,385,N/A,8,3
2,N/A,N/A,N/A,380,382,N/A,13,2
7,N/A,N/A,N/A,373,380,N/A,17,6
3,N/A,N/A,N/A,370,373,N/A,20,3
2,N/A,N/A,N/A,368,370,N/A,26,3
2,N/A,N/A,N/A,366,368,N/A,31,2
7,N/A,N/A,N/A,359,366,N/A,35,6
4,N/A,N/A,N/A,355,359,N/A,39,4
3,N/A,N/A,N/A,352,355,N/A,44,3
3,N/A,N/A,N/A,349,352,N/A,50,3
3,N/A,N/A,N/A,346,349,N/A,55,2
2,N/A,N/A,N/A,344,346,N/A,60,1
1,N/A,N/A,N/A,343,344,N/A,66,1
2,N/A,N/A,N/A,341,343,N/A,72,1
3,N/A,N/A,N/A,338,341,N/A,75,4
4,N/A,N/A,N/A,334,338,N/A,81,4
3,N/A,N/A,N/A,331,334,N/A,87,4
2,N/A,N/A,N/A,329,331,N/A,91,2
1,N/A,N/A,N/A,328,329,N/A,96,1
6,N/A,N/A,N/A,322,328,N/A,101,6
6,N/A,N/A,N/A,316,322,N/A,106,5
6,N/A,N/A,N/A,310,316,N/A,112,5
6,N/A,N/A,N/A,304,310,N/A,118,5
5,N/A,N/A,N/A,299,304,N/A,124,5
3,N/A,N/A,N/A,296,299,N/A,128,3
3,N/A,N/A,N/A,293,296,N/A,134,3
2,N/A,N/A,N/A,291,293,N/A,138,1
7,N/A,N/A,N/A,284,291,N/A,143,6
5,N/A,N/A,N/A,279,284,N/A,148,5
6,N/A,N/A,N/A,1316,1322,N/A,5,6
5,N/A,N/A,N/A,1311,1316,N/A,10,5
4,N/A,N/A,N/A,1307,1311,N/A,15,4
3,N/A,N/A,N/A,1304,1307,N/A,21,4
3,N/A,N/A,N/A,1301,1304,N/A,25,2
2,N/A,N/A,N/A,1299,1301,N/A,30,1
6,N/A,N/A,N/A,1293,1299,N/A,34,5
2,N/A,N/A,N/A,1291,1293,N/A,38,3
2,N/A,N/A,N/A,1289,1291,N/A,44,3
2,N/A,N/A,N/A,1287,1289,N/A,48,1
4,N/A,N/A,N/A,1283,1287,N/A,51,4
2,N/A,N/A,N/A,1281,1283,N/A,56,3
3,N/A,N/A,N/A,1278,1281,N/A,61,2
5,N/A,N/A,N/A,1273,1278,N/A,64,5
2,N/A,N/A,N/A,1271,1273,N/A,68,3
3,N/A,N/A,N/A,1268,1271,N/A,74,3
6,N/A,N/A,N/A,1262,1268,N/A,77,6
3,N/A,N/A,N/A,1259,1262,N/A,81,4
3,N/A,N/A,N/A,1256,1259,N/A,87,4
4,N/A,N/A,N/A,1252,1256,N/A,93,4
3,N/A,N/A,N/A,1249,1252,N/A,98,3
2,N/A,N/A,N/A,1247,1249,N/A,102,1
2,N/A,N/A,N/A,1245,1247,N/A,108,1
6,N/A,N/A,N/A,1239,1245,N/A,113,6
1,N/A,N/A,N/A,1238,1239,N/A,119,0
2,N/A,N/A,N/A,1236,1238,N/A,122,3
3,N/A,N/A,N/A,1233,1236,N/A,128,3
3,N/A,N/A,N/A,1230,1233,N/A,133,2
6,N/A,N/A,N/A,1224,1230,N/A,136,5
4,N/A,N/A,N/A,1220,1224,N/A,141,4
2,N/A,N/A,N/A,894,896,N/A,5,2
2,N/A,N/A,N/A,892,894,N/A,11,2
2,N/A,N/A,N/A,890,892,N/A,17,2
6,N/A,N/A,N/A,884,890,N/A,21,6
2,N/A,N/A,N/A,882,884,N/A,24,3
3,N/A,N/A,N/A,879,882,N/A,30,3
2,N/A,N/A,N/A,877,879,N/A,35,2
2,N/A,N/A,N/A,875,877,N/A,40,1
3,N/A,N/A,N/A,872,875,N/A,43,4
3,N/A,N/A,N/A,869,872,N/A,47,2
6,N/A,N/A,N/A,863,869,N/A,51,6
1,N/A,N/A,N/A,862,863,N/A,57,0
7,N/A,N/A,N/A,855,862,N/A,63,6
5,N/A,N/A,N/A,850,855,N/A,68,5
3,N/A,N/A,N/A,847,850,N/A,72,3
7,N/A,N/A,N/A,840,847,N/A,75,6
6,N/A,N/A,N/A,834,840,N/A,80,5
3,N/A,N/A,N/A,831,834,N/A,83,2
3,N/A,N/A,N/A,828,831,N/A,89,2
3,N/A,N/A,N/A,825,828,N/A,95,2
2,N/A,N/A,N/A,823,825,N/A,100,1
4,N/A,N/A,N/A,819,823,N/A,103,4
2,N/A,N/A,N/A,817,819,N/A,107,2
5,N/A,N/A,N/A,812,817,N/A,110,5
2,N/A,N/A,N/A,810,812,N/A,113,2
2,N/A,N/A,N/A,808,810,N/A,119,2
7,N/A,N/A,N/A,801,808,N/A,123,6
2,N/A,N/A,N/A,799,801,N/A,126,3
3,N/A,N/A,N/A,796,799,N/A,131,2
6,N/A,N/A,N/A,790,796,N/A,134,5
2,N/A,N/A,N/A,305,307,N/A,5,3
3,N/A,N/A,N/A,302,305,N/A,10,2
2,N/A,N/A,N/A,300,302,N/A,16,2
3,N/A,N/A,N/A,297,300,N/A,22,2
5,N/A,N/A,N/A,292,297,N/A,25,5
6,N/A,N/A,N/A,286,292,N/A,31,5
3,N/A,N/A,N/A,283,286,N/A,34,2
7,N/A,N/A,N/A,276,283,N/A,38,6
2,N/A,N/A,N/A,274,276,N/A,41,3
6,N/A,N/A,N/A,268,274,N/A,44,6
5,N/A,N/A,N/A,263,268,N/A,49,5
3,N/A,N/A,N/A,260,263,N/A,54,4
2,N/A,N/A,N/A,258,260,N/A,58,2
6,N/A,N/A,N/A,252,258,N/A,62,6
2,N/A,N/A,N/A,250,252,N/A,68,0
4,N/A,N/A,N/A,246,250,N/A,72,4
2,N/A,N/A,N/A,244,246,N/A,75,1
4,N/A,N/A,N/A,240,244,N/A,78,4
2,N/A,N/A,N/A,238,240,N/A,83,3
2,N/A,N/A,N/A,236,238,N/A,87,1
6,N/A,N/A,N/A,230,236,N/A,91,5
6,N/A,N/A,N/A,224,230,N/A,97,5
2,N/A,N/A,N/A,222,224,N/A,101,3
2,N/A,N/A,N/A,220,222,N/A,107,3
6,N/A,N/A,N/A,214,220,N/A,110,6
6,N/A,N/A,N/A,208,214,N/A,115,5
3,N/A,N/A,N/A,205,208,N/A,118,2
3,N/A,N/A,N/A,202,205,N/A,124,2
1,N/A,N/A,N/A,201,202,N/A,129,1
3,N/A,N/A,N/A,198,201,N/A,132,4
3,N/A,N/A,N/A,1089,1092,N/A,5,2
2,N/A,N/A,N/A,1087,1089,N/A,10,1
7,N/A,N/A,N/A,1080,1087,N/A,15,6
2,N/A,N/A,N/A,1078,1080,N/A,21,0
3,N/A,N/A,N/A,1075,1078,N/A,24,3
7,N/A,N/A,N/A,1068,1075,N/A,27,6
6,N/A,N/A,N/A,1062,1068,N/A,32,5
3,N/A,N/A,N/A,1059,1062,N/A,36,3
2,N/A,N/A,N/A,1057,1059,N/A,41,2
2,N/A,N/A,N/A,1055,1057,N/A,46,1
6,N/A,N/A,N/A,1049,1055,N/A,51,6
3,N/A,N/A,N/A,1046,1049,N/A,55,4
1,N/A,N/A,N/A,1045,1046,N/A,58,1
1,N/A,N/A,N/A,1044,1045,N/A,64,1
6,N/A,N/A,N/A,1038,1044,N/A,68,5
5,N/A,N/A,N/A,1033,1038,N/A,74,5
6,N/A,N/A,N/A,1027,1033,N/A,80,5
4,N/A,N/A,N/A,1023,1027,N/A,85,4
3,N/A,N/A,N/A,1020,1023,N/A,90,3
3,N/A,N/A,N/A,1017,1020,N/A,96,3
2,N/A,N/A,N/A,1015,1017,N/A,100,1
6,N/A,N/A,N/A,1009,1015,N/A,105,6
6,N/A,N/A,N/A,1003,1009,N/A,110,5
2,N/A,N/A,N/A,1001,1003,N/A,113,2
2,N/A,N/A,N/A,999,1001,N/A,119,2
2,N/A,N/A,N/A,997,999,N/A,124,1
5,N/A,N/A,N/A,992,997,N/A,128,5
3,N/A,N/A,N/A,989,992,N/A,132,3
7,N/A,N/A,N/A,982,989,N/A,135,6
5,N/A,N/A,N/A,977,982,N/A,140,5
2,N/A,N/A,N/A,458,460,N/A,6,1
6,N/A,N/A,N/A,452,458,N/A,11,6
2,N/A,N/A,N/A,450,452,N/A,14,3
6,N/A,N/A,N/A,444,450,N/A,17,6
6,N/A,N/A,N/A,438,444,N/A,22,5
5,N/A,N/A,N/A,433,438,N/A,28,5
2,N/A,N/A,N/A,431,433,N/A,31,2
2,N/A,N/A,N/A,429,431,N/A,36,1
5,N/A,N/A,N/A,424,429,N/A,40,5
3,N/A,N/A,N/A,421,424,N/A,43,2
7,N/A,N/A,N/A,414,421,N/A,47,6
6,N/A,N/A,N/A,408,414,N/A,52,5
6,N/A,N/A,N/A,402,408,N/A,58,5
3,N/A,N/A,N/A,399,402,N/A,61,2
6,N/A,N/A,N/A,393,399,N/A,65,6
4,N/A,N/A,N/A,389,393,N/A,69,4
2,N/A,N/A,N/A,387,389,N/A,74,3
7,N/A,N/A,N/A,380,387,N/A,77,6
2,N/A,N/A,N/A,378,380,N/A,80,3
3,N/A,N/A,N/A,375,378,N/A,86,3
2,N/A,N/A,N/A,373,375,N/A,91,2
6,N/A,N/A,N/A,367,373,N/A,95,6
6,N/A,N/A,N/A,361,367,N/A,100,5
3,N/A,N/A,N/A,358,361,N/A,104,3
6,N/A,N/A,N/A,352,358,N/A,107,6
1,N/A,N/A,N/A,351,352,N/A,113,0
3,N/A,N/A,N/A,348,351,N/A,116,3
3,N/A,N/A,N/A,345,348,N/A,122,3
3,N/A,N/A,N/A,342,345,N/A,128,3
1,N/A,N/A,N/A,341,342,N/A,132,1
2,N/A,N/A,N/A,1787,1789,N/A,5,2
1,N/A,N/A,N/A,1786,1787,N/A,10,1
3,N/A,N/A,N/A,1783,1786,N/A,13,4
3,N/A,N/A,N/A,1780,1783,N/A,17,2
5,N/A,N/A,N/A,1775,1780,N/A,20,5
4,N/A,N/A,N/A,1771,1775,N/A,25,4
3,N/A,N/A,N/A,1768,1771,N/A,31,4
3,N/A,N/A,N/A,1765,1768,N/A,37,4
4,N/A,N/A,N/A,1761,1765,N/A,43,4
4,N/A,N/A,N/A,1757,1761,N/A,49,4
3,N/A,N/A,N/A,1754,1757,N/A,55,4
2,N/A,N/A,N/A,1752,1754,N/A,59,2
1,N/A,N/A,N/A,1751,1752,N/A,64,1
3,N/A,N/A,N/A,1748,1751,N/A,67,4
2,N/A,N/A,N/A,1746,1748,N/A,70,1
1,N/A,N/A,N/A,1745,1746,N/A,76,1
6,N/A,N/A,N/A,1739,1745,N/A,81,6
2,N/A,N/A,N/A,1737,1739,N/A,84,3
2,N/A,N/A,N/A,1735,1737,N/A,90,3
7,N/A,N/A,N/A,1728,1735,N/A,93,6
2,N/A,N/A,N/A,1726,1728,N/A,99,0
5,N/A,N/A,N/A,1721,1726,N/A,104,5
3,N/A,N/A,N/A,1718,1721,N/A,108,3
7,N/A,N/A,N/A,1711,1718,N/A,111,6
2,N/A,N/A,N/A,1709,1711,N/A,114,3
2,N/A,N/A,N/A,1707,1709,N/A,118,1
1,N/A,N/A,N/A,1706,1707,N/A,124,1
7,N/A,N/A,N/A,1699,1706,N/A,129,6
1,N/A,N/A,N/A,1698,1699,N/A,135,0
7,N/A,N/A,N/A,1691,1698,N/A,141,6
3,N/A,N/A,N/A,388,391,N/A,5,3
2,N/A,N/A,N/A,386,388,N/A,9,1
3,N/A,N/A,N/A,383,386,N/A,12,4
1,N/A,N/A,N/A,382,383,N/A,15,1
7,N/A,N/A,N/A,375,382,N/A,20,6
1,N/A,N/A,N/A,374,375,N/A,26,0
4,N/A,N/A,N/A,370,374,N/A,30,4
3,N/A,N/A,N/A,367,370,N/A,35,3
1,N/A,N/A,N/A,366,367,N/A,39,1
6,N/A,N/A,N/A,360,366,N/A,44,6
6,N/A,N/A,N/A,354,360,N/A,49,5
4,N/A,N/A,N/A,350,354,N/A,54,4
3,N/A,N/A,N/A,347,350,N/A,58,2
5,N/A,N/A,N/A,342,347,N/A,61,5
3,N/A,N/A,N/A,339,342,N/A,64,2
6,N/A,N/A,N/A,333,339,N/A,68,6
4,N/A,N/A,N/A,329,333,N/A,72,4
3,N/A,N/A,N/A,326,329,N/A,78,4
3,N/A,N/A,N/A,323,326,N/A,84,4
2,N/A,N/A,N/A,321,323,N/A,87,1
3,N/A,N/A,N/A,318,321,N/A,90,4
3,N/A,N/A,N/A,315,318,N/A,94,2
3,N/A,N/A,N/A,312,315,N/A,100,2
1,N/A,N/A,N/A,311,312,N/A,105,1
5,N/A,N/A,N/A,306,311,N/A,109,5
2,N/A,N/A,N/A,304,306,N/A,112,2
6,N/A,N/A,N/A,298,304,N/A,116,6
2,N/A,N/A,N/A,296,298,N/A,119,3
3,N/A,N/A,N/A,293,296,N/A,124,2
7,N/A,N/A,N/A,286,293,N/A,128,6
2,N/A,N/A,N/A,1942,1944,N/A,5,1
5,N/A,N/A,N/A,1937,1942,N/A,9,5
3,N/A,N/A,N/A,1934,1937,N/A,13,3
2,N/A,N/A,N/A,1932,1934,N/A,17,1
3,N/A,N/A,N/A,1929,1932,N/A,20,4
3,N/A,N/A,N/A,1926,1929,N/A,24,2
2,N/A,N/A,N/A,1924,1926,N/A,30,2
1,N/A,N/A,N/A,1923,1924,N/A,35,1
1,N/A,N/A,N/A,1922,1923,N/A,41,1
7,N/A,N/A,N/A,1915,1922,N/A,46,6
2,N/A,N/A,N/A,1913,1915,N/A,52,0
6,N/A,N/A,N/A,1907,1913,N/A,58,6
5,N/A,N/A,N/A,1902,1907,N/A,63,5
5,N/A,N/A,N/A,1897,1902,N/A,69,5
2,N/A,N/A,N/A,1895,1897,N/A,72,2
6,N/A,N/A,N/A,1889,1895,N/A,76,6
3,N/A,N/A,N/A,1886,1889,N/A,80,4
2,N/A,N/A,N/A,1884,1886,N/A,85,3
6,N/A,N/A,N/A,1878,1884,N/A,88,6
2,N/A,N/A,N/A,1876,1878,N/A,94,0
3,N/A,N/A,N/A,1873,1876,N/A,98,4
3,N/A,N/A,N/A,1870,1873,N/A,102,2
6,N/A,N/A,N/A,1864,1870,N/A,106,6
3,N/A,N/A,N/A,1861,1864,N/A,109,3
2,N/A,N/A,N/A,1859,1861,N/A,115,3
6,N/A,N/A,N/A,1853,1859,N/A,118,6
4,N/A,N/A,N/A,1849,1853,N/A,122,4
2,N/A,N/A,N/A,1847,1849,N/A,125,1
2,N/A,N/A,N/A,1845,1847,N/A,131,1
5,N/A,N/A,N/A,1840,1845,N/A,135,5
3,N/A,N/A,N/A,1643,1646,N/A,6,4
3,N/A,N/A,N/A,1640,1643,N/A,11,3
1,N/A,N/A,N/A,1639,1640,N/A,15,1
6,N/A,N/A,N/A,1633,1639,N/A,19,5
4,N/A,N/A,N/A,1629,1633,N/A,24,4
1,N/A,N/A,N/A,1628,1629,N/A,27,1
2,N/A,N/A,N/A,1626,1628,N/A,33,1
7,N/A,N/A,N/A,1619,1626,N/A,38,6
2,N/A,N/A,N/A,1617,1619,N/A,41,3
2,N/A,N/A,N/A,1615,1617,N/A,45,1
6,N/A,N/A,N/A,1609,1615,N/A,49,5
3,N/A,N/A,N/A,1606,1609,N/A,52,2
2,N/A,N/A,N/A,1604,1606,N/A,58,2
3,N/A,N/A,N/A,1601,1604,N/A,64,2
5,N/A,N/A,N/A,1596,1601,N/A,67,5
2,N/A,N/A,N/A,1594,1596,N/A,70,2
3,N/A,N/A,N/A,1591,1594,N/A,76,2
6,N/A,N/A,N/A,1585,1591,N/A,80,6
3,N/A,N/A,N/A,1582,1585,N/A,84,4
2,N/A,N/A,N/A,1580,1582,N/A,87,1
2,N/A,N/A,N/A,1578,1580,N/A,93,1
6,N/A,N/A,N/A,1572,1578,N/A,97,5
2,N/A,N/A,N/A,1570,1572,N/A,100,2
7,N/A,N/A,N/A,1563,1570,N/A,104,6
5,N/A,N/A,N/A,1558,1563,N/A,109,5
2,N/A,N/A,N/A,1556,1558,N/A,113,3
1,N/A,N/A,N/A,1555,1556,N/A,117,1
6,N/A,N/A,N/A,1549,1555,N/A,121,5
5,N/A,N/A,N/A,1544,1549,N/A,127,5
4,N/A,N/A,N/A,1540,1544,N/A,132,4
3,N/A,N/A,N/A,1369,1372,N/A,5,3
3,N/A,N/A,N/A,1366,1369,N/A,10,2
6,N/A,N/A,N/A,1360,1366,N/A,13,5
3,N/A,N/A,N/A,1357,1360,N/A,16,2
6,N/A,N/A,N/A,1351,1357,N/A,19,5
2,N/A,N/A,N/A,1349,1351,N/A,23,3
6,N/A,N/A,N/A,1343,1349,N/A,26,6
2,N/A,N/A,N/A,1341,1343,N/A,32,0
4,N/A,N/A,N/A,1337,1341,N/A,36,4
1,N/A,N/A,N/A,1336,1337,N/A,39,1
6,N/A,N/A,N/A,1330,1336,N/A,44,6
1,N/A,N/A,N/A,1329,1330,N/A,50,0
2,N/A,N/A,N/A,1327,1329,N/A,53,3
7,N/A,N/A,N/A,1320,1327,N/A,56,6
6,N/A,N/A,N/A,1314,1320,N/A,61,5
2,N/A,N/A,N/A,1312,1314,N/A,65,3
1,N/A,N/A,N/A,1311,1312,N/A,69,1
6,N/A,N/A,N/A,1305,1311,N/A,74,6
4,N/A,N/A,N/A,1301,1305,N/A,78,4
3,N/A,N/A,N/A,1298,1301,N/A,82,2
5,N/A,N/A,N/A,1293,1298,N/A,85,5
3,N/A,N/A,N/A,1290,1293,N/A,88,2
2,N/A,N/A,N/A,1288,1290,N/A,94,2
7,N/A,N/A,N/A,1281,1288,N/A,98,6
6,N/A,N/A,N/A,1275,1281,N/A,103,5
2,N/A,N/A,N/A,1273,1275,N/A,106,2
1,N/A,N/A,N/A,1272,1273,N/A,111,1
2,N/A,N/A,N/A,1270,1272,N/A,117,1
2,N/A,N/A,N/A,1268,1270,N/A,123,1
6,N/A,N/A,N/A,1262,1268,N/A,128,6
1,N/A,N/A,N/A,539,540,N/A,6,1
6,N/A,N/A,N/A,533,539,N/A,10,5
5,N/A,N/A,N/A,528,533,N/A,16,5
2,N/A,N/A,N/A,526,528,N/A,19,2
2,N/A,N/A,N/A,524,526,N/A,25,2
1,N/A,N/A,N/A,523,524,N/A,30,1
3,N/A,N/A,N/A,520,523,N/A,33,4
2,N/A,N/A,N/A,518,520,N/A,37,2
2,N/A,N/A,N/A,516,518,N/A,43,2
6,N/A,N/A,N/A,510,516,N/A,46,5
4,N/A,N/A,N/A,506,510,N/A,51,4
1,N/A,N/A,N/A,505,506,N/A,54,1
2,N/A,N/A,N/A,503,505,N/A,60,1
1,N/A,N/A,N/A,502,503,N/A,66,1
2,N/A,N/A,N/A,500,502,N/A,72,1
2,N/A,N/A,N/A,498,500,N/A,78,1
6,N/A,N/A,N/A,492,498,N/A,82,5
3,N/A,N/A,N/A,489,492,N/A,86,3
2,N/A,N/A,N/A,487,489,N/A,91,2
6,N/A,N/A,N/A,481,487,N/A,94,5
4,N/A,N/A,N/A,477,481,N/A,99,4
3,N/A,N/A,N/A,474,477,N/A,105,4
2,N/A,N/A,N/A,472,474,N/A,109,2
7,N/A,N/A,N/A,465,472,N/A,113,6
2,N/A,N/A,N/A,463,465,N/A,119,0
3,N/A,N/A,N/A,460,463,N/A,123,4
3,N/A,N/A,N/A,457,460,N/A,127,2
5,N/A,N/A,N/A,452,457,N/A,130,5
4,N/A,N/A,N/A,448,452,N/A,135,4
3,N/A,N/A,N/A,445,448,N/A,139,2
7,N/A,N/A,N/A,1350,1357,N/A,3,6
1,N/A,N/A,N/A,1349,1350,N/A,9,0
5,N/A,N/A,N/A,1344,1349,N/A,14,5
5,N/A,N/A,N/A,1339,1344,N/A,20,5
6,N/A,N/A,N/A,1333,1339,N/A,26,5
3,N/A,N/A,N/A,1330,1333,N/A,30,3
2,N/A,N/A,N/A,1328,1330,N/A,36,3
7,N/A,N/A,N/A,1321,1328,N/A,39,6
4,N/A,N/A,N/A,1317,1321,N/A,43,4
3,N/A,N/A,N/A,1314,1317,N/A,47,2
2,N/A,N/A,N/A,1312,1314,N/A,53,2
3,N/A,N/A,N/A,1309,1312,N/A,59,2
2,N/A,N/A,N/A,1307,1309,N/A,65,2
6,N/A,N/A,N/A,1301,1307,N/A,69,6
5,N/A,N/A,N/A,1296,1301,N/A,74,5
3,N/A,N/A,N/A,1293,1296,N/A,78,3
7,N/A,N/A,N/A,1286,1293,N/A,81,6
3,N/A,N/A,N/A,1283,1286,N/A,85,4
2,N/A,N/A,N/A,1281,1283,N/A,90,3
1,N/A,N/A,N/A,1280,1281,N/A,94,1
6,N/A,N/A,N/A,1274,1280,N/A,98,5
4,N/A,N/A,N/A,1270,1274,N/A,103,4
3,N/A,N/A,N/A,1267,1270,N/A,108,3
3,N/A,N/A,N/A,1264,1267,N/A,113,2
3,N/A,N/A,N/A,1261,1264,N/A,119,2
2,N/A,N/A,N/A,1259,1261,N/A,125,2
2,N/A,N/A,N/A,1257,1259,N/A,131,2
6,N/A,N/A,N/A,1251,1257,N/A,134,5
6,N/A,N/A,N/A,1245,1251,N/A,140,5
6,N/A,N/A,N/A,1239,1245,N/A,146,5
2,N/A,N/A,N/A,1547,1549,N/A,5,1
4,N/A,N/A,N/A,1543,1547,N/A,8,4
2,N/A,N/A,N/A,1541,1543,N/A,13,3
3,N/A,N/A,N/A,1538,1541,N/A,19,3
2,N/A,N/A,N/A,1536,1538,N/A,23,1
5,N/A,N/A,N/A,1531,1536,N/A,27,5
4,N/A,N/A,N/A,1527,1531,N/A,32,4
3,N/A,N/A,N/A,1524,1527,N/A,36,2
3,N/A,N/A,N/A,1521,1524,N/A,42,2
6,N/A,N/A,N/A,1515,1521,N/A,46,6
2,N/A,N/A,N/A,1513,1515,N/A,49,3
3,N/A,N/A,N/A,1510,1513,N/A,54,2
2,N/A,N/A,N/A,1508,1510,N/A,60,2
6,N/A,N/A,N/A,1502,1508,N/A,63,5
3,N/A,N/A,N/A,1499,1502,N/A,67,3
6,N/A,N/A,N/A,1493,1499,N/A,70,6
2,N/A,N/A,N/A,1491,1493,N/A,76,0
7,N/A,N/A,N/A,1484,1491,N/A,82,6
2,N/A,N/A,N/A,1482,1484,N/A,88,0
4,N/A,N/A,N/A,1478,1482,N/A,92,4
2,N/A,N/A,N/A,1476,1478,N/A,95,1
5,N/A,N/A,N/A,1471,1476,N/A,99,5
2,N/A,N/A,N/A,1469,1471,N/A,103,3
2,N/A,N/A,N/A,1467,1469,N/A,108,2
3,N/A,N/A,N/A,1464,1467,N/A,114,2
3,N/A,N/A,N/A,1461,1464,N/A,120,2
6,N/A,N/A,N/A,1455,1461,N/A,124,6
2,N/A,N/A,N/A,1453,1455,N/A,130,0
3,N/A,N/A,N/A,1450,1453,N/A,134,4
3,N/A,N/A,N/A,1447,1450,N/A,138,2
3,N/A,N/A,N/A,1244,1247,N/A,3,4
1,N/A,N/A,N/A,1243,1244,N/A,6,1
7,N/A,N/A,N/A,1236,1243,N/A,11,6
2,N/A,N/A,N/A,1234,1236,N/A,14,3
6,N/A,N/A,N/A,1228,1234,N/A,17,6
4,N/A,N/A,N/A,1224,1228,N/A,21,4
2,N/A,N/A,N/A,1222,1224,N/A,25,2
6,N/A,N/A,N/A,1216,1222,N/A,29,6
5,N/A,N/A,N/A,1211,1216,N/A,34,5
4,N/A,N/A,N/A,1207,1211,N/A,39,4
2,N/A,N/A,N/A,1205,1207,N/A,43,2
5,N/A,N/A,N/A,1200,1205,N/A,46,5
2,N/A,N/A,N/A,1198,1200,N/A,50,3
3,N/A,N/A,N/A,1195,1198,N/A,56,3
3,N/A,N/A,N/A,1192,1195,N/A,62,3
6,N/A,N/A,N/A,1186,1192,N/A,65,6
6,N/A,N/A,N/A,1180,1186,N/A,70,5
3,N/A,N/A,N/A,1177,1180,N/A,75,4
3,N/A,N/A,N/A,1174,1177,N/A,81,4
2,N/A,N/A,N/A,1172,1174,N/A,85,2
3,N/A,N/A,N/A,1169,1172,N/A,91,2
6,N/A,N/A,N/A,1163,1169,N/A,94,5
4,N/A,N/A,N/A,1159,1163,N/A,99,4
1,N/A,N/A,N/A,1158,1159,N/A,102,1
6,N/A,N/A,N/A,1152,1158,N/A,107,6
5,N/A,N/A,N/A,1147,1152,N/A,112,5
2,N/A,N/A,N/A,1145,1147,N/A,115,2
1,N/A,N/A,N/A,1144,1145,N/A,120,1
6,N/A,N/A,N/A,1138,1144,N/A,125,6
2,N/A,N/A,N/A,1136,1138,N/A,131,0
6,N/A,N/A,N/A,592,598,N/A,6,5
4,N/A,N/A,N/A,588,592,N/A,11,4
3,N/A,N/A,N/A,585,588,N/A,16,3
3,N/A,N/A,N/A,582,585,N/A,22,3
2,N/A,N/A,N/A,580,582,N/A,26,1
3,N/A,N/A,N/A,577,580,N/A,29,4
4,N/A,N/A,N/A,573,577,N/A,35,4
3,N/A,N/A,N/A,570,573,N/A,41,4
3,N/A,N/A,N/A,567,570,N/A,47,4
4,N/A,N/A,N/A,563,567,N/A,53,4
2,N/A,N/A,N/A,561,563,N/A,56,1
7,N/A,N/A,N/A,554,561,N/A,61,6
2,N/A,N/A,N/A,552,554,N/A,64,3
2,N/A,N/A,N/A,550,552,N/A,68,1
6,N/A,N/A,N/A,544,550,N/A,72,5
6,N/A,N/A,N/A,538,544,N/A,78,5
2,N/A,N/A,N/A,536,538,N/A,81,2
7,N/A,N/A,N/A,529,536,N/A,85,6
5,N/A,N/A,N/A,524,529,N/A,90,5
2,N/A,N/A,N/A,522,524,N/A,93,2
6,N/A,N/A,N/A,516,522,N/A,97,6
1,N/A,N/A,N/A,515,516,N/A,103,0
4,N/A,N/A,N/A,511,515,N/A,107,4
2,N/A,N/A,N/A,509,511,N/A,110,1
7,N/A,N/A,N/A,502,509,N/A,115,6
3,N/A,N/A,N/A,499,502,N/A,118,3
2,N/A,N/A,N/A,497,499,N/A,123,2
6,N/A,N/A,N/A,491,497,N/A,126,5
3,N/A,N/A,N/A,488,491,N/A,129,2
5,N/A,N/A,N/A,483,488,N/A,132,5
4,N/A,N/A,N/A,501,505,N/A,6,4
2,N/A,N/A,N/A,499,501,N/A,11,3
3,N/A,N/A,N/A,496,499,N/A,16,2
2,N/A,N/A,N/A,494,496,N/A,21,1
1,N/A,N/A,N/A,493,494,N/A,27,1
7,N/A,N/A,N/A,486,493,N/A,32,6
2,N/A,N/A,N/A,484,486,N/A,35,3
6,N/A,N/A,N/A,478,484,N/A,38,6
2,N/A,N/A,N/A,476,478,N/A,44,0
3,N/A,N/A,N/A,473,476,N/A,48,4
1,N/A,N/A,N/A,472,473,N/A,51,1
5,N/A,N/A,N/A,467,472,N/A,55,5
5,N/A,N/A,N/A,462,467,N/A,61,5
3,N/A,N/A,N/A,459,462,N/A,65,3
3,N/A,N/A,N/A,456,459,N/A,70,2
2,N/A,N/A,N/A,454,456,N/A,76,2
6,N/A,N/A,N/A,448,454,N/A,80,6
3,N/A,N/A,N/A,445,448,N/A,83,3
3,N/A,N/A,N/A,442,445,N/A,89,3
7,N/A,N/A,N/A,435,442,N/A,92,6
2,N/A,N/A,N/A,433,435,N/A,98,0
3,N/A,N/A,N/A,430,433,N/A,101,3
2,N/A,N/A,N/A,428,430,N/A,106,2
6,N/A,N/A,N/A,422,428,N/A,110,6
1,N/A,N/A,N/A,421,422,N/A,116,0
6,N/A,N/A,N/A,415,421,N/A,122,6
1,N/A,N/A,N/A,414,415,N/A,128,0
7,N/A,N/A,N/A,407,414,N/A,134,6
3,N/A,N/A,N/A,404,407,N/A,137,3
1,N/A,N/A,N/A,403,404,N/A,141,1
1,N/A,N/A,N/A,577,578,N/A,4,1
6,N/A,N/A,N/A,571,577,N/A,9,6
1,N/A,N/A,N/A,570,571,N/A,15,0
3,N/A,N/A,N/A,567,570,N/A,18,3
2,N/A,N/A,N/A,565,567,N/A,23,2
6,N/A,N/A,N/A,559,565,N/A,26,5
3,N/A,N/A,N/A,556,559,N/A,29,2
2,N/A,N/A,N/A,554,556,N/A,35,2
2,N/A,N/A,N/A,552,554,N/A,40,1
3,N/A,N/A,N/A,549,552,N/A,43,4
3,N/A,N/A,N/A,546,549,N/A,48,3
7,N/A,N/A,N/A,539,546,N/A,51,6
2,N/A,N/A,N/A,537,539,N/A,57,0
3,N/A,N/A,N/A,534,537,N/A,60,3
2,N/A,N/A,N/A,532,534,N/A,65,2
1,N/A,N/A,N/A,531,532,N/A,70,1
4,N/A,N/A,N/A,527,531,N/A,73,4
3,N/A,N/A,N/A,524,527,N/A,78,3
2,N/A,N/A,N/A,522,524,N/A,82,1
2,N/A,N/A,N/A,520,522,N/A,88,1
7,N/A,N/A,N/A,513,520,N/A,93,6
2,N/A,N/A,N/A,511,513,N/A,96,3
2,N/A,N/A,N/A,509,511,N/A,100,1
6,N/A,N/A,N/A,503,509,N/A,104,5
5,N/A,N/A,N/A,498,503,N/A,110,5
3,N/A,N/A,N/A,495,498,N/A,114,3
3,N/A,N/A,N/A,492,495,N/A,119,2
1,N/A,N/A,N/A,491,492,N/A,124,1
6,N/A,N/A,N/A,485,491,N/A,128,5
4,N/A,N/A,N/A,481,485,N/A,133,4
1,N/A,N/A,N/A,487,488,N/A,6,1
6,N/A,N/A,N/A,481,487,N/A,10,5
6,N/A,N/A,N/A,475,481,N/A,16,5
2,N/A,N/A,N/A,473,475,N/A,19,2
2,N/A,N/A,N/A,471,473,N/A,25,2
3,N/A,N/A,N/A,468,471,N/A,31,2
6,N/A,N/A,N/A,462,468,N/A,35,6
5,N/A,N/A,N/A,457,462,N/A,40,5
3,N/A,N/A,N/A,454,457,N/A,43,2
6,N/A,N/A,N/A,448,454,N/A,46,5
5,N/A,N/A,N/A,443,448,N/A,52,5
3,N/A,N/A,N/A,440,443,N/A,57,4
1,N/A,N/A,N/A,439,440,N/A,60,1
6,N/A,N/A,N/A,433,439,N/A,65,6
2,N/A,N/A,N/A,431,433,N/A,68,3
2,N/A,N/A,N/A,429,431,N/A,73,2
7,N/A,N/A,N/A,422,429,N/A,77,6
3,N/A,N/A,N/A,419,422,N/A,81,4
4,N/A,N/A,N/A,415,419,N/A,87,4
3,N/A,N/A,N/A,412,415,N/A,91,2
7,N/A,N/A,N/A,405,412,N/A,95,6
2,N/A,N/A,N/A,403,405,N/A,101,0
7,N/A,N/A,N/A,396,403,N/A,107,6
2,N/A,N/A,N/A,394,396,N/A,113,0
4,N/A,N/A,N/A,390,394,N/A,117,4
2,N/A,N/A,N/A,388,390,N/A,121,2
6,N/A,N/A,N/A,382,388,N/A,125,6
3,N/A,N/A,N/A,379,382,N/A,129,4
2,N/A,N/A,N/A,377,379,N/A,132,1
1,N/A,N/A,N/A,376,377,N/A,138,1
2,N/A,N/A,N/A,1725,1727,N/A,4,2
3,N/A,N/A,N/A,1722,1725,N/A,10,2
1,N/A,N/A,N/A,1721,1722,N/A,15,1
7,N/A,N/A,N/A,1714,1721,N/A,20,6
1,N/A,N/A,N/A,1713,1714,N/A,26,0
4,N/A,N/A,N/A,1709,1713,N/A,30,4
4,N/A,N/A,N/A,1705,1709,N/A,36,4
2,N/A,N/A,N/A,1703,1705,N/A,39,1
7,N/A,N/A,N/A,1696,1703,N/A,44,6
5,N/A,N/A,N/A,1691,1696,N/A,49,5
5,N/A,N/A,N/A,1686,1691,N/A,55,5
4,N/A,N/A,N/A,1682,1686,N/A,60,4
2,N/A,N/A,N/A,1680,1682,N/A,64,2
2,N/A,N/A,N/A,1678,1680,N/A,70,2
6,N/A,N/A,N/A,1672,1678,N/A,74,6
2,N/A,N/A,N/A,1670,1672,N/A,80,0
7,N/A,N/A,N/A,1663,1670,N/A,86,6
5,N/A,N/A,N/A,1658,1663,N/A,91,5
3,N/A,N/A,N/A,1655,1658,N/A,96,4
3,N/A,N/A,N/A,1652,1655,N/A,101,3
3,N/A,N/A,N/A,1649,1652,N/A,106,2
2,N/A,N/A,N/A,1647,1649,N/A,111,1
3,N/A,N/A,N/A,1644,1647,N/A,114,4
3,N/A,N/A,N/A,1641,1644,N/A,120,4
3,N/A,N/A,N/A,1638,1641,N/A,126,4
4,N/A,N/A,N/A,1634,1638,N/A,132,4
3,N/A,N/A,N/A,1631,1634,N/A,136,2
6,N/A,N/A,N/A,1625,1631,N/A,139,5
2,N/A,N/A,N/A,1623,1625,N/A,142,2
3,N/A,N/A,N/A,1620,1623,N/A,148,2
3,N/A,N/A,N/A,1267,1270,N/A,4,4
3,N/A,N/A,N/A,1264,1267,N/A,10,4
3,N/A,N/A,N/A,1261,1264,N/A,14,2
3,N/A,N/A,N/A,1258,1261,N/A,20,2
7,N/A,N/A,N/A,1251,1258,N/A,24,6
3,N/A,N/A,N/A,1248,1251,N/A,28,4
3,N/A,N/A,N/A,1245,1248,N/A,32,2
2,N/A,N/A,N/A,1243,1245,N/A,38,2
6,N/A,N/A,N/A,1237,1243,N/A,41,5
4,N/A,N/A,N/A,1233,1237,N/A,46,4
3,N/A,N/A,N/A,1230,1233,N/A,50,2
7,N/A,N/A,N/A,1223,1230,N/A,54,6
5,N/A,N/A,N/A,1218,1223,N/A,59,5
2,N/A,N/A,N/A,1216,1218,N/A,63,3
3,N/A,N/A,N/A,1213,1216,N/A,68,2
6,N/A,N/A,N/A,1207,1213,N/A,72,6
2,N/A,N/A,N/A,1205,1207,N/A,78,0
5,N/A,N/A,N/A,1200,1205,N/A,83,5
3,N/A,N/A,N/A,1197,1200,N/A,88,4
4,N/A,N/A,N/A,1193,1197,N/A,94,4
1,N/A,N/A,N/A,1192,1193,N/A,97,1
5,N/A,N/A,N/A,1187,1192,N/A,101,5
3,N/A,N/A,N/A,1184,1187,N/A,105,3
7,N/A,N/A,N/A,1177,1184,N/A,108,6
3,N/A,N/A,N/A,1174,1177,N/A,111,3
2,N/A,N/A,N/A,1172,1174,N/A,116,2
3,N/A,N/A,N/A,1169,1172,N/A,122,2
3,N/A,N/A,N/A,1166,1169,N/A,128,2
6,N/A,N/A,N/A,1160,1166,N/A,131,5
2,N/A,N/A,N/A,1158,1160,N/A,135,3
2,N/A,N/A,N/A,330,332,N/A,4,1
4,N/A,N/A,N/A,326,330,N/A,7,4
2,N/A,N/A,N/A,324,326,N/A,12,3
3,N/A,N/A,N/A,321,324,N/A,18,3
2,N/A,N/A,N/A,319,321,N/A,22,1
6,N/A,N/A,N/A,313,319,N/A,27,6
1,N/A,N/A,N/A,312,313,N/A,33,0
3,N/A,N/A,N/A,309,312,N/A,37,4
3,N/A,N/A,N/A,306,309,N/A,41,2
6,N/A,N/A,N/A,300,306,N/A,45,6
3,N/A,N/A,N/A,297,300,N/A,48,3
1,N/A,N/A,N/A,296,297,N/A,52,1
6,N/A,N/A,N/A,290,296,N/A,57,6
2,N/A,N/A,N/A,288,290,N/A,60,3
3,N/A,N/A,N/A,285,288,N/A,66,3
2,N/A,N/A,N/A,283,285,N/A,71,2
6,N/A,N/A,N/A,277,283,N/A,75,6
1,N/A,N/A,N/A,276,277,N/A,81,0
2,N/A,N/A,N/A,274,276,N/A,84,3
2,N/A,N/A,N/A,272,274,N/A,89,2
2,N/A,N/A,N/A,270,272,N/A,95,2
1,N/A,N/A,N/A,269,270,N/A,100,1
6,N/A,N/A,N/A,263,269,N/A,104,5
2,N/A,N/A,N/A,261,263,N/A,107,2
3,N/A,N/A,N/A,258,261,N/A,113,2
7,N/A,N/A,N/A,251,258,N/A,117,6
6,N/A,N/A,N/A,245,251,N/A,122,5
2,N/A,N/A,N/A,243,245,N/A,125,2
1,N/A,N/A,N/A,242,243,N/A,130,1
3,N/A,N/A,N/A,239,242,N/A,133,4
6,N/A,N/A,N/A,428,434,N/A,4,5
3,N/A,N/A,N/A,425,428,N/A,9,4
3,N/A,N/A,N/A,422,425,N/A,14,3
6,N/A,N/A,N/A,416,422,N/A,17,6
2,N/A,N/A,N/A,414,416,N/A,20,3
2,N/A,N/A,N/A,412,414,N/A,25,2
2,N/A,N/A,N/A,410,412,N/A,30,1
6,N/A,N/A,N/A,404,410,N/A,35,6
2,N/A,N/A,N/A,402,404,N/A,41,0
3,N/A,N/A,N/A,399,402,N/A,45,4
3,N/A,N/A,N/A,396,399,N/A,51,4
1,N/A,N/A,N/A,395,396,N/A,54,1
3,N/A,N/A,N/A,392,395,N/A,57,4
4,N/A,N/A,N/A,388,392,N/A,63,4
2,N/A,N/A,N/A,386,388,N/A,68,3
3,N/A,N/A,N/A,383,386,N/A,74,3
3,N/A,N/A,N/A,380,383,N/A,79,2
2,N/A,N/A,N/A,378,380,N/A,85,2
6,N/A,N/A,N/A,372,378,N/A,88,5
2,N/A,N/A,N/A,370,372,N/A,92,3
6,N/A,N/A,N/A,364,370,N/A,95,6
2,N/A,N/A,N/A,362,364,N/A,101,0
3,N/A,N/A,N/A,359,362,N/A,104,3
2,N/A,N/A,N/A,357,359,N/A,109,2
3,N/A,N/A,N/A,354,357,N/A,115,2
6,N/A,N/A,N/A,348,354,N/A,118,5
3,N/A,N/A,N/A,345,348,N/A,122,3
2,N/A,N/A,N/A,343,345,N/A,128,3
2,N/A,N/A,N/A,341,343,N/A,134,3
1,N/A,N/A,N/A,340,341,N/A,138,1
3,N/A,N/A,N/A,1417,1420,N/A,3,4
2,N/A,N/A,N/A,1415,1417,N/A,6,1
4,N/A,N/A,N/A,1411,1415,N/A,9,4
3,N/A,N/A,N/A,1408,1411,N/A,13,2
6,N/A,N/A,N/A,1402,1408,N/A,16,5
4,N/A,N/A,N/A,1398,1402,N/A,21,4
3,N/A,N/A,N/A,1395,1398,N/A,27,4
2,N/A,N/A,N/A,1393,1395,N/A,32,3
3,N/A,N/A,N/A,1390,1393,N/A,37,2
5,N/A,N/A,N/A,1385,1390,N/A,40,5
3,N/A,N/A,N/A,1382,1385,N/A,44,3
2,N/A,N/A,N/A,1380,1382,N/A,50,3
3,N/A,N/A,N/A,1377,1380,N/A,55,2
2,N/A,N/A,N/A,1375,1377,N/A,61,2
7,N/A,N/A,N/A,1368,1375,N/A,65,6
1,N/A,N/A,N/A,1367,1368,N/A,71,0
6,N/A,N/A,N/A,1361,1367,N/A,77,6
3,N/A,N/A,N/A,1358,1361,N/A,80,3
1,N/A,N/A,N/A,1357,1358,N/A,84,1
4,N/A,N/A,N/A,1353,1357,N/A,87,4
2,N/A,N/A,N/A,1351,1353,N/A,90,1
7,N/A,N/A,N/A,1344,1351,N/A,95,6
3,N/A,N/A,N/A,1341,1344,N/A,99,4
2,N/A,N/A,N/A,1339,1341,N/A,102,1
7,N/A,N/A,N/A,1332,1339,N/A,107,6
5,N/A,N/A,N/A,1327,1332,N/A,112,5
2,N/A,N/A,N/A,1325,1327,N/A,116,3
7,N/A,N/A,N/A,1318,1325,N/A,119,6
3,N/A,N/A,N/A,1315,1318,N/A,122,3
1,N/A,N/A,N/A,1314,1315,N/A,126,1
