amount,category,date,name,newBalance,previousBalance,reference,timeDiff,dayOfWeek
2,N/A,N/A,N/A,1057,1059,N/A,6,1
13,N/A,N/A,N/A,1044,1057,N/A,11,6
12,N/A,N/A,N/A,1032,1044,N/A,15,4
4,N/A,N/A,N/A,1028,1032,N/A,19,2
17,N/A,N/A,N/A,1011,1028,N/A,23,6
2,N/A,N/A,N/A,1009,1011,N/A,26,3
2,N/A,N/A,N/A,1007,1009,N/A,32,3
14,N/A,N/A,N/A,993,1007,N/A,35,6
19,N/A,N/A,N/A,974,993,N/A,40,5
4,N/A,N/A,N/A,970,974,N/A,43,2
14,N/A,N/A,N/A,956,970,N/A,46,5
4,N/A,N/A,N/A,952,956,N/A,50,3
1,N/A,N/A,N/A,951,952,N/A,54,1
1,N/A,N/A,N/A,950,951,N/A,60,1
7,N/A,N/A,N/A,943,950,N/A,63,4
2,N/A,N/A,N/A,941,943,N/A,66,1
8,N/A,N/A,N/A,933,941,N/A,69,4
14,N/A,N/A,N/A,919,933,N/A,75,4
2,N/A,N/A,N/A,917,919,N/A,78,1
1,N/A,N/A,N/A,916,917,N/A,84,1
10,N/A,N/A,N/A,906,916,N/A,87,4
3,N/A,N/A,N/A,903,906,N/A,91,2
2,N/A,N/A,N/A,901,903,N/A,97,2
17,N/A,N/A,N/A,884,901,N/A,101,6
2,N/A,N/A,N/A,882,884,N/A,104,3
20,N/A,N/A,N/A,862,882,N/A,107,6
1,N/A,N/A,N/A,861,862,N/A,113,0
20,N/A,N/A,N/A,841,861,N/A,119,6
4,N/A,N/A,N/A,837,841,N/A,122,3
2,N/A,N/A,N/A,835,837,N/A,126,1
2,N/A,N/A,N/A,317,319,N/A,3,3
1,N/A,N/A,N/A,316,317,N/A,7,1
1,N/A,N/A,N/A,315,316,N/A,13,1
2,N/A,N/A,N/A,313,315,N/A,19,1
14,N/A,N/A,N/A,299,313,N/A,22,4
4,N/A,N/A,N/A,295,299,N/A,26,2
19,N/A,N/A,N/A,276,295,N/A,29,5
13,N/A,N/A,N/A,263,276,N/A,34,4
7,N/A,N/A,N/A,256,263,N/A,40,4
2,N/A,N/A,N/A,254,256,N/A,44,2
17,N/A,N/A,N/A,237,254,N/A,47,5
12,N/A,N/A,N/A,225,237,N/A,53,5
2,N/A,N/A,N/A,223,225,N/A,56,2
4,N/A,N/A,N/A,219,223,N/A,62,2
2,N/A,N/A,N/A,217,219,N/A,68,2
13,N/A,N/A,N/A,204,217,N/A,72,6
6,N/A,N/A,N/A,198,204,N/A,76,4
9,N/A,N/A,N/A,189,198,N/A,82,4
4,N/A,N/A,N/A,185,189,N/A,87,3
3,N/A,N/A,N/A,182,185,N/A,93,3
3,N/A,N/A,N/A,179,182,N/A,99,3
1,N/A,N/A,N/A,178,179,N/A,103,1
13,N/A,N/A,N/A,165,178,N/A,107,5
15,N/A,N/A,N/A,150,165,N/A,113,5
10,N/A,N/A,N/A,140,150,N/A,119,5
11,N/A,N/A,N/A,129,140,N/A,125,5
2,N/A,N/A,N/A,127,129,N/A,128,2
4,N/A,N/A,N/A,123,127,N/A,134,2
1,N/A,N/A,N/A,122,123,N/A,139,1
13,N/A,N/A,N/A,109,122,N/A,142,4
15,N/A,N/A,N/A,538,553,N/A,4,6
13,N/A,N/A,N/A,525,538,N/A,9,5
14,N/A,N/A,N/A,511,525,N/A,14,4
1,N/A,N/A,N/A,510,511,N/A,17,1
15,N/A,N/A,N/A,495,510,N/A,22,6
2,N/A,N/A,N/A,493,495,N/A,28,0
8,N/A,N/A,N/A,485,493,N/A,32,4
5,N/A,N/A,N/A,480,485,N/A,38,4
2,N/A,N/A,N/A,478,480,N/A,43,3
3,N/A,N/A,N/A,475,478,N/A,48,2
11,N/A,N/A,N/A,464,475,N/A,52,6
18,N/A,N/A,N/A,446,464,N/A,57,5
9,N/A,N/A,N/A,437,446,N/A,62,4
12,N/A,N/A,N/A,425,437,N/A,68,4
2,N/A,N/A,N/A,423,425,N/A,71,1
10,N/A,N/A,N/A,413,423,N/A,75,5
10,N/A,N/A,N/A,403,413,N/A,80,4
3,N/A,N/A,N/A,400,403,N/A,84,2
11,N/A,N/A,N/A,389,400,N/A,87,5
3,N/A,N/A,N/A,386,389,N/A,91,3
4,N/A,N/A,N/A,382,386,N/A,97,3
4,N/A,N/A,N/A,378,382,N/A,102,2
2,N/A,N/A,N/A,376,378,N/A,108,2
1,N/A,N/A,N/A,375,376,N/A,113,1
12,N/A,N/A,N/A,363,375,N/A,117,5
3,N/A,N/A,N/A,360,363,N/A,120,2
11,N/A,N/A,N/A,349,360,N/A,124,6
2,N/A,N/A,N/A,347,349,N/A,130,0
3,N/A,N/A,N/A,344,347,N/A,133,3
1,N/A,N/A,N/A,343,344,N/A,137,1
2,N/A,N/A,N/A,384,386,N/A,5,2
2,N/A,N/A,N/A,382,384,N/A,11,2
20,N/A,N/A,N/A,362,382,N/A,15,6
5,N/A,N/A,N/A,357,362,N/A,19,4
4,N/A,N/A,N/A,353,357,N/A,23,2
1,N/A,N/A,N/A,352,353,N/A,28,1
11,N/A,N/A,N/A,341,352,N/A,32,5
3,N/A,N/A,N/A,338,341,N/A,35,2
2,N/A,N/A,N/A,336,338,N/A,40,1
2,N/A,N/A,N/A,334,336,N/A,46,1
11,N/A,N/A,N/A,323,334,N/A,50,5
12,N/A,N/A,N/A,311,323,N/A,55,4
1,N/A,N/A,N/A,310,311,N/A,58,1
9,N/A,N/A,N/A,301,310,N/A,61,4
2,N/A,N/A,N/A,299,301,N/A,65,2
2,N/A,N/A,N/A,297,299,N/A,70,1
12,N/A,N/A,N/A,285,297,N/A,73,4
1,N/A,N/A,N/A,284,285,N/A,76,1
1,N/A,N/A,N/A,283,284,N/A,82,1
19,N/A,N/A,N/A,264,283,N/A,87,6
1,N/A,N/A,N/A,263,264,N/A,93,0
4,N/A,N/A,N/A,259,263,N/A,96,3
14,N/A,N/A,N/A,245,259,N/A,99,6
7,N/A,N/A,N/A,238,245,N/A,103,4
3,N/A,N/A,N/A,235,238,N/A,107,2
20,N/A,N/A,N/A,215,235,N/A,111,6
3,N/A,N/A,N/A,212,215,N/A,114,3
1,N/A,N/A,N/A,211,212,N/A,118,1
11,N/A,N/A,N/A,200,211,N/A,123,6
15,N/A,N/A,N/A,185,200,N/A,128,5
10,N/A,N/A,N/A,1576,1586,N/A,5,5
3,N/A,N/A,N/A,1573,1576,N/A,8,2
2,N/A,N/A,N/A,1571,1573,N/A,13,1
12,N/A,N/A,N/A,1559,1571,N/A,17,5
4,N/A,N/A,N/A,1555,1559,N/A,21,3
1,N/A,N/A,N/A,1554,1555,N/A,25,1
1,N/A,N/A,N/A,1553,1554,N/A,31,1
14,N/A,N/A,N/A,1539,1553,N/A,35,5
4,N/A,N/A,N/A,1535,1539,N/A,39,3
1,N/A,N/A,N/A,1534,1535,N/A,43,1
11,N/A,N/A,N/A,1523,1534,N/A,48,6
16,N/A,N/A,N/A,1507,1523,N/A,53,5
7,N/A,N/A,N/A,1500,1507,N/A,58,4
2,N/A,N/A,N/A,1498,1500,N/A,61,1
2,N/A,N/A,N/A,1496,1498,N/A,67,1
13,N/A,N/A,N/A,1483,1496,N/A,70,4
1,N/A,N/A,N/A,1482,1483,N/A,73,1
5,N/A,N/A,N/A,1477,1482,N/A,76,4
8,N/A,N/A,N/A,1469,1477,N/A,82,4
4,N/A,N/A,N/A,1465,1469,N/A,87,3
4,N/A,N/A,N/A,1461,1465,N/A,92,2
13,N/A,N/A,N/A,1448,1461,N/A,95,5
19,N/A,N/A,N/A,1429,1448,N/A,101,5
3,N/A,N/A,N/A,1426,1429,N/A,105,3
4,N/A,N/A,N/A,1422,1426,N/A,111,3
1,N/A,N/A,N/A,1421,1422,N/A,115,1
2,N/A,N/A,N/A,1419,1421,N/A,121,1
1,N/A,N/A,N/A,1418,1419,N/A,127,1
2,N/A,N/A,N/A,1416,1418,N/A,133,1
8,N/A,N/A,N/A,1408,1416,N/A,136,4
14,N/A,N/A,N/A,400,414,N/A,6,4
2,N/A,N/A,N/A,398,400,N/A,10,2
17,N/A,N/A,N/A,381,398,N/A,14,6
2,N/A,N/A,N/A,379,381,N/A,20,0
18,N/A,N/A,N/A,361,379,N/A,26,6
14,N/A,N/A,N/A,347,361,N/A,30,4
2,N/A,N/A,N/A,345,347,N/A,33,1
18,N/A,N/A,N/A,327,345,N/A,37,5
10,N/A,N/A,N/A,317,327,N/A,43,5
3,N/A,N/A,N/A,314,317,N/A,47,3
1,N/A,N/A,N/A,313,314,N/A,51,1
8,N/A,N/A,N/A,305,313,N/A,54,4
1,N/A,N/A,N/A,304,305,N/A,57,1
7,N/A,N/A,N/A,297,304,N/A,60,4
1,N/A,N/A,N/A,296,297,N/A,63,1
2,N/A,N/A,N/A,294,296,N/A,69,1
11,N/A,N/A,N/A,283,294,N/A,74,6
16,N/A,N/A,N/A,267,283,N/A,79,5
4,N/A,N/A,N/A,263,267,N/A,82,2
1,N/A,N/A,N/A,262,263,N/A,87,1
2,N/A,N/A,N/A,260,262,N/A,93,1
15,N/A,N/A,N/A,245,260,N/A,97,5
12,N/A,N/A,N/A,233,245,N/A,102,4
2,N/A,N/A,N/A,231,233,N/A,105,1
17,N/A,N/A,N/A,214,231,N/A,110,6
2,N/A,N/A,N/A,212,214,N/A,113,3
14,N/A,N/A,N/A,198,212,N/A,116,6
19,N/A,N/A,N/A,179,198,N/A,121,5
11,N/A,N/A,N/A,168,179,N/A,127,5
7,N/A,N/A,N/A,161,168,N/A,132,4
12,N/A,N/A,N/A,478,490,N/A,5,5
3,N/A,N/A,N/A,475,478,N/A,9,3
2,N/A,N/A,N/A,473,475,N/A,14,2
14,N/A,N/A,N/A,459,473,N/A,17,5
14,N/A,N/A,N/A,445,459,N/A,23,5
15,N/A,N/A,N/A,430,445,N/A,29,5
14,N/A,N/A,N/A,416,430,N/A,34,4
2,N/A,N/A,N/A,414,416,N/A,37,1
12,N/A,N/A,N/A,402,414,N/A,40,4
3,N/A,N/A,N/A,399,402,N/A,44,2
2,N/A,N/A,N/A,397,399,N/A,49,1
10,N/A,N/A,N/A,387,397,N/A,52,4
7,N/A,N/A,N/A,380,387,N/A,58,4
4,N/A,N/A,N/A,376,380,N/A,62,2
14,N/A,N/A,N/A,362,376,N/A,65,5
13,N/A,N/A,N/A,349,362,N/A,70,4
3,N/A,N/A,N/A,346,349,N/A,75,3
18,N/A,N/A,N/A,328,346,N/A,78,6
4,N/A,N/A,N/A,324,328,N/A,81,3
2,N/A,N/A,N/A,322,324,N/A,87,3
4,N/A,N/A,N/A,318,322,N/A,93,3
3,N/A,N/A,N/A,315,318,N/A,99,3
3,N/A,N/A,N/A,312,315,N/A,104,2
1,N/A,N/A,N/A,311,312,N/A,109,1
14,N/A,N/A,N/A,297,311,N/A,112,4
2,N/A,N/A,N/A,295,297,N/A,117,3
3,N/A,N/A,N/A,292,295,N/A,123,3
15,N/A,N/A,N/A,277,292,N/A,126,6
1,N/A,N/A,N/A,276,277,N/A,132,0
15,N/A,N/A,N/A,261,276,N/A,137,5
2,N/A,N/A,N/A,638,640,N/A,3,3
4,N/A,N/A,N/A,634,638,N/A,9,3
2,N/A,N/A,N/A,632,634,N/A,13,1
15,N/A,N/A,N/A,617,632,N/A,17,5
13,N/A,N/A,N/A,604,617,N/A,23,5
19,N/A,N/A,N/A,585,604,N/A,29,5
19,N/A,N/A,N/A,566,585,N/A,35,5
4,N/A,N/A,N/A,562,566,N/A,38,2
4,N/A,N/A,N/A,558,562,N/A,44,2
1,N/A,N/A,N/A,557,558,N/A,49,1
16,N/A,N/A,N/A,541,557,N/A,53,5
2,N/A,N/A,N/A,539,541,N/A,57,3
18,N/A,N/A,N/A,521,539,N/A,60,6
1,N/A,N/A,N/A,520,521,N/A,66,0
3,N/A,N/A,N/A,517,520,N/A,69,3
19,N/A,N/A,N/A,498,517,N/A,72,6
8,N/A,N/A,N/A,490,498,N/A,76,4
4,N/A,N/A,N/A,486,490,N/A,80,2
11,N/A,N/A,N/A,475,486,N/A,84,6
18,N/A,N/A,N/A,457,475,N/A,89,5
9,N/A,N/A,N/A,448,457,N/A,94,4
7,N/A,N/A,N/A,441,448,N/A,100,4
4,N/A,N/A,N/A,437,441,N/A,104,2
1,N/A,N/A,N/A,436,437,N/A,109,1
6,N/A,N/A,N/A,430,436,N/A,112,4
2,N/A,N/A,N/A,428,430,N/A,116,2
18,N/A,N/A,N/A,410,428,N/A,120,6
11,N/A,N/A,N/A,399,410,N/A,124,4
3,N/A,N/A,N/A,396,399,N/A,128,2
11,N/A,N/A,N/A,385,396,N/A,132,6
2,N/A,N/A,N/A,408,410,N/A,3,1
1,N/A,N/A,N/A,407,408,N/A,9,1
14,N/A,N/A,N/A,393,407,N/A,13,5
2,N/A,N/A,N/A,391,393,N/A,17,3
16,N/A,N/A,N/A,375,391,N/A,20,6
2,N/A,N/A,N/A,373,375,N/A,26,0
16,N/A,N/A,N/A,357,373,N/A,32,6
2,N/A,N/A,N/A,355,357,N/A,35,3
2,N/A,N/A,N/A,353,355,N/A,39,1
18,N/A,N/A,N/A,335,353,N/A,43,5
4,N/A,N/A,N/A,331,335,N/A,47,3
2,N/A,N/A,N/A,329,331,N/A,53,3
12,N/A,N/A,N/A,317,329,N/A,56,6
10,N/A,N/A,N/A,307,317,N/A,60,4
10,N/A,N/A,N/A,297,307,N/A,66,4
4,N/A,N/A,N/A,293,297,N/A,70,2
3,N/A,N/A,N/A,290,293,N/A,76,2
18,N/A,N/A,N/A,272,290,N/A,79,5
3,N/A,N/A,N/A,269,272,N/A,83,3
4,N/A,N/A,N/A,265,269,N/A,89,3
2,N/A,N/A,N/A,263,265,N/A,95,3
4,N/A,N/A,N/A,259,263,N/A,100,2
19,N/A,N/A,N/A,240,259,N/A,103,5
3,N/A,N/A,N/A,237,240,N/A,106,2
12,N/A,N/A,N/A,225,237,N/A,110,6
2,N/A,N/A,N/A,223,225,N/A,116,0
18,N/A,N/A,N/A,205,223,N/A,122,6
11,N/A,N/A,N/A,194,205,N/A,126,4
2,N/A,N/A,N/A,192,194,N/A,130,2
2,N/A,N/A,N/A,190,192,N/A,135,1
1,N/A,N/A,N/A,478,479,N/A,5,1
16,N/A,N/A,N/A,462,478,N/A,10,6
2,N/A,N/A,N/A,460,462,N/A,13,3
1,N/A,N/A,N/A,459,460,N/A,17,1
6,N/A,N/A,N/A,453,459,N/A,20,4
6,N/A,N/A,N/A,447,453,N/A,26,4
4,N/A,N/A,N/A,443,447,N/A,31,3
19,N/A,N/A,N/A,424,443,N/A,34,6
3,N/A,N/A,N/A,421,424,N/A,37,3
2,N/A,N/A,N/A,419,421,N/A,41,1
5,N/A,N/A,N/A,414,419,N/A,44,4
3,N/A,N/A,N/A,411,414,N/A,48,2
2,N/A,N/A,N/A,409,411,N/A,53,1
18,N/A,N/A,N/A,391,409,N/A,57,5
10,N/A,N/A,N/A,381,391,N/A,62,4
1,N/A,N/A,N/A,380,381,N/A,65,1
15,N/A,N/A,N/A,365,380,N/A,69,5
12,N/A,N/A,N/A,353,365,N/A,74,4
3,N/A,N/A,N/A,350,353,N/A,78,2
19,N/A,N/A,N/A,331,350,N/A,81,5
15,N/A,N/A,N/A,316,331,N/A,87,5
12,N/A,N/A,N/A,304,316,N/A,93,5
2,N/A,N/A,N/A,302,304,N/A,97,3
4,N/A,N/A,N/A,298,302,N/A,103,3
2,N/A,N/A,N/A,296,298,N/A,107,1
2,N/A,N/A,N/A,294,296,N/A,113,1
18,N/A,N/A,N/A,276,294,N/A,117,5
13,N/A,N/A,N/A,263,276,N/A,122,4
13,N/A,N/A,N/A,250,263,N/A,128,4
6,N/A,N/A,N/A,244,250,N/A,134,4
11,N/A,N/A,N/A,1617,1628,N/A,3,5
4,N/A,N/A,N/A,1613,1617,N/A,7,3
1,N/A,N/A,N/A,1612,1613,N/A,11,1
18,N/A,N/A,N/A,1594,1612,N/A,16,6
11,N/A,N/A,N/A,1583,1594,N/A,20,4
8,N/A,N/A,N/A,1575,1583,N/A,26,4
12,N/A,N/A,N/A,1563,1575,N/A,32,4
2,N/A,N/A,N/A,1561,1563,N/A,35,1
17,N/A,N/A,N/A,1544,1561,N/A,39,5
11,N/A,N/A,N/A,1533,1544,N/A,45,5
16,N/A,N/A,N/A,1517,1533,N/A,51,5
2,N/A,N/A,N/A,1515,1517,N/A,54,2
18,N/A,N/A,N/A,1497,1515,N/A,58,6
2,N/A,N/A,N/A,1495,1497,N/A,64,0
9,N/A,N/A,N/A,1486,1495,N/A,68,4
13,N/A,N/A,N/A,1473,1486,N/A,74,4
3,N/A,N/A,N/A,1470,1473,N/A,78,2
12,N/A,N/A,N/A,1458,1470,N/A,82,6
16,N/A,N/A,N/A,1442,1458,N/A,87,5
3,N/A,N/A,N/A,1439,1442,N/A,91,3
2,N/A,N/A,N/A,1437,1439,N/A,96,2
13,N/A,N/A,N/A,1424,1437,N/A,100,6
16,N/A,N/A,N/A,1408,1424,N/A,105,5
4,N/A,N/A,N/A,1404,1408,N/A,108,2
2,N/A,N/A,N/A,1402,1404,N/A,113,1
19,N/A,N/A,N/A,1383,1402,N/A,118,6
2,N/A,N/A,N/A,1381,1383,N/A,124,0
12,N/A,N/A,N/A,1369,1381,N/A,129,5
3,N/A,N/A,N/A,1366,1369,N/A,133,3
3,N/A,N/A,N/A,1363,1366,N/A,138,2
8,N/A,N/A,N/A,582,590,N/A,3,4
6,N/A,N/A,N/A,576,582,N/A,9,4
3,N/A,N/A,N/A,573,576,N/A,13,2
12,N/A,N/A,N/A,561,573,N/A,16,5
2,N/A,N/A,N/A,559,561,N/A,20,3
2,N/A,N/A,N/A,557,559,N/A,25,2
2,N/A,N/A,N/A,555,557,N/A,30,1
12,N/A,N/A,N/A,543,555,N/A,34,5
4,N/A,N/A,N/A,539,543,N/A,38,3
3,N/A,N/A,N/A,536,539,N/A,44,3
1,N/A,N/A,N/A,535,536,N/A,48,1
19,N/A,N/A,N/A,516,535,N/A,53,6
10,N/A,N/A,N/A,506,516,N/A,58,5
4,N/A,N/A,N/A,502,506,N/A,62,3
17,N/A,N/A,N/A,485,502,N/A,65,6
12,N/A,N/A,N/A,473,485,N/A,70,5
9,N/A,N/A,N/A,464,473,N/A,75,4
1,N/A,N/A,N/A,463,464,N/A,78,1
8,N/A,N/A,N/A,455,463,N/A,81,4
11,N/A,N/A,N/A,444,455,N/A,87,4
3,N/A,N/A,N/A,441,444,N/A,92,3
2,N/A,N/A,N/A,439,441,N/A,96,1
10,N/A,N/A,N/A,429,439,N/A,99,4
14,N/A,N/A,N/A,415,429,N/A,105,4
10,N/A,N/A,N/A,405,415,N/A,111,4
3,N/A,N/A,N/A,402,405,N/A,116,3
11,N/A,N/A,N/A,391,402,N/A,119,6
10,N/A,N/A,N/A,381,391,N/A,124,5
2,N/A,N/A,N/A,379,381,N/A,127,2
2,N/A,N/A,N/A,377,379,N/A,133,2
11,N/A,N/A,N/A,314,325,N/A,3,5
8,N/A,N/A,N/A,306,314,N/A,8,4
6,N/A,N/A,N/A,300,306,N/A,14,4
1,N/A,N/A,N/A,299,300,N/A,17,1
16,N/A,N/A,N/A,283,299,N/A,22,6
1,N/A,N/A,N/A,282,283,N/A,28,0
12,N/A,N/A,N/A,270,282,N/A,32,4
2,N/A,N/A,N/A,268,270,N/A,36,2
2,N/A,N/A,N/A,266,268,N/A,42,2
19,N/A,N/A,N/A,247,266,N/A,45,5
2,N/A,N/A,N/A,245,247,N/A,49,3
4,N/A,N/A,N/A,241,245,N/A,54,2
12,N/A,N/A,N/A,229,241,N/A,57,5
4,N/A,N/A,N/A,225,229,N/A,61,3
2,N/A,N/A,N/A,223,225,N/A,66,2
10,N/A,N/A,N/A,213,223,N/A,69,5
3,N/A,N/A,N/A,210,213,N/A,72,2
14,N/A,N/A,N/A,196,210,N/A,76,6
1,N/A,N/A,N/A,195,196,N/A,82,0
4,N/A,N/A,N/A,191,195,N/A,85,3
11,N/A,N/A,N/A,180,191,N/A,88,6
10,N/A,N/A,N/A,170,180,N/A,93,5
7,N/A,N/A,N/A,163,170,N/A,98,4
7,N/A,N/A,N/A,156,163,N/A,104,4
3,N/A,N/A,N/A,153,156,N/A,108,2
1,N/A,N/A,N/A,152,153,N/A,113,1
1,N/A,N/A,N/A,151,152,N/A,119,1
2,N/A,N/A,N/A,149,151,N/A,125,1
20,N/A,N/A,N/A,129,149,N/A,130,6
2,N/A,N/A,N/A,127,129,N/A,133,3
3,N/A,N/A,N/A,864,867,N/A,5,2
18,N/A,N/A,N/A,846,864,N/A,8,5
19,N/A,N/A,N/A,827,846,N/A,14,5
10,N/A,N/A,N/A,817,827,N/A,19,4
2,N/A,N/A,N/A,815,817,N/A,23,2
2,N/A,N/A,N/A,813,815,N/A,29,2
3,N/A,N/A,N/A,810,813,N/A,35,2
12,N/A,N/A,N/A,798,810,N/A,39,6
4,N/A,N/A,N/A,794,798,N/A,42,3
3,N/A,N/A,N/A,791,794,N/A,47,2
19,N/A,N/A,N/A,772,791,N/A,51,6
1,N/A,N/A,N/A,771,772,N/A,57,0
5,N/A,N/A,N/A,766,771,N/A,61,4
1,N/A,N/A,N/A,765,766,N/A,64,1
2,N/A,N/A,N/A,763,765,N/A,70,1
14,N/A,N/A,N/A,749,763,N/A,73,4
3,N/A,N/A,N/A,746,749,N/A,78,3
1,N/A,N/A,N/A,745,746,N/A,82,1
7,N/A,N/A,N/A,738,745,N/A,85,4
1,N/A,N/A,N/A,737,738,N/A,88,1
1,N/A,N/A,N/A,736,737,N/A,94,1
2,N/A,N/A,N/A,734,736,N/A,100,1
18,N/A,N/A,N/A,716,734,N/A,105,6
5,N/A,N/A,N/A,711,716,N/A,109,4
3,N/A,N/A,N/A,708,711,N/A,114,3
11,N/A,N/A,N/A,697,708,N/A,117,6
13,N/A,N/A,N/A,684,697,N/A,122,5
4,N/A,N/A,N/A,680,684,N/A,125,2
2,N/A,N/A,N/A,678,680,N/A,130,1
10,N/A,N/A,N/A,668,678,N/A,133,4
3,N/A,N/A,N/A,1446,1449,N/A,6,2
2,N/A,N/A,N/A,1444,1446,N/A,11,1
14,N/A,N/A,N/A,1430,1444,N/A,15,5
6,N/A,N/A,N/A,1424,1430,N/A,20,4
2,N/A,N/A,N/A,1422,1424,N/A,25,3
1,N/A,N/A,N/A,1421,1422,N/A,29,1
12,N/A,N/A,N/A,1409,1421,N/A,33,5
4,N/A,N/A,N/A,1405,1409,N/A,36,2
4,N/A,N/A,N/A,1401,1405,N/A,42,2
15,N/A,N/A,N/A,1386,1401,N/A,46,6
12,N/A,N/A,N/A,1374,1386,N/A,51,5
2,N/A,N/A,N/A,1372,1374,N/A,54,2
2,N/A,N/A,N/A,1370,1372,N/A,59,1
2,N/A,N/A,N/A,1368,1370,N/A,65,1
2,N/A,N/A,N/A,1366,1368,N/A,71,1
19,N/A,N/A,N/A,1347,1366,N/A,76,6
1,N/A,N/A,N/A,1346,1347,N/A,82,0
13,N/A,N/A,N/A,1333,1346,N/A,87,5
9,N/A,N/A,N/A,1324,1333,N/A,92,4
4,N/A,N/A,N/A,1320,1324,N/A,96,2
19,N/A,N/A,N/A,1301,1320,N/A,99,5
3,N/A,N/A,N/A,1298,1301,N/A,102,2
2,N/A,N/A,N/A,1296,1298,N/A,107,1
14,N/A,N/A,N/A,1282,1296,N/A,111,5
17,N/A,N/A,N/A,1265,1282,N/A,117,5
15,N/A,N/A,N/A,1250,1265,N/A,123,5
19,N/A,N/A,N/A,1231,1250,N/A,129,5
2,N/A,N/A,N/A,1229,1231,N/A,132,2
3,N/A,N/A,N/A,1226,1229,N/A,138,2
2,N/A,N/A,N/A,1224,1226,N/A,144,2
3,N/A,N/A,N/A,304,307,N/A,3,3
15,N/A,N/A,N/A,289,304,N/A,6,6
3,N/A,N/A,N/A,286,289,N/A,9,3
2,N/A,N/A,N/A,284,286,N/A,14,2
13,N/A,N/A,N/A,271,284,N/A,17,5
2,N/A,N/A,N/A,269,271,N/A,20,2
4,N/A,N/A,N/A,265,269,N/A,26,2
10,N/A,N/A,N/A,255,265,N/A,29,5
4,N/A,N/A,N/A,251,255,N/A,33,3
13,N/A,N/A,N/A,238,251,N/A,36,6
18,N/A,N/A,N/A,220,238,N/A,41,5
2,N/A,N/A,N/A,218,220,N/A,45,3
14,N/A,N/A,N/A,204,218,N/A,48,6
14,N/A,N/A,N/A,190,204,N/A,52,4
1,N/A,N/A,N/A,189,190,N/A,55,1
12,N/A,N/A,N/A,177,189,N/A,58,4
2,N/A,N/A,N/A,175,177,N/A,62,2
13,N/A,N/A,N/A,162,175,N/A,65,5
4,N/A,N/A,N/A,158,162,N/A,68,2
15,N/A,N/A,N/A,143,158,N/A,72,6
3,N/A,N/A,N/A,140,143,N/A,75,3
18,N/A,N/A,N/A,122,140,N/A,78,6
4,N/A,N/A,N/A,118,122,N/A,81,3
11,N/A,N/A,N/A,107,118,N/A,84,6
2,N/A,N/A,N/A,105,107,N/A,87,3
3,N/A,N/A,N/A,102,105,N/A,93,3
2,N/A,N/A,N/A,100,102,N/A,97,1
2,N/A,N/A,N/A,98,100,N/A,103,1
13,N/A,N/A,N/A,85,98,N/A,107,5
16,N/A,N/A,N/A,69,85,N/A,113,5
11,N/A,N/A,N/A,1304,1315,N/A,6,5
3,N/A,N/A,N/A,1301,1304,N/A,10,3
4,N/A,N/A,N/A,1297,1301,N/A,15,2
2,N/A,N/A,N/A,1295,1297,N/A,21,2
11,N/A,N/A,N/A,1284,1295,N/A,25,6
8,N/A,N/A,N/A,1276,1284,N/A,29,4
4,N/A,N/A,N/A,1272,1276,N/A,34,3
1,N/A,N/A,N/A,1271,1272,N/A,38,1
19,N/A,N/A,N/A,1252,1271,N/A,43,6
14,N/A,N/A,N/A,1238,1252,N/A,48,5
3,N/A,N/A,N/A,1235,1238,N/A,51,2
2,N/A,N/A,N/A,1233,1235,N/A,56,1
13,N/A,N/A,N/A,1220,1233,N/A,61,6
1,N/A,N/A,N/A,1219,1220,N/A,67,0
14,N/A,N/A,N/A,1205,1219,N/A,71,4
2,N/A,N/A,N/A,1203,1205,N/A,74,1
5,N/A,N/A,N/A,1198,1203,N/A,77,4
9,N/A,N/A,N/A,1189,1198,N/A,83,4
1,N/A,N/A,N/A,1188,1189,N/A,86,1
1,N/A,N/A,N/A,1187,1188,N/A,92,1
2,N/A,N/A,N/A,1185,1187,N/A,98,1
10,N/A,N/A,N/A,1175,1185,N/A,101,4
14,N/A,N/A,N/A,1161,1175,N/A,107,4
2,N/A,N/A,N/A,1159,1161,N/A,110,1
10,N/A,N/A,N/A,1149,1159,N/A,113,4
1,N/A,N/A,N/A,1148,1149,N/A,116,1
17,N/A,N/A,N/A,1131,1148,N/A,120,5
3,N/A,N/A,N/A,1128,1131,N/A,124,3
2,N/A,N/A,N/A,1126,1128,N/A,128,1
2,N/A,N/A,N/A,1124,1126,N/A,134,1
2,N/A,N/A,N/A,1404,1406,N/A,3,2
12,N/A,N/A,N/A,1392,1404,N/A,6,5
8,N/A,N/A,N/A,1384,1392,N/A,11,4
4,N/A,N/A,N/A,1380,1384,N/A,16,3
4,N/A,N/A,N/A,1376,1380,N/A,21,2
12,N/A,N/A,N/A,1364,1376,N/A,25,6
10,N/A,N/A,N/A,1354,1364,N/A,30,5
3,N/A,N/A,N/A,1351,1354,N/A,33,2
19,N/A,N/A,N/A,1332,1351,N/A,36,5
15,N/A,N/A,N/A,1317,1332,N/A,42,5
19,N/A,N/A,N/A,1298,1317,N/A,48,5
16,N/A,N/A,N/A,1282,1298,N/A,54,5
4,N/A,N/A,N/A,1278,1282,N/A,57,2
18,N/A,N/A,N/A,1260,1278,N/A,61,6
3,N/A,N/A,N/A,1257,1260,N/A,64,3
2,N/A,N/A,N/A,1255,1257,N/A,68,1
10,N/A,N/A,N/A,1245,1255,N/A,72,5
4,N/A,N/A,N/A,1241,1245,N/A,75,2
15,N/A,N/A,N/A,1226,1241,N/A,78,5
2,N/A,N/A,N/A,1224,1226,N/A,82,3
2,N/A,N/A,N/A,1222,1224,N/A,86,1
14,N/A,N/A,N/A,1208,1222,N/A,91,6
13,N/A,N/A,N/A,1195,1208,N/A,96,5
3,N/A,N/A,N/A,1192,1195,N/A,100,3
2,N/A,N/A,N/A,1190,1192,N/A,106,3
2,N/A,N/A,N/A,1188,1190,N/A,112,3
2,N/A,N/A,N/A,1186,1188,N/A,118,3
2,N/A,N/A,N/A,1184,1186,N/A,124,3
2,N/A,N/A,N/A,1182,1184,N/A,130,3
2,N/A,N/A,N/A,1180,1182,N/A,136,3
1,N/A,N/A,N/A,1562,1563,N/A,3,1
7,N/A,N/A,N/A,1555,1562,N/A,6,4
2,N/A,N/A,N/A,1553,1555,N/A,11,3
15,N/A,N/A,N/A,1538,1553,N/A,14,6
1,N/A,N/A,N/A,1537,1538,N/A,20,0
14,N/A,N/A,N/A,1523,1537,N/A,25,5
10,N/A,N/A,N/A,1513,1523,N/A,30,4
7,N/A,N/A,N/A,1506,1513,N/A,36,4
13,N/A,N/A,N/A,1493,1506,N/A,42,4
1,N/A,N/A,N/A,1492,1493,N/A,45,1
1,N/A,N/A,N/A,1491,1492,N/A,51,1
2,N/A,N/A,N/A,1489,1491,N/A,57,1
14,N/A,N/A,N/A,1475,1489,N/A,60,4
4,N/A,N/A,N/A,1471,1475,N/A,64,2
1,N/A,N/A,N/A,1470,1471,N/A,69,1
15,N/A,N/A,N/A,1455,1470,N/A,74,6
13,N/A,N/A,N/A,1442,1455,N/A,79,5
13,N/A,N/A,N/A,1429,1442,N/A,85,5
11,N/A,N/A,N/A,1418,1429,N/A,91,5
2,N/A,N/A,N/A,1416,1418,N/A,95,3
2,N/A,N/A,N/A,1414,1416,N/A,99,1
18,N/A,N/A,N/A,1396,1414,N/A,103,5
2,N/A,N/A,N/A,1394,1396,N/A,106,2
18,N/A,N/A,N/A,1376,1394,N/A,109,5
4,N/A,N/A,N/A,1372,1376,N/A,112,2
3,N/A,N/A,N/A,1369,1372,N/A,118,2
2,N/A,N/A,N/A,1367,1369,N/A,123,1
7,N/A,N/A,N/A,1360,1367,N/A,126,4
3,N/A,N/A,N/A,1357,1360,N/A,130,2
4,N/A,N/A,N/A,1353,1357,N/A,136,2
1,N/A,N/A,N/A,361,362,N/A,5,1
12,N/A,N/A,N/A,349,361,N/A,10,6
2,N/A,N/A,N/A,347,349,N/A,16,0
16,N/A,N/A,N/A,331,347,N/A,21,5
3,N/A,N/A,N/A,328,331,N/A,24,2
2,N/A,N/A,N/A,326,328,N/A,29,1
11,N/A,N/A,N/A,315,326,N/A,32,4
2,N/A,N/A,N/A,313,315,N/A,35,1
12,N/A,N/A,N/A,301,313,N/A,38,4
3,N/A,N/A,N/A,298,301,N/A,43,3
1,N/A,N/A,N/A,297,298,N/A,47,1
2,N/A,N/A,N/A,295,297,N/A,53,1
2,N/A,N/A,N/A,293,295,N/A,59,1
8,N/A,N/A,N/A,285,293,N/A,62,4
4,N/A,N/A,N/A,281,285,N/A,66,2
10,N/A,N/A,N/A,271,281,N/A,69,5
18,N/A,N/A,N/A,253,271,N/A,75,5
12,N/A,N/A,N/A,241,253,N/A,81,5
14,N/A,N/A,N/A,227,241,N/A,86,4
2,N/A,N/A,N/A,225,227,N/A,89,1
11,N/A,N/A,N/A,214,225,N/A,93,5
14,N/A,N/A,N/A,200,214,N/A,99,5
3,N/A,N/A,N/A,197,200,N/A,103,3
4,N/A,N/A,N/A,193,197,N/A,108,2
14,N/A,N/A,N/A,179,193,N/A,112,6
17,N/A,N/A,N/A,162,179,N/A,117,5
4,N/A,N/A,N/A,158,162,N/A,120,2
19,N/A,N/A,N/A,139,158,N/A,124,6
14,N/A,N/A,N/A,125,139,N/A,128,4
5,N/A,N/A,N/A,120,125,N/A,134,4
3,N/A,N/A,N/A,1976,1979,N/A,3,3
4,N/A,N/A,N/A,1972,1976,N/A,8,2
11,N/A,N/A,N/A,1961,1972,N/A,11,5
13,N/A,N/A,N/A,1948,1961,N/A,16,4
1,N/A,N/A,N/A,1947,1948,N/A,19,1
16,N/A,N/A,N/A,1931,1947,N/A,23,5
3,N/A,N/A,N/A,1928,1931,N/A,27,3
3,N/A,N/A,N/A,1925,1928,N/A,33,3
4,N/A,N/A,N/A,1921,1925,N/A,39,3
13,N/A,N/A,N/A,1908,1921,N/A,42,6
2,N/A,N/A,N/A,1906,1908,N/A,45,3
3,N/A,N/A,N/A,1903,1906,N/A,50,2
12,N/A,N/A,N/A,1891,1903,N/A,54,6
10,N/A,N/A,N/A,1881,1891,N/A,58,4
4,N/A,N/A,N/A,1877,1881,N/A,62,2
3,N/A,N/A,N/A,1874,1877,N/A,68,2
17,N/A,N/A,N/A,1857,1874,N/A,72,6
1,N/A,N/A,N/A,1856,1857,N/A,78,0
18,N/A,N/A,N/A,1838,1856,N/A,84,6
1,N/A,N/A,N/A,1837,1838,N/A,90,0
12,N/A,N/A,N/A,1825,1837,N/A,96,6
4,N/A,N/A,N/A,1821,1825,N/A,99,3
1,N/A,N/A,N/A,1820,1821,N/A,103,1
19,N/A,N/A,N/A,1801,1820,N/A,107,5
4,N/A,N/A,N/A,1797,1801,N/A,110,2
10,N/A,N/A,N/A,1787,1797,N/A,113,5
15,N/A,N/A,N/A,1772,1787,N/A,119,5
4,N/A,N/A,N/A,1768,1772,N/A,123,3
4,N/A,N/A,N/A,1764,1768,N/A,128,2
10,N/A,N/A,N/A,1754,1764,N/A,131,5
6,N/A,N/A,N/A,1225,1231,N/A,5,4
9,N/A,N/A,N/A,1216,1225,N/A,11,4
2,N/A,N/A,N/A,1214,1216,N/A,14,1
2,N/A,N/A,N/A,1212,1214,N/A,20,1
16,N/A,N/A,N/A,1196,1212,N/A,25,6
14,N/A,N/A,N/A,1182,1196,N/A,29,4
1,N/A,N/A,N/A,1181,1182,N/A,32,1
1,N/A,N/A,N/A,1180,1181,N/A,38,1
9,N/A,N/A,N/A,1171,1180,N/A,41,4
2,N/A,N/A,N/A,1169,1171,N/A,45,2
10,N/A,N/A,N/A,1159,1169,N/A,48,5
12,N/A,N/A,N/A,1147,1159,N/A,54,5
11,N/A,N/A,N/A,1136,1147,N/A,59,4
2,N/A,N/A,N/A,1134,1136,N/A,62,1
12,N/A,N/A,N/A,1122,1134,N/A,67,6
9,N/A,N/A,N/A,1113,1122,N/A,71,4
10,N/A,N/A,N/A,1103,1113,N/A,77,4
2,N/A,N/A,N/A,1101,1103,N/A,80,1
7,N/A,N/A,N/A,1094,1101,N/A,83,4
4,N/A,N/A,N/A,1090,1094,N/A,87,2
3,N/A,N/A,N/A,1087,1090,N/A,93,2
12,N/A,N/A,N/A,1075,1087,N/A,97,6
1,N/A,N/A,N/A,1074,1075,N/A,103,0
6,N/A,N/A,N/A,1068,1074,N/A,107,4
8,N/A,N/A,N/A,1060,1068,N/A,113,4
1,N/A,N/A,N/A,1059,1060,N/A,116,1
13,N/A,N/A,N/A,1046,1059,N/A,119,4
2,N/A,N/A,N/A,1044,1046,N/A,124,3
4,N/A,N/A,N/A,1040,1044,N/A,129,2
1,N/A,N/A,N/A,1039,1040,N/A,134,1
2,N/A,N/A,N/A,518,520,N/A,6,1
1,N/A,N/A,N/A,517,518,N/A,12,1
14,N/A,N/A,N/A,503,517,N/A,15,4
2,N/A,N/A,N/A,501,503,N/A,18,1
9,N/A,N/A,N/A,492,501,N/A,21,4
2,N/A,N/A,N/A,490,492,N/A,25,2
1,N/A,N/A,N/A,489,490,N/A,30,1
1,N/A,N/A,N/A,488,489,N/A,36,1
10,N/A,N/A,N/A,478,488,N/A,39,4
2,N/A,N/A,N/A,476,478,N/A,43,2
2,N/A,N/A,N/A,474,476,N/A,49,2
11,N/A,N/A,N/A,463,474,N/A,52,5
3,N/A,N/A,N/A,460,463,N/A,55,2
1,N/A,N/A,N/A,459,460,N/A,60,1
15,N/A,N/A,N/A,444,459,N/A,64,5
2,N/A,N/A,N/A,442,444,N/A,68,3
11,N/A,N/A,N/A,431,442,N/A,71,6
10,N/A,N/A,N/A,421,431,N/A,75,4
2,N/A,N/A,N/A,419,421,N/A,78,1
1,N/A,N/A,N/A,418,419,N/A,84,1
12,N/A,N/A,N/A,406,418,N/A,89,6
10,N/A,N/A,N/A,396,406,N/A,94,5
14,N/A,N/A,N/A,382,396,N/A,99,4
1,N/A,N/A,N/A,381,382,N/A,102,1
2,N/A,N/A,N/A,379,381,N/A,108,1
19,N/A,N/A,N/A,360,379,N/A,113,6
2,N/A,N/A,N/A,358,360,N/A,119,0
11,N/A,N/A,N/A,347,358,N/A,123,4
4,N/A,N/A,N/A,343,347,N/A,128,3
3,N/A,N/A,N/A,340,343,N/A,134,3
1,N/A,N/A,N/A,1113,1114,N/A,3,1
2,N/A,N/A,N/A,1111,1113,N/A,9,1
5,N/A,N/A,N/A,1106,1111,N/A,12,4
14,N/A,N/A,N/A,1092,1106,N/A,18,4
4,N/A,N/A,N/A,1088,1092,N/A,23,3
2,N/A,N/A,N/A,1086,1088,N/A,27,1
19,N/A,N/A,N/A,1067,1086,N/A,32,6
13,N/A,N/A,N/A,1054,1067,N/A,36,4
2,N/A,N/A,N/A,1052,1054,N/A,39,1
9,N/A,N/A,N/A,1043,1052,N/A,42,4
4,N/A,N/A,N/A,1039,1043,N/A,46,2
11,N/A,N/A,N/A,1028,1039,N/A,50,6
2,N/A,N/A,N/A,1026,1028,N/A,56,0
14,N/A,N/A,N/A,1012,1026,N/A,61,5
2,N/A,N/A,N/A,1010,1012,N/A,65,3
1,N/A,N/A,N/A,1009,1010,N/A,69,1
2,N/A,N/A,N/A,1007,1009,N/A,75,1
12,N/A,N/A,N/A,995,1007,N/A,78,4
4,N/A,N/A,N/A,991,995,N/A,82,2
1,N/A,N/A,N/A,990,991,N/A,87,1
1,N/A,N/A,N/A,989,990,N/A,93,1
6,N/A,N/A,N/A,983,989,N/A,96,4
4,N/A,N/A,N/A,979,983,N/A,100,2
16,N/A,N/A,N/A,963,979,N/A,103,5
11,N/A,N/A,N/A,952,963,N/A,108,4
1,N/A,N/A,N/A,951,952,N/A,111,1
9,N/A,N/A,N/A,942,951,N/A,114,4
4,N/A,N/A,N/A,938,942,N/A,119,3
3,N/A,N/A,N/A,935,938,N/A,125,3
17,N/A,N/A,N/A,918,935,N/A,128,6
13,N/A,N/A,N/A,1696,1709,N/A,4,6
3,N/A,N/A,N/A,1693,1696,N/A,7,3
15,N/A,N/A,N/A,1678,1693,N/A,10,6
18,N/A,N/A,N/A,1660,1678,N/A,15,5
10,N/A,N/A,N/A,1650,1660,N/A,21,5
2,N/A,N/A,N/A,1648,1650,N/A,25,3
3,N/A,N/A,N/A,1645,1648,N/A,31,3
2,N/A,N/A,N/A,1643,1645,N/A,36,2
16,N/A,N/A,N/A,1627,1643,N/A,40,6
1,N/A,N/A,N/A,1626,1627,N/A,46,0
3,N/A,N/A,N/A,1623,1626,N/A,49,3
3,N/A,N/A,N/A,1620,1623,N/A,55,3
2,N/A,N/A,N/A,1618,1620,N/A,61,3
20,N/A,N/A,N/A,1598,1618,N/A,64,6
1,N/A,N/A,N/A,1597,1598,N/A,70,0
14,N/A,N/A,N/A,1583,1597,N/A,74,4
4,N/A,N/A,N/A,1579,1583,N/A,78,2
13,N/A,N/A,N/A,1566,1579,N/A,81,5
11,N/A,N/A,N/A,1555,1566,N/A,87,5
18,N/A,N/A,N/A,1537,1555,N/A,93,5
3,N/A,N/A,N/A,1534,1537,N/A,97,3
2,N/A,N/A,N/A,1532,1534,N/A,103,3
19,N/A,N/A,N/A,1513,1532,N/A,106,6
4,N/A,N/A,N/A,1509,1513,N/A,109,3
2,N/A,N/A,N/A,1507,1509,N/A,114,2
12,N/A,N/A,N/A,1495,1507,N/A,118,6
14,N/A,N/A,N/A,1481,1495,N/A,122,4
6,N/A,N/A,N/A,1475,1481,N/A,128,4
2,N/A,N/A,N/A,1473,1475,N/A,131,1
2,N/A,N/A,N/A,1471,1473,N/A,137,1
2,N/A,N/A,N/A,1481,1483,N/A,6,1
16,N/A,N/A,N/A,1465,1481,N/A,10,5
4,N/A,N/A,N/A,1461,1465,N/A,13,2
14,N/A,N/A,N/A,1447,1461,N/A,17,6
7,N/A,N/A,N/A,1440,1447,N/A,21,4
5,N/A,N/A,N/A,1435,1440,N/A,27,4
10,N/A,N/A,N/A,1425,1435,N/A,33,4
8,N/A,N/A,N/A,1417,1425,N/A,39,4
2,N/A,N/A,N/A,1415,1417,N/A,43,2
15,N/A,N/A,N/A,1400,1415,N/A,46,5
12,N/A,N/A,N/A,1388,1400,N/A,52,5
4,N/A,N/A,N/A,1384,1388,N/A,56,3
3,N/A,N/A,N/A,1381,1384,N/A,62,3
3,N/A,N/A,N/A,1378,1381,N/A,67,2
1,N/A,N/A,N/A,1377,1378,N/A,72,1
14,N/A,N/A,N/A,1363,1377,N/A,75,4
2,N/A,N/A,N/A,1361,1363,N/A,80,3
2,N/A,N/A,N/A,1359,1361,N/A,84,1
12,N/A,N/A,N/A,1347,1359,N/A,89,6
15,N/A,N/A,N/A,1332,1347,N/A,94,5
11,N/A,N/A,N/A,1321,1332,N/A,99,4
7,N/A,N/A,N/A,1314,1321,N/A,105,4
4,N/A,N/A,N/A,1310,1314,N/A,109,2
16,N/A,N/A,N/A,1294,1310,N/A,113,6
2,N/A,N/A,N/A,1292,1294,N/A,119,0
17,N/A,N/A,N/A,1275,1292,N/A,124,5
5,N/A,N/A,N/A,1270,1275,N/A,129,4
2,N/A,N/A,N/A,1268,1270,N/A,132,1
13,N/A,N/A,N/A,1255,1268,N/A,136,5
4,N/A,N/A,N/A,1251,1255,N/A,139,2
2,N/A,N/A,N/A,1446,1448,N/A,5,1
1,N/A,N/A,N/A,1445,1446,N/A,11,1
16,N/A,N/A,N/A,1429,1445,N/A,16,6
1,N/A,N/A,N/A,1428,1429,N/A,22,0
13,N/A,N/A,N/A,1415,1428,N/A,27,5
13,N/A,N/A,N/A,1402,1415,N/A,33,5
4,N/A,N/A,N/A,1398,1402,N/A,37,3
3,N/A,N/A,N/A,1395,1398,N/A,42,2
4,N/A,N/A,N/A,1391,1395,N/A,48,2
1,N/A,N/A,N/A,1390,1391,N/A,53,1
12,N/A,N/A,N/A,1378,1390,N/A,56,4
1,N/A,N/A,N/A,1377,1378,N/A,59,1
19,N/A,N/A,N/A,1358,1377,N/A,64,6
1,N/A,N/A,N/A,1357,1358,N/A,70,0
13,N/A,N/A,N/A,1344,1357,N/A,75,5
19,N/A,N/A,N/A,1325,1344,N/A,81,5
2,N/A,N/A,N/A,1323,1325,N/A,84,2
4,N/A,N/A,N/A,1319,1323,N/A,90,2
10,N/A,N/A,N/A,1309,1319,N/A,93,5
12,N/A,N/A,N/A,1297,1309,N/A,99,5
4,N/A,N/A,N/A,1293,1297,N/A,102,2
2,N/A,N/A,N/A,1291,1293,N/A,108,2
2,N/A,N/A,N/A,1289,1291,N/A,114,2
18,N/A,N/A,N/A,1271,1289,N/A,118,6
10,N/A,N/A,N/A,1261,1271,N/A,122,4
4,N/A,N/A,N/A,1257,1261,N/A,126,2
3,N/A,N/A,N/A,1254,1257,N/A,132,2
20,N/A,N/A,N/A,1234,1254,N/A,136,6
1,N/A,N/A,N/A,1233,1234,N/A,142,0
18,N/A,N/A,N/A,1215,1233,N/A,148,6
2,N/A,N/A,N/A,1780,1782,N/A,6,2
11,N/A,N/A,N/A,1769,1780,N/A,10,6
2,N/A,N/A,N/A,1767,1769,N/A,13,3
3,N/A,N/A,N/A,1764,1767,N/A,18,2
1,N/A,N/A,N/A,1763,1764,N/A,23,1
2,N/A,N/A,N/A,1761,1763,N/A,29,1
11,N/A,N/A,N/A,1750,1761,N/A,34,6
13,N/A,N/A,N/A,1737,1750,N/A,38,4
2,N/A,N/A,N/A,1735,1737,N/A,43,3
2,N/A,N/A,N/A,1733,1735,N/A,49,3
4,N/A,N/A,N/A,1729,1733,N/A,55,3
3,N/A,N/A,N/A,1726,1729,N/A,60,2
12,N/A,N/A,N/A,1714,1726,N/A,63,5
12,N/A,N/A,N/A,1702,1714,N/A,68,4
4,N/A,N/A,N/A,1698,1702,N/A,73,3
18,N/A,N/A,N/A,1680,1698,N/A,76,6
11,N/A,N/A,N/A,1669,1680,N/A,81,5
2,N/A,N/A,N/A,1667,1669,N/A,85,3
3,N/A,N/A,N/A,1664,1667,N/A,90,2
16,N/A,N/A,N/A,1648,1664,N/A,94,6
1,N/A,N/A,N/A,1647,1648,N/A,100,0
11,N/A,N/A,N/A,1636,1647,N/A,106,6
2,N/A,N/A,N/A,1634,1636,N/A,109,3
2,N/A,N/A,N/A,1632,1634,N/A,115,3
15,N/A,N/A,N/A,1617,1632,N/A,118,6
12,N/A,N/A,N/A,1605,1617,N/A,122,4
2,N/A,N/A,N/A,1603,1605,N/A,125,1
17,N/A,N/A,N/A,1586,1603,N/A,129,5
14,N/A,N/A,N/A,1572,1586,N/A,135,5
4,N/A,N/A,N/A,1568,1572,N/A,139,3
4,N/A,N/A,N/A,1570,1574,N/A,3,3
4,N/A,N/A,N/A,1566,1570,N/A,8,2
13,N/A,N/A,N/A,1553,1566,N/A,11,5
12,N/A,N/A,N/A,1541,1553,N/A,17,5
3,N/A,N/A,N/A,1538,1541,N/A,21,3
3,N/A,N/A,N/A,1535,1538,N/A,26,2
10,N/A,N/A,N/A,1525,1535,N/A,29,5
4,N/A,N/A,N/A,1521,1525,N/A,33,3
19,N/A,N/A,N/A,1502,1521,N/A,36,6
2,N/A,N/A,N/A,1500,1502,N/A,39,3
3,N/A,N/A,N/A,1497,1500,N/A,44,2
17,N/A,N/A,N/A,1480,1497,N/A,48,6
3,N/A,N/A,N/A,1477,1480,N/A,51,3
1,N/A,N/A,N/A,1476,1477,N/A,55,1
13,N/A,N/A,N/A,1463,1476,N/A,58,4
9,N/A,N/A,N/A,1454,1463,N/A,64,4
3,N/A,N/A,N/A,1451,1454,N/A,68,2
2,N/A,N/A,N/A,1449,1451,N/A,74,2
12,N/A,N/A,N/A,1437,1449,N/A,77,5
2,N/A,N/A,N/A,1435,1437,N/A,80,2
17,N/A,N/A,N/A,1418,1435,N/A,83,5
4,N/A,N/A,N/A,1414,1418,N/A,86,2
11,N/A,N/A,N/A,1403,1414,N/A,90,6
19,N/A,N/A,N/A,1384,1403,N/A,95,5
6,N/A,N/A,N/A,1378,1384,N/A,100,4
2,N/A,N/A,N/A,1376,1378,N/A,105,3
4,N/A,N/A,N/A,1372,1376,N/A,110,2
2,N/A,N/A,N/A,1370,1372,N/A,115,1
2,N/A,N/A,N/A,1368,1370,N/A,121,1
12,N/A,N/A,N/A,1356,1368,N/A,125,5
12,N/A,N/A,N/A,1232,1244,N/A,5,6
5,N/A,N/A,N/A,1227,1232,N/A,9,4
3,N/A,N/A,N/A,1224,1227,N/A,13,2
15,N/A,N/A,N/A,1209,1224,N/A,16,5
13,N/A,N/A,N/A,1196,1209,N/A,21,4
2,N/A,N/A,N/A,1194,1196,N/A,26,3
17,N/A,N/A,N/A,1177,1194,N/A,29,6
2,N/A,N/A,N/A,1175,1177,N/A,35,0
14,N/A,N/A,N/A,1161,1175,N/A,41,6
2,N/A,N/A,N/A,1159,1161,N/A,47,0
12,N/A,N/A,N/A,1147,1159,N/A,53,6
2,N/A,N/A,N/A,1145,1147,N/A,56,3
12,N/A,N/A,N/A,1133,1145,N/A,59,6
16,N/A,N/A,N/A,1117,1133,N/A,64,5
2,N/A,N/A,N/A,1115,1117,N/A,68,3
2,N/A,N/A,N/A,1113,1115,N/A,72,1
15,N/A,N/A,N/A,1098,1113,N/A,77,6
2,N/A,N/A,N/A,1096,1098,N/A,80,3
1,N/A,N/A,N/A,1095,1096,N/A,84,1
1,N/A,N/A,N/A,1094,1095,N/A,90,1
13,N/A,N/A,N/A,1081,1094,N/A,94,5
4,N/A,N/A,N/A,1077,1081,N/A,98,3
1,N/A,N/A,N/A,1076,1077,N/A,102,1
13,N/A,N/A,N/A,1063,1076,N/A,106,5
19,N/A,N/A,N/A,1044,1063,N/A,112,5
13,N/A,N/A,N/A,1031,1044,N/A,118,5
15,N/A,N/A,N/A,1016,1031,N/A,124,5
3,N/A,N/A,N/A,1013,1016,N/A,127,2
11,N/A,N/A,N/A,1002,1013,N/A,131,6
8,N/A,N/A,N/A,994,1002,N/A,135,4
1,N/A,N/A,N/A,1289,1290,N/A,6,1
16,N/A,N/A,N/A,1273,1289,N/A,10,5
9,N/A,N/A,N/A,1264,1273,N/A,15,4
3,N/A,N/A,N/A,1261,1264,N/A,20,3
1,N/A,N/A,N/A,1260,1261,N/A,24,1
12,N/A,N/A,N/A,1248,1260,N/A,27,4
4,N/A,N/A,N/A,1244,1248,N/A,32,3
19,N/A,N/A,N/A,1225,1244,N/A,35,6
7,N/A,N/A,N/A,1218,1225,N/A,39,4
2,N/A,N/A,N/A,1216,1218,N/A,42,1
1,N/A,N/A,N/A,1215,1216,N/A,48,1
18,N/A,N/A,N/A,1197,1215,N/A,52,5
3,N/A,N/A,N/A,1194,1197,N/A,56,3
2,N/A,N/A,N/A,1192,1194,N/A,61,2
4,N/A,N/A,N/A,1188,1192,N/A,67,2
2,N/A,N/A,N/A,1186,1188,N/A,73,2
1,N/A,N/A,N/A,1185,1186,N/A,78,1
2,N/A,N/A,N/A,1183,1185,N/A,84,1
2,N/A,N/A,N/A,1181,1183,N/A,90,1
2,N/A,N/A,N/A,1179,1181,N/A,96,1
15,N/A,N/A,N/A,1164,1179,N/A,101,6
3,N/A,N/A,N/A,1161,1164,N/A,104,3
14,N/A,N/A,N/A,1147,1161,N/A,107,6
15,N/A,N/A,N/A,1132,1147,N/A,112,5
4,N/A,N/A,N/A,1128,1132,N/A,115,2
17,N/A,N/A,N/A,1111,1128,N/A,118,5
2,N/A,N/A,N/A,1109,1111,N/A,122,3
4,N/A,N/A,N/A,1105,1109,N/A,128,3
2,N/A,N/A,N/A,1103,1105,N/A,133,2
3,N/A,N/A,N/A,1100,1103,N/A,139,2
11,N/A,N/A,N/A,700,711,N/A,6,5
3,N/A,N/A,N/A,697,700,N/A,9,2
15,N/A,N/A,N/A,682,697,N/A,12,5
7,N/A,N/A,N/A,675,682,N/A,17,4
1,N/A,N/A,N/A,674,675,N/A,20,1
1,N/A,N/A,N/A,673,674,N/A,26,1
16,N/A,N/A,N/A,657,673,N/A,30,5
2,N/A,N/A,N/A,655,657,N/A,34,3
20,N/A,N/A,N/A,635,655,N/A,37,6
1,N/A,N/A,N/A,634,635,N/A,43,0
2,N/A,N/A,N/A,632,634,N/A,46,3
1,N/A,N/A,N/A,631,632,N/A,50,1
5,N/A,N/A,N/A,626,631,N/A,53,4
3,N/A,N/A,N/A,623,626,N/A,57,2
1,N/A,N/A,N/A,622,623,N/A,62,1
5,N/A,N/A,N/A,617,622,N/A,65,4
4,N/A,N/A,N/A,613,617,N/A,70,3
2,N/A,N/A,N/A,611,613,N/A,74,1
10,N/A,N/A,N/A,601,611,N/A,77,4
10,N/A,N/A,N/A,591,601,N/A,83,4
7,N/A,N/A,N/A,584,591,N/A,89,4
3,N/A,N/A,N/A,581,584,N/A,93,2
1,N/A,N/A,N/A,580,581,N/A,98,1
1,N/A,N/A,N/A,579,580,N/A,104,1
1,N/A,N/A,N/A,578,579,N/A,110,1
14,N/A,N/A,N/A,564,578,N/A,115,6
2,N/A,N/A,N/A,562,564,N/A,121,0
3,N/A,N/A,N/A,559,562,N/A,124,3
2,N/A,N/A,N/A,557,559,N/A,129,2
19,N/A,N/A,N/A,538,557,N/A,133,6
12,N/A,N/A,N/A,1941,1953,N/A,6,5
4,N/A,N/A,N/A,1937,1941,N/A,9,2
15,N/A,N/A,N/A,1922,1937,N/A,13,6
1,N/A,N/A,N/A,1921,1922,N/A,19,0
12,N/A,N/A,N/A,1909,1921,N/A,23,4
6,N/A,N/A,N/A,1903,1909,N/A,29,4
4,N/A,N/A,N/A,1899,1903,N/A,33,2
14,N/A,N/A,N/A,1885,1899,N/A,37,6
2,N/A,N/A,N/A,1883,1885,N/A,43,0
18,N/A,N/A,N/A,1865,1883,N/A,49,6
19,N/A,N/A,N/A,1846,1865,N/A,54,5
12,N/A,N/A,N/A,1834,1846,N/A,60,5
4,N/A,N/A,N/A,1830,1834,N/A,64,3
14,N/A,N/A,N/A,1816,1830,N/A,67,6
1,N/A,N/A,N/A,1815,1816,N/A,73,0
10,N/A,N/A,N/A,1805,1815,N/A,77,4
4,N/A,N/A,N/A,1801,1805,N/A,81,2
18,N/A,N/A,N/A,1783,1801,N/A,84,5
5,N/A,N/A,N/A,1778,1783,N/A,89,4
3,N/A,N/A,N/A,1775,1778,N/A,93,2
19,N/A,N/A,N/A,1756,1775,N/A,97,6
2,N/A,N/A,N/A,1754,1756,N/A,103,0
17,N/A,N/A,N/A,1737,1754,N/A,108,5
2,N/A,N/A,N/A,1735,1737,N/A,111,2
2,N/A,N/A,N/A,1733,1735,N/A,116,1
13,N/A,N/A,N/A,1720,1733,N/A,120,5
3,N/A,N/A,N/A,1717,1720,N/A,124,3
3,N/A,N/A,N/A,1714,1717,N/A,129,2
2,N/A,N/A,N/A,1712,1714,N/A,134,1
10,N/A,N/A,N/A,1702,1712,N/A,138,5
2,N/A,N/A,N/A,1707,1709,N/A,4,1
15,N/A,N/A,N/A,1692,1707,N/A,8,5
4,N/A,N/A,N/A,1688,1692,N/A,11,2
17,N/A,N/A,N/A,1671,1688,N/A,15,6
4,N/A,N/A,N/A,1667,1671,N/A,18,3
1,N/A,N/A,N/A,1666,1667,N/A,22,1
11,N/A,N/A,N/A,1655,1666,N/A,26,5
8,N/A,N/A,N/A,1647,1655,N/A,31,4
14,N/A,N/A,N/A,1633,1647,N/A,37,4
12,N/A,N/A,N/A,1621,1633,N/A,43,4
4,N/A,N/A,N/A,1617,1621,N/A,47,2
1,N/A,N/A,N/A,1616,1617,N/A,52,1
14,N/A,N/A,N/A,1602,1616,N/A,55,4
2,N/A,N/A,N/A,1600,1602,N/A,59,2
11,N/A,N/A,N/A,1589,1600,N/A,63,6
9,N/A,N/A,N/A,1580,1589,N/A,67,4
12,N/A,N/A,N/A,1568,1580,N/A,73,4
4,N/A,N/A,N/A,1564,1568,N/A,78,3
3,N/A,N/A,N/A,1561,1564,N/A,84,3
3,N/A,N/A,N/A,1558,1561,N/A,90,3
2,N/A,N/A,N/A,1556,1558,N/A,96,3
2,N/A,N/A,N/A,1554,1556,N/A,100,1
1,N/A,N/A,N/A,1553,1554,N/A,106,1
8,N/A,N/A,N/A,1545,1553,N/A,109,4
2,N/A,N/A,N/A,1543,1545,N/A,113,2
2,N/A,N/A,N/A,1541,1543,N/A,119,2
15,N/A,N/A,N/A,1526,1541,N/A,123,6
4,N/A,N/A,N/A,1522,1526,N/A,126,3
1,N/A,N/A,N/A,1521,1522,N/A,130,1
15,N/A,N/A,N/A,1506,1521,N/A,135,6
11,N/A,N/A,N/A,1259,1270,N/A,6,5
7,N/A,N/A,N/A,1252,1259,N/A,11,4
4,N/A,N/A,N/A,1248,1252,N/A,15,2
10,N/A,N/A,N/A,1238,1248,N/A,18,5
2,N/A,N/A,N/A,1236,1238,N/A,21,2
2,N/A,N/A,N/A,1234,1236,N/A,27,2
3,N/A,N/A,N/A,1231,1234,N/A,33,2
17,N/A,N/A,N/A,1214,1231,N/A,36,5
11,N/A,N/A,N/A,1203,1214,N/A,41,4
4,N/A,N/A,N/A,1199,1203,N/A,46,3
2,N/A,N/A,N/A,1197,1199,N/A,51,2
2,N/A,N/A,N/A,1195,1197,N/A,56,1
6,N/A,N/A,N/A,1189,1195,N/A,59,4
2,N/A,N/A,N/A,1187,1189,N/A,64,3
1,N/A,N/A,N/A,1186,1187,N/A,68,1
6,N/A,N/A,N/A,1180,1186,N/A,71,4
1,N/A,N/A,N/A,1179,1180,N/A,74,1
5,N/A,N/A,N/A,1174,1179,N/A,77,4
3,N/A,N/A,N/A,1171,1174,N/A,81,2
17,N/A,N/A,N/A,1154,1171,N/A,85,6
1,N/A,N/A,N/A,1153,1154,N/A,91,0
4,N/A,N/A,N/A,1149,1153,N/A,94,3
16,N/A,N/A,N/A,1133,1149,N/A,97,6
2,N/A,N/A,N/A,1131,1133,N/A,103,0
18,N/A,N/A,N/A,1113,1131,N/A,109,6
14,N/A,N/A,N/A,1099,1113,N/A,114,5
2,N/A,N/A,N/A,1097,1099,N/A,117,2
11,N/A,N/A,N/A,1086,1097,N/A,121,6
2,N/A,N/A,N/A,1084,1086,N/A,127,0
8,N/A,N/A,N/A,1076,1084,N/A,131,4
11,N/A,N/A,N/A,1878,1889,N/A,3,4
2,N/A,N/A,N/A,1876,1878,N/A,7,2
4,N/A,N/A,N/A,1872,1876,N/A,13,2
17,N/A,N/A,N/A,1855,1872,N/A,16,5
4,N/A,N/A,N/A,1851,1855,N/A,19,2
10,N/A,N/A,N/A,1841,1851,N/A,22,5
4,N/A,N/A,N/A,1837,1841,N/A,26,3
1,N/A,N/A,N/A,1836,1837,N/A,30,1
6,N/A,N/A,N/A,1830,1836,N/A,33,4
3,N/A,N/A,N/A,1827,1830,N/A,37,2
1,N/A,N/A,N/A,1826,1827,N/A,42,1
10,N/A,N/A,N/A,1816,1826,N/A,45,4
2,N/A,N/A,N/A,1814,1816,N/A,50,3
1,N/A,N/A,N/A,1813,1814,N/A,54,1
2,N/A,N/A,N/A,1811,1813,N/A,60,1
2,N/A,N/A,N/A,1809,1811,N/A,66,1
12,N/A,N/A,N/A,1797,1809,N/A,71,6
18,N/A,N/A,N/A,1779,1797,N/A,76,5
11,N/A,N/A,N/A,1768,1779,N/A,81,4
1,N/A,N/A,N/A,1767,1768,N/A,84,1
11,N/A,N/A,N/A,1756,1767,N/A,87,4
3,N/A,N/A,N/A,1753,1756,N/A,92,3
3,N/A,N/A,N/A,1750,1753,N/A,98,3
2,N/A,N/A,N/A,1748,1750,N/A,102,1
16,N/A,N/A,N/A,1732,1748,N/A,107,6
16,N/A,N/A,N/A,1716,1732,N/A,112,5
4,N/A,N/A,N/A,1712,1716,N/A,116,3
2,N/A,N/A,N/A,1710,1712,N/A,121,2
11,N/A,N/A,N/A,1699,1710,N/A,125,6
19,N/A,N/A,N/A,1680,1699,N/A,130,5
3,N/A,N/A,N/A,1901,1904,N/A,4,3
2,N/A,N/A,N/A,1899,1901,N/A,8,1
18,N/A,N/A,N/A,1881,1899,N/A,12,5
11,N/A,N/A,N/A,1870,1881,N/A,17,4
4,N/A,N/A,N/A,1866,1870,N/A,22,3
1,N/A,N/A,N/A,1865,1866,N/A,26,1
19,N/A,N/A,N/A,1846,1865,N/A,31,6
7,N/A,N/A,N/A,1839,1846,N/A,35,4
3,N/A,N/A,N/A,1836,1839,N/A,39,2
11,N/A,N/A,N/A,1825,1836,N/A,43,6
2,N/A,N/A,N/A,1823,1825,N/A,49,0
11,N/A,N/A,N/A,1812,1823,N/A,54,5
11,N/A,N/A,N/A,1801,1812,N/A,59,4
3,N/A,N/A,N/A,1798,1801,N/A,64,3
3,N/A,N/A,N/A,1795,1798,N/A,69,2
2,N/A,N/A,N/A,1793,1795,N/A,74,1
2,N/A,N/A,N/A,1791,1793,N/A,80,1
11,N/A,N/A,N/A,1780,1791,N/A,84,5
6,N/A,N/A,N/A,1774,1780,N/A,89,4
2,N/A,N/A,N/A,1772,1774,N/A,92,1
2,N/A,N/A,N/A,1770,1772,N/A,98,1
1,N/A,N/A,N/A,1769,1770,N/A,104,1
6,N/A,N/A,N/A,1763,1769,N/A,107,4
13,N/A,N/A,N/A,1750,1763,N/A,113,4
4,N/A,N/A,N/A,1746,1750,N/A,118,3
3,N/A,N/A,N/A,1743,1746,N/A,124,3
3,N/A,N/A,N/A,1740,1743,N/A,130,3
3,N/A,N/A,N/A,1737,1740,N/A,136,3
2,N/A,N/A,N/A,1735,1737,N/A,141,2
3,N/A,N/A,N/A,1732,1735,N/A,147,2
1,N/A,N/A,N/A,823,824,N/A,6,1
15,N/A,N/A,N/A,808,823,N/A,11,6
4,N/A,N/A,N/A,804,808,N/A,14,3
2,N/A,N/A,N/A,802,804,N/A,20,3
4,N/A,N/A,N/A,798,802,N/A,25,2
13,N/A,N/A,N/A,785,798,N/A,28,5
3,N/A,N/A,N/A,782,785,N/A,31,2
19,N/A,N/A,N/A,763,782,N/A,34,5
2,N/A,N/A,N/A,761,763,N/A,37,2
19,N/A,N/A,N/A,742,761,N/A,40,5
8,N/A,N/A,N/A,734,742,N/A,45,4
6,N/A,N/A,N/A,728,734,N/A,51,4
11,N/A,N/A,N/A,717,728,N/A,57,4
9,N/A,N/A,N/A,708,717,N/A,63,4
4,N/A,N/A,N/A,704,708,N/A,67,2
12,N/A,N/A,N/A,692,704,N/A,71,6
10,N/A,N/A,N/A,682,692,N/A,75,4
10,N/A,N/A,N/A,672,682,N/A,81,4
1,N/A,N/A,N/A,671,672,N/A,84,1
6,N/A,N/A,N/A,665,671,N/A,87,4
3,N/A,N/A,N/A,662,665,N/A,91,2
3,N/A,N/A,N/A,659,662,N/A,97,2
2,N/A,N/A,N/A,657,659,N/A,102,1
1,N/A,N/A,N/A,656,657,N/A,108,1
1,N/A,N/A,N/A,655,656,N/A,114,1
16,N/A,N/A,N/A,639,655,N/A,118,5
4,N/A,N/A,N/A,635,639,N/A,121,2
2,N/A,N/A,N/A,633,635,N/A,126,1
12,N/A,N/A,N/A,621,633,N/A,131,6
17,N/A,N/A,N/A,604,621,N/A,136,5
7,N/A,N/A,N/A,504,511,N/A,4,4
14,N/A,N/A,N/A,490,504,N/A,10,4
2,N/A,N/A,N/A,488,490,N/A,13,1
15,N/A,N/A,N/A,473,488,N/A,17,5
13,N/A,N/A,N/A,460,473,N/A,23,5
9,N/A,N/A,N/A,451,460,N/A,28,4
14,N/A,N/A,N/A,437,451,N/A,34,4
4,N/A,N/A,N/A,433,437,N/A,39,3
1,N/A,N/A,N/A,432,433,N/A,43,1
1,N/A,N/A,N/A,431,432,N/A,49,1
13,N/A,N/A,N/A,418,431,N/A,52,4
2,N/A,N/A,N/A,416,418,N/A,57,3
2,N/A,N/A,N/A,414,416,N/A,61,1
13,N/A,N/A,N/A,401,414,N/A,65,5
12,N/A,N/A,N/A,389,401,N/A,70,4
13,N/A,N/A,N/A,376,389,N/A,76,4
3,N/A,N/A,N/A,373,376,N/A,80,2
2,N/A,N/A,N/A,371,373,N/A,85,1
2,N/A,N/A,N/A,369,371,N/A,91,1
2,N/A,N/A,N/A,367,369,N/A,97,1
9,N/A,N/A,N/A,358,367,N/A,100,4
1,N/A,N/A,N/A,357,358,N/A,103,1
14,N/A,N/A,N/A,343,357,N/A,106,4
3,N/A,N/A,N/A,340,343,N/A,110,2
1,N/A,N/A,N/A,339,340,N/A,115,1
11,N/A,N/A,N/A,328,339,N/A,119,5
17,N/A,N/A,N/A,311,328,N/A,125,5
18,N/A,N/A,N/A,293,311,N/A,131,5
6,N/A,N/A,N/A,287,293,N/A,136,4
6,N/A,N/A,N/A,281,287,N/A,142,4
11,N/A,N/A,N/A,784,795,N/A,5,5
2,N/A,N/A,N/A,782,784,N/A,8,2
14,N/A,N/A,N/A,768,782,N/A,12,6
14,N/A,N/A,N/A,754,768,N/A,17,5
3,N/A,N/A,N/A,751,754,N/A,20,2
4,N/A,N/A,N/A,747,751,N/A,26,2
3,N/A,N/A,N/A,744,747,N/A,32,2
1,N/A,N/A,N/A,743,744,N/A,37,1
10,N/A,N/A,N/A,733,743,N/A,41,5
10,N/A,N/A,N/A,723,733,N/A,46,4
3,N/A,N/A,N/A,720,723,N/A,51,3
2,N/A,N/A,N/A,718,720,N/A,57,3
2,N/A,N/A,N/A,716,718,N/A,63,3
4,N/A,N/A,N/A,712,716,N/A,69,3
1,N/A,N/A,N/A,711,712,N/A,73,1
19,N/A,N/A,N/A,692,711,N/A,78,6
5,N/A,N/A,N/A,687,692,N/A,82,4
14,N/A,N/A,N/A,673,687,N/A,88,4
4,N/A,N/A,N/A,669,673,N/A,93,3
17,N/A,N/A,N/A,652,669,N/A,96,6
4,N/A,N/A,N/A,648,652,N/A,99,3
1,N/A,N/A,N/A,647,648,N/A,103,1
11,N/A,N/A,N/A,636,647,N/A,106,4
2,N/A,N/A,N/A,634,636,N/A,110,2
2,N/A,N/A,N/A,632,634,N/A,116,2
14,N/A,N/A,N/A,618,632,N/A,120,6
15,N/A,N/A,N/A,603,618,N/A,125,5
4,N/A,N/A,N/A,599,603,N/A,129,3
2,N/A,N/A,N/A,597,599,N/A,133,1
8,N/A,N/A,N/A,589,597,N/A,136,4
5,N/A,N/A,N/A,999,1004,N/A,4,4
2,N/A,N/A,N/A,997,999,N/A,9,3
13,N/A,N/A,N/A,984,997,N/A,12,6
1,N/A,N/A,N/A,983,984,N/A,18,0
17,N/A,N/A,N/A,966,983,N/A,24,6
19,N/A,N/A,N/A,947,966,N/A,29,5
5,N/A,N/A,N/A,942,947,N/A,34,4
2,N/A,N/A,N/A,940,942,N/A,37,1
14,N/A,N/A,N/A,926,940,N/A,40,4
13,N/A,N/A,N/A,913,926,N/A,46,4
10,N/A,N/A,N/A,903,913,N/A,52,4
1,N/A,N/A,N/A,902,903,N/A,55,1
10,N/A,N/A,N/A,892,902,N/A,59,5
14,N/A,N/A,N/A,878,892,N/A,65,5
3,N/A,N/A,N/A,875,878,N/A,69,3
2,N/A,N/A,N/A,873,875,N/A,73,1
2,N/A,N/A,N/A,871,873,N/A,79,1
2,N/A,N/A,N/A,869,871,N/A,85,1
20,N/A,N/A,N/A,849,869,N/A,90,6
2,N/A,N/A,N/A,847,849,N/A,96,0
19,N/A,N/A,N/A,828,847,N/A,102,6
16,N/A,N/A,N/A,812,828,N/A,107,5
2,N/A,N/A,N/A,810,812,N/A,111,3
4,N/A,N/A,N/A,806,810,N/A,116,2
18,N/A,N/A,N/A,788,806,N/A,119,5
12,N/A,N/A,N/A,776,788,N/A,125,5
16,N/A,N/A,N/A,760,776,N/A,131,5
10,N/A,N/A,N/A,750,760,N/A,136,4
2,N/A,N/A,N/A,748,750,N/A,139,1
6,N/A,N/A,N/A,742,748,N/A,142,4
16,N/A,N/A,N/A,1398,1414,N/A,3,6
16,N/A,N/A,N/A,1382,1398,N/A,8,5
11,N/A,N/A,N/A,1371,1382,N/A,13,4
2,N/A,N/A,N/A,1369,1371,N/A,18,3
20,N/A,N/A,N/A,1349,1369,N/A,21,6
17,N/A,N/A,N/A,1332,1349,N/A,26,5
3,N/A,N/A,N/A,1329,1332,N/A,30,3
3,N/A,N/A,N/A,1326,1329,N/A,36,3
4,N/A,N/A,N/A,1322,1326,N/A,42,3
18,N/A,N/A,N/A,1304,1322,N/A,45,6
1,N/A,N/A,N/A,1303,1304,N/A,51,0
19,N/A,N/A,N/A,1284,1303,N/A,57,6
12,N/A,N/A,N/A,1272,1284,N/A,61,4
4,N/A,N/A,N/A,1268,1272,N/A,66,3
4,N/A,N/A,N/A,1264,1268,N/A,72,3
3,N/A,N/A,N/A,1261,1264,N/A,77,2
2,N/A,N/A,N/A,1259,1261,N/A,82,1
9,N/A,N/A,N/A,1250,1259,N/A,85,4
2,N/A,N/A,N/A,1248,1250,N/A,88,1
14,N/A,N/A,N/A,1234,1248,N/A,93,6
2,N/A,N/A,N/A,1232,1234,N/A,99,0
9,N/A,N/A,N/A,1223,1232,N/A,103,4
2,N/A,N/A,N/A,1221,1223,N/A,108,3
3,N/A,N/A,N/A,1218,1221,N/A,114,3
14,N/A,N/A,N/A,1204,1218,N/A,117,6
9,N/A,N/A,N/A,1195,1204,N/A,121,4
3,N/A,N/A,N/A,1192,1195,N/A,125,2
15,N/A,N/A,N/A,1177,1192,N/A,129,6
4,N/A,N/A,N/A,1173,1177,N/A,132,3
3,N/A,N/A,N/A,1170,1173,N/A,137,2
3,N/A,N/A,N/A,973,976,N/A,4,3
2,N/A,N/A,N/A,971,973,N/A,9,2
3,N/A,N/A,N/A,968,971,N/A,15,2
13,N/A,N/A,N/A,955,968,N/A,19,6
8,N/A,N/A,N/A,947,955,N/A,23,4
3,N/A,N/A,N/A,944,947,N/A,28,3
2,N/A,N/A,N/A,942,944,N/A,34,3
4,N/A,N/A,N/A,938,942,N/A,39,2
13,N/A,N/A,N/A,925,938,N/A,43,6
2,N/A,N/A,N/A,923,925,N/A,49,0
7,N/A,N/A,N/A,916,923,N/A,53,4
13,N/A,N/A,N/A,903,916,N/A,59,4
3,N/A,N/A,N/A,900,903,N/A,63,2
3,N/A,N/A,N/A,897,900,N/A,69,2
4,N/A,N/A,N/A,893,897,N/A,75,2
17,N/A,N/A,N/A,876,893,N/A,78,5
3,N/A,N/A,N/A,873,876,N/A,82,3
4,N/A,N/A,N/A,869,873,N/A,88,3
2,N/A,N/A,N/A,867,869,N/A,92,1
1,N/A,N/A,N/A,866,867,N/A,98,1
15,N/A,N/A,N/A,851,866,N/A,103,6
2,N/A,N/A,N/A,849,851,N/A,109,0
4,N/A,N/A,N/A,845,849,N/A,112,3
3,N/A,N/A,N/A,842,845,N/A,117,2
2,N/A,N/A,N/A,840,842,N/A,123,2
2,N/A,N/A,N/A,838,840,N/A,129,2
1,N/A,N/A,N/A,837,838,N/A,134,1
8,N/A,N/A,N/A,829,837,N/A,137,4
1,N/A,N/A,N/A,828,829,N/A,140,1
19,N/A,N/A,N/A,809,828,N/A,145,6
8,N/A,N/A,N/A,902,910,N/A,3,4
2,N/A,N/A,N/A,900,902,N/A,7,2
2,N/A,N/A,N/A,898,900,N/A,12,1
13,N/A,N/A,N/A,885,898,N/A,17,6
2,N/A,N/A,N/A,883,885,N/A,23,0
17,N/A,N/A,N/A,866,883,N/A,29,6
8,N/A,N/A,N/A,858,866,N/A,33,4
1,N/A,N/A,N/A,857,858,N/A,36,1
2,N/A,N/A,N/A,855,857,N/A,42,1
19,N/A,N/A,N/A,836,855,N/A,46,5
3,N/A,N/A,N/A,833,836,N/A,49,2
13,N/A,N/A,N/A,820,833,N/A,53,6
10,N/A,N/A,N/A,810,820,N/A,58,5
6,N/A,N/A,N/A,804,810,N/A,63,4
11,N/A,N/A,N/A,793,804,N/A,69,4
1,N/A,N/A,N/A,792,793,N/A,72,1
6,N/A,N/A,N/A,786,792,N/A,75,4
6,N/A,N/A,N/A,780,786,N/A,81,4
4,N/A,N/A,N/A,776,780,N/A,85,2
2,N/A,N/A,N/A,774,776,N/A,90,1
1,N/A,N/A,N/A,773,774,N/A,96,1
17,N/A,N/A,N/A,756,773,N/A,101,6
1,N/A,N/A,N/A,755,756,N/A,107,0
2,N/A,N/A,N/A,753,755,N/A,110,3
15,N/A,N/A,N/A,738,753,N/A,113,6
2,N/A,N/A,N/A,736,738,N/A,119,0
3,N/A,N/A,N/A,733,736,N/A,122,3
16,N/A,N/A,N/A,717,733,N/A,125,6
18,N/A,N/A,N/A,699,717,N/A,130,5
4,N/A,N/A,N/A,695,699,N/A,134,3
16,N/A,N/A,N/A,622,638,N/A,6,6
10,N/A,N/A,N/A,612,622,N/A,11,5
7,N/A,N/A,N/A,605,612,N/A,16,4
3,N/A,N/A,N/A,602,605,N/A,21,3
2,N/A,N/A,N/A,600,602,N/A,26,2
13,N/A,N/A,N/A,587,600,N/A,30,6
14,N/A,N/A,N/A,573,587,N/A,35,5
6,N/A,N/A,N/A,567,573,N/A,40,4
12,N/A,N/A,N/A,555,567,N/A,46,4
4,N/A,N/A,N/A,551,555,N/A,51,3
4,N/A,N/A,N/A,547,551,N/A,56,2
15,N/A,N/A,N/A,532,547,N/A,59,5
4,N/A,N/A,N/A,528,532,N/A,62,2
15,N/A,N/A,N/A,513,528,N/A,65,5
2,N/A,N/A,N/A,511,513,N/A,68,2
15,N/A,N/A,N/A,496,511,N/A,72,6
10,N/A,N/A,N/A,486,496,N/A,76,4
2,N/A,N/A,N/A,484,486,N/A,79,1
10,N/A,N/A,N/A,474,484,N/A,83,5
19,N/A,N/A,N/A,455,474,N/A,89,5
4,N/A,N/A,N/A,451,455,N/A,93,3
20,N/A,N/A,N/A,431,451,N/A,96,6
2,N/A,N/A,N/A,429,431,N/A,102,0
19,N/A,N/A,N/A,410,429,N/A,107,5
4,N/A,N/A,N/A,406,410,N/A,111,3
4,N/A,N/A,N/A,402,406,N/A,117,3
11,N/A,N/A,N/A,391,402,N/A,120,6
11,N/A,N/A,N/A,380,391,N/A,125,5
14,N/A,N/A,N/A,366,380,N/A,131,5
4,N/A,N/A,N/A,362,366,N/A,134,2
19,N/A,N/A,N/A,1488,1507,N/A,6,6
2,N/A,N/A,N/A,1486,1488,N/A,12,0
19,N/A,N/A,N/A,1467,1486,N/A,17,5
15,N/A,N/A,N/A,1452,1467,N/A,23,5
10,N/A,N/A,N/A,1442,1452,N/A,28,4
4,N/A,N/A,N/A,1438,1442,N/A,33,3
14,N/A,N/A,N/A,1424,1438,N/A,36,6
2,N/A,N/A,N/A,1422,1424,N/A,42,0
15,N/A,N/A,N/A,1407,1422,N/A,48,6
14,N/A,N/A,N/A,1393,1407,N/A,53,5
17,N/A,N/A,N/A,1376,1393,N/A,59,5
13,N/A,N/A,N/A,1363,1376,N/A,65,5
4,N/A,N/A,N/A,1359,1363,N/A,68,2
10,N/A,N/A,N/A,1349,1359,N/A,71,5
3,N/A,N/A,N/A,1346,1349,N/A,74,2
18,N/A,N/A,N/A,1328,1346,N/A,78,6
3,N/A,N/A,N/A,1325,1328,N/A,81,3
4,N/A,N/A,N/A,1321,1325,N/A,87,3
3,N/A,N/A,N/A,1318,1321,N/A,93,3
20,N/A,N/A,N/A,1298,1318,N/A,96,6
9,N/A,N/A,N/A,1289,1298,N/A,100,4
5,N/A,N/A,N/A,1284,1289,N/A,106,4
2,N/A,N/A,N/A,1282,1284,N/A,110,2
4,N/A,N/A,N/A,1278,1282,N/A,116,2
1,N/A,N/A,N/A,1277,1278,N/A,121,1
16,N/A,N/A,N/A,1261,1277,N/A,125,5
3,N/A,N/A,N/A,1258,1261,N/A,129,3
2,N/A,N/A,N/A,1256,1258,N/A,133,1
14,N/A,N/A,N/A,1242,1256,N/A,138,6
16,N/A,N/A,N/A,1226,1242,N/A,143,5
4,N/A,N/A,N/A,1080,1084,N/A,6,2
18,N/A,N/A,N/A,1062,1080,N/A,10,6
2,N/A,N/A,N/A,1060,1062,N/A,13,3
14,N/A,N/A,N/A,1046,1060,N/A,16,6
18,N/A,N/A,N/A,1028,1046,N/A,21,5
10,N/A,N/A,N/A,1018,1028,N/A,27,5
3,N/A,N/A,N/A,1015,1018,N/A,30,2
3,N/A,N/A,N/A,1012,1015,N/A,36,2
13,N/A,N/A,N/A,999,1012,N/A,40,6
16,N/A,N/A,N/A,983,999,N/A,45,5
4,N/A,N/A,N/A,979,983,N/A,48,2
11,N/A,N/A,N/A,968,979,N/A,51,5
3,N/A,N/A,N/A,965,968,N/A,55,3
2,N/A,N/A,N/A,963,965,N/A,61,3
1,N/A,N/A,N/A,962,963,N/A,65,1
2,N/A,N/A,N/A,960,962,N/A,71,1
1,N/A,N/A,N/A,959,960,N/A,77,1
2,N/A,N/A,N/A,957,959,N/A,83,1
19,N/A,N/A,N/A,938,957,N/A,87,5
2,N/A,N/A,N/A,936,938,N/A,91,3
2,N/A,N/A,N/A,934,936,N/A,95,1
1,N/A,N/A,N/A,933,934,N/A,101,1
13,N/A,N/A,N/A,920,933,N/A,104,4
4,N/A,N/A,N/A,916,920,N/A,109,3
1,N/A,N/A,N/A,915,916,N/A,113,1
20,N/A,N/A,N/A,895,915,N/A,118,6
10,N/A,N/A,N/A,885,895,N/A,123,5
3,N/A,N/A,N/A,882,885,N/A,127,3
2,N/A,N/A,N/A,880,882,N/A,131,1
8,N/A,N/A,N/A,872,880,N/A,134,4
11,N/A,N/A,N/A,1283,1294,N/A,6,4
13,N/A,N/A,N/A,1270,1283,N/A,12,4
2,N/A,N/A,N/A,1268,1270,N/A,15,1
12,N/A,N/A,N/A,1256,1268,N/A,18,4
3,N/A,N/A,N/A,1253,1256,N/A,23,3
4,N/A,N/A,N/A,1249,1253,N/A,28,2
14,N/A,N/A,N/A,1235,1249,N/A,31,5
3,N/A,N/A,N/A,1232,1235,N/A,35,3
13,N/A,N/A,N/A,1219,1232,N/A,38,6
2,N/A,N/A,N/A,1217,1219,N/A,44,0
19,N/A,N/A,N/A,1198,1217,N/A,49,5
2,N/A,N/A,N/A,1196,1198,N/A,52,2
12,N/A,N/A,N/A,1184,1196,N/A,56,6
4,N/A,N/A,N/A,1180,1184,N/A,59,3
4,N/A,N/A,N/A,1176,1180,N/A,64,2
4,N/A,N/A,N/A,1172,1176,N/A,70,2
14,N/A,N/A,N/A,1158,1172,N/A,73,5
4,N/A,N/A,N/A,1154,1158,N/A,77,3
2,N/A,N/A,N/A,1152,1154,N/A,81,1
1,N/A,N/A,N/A,1151,1152,N/A,87,1
1,N/A,N/A,N/A,1150,1151,N/A,93,1
1,N/A,N/A,N/A,1149,1150,N/A,99,1
10,N/A,N/A,N/A,1139,1149,N/A,103,5
12,N/A,N/A,N/A,1127,1139,N/A,108,4
1,N/A,N/A,N/A,1126,1127,N/A,111,1
14,N/A,N/A,N/A,1112,1126,N/A,115,5
10,N/A,N/A,N/A,1102,1112,N/A,121,5
19,N/A,N/A,N/A,1083,1102,N/A,127,5
14,N/A,N/A,N/A,1069,1083,N/A,133,5
12,N/A,N/A,N/A,1057,1069,N/A,139,5
17,N/A,N/A,N/A,401,418,N/A,6,5
3,N/A,N/A,N/A,398,401,N/A,9,2
2,N/A,N/A,N/A,396,398,N/A,15,2
2,N/A,N/A,N/A,394,396,N/A,20,1
1,N/A,N/A,N/A,393,394,N/A,26,1
20,N/A,N/A,N/A,373,393,N/A,31,6
12,N/A,N/A,N/A,361,373,N/A,35,4
10,N/A,N/A,N/A,351,361,N/A,41,4
2,N/A,N/A,N/A,349,351,N/A,44,1
1,N/A,N/A,N/A,348,349,N/A,50,1
13,N/A,N/A,N/A,335,348,N/A,53,4
10,N/A,N/A,N/A,325,335,N/A,59,4
4,N/A,N/A,N/A,321,325,N/A,64,3
3,N/A,N/A,N/A,318,321,N/A,70,3
4,N/A,N/A,N/A,314,318,N/A,76,3
4,N/A,N/A,N/A,310,314,N/A,82,3
18,N/A,N/A,N/A,292,310,N/A,85,6
10,N/A,N/A,N/A,282,292,N/A,89,4
2,N/A,N/A,N/A,280,282,N/A,94,3
1,N/A,N/A,N/A,279,280,N/A,98,1
7,N/A,N/A,N/A,272,279,N/A,101,4
12,N/A,N/A,N/A,260,272,N/A,107,4
3,N/A,N/A,N/A,257,260,N/A,112,3
16,N/A,N/A,N/A,241,257,N/A,115,6
4,N/A,N/A,N/A,237,241,N/A,118,3
14,N/A,N/A,N/A,223,237,N/A,121,6
2,N/A,N/A,N/A,221,223,N/A,127,0
12,N/A,N/A,N/A,209,221,N/A,131,4
4,N/A,N/A,N/A,205,209,N/A,135,2
3,N/A,N/A,N/A,202,205,N/A,141,2
2,N/A,N/A,N/A,926,928,N/A,3,1
18,N/A,N/A,N/A,908,926,N/A,8,6
2,N/A,N/A,N/A,906,908,N/A,11,3
1,N/A,N/A,N/A,905,906,N/A,15,1
15,N/A,N/A,N/A,890,905,N/A,20,6
17,N/A,N/A,N/A,873,890,N/A,25,5
3,N/A,N/A,N/A,870,873,N/A,29,3
13,N/A,N/A,N/A,857,870,N/A,32,6
3,N/A,N/A,N/A,854,857,N/A,35,3
2,N/A,N/A,N/A,852,854,N/A,41,3
4,N/A,N/A,N/A,848,852,N/A,47,3
1,N/A,N/A,N/A,847,848,N/A,51,1
14,N/A,N/A,N/A,833,847,N/A,56,6
1,N/A,N/A,N/A,832,833,N/A,62,0
10,N/A,N/A,N/A,822,832,N/A,67,5
7,N/A,N/A,N/A,815,822,N/A,72,4
12,N/A,N/A,N/A,803,815,N/A,78,4
8,N/A,N/A,N/A,795,803,N/A,84,4
3,N/A,N/A,N/A,792,795,N/A,89,3
13,N/A,N/A,N/A,779,792,N/A,92,6
2,N/A,N/A,N/A,777,779,N/A,95,3
1,N/A,N/A,N/A,776,777,N/A,99,1
2,N/A,N/A,N/A,774,776,N/A,105,1
8,N/A,N/A,N/A,766,774,N/A,108,4
3,N/A,N/A,N/A,763,766,N/A,113,3
11,N/A,N/A,N/A,752,763,N/A,116,6
14,N/A,N/A,N/A,738,752,N/A,120,4
3,N/A,N/A,N/A,735,738,N/A,124,2
20,N/A,N/A,N/A,715,735,N/A,128,6
4,N/A,N/A,N/A,711,715,N/A,131,3
10,N/A,N/A,N/A,1378,1388,N/A,4,5
18,N/A,N/A,N/A,1360,1378,N/A,10,5
14,N/A,N/A,N/A,1346,1360,N/A,15,4
13,N/A,N/A,N/A,1333,1346,N/A,21,4
8,N/A,N/A,N/A,1325,1333,N/A,27,4
2,N/A,N/A,N/A,1323,1325,N/A,31,2
16,N/A,N/A,N/A,1307,1323,N/A,35,6
4,N/A,N/A,N/A,1303,1307,N/A,38,3
2,N/A,N/A,N/A,1301,1303,N/A,42,1
1,N/A,N/A,N/A,1300,1301,N/A,48,1
19,N/A,N/A,N/A,1281,1300,N/A,53,6
2,N/A,N/A,N/A,1279,1281,N/A,56,3
2,N/A,N/A,N/A,1277,1279,N/A,60,1
16,N/A,N/A,N/A,1261,1277,N/A,64,5
2,N/A,N/A,N/A,1259,1261,N/A,67,2
17,N/A,N/A,N/A,1242,1259,N/A,70,5
3,N/A,N/A,N/A,1239,1242,N/A,74,3
2,N/A,N/A,N/A,1237,1239,N/A,79,2
4,N/A,N/A,N/A,1233,1237,N/A,85,2
2,N/A,N/A,N/A,1231,1233,N/A,91,2
4,N/A,N/A,N/A,1227,1231,N/A,97,2
15,N/A,N/A,N/A,1212,1227,N/A,100,5
15,N/A,N/A,N/A,1197,1212,N/A,106,5
11,N/A,N/A,N/A,1186,1197,N/A,112,5
18,N/A,N/A,N/A,1168,1186,N/A,118,5
13,N/A,N/A,N/A,1155,1168,N/A,124,5
4,N/A,N/A,N/A,1151,1155,N/A,127,2
1,N/A,N/A,N/A,1150,1151,N/A,132,1
15,N/A,N/A,N/A,1135,1150,N/A,136,5
3,N/A,N/A,N/A,1132,1135,N/A,140,3
14,N/A,N/A,N/A,1538,1552,N/A,5,6
1,N/A,N/A,N/A,1537,1538,N/A,11,0
13,N/A,N/A,N/A,1524,1537,N/A,16,5
3,N/A,N/A,N/A,1521,1524,N/A,19,2
11,N/A,N/A,N/A,1510,1521,N/A,23,6
4,N/A,N/A,N/A,1506,1510,N/A,26,3
3,N/A,N/A,N/A,1503,1506,N/A,31,2
1,N/A,N/A,N/A,1502,1503,N/A,36,1
1,N/A,N/A,N/A,1501,1502,N/A,42,1
16,N/A,N/A,N/A,1485,1501,N/A,46,5
2,N/A,N/A,N/A,1483,1485,N/A,50,3
2,N/A,N/A,N/A,1481,1483,N/A,54,1
2,N/A,N/A,N/A,1479,1481,N/A,60,1
12,N/A,N/A,N/A,1467,1479,N/A,63,4
2,N/A,N/A,N/A,1465,1467,N/A,67,2
16,N/A,N/A,N/A,1449,1465,N/A,71,6
11,N/A,N/A,N/A,1438,1449,N/A,76,5
17,N/A,N/A,N/A,1421,1438,N/A,82,5
2,N/A,N/A,N/A,1419,1421,N/A,85,2
3,N/A,N/A,N/A,1416,1419,N/A,91,2
2,N/A,N/A,N/A,1414,1416,N/A,97,2
2,N/A,N/A,N/A,1412,1414,N/A,102,1
1,N/A,N/A,N/A,1411,1412,N/A,108,1
8,N/A,N/A,N/A,1403,1411,N/A,111,4
2,N/A,N/A,N/A,1401,1403,N/A,114,1
14,N/A,N/A,N/A,1387,1401,N/A,117,4
10,N/A,N/A,N/A,1377,1387,N/A,123,4
4,N/A,N/A,N/A,1373,1377,N/A,127,2
12,N/A,N/A,N/A,1361,1373,N/A,131,6
11,N/A,N/A,N/A,1350,1361,N/A,136,5
13,N/A,N/A,N/A,959,972,N/A,4,4
2,N/A,N/A,N/A,957,959,N/A,8,2
18,N/A,N/A,N/A,939,957,N/A,11,5
16,N/A,N/A,N/A,923,939,N/A,17,5
4,N/A,N/A,N/A,919,923,N/A,21,3
18,N/A,N/A,N/A,901,919,N/A,24,6
1,N/A,N/A,N/A,900,901,N/A,30,0
11,N/A,N/A,N/A,889,900,N/A,35,5
17,N/A,N/A,N/A,872,889,N/A,41,5
15,N/A,N/A,N/A,857,872,N/A,47,5
13,N/A,N/A,N/A,844,857,N/A,52,4
2,N/A,N/A,N/A,842,844,N/A,56,2
2,N/A,N/A,N/A,840,842,N/A,62,2
2,N/A,N/A,N/A,838,840,N/A,67,1
2,N/A,N/A,N/A,836,838,N/A,73,1
5,N/A,N/A,N/A,831,836,N/A,76,4
3,N/A,N/A,N/A,828,831,N/A,81,3
3,N/A,N/A,N/A,825,828,N/A,86,2
4,N/A,N/A,N/A,821,825,N/A,92,2
14,N/A,N/A,N/A,807,821,N/A,96,6
3,N/A,N/A,N/A,804,807,N/A,99,3
3,N/A,N/A,N/A,801,804,N/A,105,3
3,N/A,N/A,N/A,798,801,N/A,110,2
2,N/A,N/A,N/A,796,798,N/A,115,1
14,N/A,N/A,N/A,782,796,N/A,118,4
2,N/A,N/A,N/A,780,782,N/A,122,2
15,N/A,N/A,N/A,765,780,N/A,125,5
7,N/A,N/A,N/A,758,765,N/A,130,4
4,N/A,N/A,N/A,754,758,N/A,134,2
3,N/A,N/A,N/A,751,754,N/A,140,2
2,N/A,N/A,N/A,1268,1270,N/A,6,3
13,N/A,N/A,N/A,1255,1268,N/A,9,6
4,N/A,N/A,N/A,1251,1255,N/A,12,3
2,N/A,N/A,N/A,1249,1251,N/A,17,2
1,N/A,N/A,N/A,1248,1249,N/A,22,1
1,N/A,N/A,N/A,1247,1248,N/A,28,1
2,N/A,N/A,N/A,1245,1247,N/A,34,1
2,N/A,N/A,N/A,1243,1245,N/A,40,1
10,N/A,N/A,N/A,1233,1243,N/A,44,5
8,N/A,N/A,N/A,1225,1233,N/A,49,4
2,N/A,N/A,N/A,1223,1225,N/A,53,2
4,N/A,N/A,N/A,1219,1223,N/A,59,2
1,N/A,N/A,N/A,1218,1219,N/A,64,1
1,N/A,N/A,N/A,1217,1218,N/A,70,1
15,N/A,N/A,N/A,1202,1217,N/A,74,5
4,N/A,N/A,N/A,1198,1202,N/A,78,3
19,N/A,N/A,N/A,1179,1198,N/A,81,6
5,N/A,N/A,N/A,1174,1179,N/A,85,4
4,N/A,N/A,N/A,1170,1174,N/A,90,3
20,N/A,N/A,N/A,1150,1170,N/A,93,6
1,N/A,N/A,N/A,1149,1150,N/A,99,0
2,N/A,N/A,N/A,1147,1149,N/A,102,3
4,N/A,N/A,N/A,1143,1147,N/A,107,2
2,N/A,N/A,N/A,1141,1143,N/A,113,2
3,N/A,N/A,N/A,1138,1141,N/A,119,2
19,N/A,N/A,N/A,1119,1138,N/A,122,5
4,N/A,N/A,N/A,1115,1119,N/A,125,2
20,N/A,N/A,N/A,1095,1115,N/A,129,6
3,N/A,N/A,N/A,1092,1095,N/A,132,3
3,N/A,N/A,N/A,1089,1092,N/A,138,3
16,N/A,N/A,N/A,670,686,N/A,4,5
3,N/A,N/A,N/A,667,670,N/A,7,2
4,N/A,N/A,N/A,663,667,N/A,13,2
16,N/A,N/A,N/A,647,663,N/A,17,6
2,N/A,N/A,N/A,645,647,N/A,23,0
4,N/A,N/A,N/A,641,645,N/A,26,3
11,N/A,N/A,N/A,630,641,N/A,29,6
11,N/A,N/A,N/A,619,630,N/A,33,4
1,N/A,N/A,N/A,618,619,N/A,36,1
11,N/A,N/A,N/A,607,618,N/A,41,6
3,N/A,N/A,N/A,604,607,N/A,44,3
2,N/A,N/A,N/A,602,604,N/A,50,3
3,N/A,N/A,N/A,599,602,N/A,56,3
12,N/A,N/A,N/A,587,599,N/A,59,6
13,N/A,N/A,N/A,574,587,N/A,63,4
13,N/A,N/A,N/A,561,574,N/A,69,4
1,N/A,N/A,N/A,560,561,N/A,72,1
10,N/A,N/A,N/A,550,560,N/A,75,4
2,N/A,N/A,N/A,548,550,N/A,78,1
2,N/A,N/A,N/A,546,548,N/A,84,1
9,N/A,N/A,N/A,537,546,N/A,87,4
7,N/A,N/A,N/A,530,537,N/A,93,4
1,N/A,N/A,N/A,529,530,N/A,96,1
17,N/A,N/A,N/A,512,529,N/A,100,5
3,N/A,N/A,N/A,509,512,N/A,104,3
17,N/A,N/A,N/A,492,509,N/A,107,6
17,N/A,N/A,N/A,475,492,N/A,112,5
13,N/A,N/A,N/A,462,475,N/A,117,4
8,N/A,N/A,N/A,454,462,N/A,123,4
3,N/A,N/A,N/A,451,454,N/A,128,3
12,N/A,N/A,N/A,870,882,N/A,4,6
1,N/A,N/A,N/A,869,870,N/A,10,0
14,N/A,N/A,N/A,855,869,N/A,16,6
11,N/A,N/A,N/A,844,855,N/A,21,5
2,N/A,N/A,N/A,842,844,N/A,25,3
1,N/A,N/A,N/A,841,842,N/A,29,1
17,N/A,N/A,N/A,824,841,N/A,34,6
3,N/A,N/A,N/A,821,824,N/A,37,3
4,N/A,N/A,N/A,817,821,N/A,42,2
4,N/A,N/A,N/A,813,817,N/A,48,2
3,N/A,N/A,N/A,810,813,N/A,54,2
14,N/A,N/A,N/A,796,810,N/A,57,5
16,N/A,N/A,N/A,780,796,N/A,63,5
3,N/A,N/A,N/A,777,780,N/A,66,2
19,N/A,N/A,N/A,758,777,N/A,70,6
10,N/A,N/A,N/A,748,758,N/A,75,5
2,N/A,N/A,N/A,746,748,N/A,78,2
18,N/A,N/A,N/A,728,746,N/A,81,5
8,N/A,N/A,N/A,720,728,N/A,86,4
2,N/A,N/A,N/A,718,720,N/A,91,3
2,N/A,N/A,N/A,716,718,N/A,96,2
3,N/A,N/A,N/A,713,716,N/A,102,2
17,N/A,N/A,N/A,696,713,N/A,105,5
10,N/A,N/A,N/A,686,696,N/A,111,5
2,N/A,N/A,N/A,684,686,N/A,114,2
13,N/A,N/A,N/A,671,684,N/A,118,6
8,N/A,N/A,N/A,663,671,N/A,122,4
13,N/A,N/A,N/A,650,663,N/A,128,4
4,N/A,N/A,N/A,646,650,N/A,132,2
13,N/A,N/A,N/A,633,646,N/A,136,6
4,N/A,N/A,N/A,1505,1509,N/A,4,3
2,N/A,N/A,N/A,1503,1505,N/A,10,3
3,N/A,N/A,N/A,1500,1503,N/A,16,3
3,N/A,N/A,N/A,1497,1500,N/A,21,2
12,N/A,N/A,N/A,1485,1497,N/A,24,5
10,N/A,N/A,N/A,1475,1485,N/A,29,4
2,N/A,N/A,N/A,1473,1475,N/A,34,3
2,N/A,N/A,N/A,1471,1473,N/A,39,2
3,N/A,N/A,N/A,1468,1471,N/A,45,2
1,N/A,N/A,N/A,1467,1468,N/A,50,1
7,N/A,N/A,N/A,1460,1467,N/A,53,4
2,N/A,N/A,N/A,1458,1460,N/A,56,1
14,N/A,N/A,N/A,1444,1458,N/A,60,5
2,N/A,N/A,N/A,1442,1444,N/A,63,2
13,N/A,N/A,N/A,1429,1442,N/A,66,5
10,N/A,N/A,N/A,1419,1429,N/A,71,4
2,N/A,N/A,N/A,1417,1419,N/A,75,2
19,N/A,N/A,N/A,1398,1417,N/A,78,5
4,N/A,N/A,N/A,1394,1398,N/A,81,2
2,N/A,N/A,N/A,1392,1394,N/A,86,1
12,N/A,N/A,N/A,1380,1392,N/A,89,4
2,N/A,N/A,N/A,1378,1380,N/A,92,1
10,N/A,N/A,N/A,1368,1378,N/A,95,4
2,N/A,N/A,N/A,1366,1368,N/A,98,1
18,N/A,N/A,N/A,1348,1366,N/A,103,6
4,N/A,N/A,N/A,1344,1348,N/A,106,3
11,N/A,N/A,N/A,1333,1344,N/A,109,6
13,N/A,N/A,N/A,1320,1333,N/A,113,4
1,N/A,N/A,N/A,1319,1320,N/A,116,1
9,N/A,N/A,N/A,1310,1319,N/A,119,4
3,N/A,N/A,N/A,343,346,N/A,4,3
4,N/A,N/A,N/A,339,343,N/A,10,3
2,N/A,N/A,N/A,337,339,N/A,14,1
7,N/A,N/A,N/A,330,337,N/A,17,4
2,N/A,N/A,N/A,328,330,N/A,22,3
1,N/A,N/A,N/A,327,328,N/A,26,1
2,N/A,N/A,N/A,325,327,N/A,32,1
16,N/A,N/A,N/A,309,325,N/A,36,5
4,N/A,N/A,N/A,305,309,N/A,39,2
12,N/A,N/A,N/A,293,305,N/A,43,6
5,N/A,N/A,N/A,288,293,N/A,47,4
1,N/A,N/A,N/A,287,288,N/A,50,1
2,N/A,N/A,N/A,285,287,N/A,56,1
1,N/A,N/A,N/A,284,285,N/A,62,1
11,N/A,N/A,N/A,273,284,N/A,66,5
14,N/A,N/A,N/A,259,273,N/A,71,4
7,N/A,N/A,N/A,252,259,N/A,77,4
2,N/A,N/A,N/A,250,252,N/A,82,3
4,N/A,N/A,N/A,246,250,N/A,87,2
14,N/A,N/A,N/A,232,246,N/A,91,6
14,N/A,N/A,N/A,218,232,N/A,96,5
10,N/A,N/A,N/A,208,218,N/A,101,4
2,N/A,N/A,N/A,206,208,N/A,104,1
17,N/A,N/A,N/A,189,206,N/A,108,5
2,N/A,N/A,N/A,187,189,N/A,112,3
2,N/A,N/A,N/A,185,187,N/A,116,1
11,N/A,N/A,N/A,174,185,N/A,120,5
9,N/A,N/A,N/A,165,174,N/A,125,4
13,N/A,N/A,N/A,152,165,N/A,131,4
4,N/A,N/A,N/A,148,152,N/A,136,3
18,N/A,N/A,N/A,1480,1498,N/A,5,5
12,N/A,N/A,N/A,1468,1480,N/A,11,5
2,N/A,N/A,N/A,1466,1468,N/A,15,3
3,N/A,N/A,N/A,1463,1466,N/A,21,3
3,N/A,N/A,N/A,1460,1463,N/A,27,3
1,N/A,N/A,N/A,1459,1460,N/A,31,1
16,N/A,N/A,N/A,1443,1459,N/A,35,5
14,N/A,N/A,N/A,1429,1443,N/A,40,4
3,N/A,N/A,N/A,1426,1429,N/A,44,2
3,N/A,N/A,N/A,1423,1426,N/A,50,2
1,N/A,N/A,N/A,1422,1423,N/A,55,1
18,N/A,N/A,N/A,1404,1422,N/A,59,5
17,N/A,N/A,N/A,1387,1404,N/A,65,5
7,N/A,N/A,N/A,1380,1387,N/A,70,4
8,N/A,N/A,N/A,1372,1380,N/A,76,4
2,N/A,N/A,N/A,1370,1372,N/A,79,1
1,N/A,N/A,N/A,1369,1370,N/A,85,1
2,N/A,N/A,N/A,1367,1369,N/A,91,1
8,N/A,N/A,N/A,1359,1367,N/A,94,4
1,N/A,N/A,N/A,1358,1359,N/A,97,1
14,N/A,N/A,N/A,1344,1358,N/A,101,5
11,N/A,N/A,N/A,1333,1344,N/A,106,4
2,N/A,N/A,N/A,1331,1333,N/A,111,3
4,N/A,N/A,N/A,1327,1331,N/A,117,3
2,N/A,N/A,N/A,1325,1327,N/A,121,1
1,N/A,N/A,N/A,1324,1325,N/A,127,1
13,N/A,N/A,N/A,1311,1324,N/A,131,5
4,N/A,N/A,N/A,1307,1311,N/A,135,3
3,N/A,N/A,N/A,1304,1307,N/A,141,3
3,N/A,N/A,N/A,1301,1304,N/A,146,2
3,N/A,N/A,N/A,790,793,N/A,6,2
3,N/A,N/A,N/A,787,790,N/A,12,2
3,N/A,N/A,N/A,784,787,N/A,18,2
12,N/A,N/A,N/A,772,784,N/A,21,5
2,N/A,N/A,N/A,770,772,N/A,25,3
14,N/A,N/A,N/A,756,770,N/A,28,6
3,N/A,N/A,N/A,753,756,N/A,31,3
1,N/A,N/A,N/A,752,753,N/A,35,1
13,N/A,N/A,N/A,739,752,N/A,39,5
13,N/A,N/A,N/A,726,739,N/A,45,5
12,N/A,N/A,N/A,714,726,N/A,51,5
2,N/A,N/A,N/A,712,714,N/A,54,2
13,N/A,N/A,N/A,699,712,N/A,58,6
18,N/A,N/A,N/A,681,699,N/A,63,5
10,N/A,N/A,N/A,671,681,N/A,68,4
4,N/A,N/A,N/A,667,671,N/A,73,3
3,N/A,N/A,N/A,664,667,N/A,79,3
4,N/A,N/A,N/A,660,664,N/A,85,3
2,N/A,N/A,N/A,658,660,N/A,89,1
15,N/A,N/A,N/A,643,658,N/A,94,6
4,N/A,N/A,N/A,639,643,N/A,97,3
2,N/A,N/A,N/A,637,639,N/A,103,3
2,N/A,N/A,N/A,635,637,N/A,107,1
2,N/A,N/A,N/A,633,635,N/A,113,1
14,N/A,N/A,N/A,619,633,N/A,116,4
2,N/A,N/A,N/A,617,619,N/A,121,3
1,N/A,N/A,N/A,616,617,N/A,125,1
6,N/A,N/A,N/A,610,616,N/A,128,4
2,N/A,N/A,N/A,608,610,N/A,133,3
2,N/A,N/A,N/A,606,608,N/A,137,1
2,N/A,N/A,N/A,1397,1399,N/A,6,2
17,N/A,N/A,N/A,1380,1397,N/A,10,6
13,N/A,N/A,N/A,1367,1380,N/A,14,4
4,N/A,N/A,N/A,1363,1367,N/A,18,2
2,N/A,N/A,N/A,1361,1363,N/A,24,2
4,N/A,N/A,N/A,1357,1361,N/A,30,2
16,N/A,N/A,N/A,1341,1357,N/A,34,6
1,N/A,N/A,N/A,1340,1341,N/A,40,0
4,N/A,N/A,N/A,1336,1340,N/A,43,3
17,N/A,N/A,N/A,1319,1336,N/A,46,6
11,N/A,N/A,N/A,1308,1319,N/A,51,5
4,N/A,N/A,N/A,1304,1308,N/A,54,2
11,N/A,N/A,N/A,1293,1304,N/A,57,5
2,N/A,N/A,N/A,1291,1293,N/A,61,3
2,N/A,N/A,N/A,1289,1291,N/A,67,3
2,N/A,N/A,N/A,1287,1289,N/A,71,1
9,N/A,N/A,N/A,1278,1287,N/A,74,4
3,N/A,N/A,N/A,1275,1278,N/A,78,2
11,N/A,N/A,N/A,1264,1275,N/A,82,6
2,N/A,N/A,N/A,1262,1264,N/A,88,0
17,N/A,N/A,N/A,1245,1262,N/A,94,6
12,N/A,N/A,N/A,1233,1245,N/A,99,5
18,N/A,N/A,N/A,1215,1233,N/A,105,5
12,N/A,N/A,N/A,1203,1215,N/A,111,5
3,N/A,N/A,N/A,1200,1203,N/A,114,2
18,N/A,N/A,N/A,1182,1200,N/A,117,5
3,N/A,N/A,N/A,1179,1182,N/A,121,3
2,N/A,N/A,N/A,1177,1179,N/A,125,1
14,N/A,N/A,N/A,1163,1177,N/A,130,6
16,N/A,N/A,N/A,1147,1163,N/A,135,5
9,N/A,N/A,N/A,1922,1931,N/A,4,4
6,N/A,N/A,N/A,1916,1922,N/A,10,4
3,N/A,N/A,N/A,1913,1916,N/A,15,3
3,N/A,N/A,N/A,1910,1913,N/A,20,2
18,N/A,N/A,N/A,1892,1910,N/A,23,5
10,N/A,N/A,N/A,1882,1892,N/A,28,4
2,N/A,N/A,N/A,1880,1882,N/A,32,2
18,N/A,N/A,N/A,1862,1880,N/A,35,5
10,N/A,N/A,N/A,1852,1862,N/A,40,4
3,N/A,N/A,N/A,1849,1852,N/A,44,2
2,N/A,N/A,N/A,1847,1849,N/A,49,1
18,N/A,N/A,N/A,1829,1847,N/A,54,6
12,N/A,N/A,N/A,1817,1829,N/A,59,5
2,N/A,N/A,N/A,1815,1817,N/A,63,3
15,N/A,N/A,N/A,1800,1815,N/A,66,6
11,N/A,N/A,N/A,1789,1800,N/A,70,4
2,N/A,N/A,N/A,1787,1789,N/A,75,3
14,N/A,N/A,N/A,1773,1787,N/A,78,6
18,N/A,N/A,N/A,1755,1773,N/A,83,5
3,N/A,N/A,N/A,1752,1755,N/A,86,2
2,N/A,N/A,N/A,1750,1752,N/A,91,1
1,N/A,N/A,N/A,1749,1750,N/A,97,1
10,N/A,N/A,N/A,1739,1749,N/A,101,5
16,N/A,N/A,N/A,1723,1739,N/A,107,5
10,N/A,N/A,N/A,1713,1723,N/A,112,4
2,N/A,N/A,N/A,1711,1713,N/A,115,1
2,N/A,N/A,N/A,1709,1711,N/A,121,1
17,N/A,N/A,N/A,1692,1709,N/A,126,6
18,N/A,N/A,N/A,1674,1692,N/A,131,5
14,N/A,N/A,N/A,1660,1674,N/A,137,5
1,N/A,N/A,N/A,891,892,N/A,6,1
17,N/A,N/A,N/A,874,891,N/A,10,5
18,N/A,N/A,N/A,856,874,N/A,16,5
3,N/A,N/A,N/A,853,856,N/A,19,2
11,N/A,N/A,N/A,842,853,N/A,22,5
2,N/A,N/A,N/A,840,842,N/A,25,2
20,N/A,N/A,N/A,820,840,N/A,29,6
2,N/A,N/A,N/A,818,820,N/A,35,0
4,N/A,N/A,N/A,814,818,N/A,38,3
3,N/A,N/A,N/A,811,814,N/A,44,3
19,N/A,N/A,N/A,792,811,N/A,47,6
12,N/A,N/A,N/A,780,792,N/A,52,5
7,N/A,N/A,N/A,773,780,N/A,57,4
1,N/A,N/A,N/A,772,773,N/A,60,1
19,N/A,N/A,N/A,753,772,N/A,65,6
2,N/A,N/A,N/A,751,753,N/A,68,3
19,N/A,N/A,N/A,732,751,N/A,71,6
14,N/A,N/A,N/A,718,732,N/A,75,4
3,N/A,N/A,N/A,715,718,N/A,79,2
17,N/A,N/A,N/A,698,715,N/A,83,6
10,N/A,N/A,N/A,688,698,N/A,87,4
2,N/A,N/A,N/A,686,688,N/A,90,1
1,N/A,N/A,N/A,685,686,N/A,96,1
11,N/A,N/A,N/A,674,685,N/A,100,5
11,N/A,N/A,N/A,663,674,N/A,105,4
14,N/A,N/A,N/A,649,663,N/A,111,4
6,N/A,N/A,N/A,643,649,N/A,117,4
10,N/A,N/A,N/A,633,643,N/A,123,4
2,N/A,N/A,N/A,631,633,N/A,128,3
2,N/A,N/A,N/A,629,631,N/A,132,1
2,N/A,N/A,N/A,435,437,N/A,3,3
3,N/A,N/A,N/A,432,435,N/A,8,2
11,N/A,N/A,N/A,421,432,N/A,12,6
3,N/A,N/A,N/A,418,421,N/A,15,3
3,N/A,N/A,N/A,415,418,N/A,20,2
2,N/A,N/A,N/A,413,415,N/A,25,1
18,N/A,N/A,N/A,395,413,N/A,30,6
2,N/A,N/A,N/A,393,395,N/A,36,0
2,N/A,N/A,N/A,391,393,N/A,39,3
2,N/A,N/A,N/A,389,391,N/A,45,3
2,N/A,N/A,N/A,387,389,N/A,49,1
17,N/A,N/A,N/A,370,387,N/A,53,5
2,N/A,N/A,N/A,368,370,N/A,56,2
4,N/A,N/A,N/A,364,368,N/A,62,2
17,N/A,N/A,N/A,347,364,N/A,66,6
2,N/A,N/A,N/A,345,347,N/A,72,0
5,N/A,N/A,N/A,340,345,N/A,76,4
2,N/A,N/A,N/A,338,340,N/A,80,2
11,N/A,N/A,N/A,327,338,N/A,84,6
13,N/A,N/A,N/A,314,327,N/A,89,5
15,N/A,N/A,N/A,299,314,N/A,95,5
3,N/A,N/A,N/A,296,299,N/A,98,2
2,N/A,N/A,N/A,294,296,N/A,103,1
14,N/A,N/A,N/A,280,294,N/A,108,6
14,N/A,N/A,N/A,266,280,N/A,113,5
12,N/A,N/A,N/A,254,266,N/A,118,4
2,N/A,N/A,N/A,252,254,N/A,122,2
1,N/A,N/A,N/A,251,252,N/A,127,1
12,N/A,N/A,N/A,239,251,N/A,130,4
13,N/A,N/A,N/A,226,239,N/A,136,4
7,N/A,N/A,N/A,1260,1267,N/A,5,4
3,N/A,N/A,N/A,1257,1260,N/A,10,3
3,N/A,N/A,N/A,1254,1257,N/A,16,3
3,N/A,N/A,N/A,1251,1254,N/A,22,3
4,N/A,N/A,N/A,1247,1251,N/A,27,2
14,N/A,N/A,N/A,1233,1247,N/A,30,5
6,N/A,N/A,N/A,1227,1233,N/A,35,4
3,N/A,N/A,N/A,1224,1227,N/A,39,2
4,N/A,N/A,N/A,1220,1224,N/A,45,2
4,N/A,N/A,N/A,1216,1220,N/A,51,2
3,N/A,N/A,N/A,1213,1216,N/A,57,2
2,N/A,N/A,N/A,1211,1213,N/A,62,1
12,N/A,N/A,N/A,1199,1211,N/A,66,5
12,N/A,N/A,N/A,1187,1199,N/A,72,5
4,N/A,N/A,N/A,1183,1187,N/A,76,3
15,N/A,N/A,N/A,1168,1183,N/A,79,6
11,N/A,N/A,N/A,1157,1168,N/A,83,4
2,N/A,N/A,N/A,1155,1157,N/A,86,1
2,N/A,N/A,N/A,1153,1155,N/A,92,1
12,N/A,N/A,N/A,1141,1153,N/A,96,5
19,N/A,N/A,N/A,1122,1141,N/A,102,5
15,N/A,N/A,N/A,1107,1122,N/A,108,5
19,N/A,N/A,N/A,1088,1107,N/A,114,5
10,N/A,N/A,N/A,1078,1088,N/A,119,4
12,N/A,N/A,N/A,1066,1078,N/A,125,4
4,N/A,N/A,N/A,1062,1066,N/A,129,2
19,N/A,N/A,N/A,1043,1062,N/A,133,6
1,N/A,N/A,N/A,1042,1043,N/A,139,0
14,N/A,N/A,N/A,1028,1042,N/A,143,4
2,N/A,N/A,N/A,1026,1028,N/A,148,3
3,N/A,N/A,N/A,1733,1736,N/A,5,3
2,N/A,N/A,N/A,1731,1733,N/A,10,2
2,N/A,N/A,N/A,1729,1731,N/A,16,2
4,N/A,N/A,N/A,1725,1729,N/A,22,2
2,N/A,N/A,N/A,1723,1725,N/A,27,1
17,N/A,N/A,N/A,1706,1723,N/A,31,5
13,N/A,N/A,N/A,1693,1706,N/A,37,5
12,N/A,N/A,N/A,1681,1693,N/A,43,5
4,N/A,N/A,N/A,1677,1681,N/A,46,2
12,N/A,N/A,N/A,1665,1677,N/A,50,6
3,N/A,N/A,N/A,1662,1665,N/A,53,3
2,N/A,N/A,N/A,1660,1662,N/A,57,1
2,N/A,N/A,N/A,1658,1660,N/A,63,1
1,N/A,N/A,N/A,1657,1658,N/A,69,1
1,N/A,N/A,N/A,1656,1657,N/A,75,1
12,N/A,N/A,N/A,1644,1656,N/A,79,5
4,N/A,N/A,N/A,1640,1644,N/A,83,3
4,N/A,N/A,N/A,1636,1640,N/A,89,3
2,N/A,N/A,N/A,1634,1636,N/A,94,2
14,N/A,N/A,N/A,1620,1634,N/A,98,6
2,N/A,N/A,N/A,1618,1620,N/A,104,0
14,N/A,N/A,N/A,1604,1618,N/A,109,5
15,N/A,N/A,N/A,1589,1604,N/A,115,5
16,N/A,N/A,N/A,1573,1589,N/A,121,5
17,N/A,N/A,N/A,1556,1573,N/A,127,5
3,N/A,N/A,N/A,1553,1556,N/A,130,2
12,N/A,N/A,N/A,1541,1553,N/A,134,6
13,N/A,N/A,N/A,1528,1541,N/A,138,4
2,N/A,N/A,N/A,1526,1528,N/A,142,2
16,N/A,N/A,N/A,1510,1526,N/A,146,6
4,N/A,N/A,N/A,1613,1617,N/A,4,2
18,N/A,N/A,N/A,1595,1613,N/A,7,5
10,N/A,N/A,N/A,1585,1595,N/A,13,5
11,N/A,N/A,N/A,1574,1585,N/A,18,4
3,N/A,N/A,N/A,1571,1574,N/A,23,3
2,N/A,N/A,N/A,1569,1571,N/A,29,3
4,N/A,N/A,N/A,1565,1569,N/A,34,2
2,N/A,N/A,N/A,1563,1565,N/A,39,1
17,N/A,N/A,N/A,1546,1563,N/A,43,5
12,N/A,N/A,N/A,1534,1546,N/A,48,4
1,N/A,N/A,N/A,1533,1534,N/A,51,1
13,N/A,N/A,N/A,1520,1533,N/A,55,5
2,N/A,N/A,N/A,1518,1520,N/A,58,2
19,N/A,N/A,N/A,1499,1518,N/A,62,6
1,N/A,N/A,N/A,1498,1499,N/A,68,0
16,N/A,N/A,N/A,1482,1498,N/A,73,5
6,N/A,N/A,N/A,1476,1482,N/A,78,4
3,N/A,N/A,N/A,1473,1476,N/A,83,3
2,N/A,N/A,N/A,1471,1473,N/A,87,1
16,N/A,N/A,N/A,1455,1471,N/A,91,5
4,N/A,N/A,N/A,1451,1455,N/A,95,3
1,N/A,N/A,N/A,1450,1451,N/A,99,1
16,N/A,N/A,N/A,1434,1450,N/A,103,5
7,N/A,N/A,N/A,1427,1434,N/A,108,4
1,N/A,N/A,N/A,1426,1427,N/A,111,1
16,N/A,N/A,N/A,1410,1426,N/A,115,5
2,N/A,N/A,N/A,1408,1410,N/A,118,2
2,N/A,N/A,N/A,1406,1408,N/A,124,2
3,N/A,N/A,N/A,1403,1406,N/A,130,2
12,N/A,N/A,N/A,1391,1403,N/A,134,6
3,N/A,N/A,N/A,594,597,N/A,3,2
11,N/A,N/A,N/A,583,594,N/A,6,5
11,N/A,N/A,N/A,572,583,N/A,11,4
4,N/A,N/A,N/A,568,572,N/A,15,2
2,N/A,N/A,N/A,566,568,N/A,21,2
1,N/A,N/A,N/A,565,566,N/A,26,1
6,N/A,N/A,N/A,559,565,N/A,29,4
3,N/A,N/A,N/A,556,559,N/A,34,3
2,N/A,N/A,N/A,554,556,N/A,40,3
2,N/A,N/A,N/A,552,554,N/A,44,1
11,N/A,N/A,N/A,541,552,N/A,49,6
3,N/A,N/A,N/A,538,541,N/A,52,3
12,N/A,N/A,N/A,526,538,N/A,55,6
3,N/A,N/A,N/A,523,526,N/A,58,3
2,N/A,N/A,N/A,521,523,N/A,63,2
19,N/A,N/A,N/A,502,521,N/A,66,5
2,N/A,N/A,N/A,500,502,N/A,69,2
10,N/A,N/A,N/A,490,500,N/A,72,5
11,N/A,N/A,N/A,479,490,N/A,77,4
4,N/A,N/A,N/A,475,479,N/A,82,3
3,N/A,N/A,N/A,472,475,N/A,87,2
20,N/A,N/A,N/A,452,472,N/A,91,6
2,N/A,N/A,N/A,450,452,N/A,94,3
15,N/A,N/A,N/A,435,450,N/A,97,6
5,N/A,N/A,N/A,430,435,N/A,101,4
3,N/A,N/A,N/A,427,430,N/A,105,2
16,N/A,N/A,N/A,411,427,N/A,108,5
3,N/A,N/A,N/A,408,411,N/A,111,2
18,N/A,N/A,N/A,390,408,N/A,115,6
1,N/A,N/A,N/A,389,390,N/A,121,0
3,N/A,N/A,N/A,482,485,N/A,5,3
20,N/A,N/A,N/A,462,482,N/A,8,6
1,N/A,N/A,N/A,461,462,N/A,14,0
13,N/A,N/A,N/A,448,461,N/A,18,4
1,N/A,N/A,N/A,447,448,N/A,21,1
12,N/A,N/A,N/A,435,447,N/A,24,4
1,N/A,N/A,N/A,434,435,N/A,27,1
19,N/A,N/A,N/A,415,434,N/A,32,6
3,N/A,N/A,N/A,412,415,N/A,35,3
2,N/A,N/A,N/A,410,412,N/A,40,2
2,N/A,N/A,N/A,408,410,N/A,45,1
16,N/A,N/A,N/A,392,408,N/A,49,5
2,N/A,N/A,N/A,390,392,N/A,53,3
19,N/A,N/A,N/A,371,390,N/A,56,6
2,N/A,N/A,N/A,369,371,N/A,62,0
17,N/A,N/A,N/A,352,369,N/A,68,6
18,N/A,N/A,N/A,334,352,N/A,73,5
4,N/A,N/A,N/A,330,334,N/A,77,3
2,N/A,N/A,N/A,328,330,N/A,82,2
18,N/A,N/A,N/A,310,328,N/A,85,5
14,N/A,N/A,N/A,296,310,N/A,91,5
16,N/A,N/A,N/A,280,296,N/A,97,5
6,N/A,N/A,N/A,274,280,N/A,102,4
1,N/A,N/A,N/A,273,274,N/A,105,1
1,N/A,N/A,N/A,272,273,N/A,111,1
7,N/A,N/A,N/A,265,272,N/A,114,4
3,N/A,N/A,N/A,262,265,N/A,118,2
12,N/A,N/A,N/A,250,262,N/A,121,5
18,N/A,N/A,N/A,232,250,N/A,127,5
4,N/A,N/A,N/A,228,232,N/A,130,2
9,N/A,N/A,N/A,1757,1766,N/A,6,4
2,N/A,N/A,N/A,1755,1757,N/A,10,2
20,N/A,N/A,N/A,1735,1755,N/A,14,6
10,N/A,N/A,N/A,1725,1735,N/A,19,5
3,N/A,N/A,N/A,1722,1725,N/A,22,2
4,N/A,N/A,N/A,1718,1722,N/A,28,2
2,N/A,N/A,N/A,1716,1718,N/A,33,1
1,N/A,N/A,N/A,1715,1716,N/A,39,1
11,N/A,N/A,N/A,1704,1715,N/A,44,6
14,N/A,N/A,N/A,1690,1704,N/A,48,4
2,N/A,N/A,N/A,1688,1690,N/A,53,3
4,N/A,N/A,N/A,1684,1688,N/A,59,3
11,N/A,N/A,N/A,1673,1684,N/A,62,6
13,N/A,N/A,N/A,1660,1673,N/A,67,5
2,N/A,N/A,N/A,1658,1660,N/A,71,3
2,N/A,N/A,N/A,1656,1658,N/A,75,1
17,N/A,N/A,N/A,1639,1656,N/A,79,5
12,N/A,N/A,N/A,1627,1639,N/A,85,5
16,N/A,N/A,N/A,1611,1627,N/A,91,5
18,N/A,N/A,N/A,1593,1611,N/A,97,5
4,N/A,N/A,N/A,1589,1593,N/A,101,3
12,N/A,N/A,N/A,1577,1589,N/A,104,6
4,N/A,N/A,N/A,1573,1577,N/A,107,3
2,N/A,N/A,N/A,1571,1573,N/A,113,3
4,N/A,N/A,N/A,1567,1571,N/A,119,3
1,N/A,N/A,N/A,1566,1567,N/A,123,1
13,N/A,N/A,N/A,1553,1566,N/A,126,4
13,N/A,N/A,N/A,1540,1553,N/A,132,4
3,N/A,N/A,N/A,1537,1540,N/A,136,2
1,N/A,N/A,N/A,1536,1537,N/A,141,1
8,N/A,N/A,N/A,1797,1805,N/A,6,4
7,N/A,N/A,N/A,1790,1797,N/A,12,4
14,N/A,N/A,N/A,1776,1790,N/A,18,4
1,N/A,N/A,N/A,1775,1776,N/A,21,1
11,N/A,N/A,N/A,1764,1775,N/A,24,4
4,N/A,N/A,N/A,1760,1764,N/A,28,2
19,N/A,N/A,N/A,1741,1760,N/A,31,5
15,N/A,N/A,N/A,1726,1741,N/A,37,5
4,N/A,N/A,N/A,1722,1726,N/A,40,2
4,N/A,N/A,N/A,1718,1722,N/A,46,2
12,N/A,N/A,N/A,1706,1718,N/A,49,5
18,N/A,N/A,N/A,1688,1706,N/A,55,5
2,N/A,N/A,N/A,1686,1688,N/A,59,3
2,N/A,N/A,N/A,1684,1686,N/A,65,3
2,N/A,N/A,N/A,1682,1684,N/A,69,1
20,N/A,N/A,N/A,1662,1682,N/A,74,6
5,N/A,N/A,N/A,1657,1662,N/A,78,4
4,N/A,N/A,N/A,1653,1657,N/A,83,3
3,N/A,N/A,N/A,1650,1653,N/A,89,3
4,N/A,N/A,N/A,1646,1650,N/A,95,3
4,N/A,N/A,N/A,1642,1646,N/A,100,2
15,N/A,N/A,N/A,1627,1642,N/A,104,6
3,N/A,N/A,N/A,1624,1627,N/A,107,3
13,N/A,N/A,N/A,1611,1624,N/A,110,6
2,N/A,N/A,N/A,1609,1611,N/A,116,0
3,N/A,N/A,N/A,1606,1609,N/A,119,3
4,N/A,N/A,N/A,1602,1606,N/A,125,3
4,N/A,N/A,N/A,1598,1602,N/A,131,3
20,N/A,N/A,N/A,1578,1598,N/A,134,6
4,N/A,N/A,N/A,1574,1578,N/A,137,3
12,N/A,N/A,N/A,896,908,N/A,6,5
14,N/A,N/A,N/A,882,896,N/A,12,5
4,N/A,N/A,N/A,878,882,N/A,15,2
2,N/A,N/A,N/A,876,878,N/A,20,1
11,N/A,N/A,N/A,865,876,N/A,23,4
2,N/A,N/A,N/A,863,865,N/A,26,1
18,N/A,N/A,N/A,845,863,N/A,30,5
10,N/A,N/A,N/A,835,845,N/A,35,4
2,N/A,N/A,N/A,833,835,N/A,38,1
13,N/A,N/A,N/A,820,833,N/A,43,6
12,N/A,N/A,N/A,808,820,N/A,47,4
10,N/A,N/A,N/A,798,808,N/A,53,4
3,N/A,N/A,N/A,795,798,N/A,58,3
4,N/A,N/A,N/A,791,795,N/A,64,3
17,N/A,N/A,N/A,774,791,N/A,67,6
17,N/A,N/A,N/A,757,774,N/A,72,5
12,N/A,N/A,N/A,745,757,N/A,77,4
4,N/A,N/A,N/A,741,745,N/A,81,2
2,N/A,N/A,N/A,739,741,N/A,87,2
19,N/A,N/A,N/A,720,739,N/A,90,5
6,N/A,N/A,N/A,714,720,N/A,95,4
4,N/A,N/A,N/A,710,714,N/A,99,2
2,N/A,N/A,N/A,708,710,N/A,104,1
1,N/A,N/A,N/A,707,708,N/A,110,1
18,N/A,N/A,N/A,689,707,N/A,115,6
1,N/A,N/A,N/A,688,689,N/A,121,0
14,N/A,N/A,N/A,674,688,N/A,127,6
4,N/A,N/A,N/A,670,674,N/A,130,3
4,N/A,N/A,N/A,666,670,N/A,136,3
16,N/A,N/A,N/A,650,666,N/A,139,6
4,N/A,N/A,N/A,613,617,N/A,6,2
3,N/A,N/A,N/A,610,613,N/A,12,2
2,N/A,N/A,N/A,608,610,N/A,17,1
14,N/A,N/A,N/A,594,608,N/A,20,4
3,N/A,N/A,N/A,591,594,N/A,25,3
2,N/A,N/A,N/A,589,591,N/A,31,3
2,N/A,N/A,N/A,587,589,N/A,35,1
14,N/A,N/A,N/A,573,587,N/A,38,4
2,N/A,N/A,N/A,571,573,N/A,43,3
4,N/A,N/A,N/A,567,571,N/A,49,3
2,N/A,N/A,N/A,565,567,N/A,55,3
3,N/A,N/A,N/A,562,565,N/A,60,2
11,N/A,N/A,N/A,551,562,N/A,63,5
4,N/A,N/A,N/A,547,551,N/A,67,3
1,N/A,N/A,N/A,546,547,N/A,71,1
12,N/A,N/A,N/A,534,546,N/A,75,5
3,N/A,N/A,N/A,531,534,N/A,79,3
2,N/A,N/A,N/A,529,531,N/A,85,3
14,N/A,N/A,N/A,515,529,N/A,88,6
4,N/A,N/A,N/A,511,515,N/A,91,3
12,N/A,N/A,N/A,499,511,N/A,94,6
2,N/A,N/A,N/A,497,499,N/A,97,3
4,N/A,N/A,N/A,493,497,N/A,102,2
1,N/A,N/A,N/A,492,493,N/A,107,1
17,N/A,N/A,N/A,475,492,N/A,111,5
12,N/A,N/A,N/A,463,475,N/A,116,4
1,N/A,N/A,N/A,462,463,N/A,119,1
2,N/A,N/A,N/A,460,462,N/A,125,1
13,N/A,N/A,N/A,447,460,N/A,130,6
1,N/A,N/A,N/A,446,447,N/A,136,0
3,N/A,N/A,N/A,1039,1042,N/A,5,2
3,N/A,N/A,N/A,1036,1039,N/A,11,2
15,N/A,N/A,N/A,1021,1036,N/A,14,5
12,N/A,N/A,N/A,1009,1021,N/A,20,5
10,N/A,N/A,N/A,999,1009,N/A,26,5
9,N/A,N/A,N/A,990,999,N/A,31,4
2,N/A,N/A,N/A,988,990,N/A,35,2
1,N/A,N/A,N/A,987,988,N/A,40,1
2,N/A,N/A,N/A,985,987,N/A,46,1
2,N/A,N/A,N/A,983,985,N/A,52,1
13,N/A,N/A,N/A,970,983,N/A,56,5
16,N/A,N/A,N/A,954,970,N/A,62,5
4,N/A,N/A,N/A,950,954,N/A,65,2
18,N/A,N/A,N/A,932,950,N/A,69,6
2,N/A,N/A,N/A,930,932,N/A,75,0
7,N/A,N/A,N/A,923,930,N/A,79,4
2,N/A,N/A,N/A,921,923,N/A,83,2
3,N/A,N/A,N/A,918,921,N/A,89,2
15,N/A,N/A,N/A,903,918,N/A,92,5
13,N/A,N/A,N/A,890,903,N/A,97,4
5,N/A,N/A,N/A,885,890,N/A,103,4
3,N/A,N/A,N/A,882,885,N/A,108,3
12,N/A,N/A,N/A,870,882,N/A,111,6
4,N/A,N/A,N/A,866,870,N/A,114,3
2,N/A,N/A,N/A,864,866,N/A,119,2
1,N/A,N/A,N/A,863,864,N/A,124,1
10,N/A,N/A,N/A,853,863,N/A,128,5
11,N/A,N/A,N/A,842,853,N/A,133,4
3,N/A,N/A,N/A,839,842,N/A,138,3
1,N/A,N/A,N/A,838,839,N/A,142,1
2,N/A,N/A,N/A,1260,1262,N/A,3,1
15,N/A,N/A,N/A,1245,1260,N/A,7,5
15,N/A,N/A,N/A,1230,1245,N/A,13,5
14,N/A,N/A,N/A,1216,1230,N/A,19,5
2,N/A,N/A,N/A,1214,1216,N/A,22,2
15,N/A,N/A,N/A,1199,1214,N/A,26,6
1,N/A,N/A,N/A,1198,1199,N/A,32,0
13,N/A,N/A,N/A,1185,1198,N/A,37,5
2,N/A,N/A,N/A,1183,1185,N/A,41,3
3,N/A,N/A,N/A,1180,1183,N/A,46,2
17,N/A,N/A,N/A,1163,1180,N/A,50,6
15,N/A,N/A,N/A,1148,1163,N/A,55,5
11,N/A,N/A,N/A,1137,1148,N/A,60,4
13,N/A,N/A,N/A,1124,1137,N/A,66,4
4,N/A,N/A,N/A,1120,1124,N/A,70,2
3,N/A,N/A,N/A,1117,1120,N/A,76,2
3,N/A,N/A,N/A,1114,1117,N/A,82,2
3,N/A,N/A,N/A,1111,1114,N/A,88,2
4,N/A,N/A,N/A,1107,1111,N/A,94,2
11,N/A,N/A,N/A,1096,1107,N/A,97,5
14,N/A,N/A,N/A,1082,1096,N/A,102,4
1,N/A,N/A,N/A,1081,1082,N/A,105,1
17,N/A,N/A,N/A,1064,1081,N/A,109,5
3,N/A,N/A,N/A,1061,1064,N/A,113,3
2,N/A,N/A,N/A,1059,1061,N/A,117,1
1,N/A,N/A,N/A,1058,1059,N/A,123,1
8,N/A,N/A,N/A,1050,1058,N/A,126,4
3,N/A,N/A,N/A,1047,1050,N/A,131,3
1,N/A,N/A,N/A,1046,1047,N/A,135,1
14,N/A,N/A,N/A,1032,1046,N/A,138,4
3,N/A,N/A,N/A,718,721,N/A,6,2
16,N/A,N/A,N/A,702,718,N/A,9,5
4,N/A,N/A,N/A,698,702,N/A,12,2
11,N/A,N/A,N/A,687,698,N/A,16,6
1,N/A,N/A,N/A,686,687,N/A,22,0
15,N/A,N/A,N/A,671,686,N/A,28,6
2,N/A,N/A,N/A,669,671,N/A,34,0
4,N/A,N/A,N/A,665,669,N/A,37,3
16,N/A,N/A,N/A,649,665,N/A,40,6
6,N/A,N/A,N/A,643,649,N/A,44,4
5,N/A,N/A,N/A,638,643,N/A,50,4
3,N/A,N/A,N/A,635,638,N/A,54,2
2,N/A,N/A,N/A,633,635,N/A,60,2
2,N/A,N/A,N/A,631,633,N/A,65,1
17,N/A,N/A,N/A,614,631,N/A,70,6
8,N/A,N/A,N/A,606,614,N/A,74,4
9,N/A,N/A,N/A,597,606,N/A,80,4
3,N/A,N/A,N/A,594,597,N/A,84,2
18,N/A,N/A,N/A,576,594,N/A,88,6
2,N/A,N/A,N/A,574,576,N/A,91,3
16,N/A,N/A,N/A,558,574,N/A,94,6
7,N/A,N/A,N/A,551,558,N/A,98,4
3,N/A,N/A,N/A,548,551,N/A,102,2
15,N/A,N/A,N/A,533,548,N/A,106,6
3,N/A,N/A,N/A,530,533,N/A,109,3
1,N/A,N/A,N/A,529,530,N/A,113,1
17,N/A,N/A,N/A,512,529,N/A,117,5
13,N/A,N/A,N/A,499,512,N/A,122,4
1,N/A,N/A,N/A,498,499,N/A,125,1
16,N/A,N/A,N/A,482,498,N/A,130,6
18,N/A,N/A,N/A,1762,1780,N/A,5,5
6,N/A,N/A,N/A,1756,1762,N/A,10,4
6,N/A,N/A,N/A,1750,1756,N/A,16,4
3,N/A,N/A,N/A,1747,1750,N/A,20,2
1,N/A,N/A,N/A,1746,1747,N/A,25,1
5,N/A,N/A,N/A,1741,1746,N/A,28,4
10,N/A,N/A,N/A,1731,1741,N/A,34,4
7,N/A,N/A,N/A,1724,1731,N/A,40,4
1,N/A,N/A,N/A,1723,1724,N/A,43,1
1,N/A,N/A,N/A,1722,1723,N/A,49,1
1,N/A,N/A,N/A,1721,1722,N/A,55,1
16,N/A,N/A,N/A,1705,1721,N/A,60,6
2,N/A,N/A,N/A,1703,1705,N/A,63,3
3,N/A,N/A,N/A,1700,1703,N/A,69,3
2,N/A,N/A,N/A,1698,1700,N/A,74,2
4,N/A,N/A,N/A,1694,1698,N/A,80,2
20,N/A,N/A,N/A,1674,1694,N/A,84,6
14,N/A,N/A,N/A,1660,1674,N/A,88,4
4,N/A,N/A,N/A,1656,1660,N/A,93,3
2,N/A,N/A,N/A,1654,1656,N/A,98,2
15,N/A,N/A,N/A,1639,1654,N/A,101,5
13,N/A,N/A,N/A,1626,1639,N/A,107,5
4,N/A,N/A,N/A,1622,1626,N/A,110,2
10,N/A,N/A,N/A,1612,1622,N/A,113,5
3,N/A,N/A,N/A,1609,1612,N/A,116,2
4,N/A,N/A,N/A,1605,1609,N/A,122,2
1,N/A,N/A,N/A,1604,1605,N/A,127,1
17,N/A,N/A,N/A,1587,1604,N/A,131,5
2,N/A,N/A,N/A,1585,1587,N/A,135,3
3,N/A,N/A,N/A,1582,1585,N/A,140,2
9,N/A,N/A,N/A,364,373,N/A,4,4
6,N/A,N/A,N/A,358,364,N/A,10,4
2,N/A,N/A,N/A,356,358,N/A,13,1
9,N/A,N/A,N/A,347,356,N/A,16,4
2,N/A,N/A,N/A,345,347,N/A,21,3
17,N/A,N/A,N/A,328,345,N/A,24,6
4,N/A,N/A,N/A,324,328,N/A,27,3
3,N/A,N/A,N/A,321,324,N/A,32,2
16,N/A,N/A,N/A,305,321,N/A,35,5
4,N/A,N/A,N/A,301,305,N/A,39,3
4,N/A,N/A,N/A,297,301,N/A,44,2
1,N/A,N/A,N/A,296,297,N/A,49,1
1,N/A,N/A,N/A,295,296,N/A,55,1
13,N/A,N/A,N/A,282,295,N/A,58,4
3,N/A,N/A,N/A,279,282,N/A,62,2
3,N/A,N/A,N/A,276,279,N/A,68,2
1,N/A,N/A,N/A,275,276,N/A,73,1
20,N/A,N/A,N/A,255,275,N/A,78,6
18,N/A,N/A,N/A,237,255,N/A,83,5
4,N/A,N/A,N/A,233,237,N/A,87,3
3,N/A,N/A,N/A,230,233,N/A,92,2
2,N/A,N/A,N/A,228,230,N/A,97,1
17,N/A,N/A,N/A,211,228,N/A,101,5
4,N/A,N/A,N/A,207,211,N/A,105,3
4,N/A,N/A,N/A,203,207,N/A,111,3
12,N/A,N/A,N/A,191,203,N/A,114,6
11,N/A,N/A,N/A,180,191,N/A,118,4
2,N/A,N/A,N/A,178,180,N/A,121,1
1,N/A,N/A,N/A,177,178,N/A,127,1
2,N/A,N/A,N/A,175,177,N/A,133,1
11,N/A,N/A,N/A,1606,1617,N/A,5,4
5,N/A,N/A,N/A,1601,1606,N/A,11,4
3,N/A,N/A,N/A,1598,1601,N/A,15,2
2,N/A,N/A,N/A,1596,1598,N/A,20,1
20,N/A,N/A,N/A,1576,1596,N/A,25,6
1,N/A,N/A,N/A,1575,1576,N/A,31,0
2,N/A,N/A,N/A,1573,1575,N/A,34,3
12,N/A,N/A,N/A,1561,1573,N/A,37,6
18,N/A,N/A,N/A,1543,1561,N/A,42,5
15,N/A,N/A,N/A,1528,1543,N/A,48,5
4,N/A,N/A,N/A,1524,1528,N/A,51,2
11,N/A,N/A,N/A,1513,1524,N/A,55,6
4,N/A,N/A,N/A,1509,1513,N/A,58,3
4,N/A,N/A,N/A,1505,1509,N/A,63,2
12,N/A,N/A,N/A,1493,1505,N/A,66,5
2,N/A,N/A,N/A,1491,1493,N/A,70,3
3,N/A,N/A,N/A,1488,1491,N/A,75,2
3,N/A,N/A,N/A,1485,1488,N/A,81,2
18,N/A,N/A,N/A,1467,1485,N/A,84,5
3,N/A,N/A,N/A,1464,1467,N/A,88,3
12,N/A,N/A,N/A,1452,1464,N/A,91,6
4,N/A,N/A,N/A,1448,1452,N/A,94,3
2,N/A,N/A,N/A,1446,1448,N/A,98,1
13,N/A,N/A,N/A,1433,1446,N/A,102,5
2,N/A,N/A,N/A,1431,1433,N/A,106,3
3,N/A,N/A,N/A,1428,1431,N/A,111,2
4,N/A,N/A,N/A,1424,1428,N/A,117,2
16,N/A,N/A,N/A,1408,1424,N/A,121,6
2,N/A,N/A,N/A,1406,1408,N/A,124,3
2,N/A,N/A,N/A,1404,1406,N/A,129,2
12,N/A,N/A,N/A,1531,1543,N/A,4,5
3,N/A,N/A,N/A,1528,1531,N/A,7,2
19,N/A,N/A,N/A,1509,1528,N/A,10,5
4,N/A,N/A,N/A,1505,1509,N/A,14,3
11,N/A,N/A,N/A,1494,1505,N/A,17,6
7,N/A,N/A,N/A,1487,1494,N/A,21,4
4,N/A,N/A,N/A,1483,1487,N/A,26,3
1,N/A,N/A,N/A,1482,1483,N/A,30,1
2,N/A,N/A,N/A,1480,1482,N/A,36,1
13,N/A,N/A,N/A,1467,1480,N/A,39,4
2,N/A,N/A,N/A,1465,1467,N/A,43,2
3,N/A,N/A,N/A,1462,1465,N/A,49,2
2,N/A,N/A,N/A,1460,1462,N/A,55,2
1,N/A,N/A,N/A,1459,1460,N/A,60,1
19,N/A,N/A,N/A,1440,1459,N/A,65,6
3,N/A,N/A,N/A,1437,1440,N/A,68,3
16,N/A,N/A,N/A,1421,1437,N/A,71,6
11,N/A,N/A,N/A,1410,1421,N/A,75,4
2,N/A,N/A,N/A,1408,1410,N/A,79,2
15,N/A,N/A,N/A,1393,1408,N/A,83,6
4,N/A,N/A,N/A,1389,1393,N/A,86,3
18,N/A,N/A,N/A,1371,1389,N/A,89,6
4,N/A,N/A,N/A,1367,1371,N/A,92,3
15,N/A,N/A,N/A,1352,1367,N/A,95,6
12,N/A,N/A,N/A,1340,1352,N/A,99,4
3,N/A,N/A,N/A,1337,1340,N/A,103,2
13,N/A,N/A,N/A,1324,1337,N/A,107,6
1,N/A,N/A,N/A,1323,1324,N/A,113,0
11,N/A,N/A,N/A,1312,1323,N/A,117,4
4,N/A,N/A,N/A,1308,1312,N/A,122,3
2,N/A,N/A,N/A,1974,1976,N/A,5,2
14,N/A,N/A,N/A,1960,1974,N/A,9,6
1,N/A,N/A,N/A,1959,1960,N/A,15,0
12,N/A,N/A,N/A,1947,1959,N/A,20,5
5,N/A,N/A,N/A,1942,1947,N/A,25,4
2,N/A,N/A,N/A,1940,1942,N/A,29,2
2,N/A,N/A,N/A,1938,1940,N/A,34,1
5,N/A,N/A,N/A,1933,1938,N/A,37,4
3,N/A,N/A,N/A,1930,1933,N/A,41,2
3,N/A,N/A,N/A,1927,1930,N/A,47,2
2,N/A,N/A,N/A,1925,1927,N/A,53,2
1,N/A,N/A,N/A,1924,1925,N/A,58,1
7,N/A,N/A,N/A,1917,1924,N/A,61,4
10,N/A,N/A,N/A,1907,1917,N/A,67,4
8,N/A,N/A,N/A,1899,1907,N/A,73,4
1,N/A,N/A,N/A,1898,1899,N/A,76,1
11,N/A,N/A,N/A,1887,1898,N/A,80,5
2,N/A,N/A,N/A,1885,1887,N/A,83,2
18,N/A,N/A,N/A,1867,1885,N/A,87,6
19,N/A,N/A,N/A,1848,1867,N/A,92,5
14,N/A,N/A,N/A,1834,1848,N/A,98,5
6,N/A,N/A,N/A,1828,1834,N/A,103,4
7,N/A,N/A,N/A,1821,1828,N/A,109,4
2,N/A,N/A,N/A,1819,1821,N/A,112,1
14,N/A,N/A,N/A,1805,1819,N/A,116,5
3,N/A,N/A,N/A,1802,1805,N/A,120,3
2,N/A,N/A,N/A,1800,1802,N/A,124,1
13,N/A,N/A,N/A,1787,1800,N/A,128,5
14,N/A,N/A,N/A,1773,1787,N/A,134,5
4,N/A,N/A,N/A,1769,1773,N/A,138,3
12,N/A,N/A,N/A,798,810,N/A,4,5
2,N/A,N/A,N/A,796,798,N/A,8,3
20,N/A,N/A,N/A,776,796,N/A,11,6
3,N/A,N/A,N/A,773,776,N/A,14,3
2,N/A,N/A,N/A,771,773,N/A,20,3
2,N/A,N/A,N/A,769,771,N/A,26,3
19,N/A,N/A,N/A,750,769,N/A,29,6
2,N/A,N/A,N/A,748,750,N/A,32,3
2,N/A,N/A,N/A,746,748,N/A,36,1
1,N/A,N/A,N/A,745,746,N/A,42,1
2,N/A,N/A,N/A,743,745,N/A,48,1
10,N/A,N/A,N/A,733,743,N/A,52,5
3,N/A,N/A,N/A,730,733,N/A,56,3
17,N/A,N/A,N/A,713,730,N/A,59,6
4,N/A,N/A,N/A,709,713,N/A,62,3
4,N/A,N/A,N/A,705,709,N/A,67,2
2,N/A,N/A,N/A,703,705,N/A,73,2
2,N/A,N/A,N/A,701,703,N/A,78,1
1,N/A,N/A,N/A,700,701,N/A,84,1
12,N/A,N/A,N/A,688,700,N/A,88,5
4,N/A,N/A,N/A,684,688,N/A,91,2
18,N/A,N/A,N/A,666,684,N/A,95,6
13,N/A,N/A,N/A,653,666,N/A,99,4
4,N/A,N/A,N/A,649,653,N/A,104,3
3,N/A,N/A,N/A,646,649,N/A,109,2
12,N/A,N/A,N/A,634,646,N/A,112,5
19,N/A,N/A,N/A,615,634,N/A,118,5
3,N/A,N/A,N/A,612,615,N/A,122,3
12,N/A,N/A,N/A,600,612,N/A,125,6
12,N/A,N/A,N/A,588,600,N/A,130,5
3,N/A,N/A,N/A,844,847,N/A,4,3
15,N/A,N/A,N/A,829,844,N/A,7,6
4,N/A,N/A,N/A,825,829,N/A,10,3
1,N/A,N/A,N/A,824,825,N/A,14,1
19,N/A,N/A,N/A,805,824,N/A,18,5
3,N/A,N/A,N/A,802,805,N/A,21,2
10,N/A,N/A,N/A,792,802,N/A,24,5
8,N/A,N/A,N/A,784,792,N/A,29,4
4,N/A,N/A,N/A,780,784,N/A,33,2
2,N/A,N/A,N/A,778,780,N/A,38,1
7,N/A,N/A,N/A,771,778,N/A,41,4
2,N/A,N/A,N/A,769,771,N/A,44,1
7,N/A,N/A,N/A,762,769,N/A,47,4
1,N/A,N/A,N/A,761,762,N/A,50,1
13,N/A,N/A,N/A,748,761,N/A,53,4
2,N/A,N/A,N/A,746,748,N/A,58,3
2,N/A,N/A,N/A,744,746,N/A,63,2
15,N/A,N/A,N/A,729,744,N/A,66,5
5,N/A,N/A,N/A,724,729,N/A,71,4
1,N/A,N/A,N/A,723,724,N/A,74,1
19,N/A,N/A,N/A,704,723,N/A,78,5
8,N/A,N/A,N/A,696,704,N/A,83,4
2,N/A,N/A,N/A,694,696,N/A,86,1
13,N/A,N/A,N/A,681,694,N/A,90,5
4,N/A,N/A,N/A,677,681,N/A,94,3
12,N/A,N/A,N/A,665,677,N/A,97,6
5,N/A,N/A,N/A,660,665,N/A,101,4
7,N/A,N/A,N/A,653,660,N/A,107,4
8,N/A,N/A,N/A,645,653,N/A,113,4
2,N/A,N/A,N/A,643,645,N/A,117,2
4,N/A,N/A,N/A,619,623,N/A,3,3
12,N/A,N/A,N/A,607,619,N/A,6,6
3,N/A,N/A,N/A,604,607,N/A,9,3
15,N/A,N/A,N/A,589,604,N/A,12,6
7,N/A,N/A,N/A,582,589,N/A,16,4
2,N/A,N/A,N/A,580,582,N/A,20,2
2,N/A,N/A,N/A,578,580,N/A,26,2
13,N/A,N/A,N/A,565,578,N/A,29,5
2,N/A,N/A,N/A,563,565,N/A,32,2
16,N/A,N/A,N/A,547,563,N/A,36,6
19,N/A,N/A,N/A,528,547,N/A,41,5
3,N/A,N/A,N/A,525,528,N/A,44,2
18,N/A,N/A,N/A,507,525,N/A,48,6
2,N/A,N/A,N/A,505,507,N/A,51,3
3,N/A,N/A,N/A,502,505,N/A,57,3
1,N/A,N/A,N/A,501,502,N/A,61,1
13,N/A,N/A,N/A,488,501,N/A,66,6
1,N/A,N/A,N/A,487,488,N/A,72,0
15,N/A,N/A,N/A,472,487,N/A,78,6
3,N/A,N/A,N/A,469,472,N/A,81,3
4,N/A,N/A,N/A,465,469,N/A,87,3
4,N/A,N/A,N/A,461,465,N/A,92,2
11,N/A,N/A,N/A,450,461,N/A,96,6
13,N/A,N/A,N/A,437,450,N/A,101,5
15,N/A,N/A,N/A,422,437,N/A,107,5
18,N/A,N/A,N/A,404,422,N/A,113,5
4,N/A,N/A,N/A,400,404,N/A,117,3
2,N/A,N/A,N/A,398,400,N/A,122,2
3,N/A,N/A,N/A,395,398,N/A,128,2
16,N/A,N/A,N/A,379,395,N/A,131,5
2,N/A,N/A,N/A,1885,1887,N/A,6,2
1,N/A,N/A,N/A,1884,1885,N/A,11,1
2,N/A,N/A,N/A,1882,1884,N/A,17,1
10,N/A,N/A,N/A,1872,1882,N/A,20,4
2,N/A,N/A,N/A,1870,1872,N/A,25,3
3,N/A,N/A,N/A,1867,1870,N/A,31,3
2,N/A,N/A,N/A,1865,1867,N/A,37,3
4,N/A,N/A,N/A,1861,1865,N/A,43,3
1,N/A,N/A,N/A,1860,1861,N/A,47,1
12,N/A,N/A,N/A,1848,1860,N/A,51,5
2,N/A,N/A,N/A,1846,1848,N/A,54,2
3,N/A,N/A,N/A,1843,1846,N/A,60,2
19,N/A,N/A,N/A,1824,1843,N/A,64,6
2,N/A,N/A,N/A,1822,1824,N/A,70,0
6,N/A,N/A,N/A,1816,1822,N/A,74,4
11,N/A,N/A,N/A,1805,1816,N/A,80,4
2,N/A,N/A,N/A,1803,1805,N/A,83,1
1,N/A,N/A,N/A,1802,1803,N/A,89,1
15,N/A,N/A,N/A,1787,1802,N/A,93,5
10,N/A,N/A,N/A,1777,1787,N/A,98,4
1,N/A,N/A,N/A,1776,1777,N/A,101,1
20,N/A,N/A,N/A,1756,1776,N/A,106,6
4,N/A,N/A,N/A,1752,1756,N/A,109,3
13,N/A,N/A,N/A,1739,1752,N/A,112,6
16,N/A,N/A,N/A,1723,1739,N/A,117,5
3,N/A,N/A,N/A,1720,1723,N/A,120,2
20,N/A,N/A,N/A,1700,1720,N/A,124,6
2,N/A,N/A,N/A,1698,1700,N/A,127,3
13,N/A,N/A,N/A,1685,1698,N/A,130,6
2,N/A,N/A,N/A,1683,1685,N/A,136,0
1,N/A,N/A,N/A,1975,1976,N/A,5,1
14,N/A,N/A,N/A,1961,1975,N/A,9,5
10,N/A,N/A,N/A,1951,1961,N/A,15,5
14,N/A,N/A,N/A,1937,1951,N/A,20,4
7,N/A,N/A,N/A,1930,1937,N/A,26,4
2,N/A,N/A,N/A,1928,1930,N/A,30,2
2,N/A,N/A,N/A,1926,1928,N/A,36,2
2,N/A,N/A,N/A,1924,1926,N/A,41,1
2,N/A,N/A,N/A,1922,1924,N/A,47,1
16,N/A,N/A,N/A,1906,1922,N/A,51,5
13,N/A,N/A,N/A,1893,1906,N/A,56,4
3,N/A,N/A,N/A,1890,1893,N/A,60,2
13,N/A,N/A,N/A,1877,1890,N/A,64,6
4,N/A,N/A,N/A,1873,1877,N/A,67,3
4,N/A,N/A,N/A,1869,1873,N/A,72,2
12,N/A,N/A,N/A,1857,1869,N/A,75,5
4,N/A,N/A,N/A,1853,1857,N/A,78,2
1,N/A,N/A,N/A,1852,1853,N/A,83,1
16,N/A,N/A,N/A,1836,1852,N/A,87,5
10,N/A,N/A,N/A,1826,1836,N/A,92,4
7,N/A,N/A,N/A,1819,1826,N/A,98,4
4,N/A,N/A,N/A,1815,1819,N/A,102,2
4,N/A,N/A,N/A,1811,1815,N/A,108,2
16,N/A,N/A,N/A,1795,1811,N/A,111,5
19,N/A,N/A,N/A,1776,1795,N/A,117,5
3,N/A,N/A,N/A,1773,1776,N/A,120,2
19,N/A,N/A,N/A,1754,1773,N/A,123,5
2,N/A,N/A,N/A,1752,1754,N/A,126,2
12,N/A,N/A,N/A,1740,1752,N/A,130,6
1,N/A,N/A,N/A,1739,1740,N/A,136,0
9,N/A,N/A,N/A,1376,1385,N/A,6,4
1,N/A,N/A,N/A,1375,1376,N/A,9,1
15,N/A,N/A,N/A,1360,1375,N/A,13,5
2,N/A,N/A,N/A,1358,1360,N/A,16,2
20,N/A,N/A,N/A,1338,1358,N/A,20,6
12,N/A,N/A,N/A,1326,1338,N/A,25,5
3,N/A,N/A,N/A,1323,1326,N/A,29,3
2,N/A,N/A,N/A,1321,1323,N/A,35,3
1,N/A,N/A,N/A,1320,1321,N/A,39,1
1,N/A,N/A,N/A,1319,1320,N/A,45,1
11,N/A,N/A,N/A,1308,1319,N/A,50,6
4,N/A,N/A,N/A,1304,1308,N/A,53,3
20,N/A,N/A,N/A,1284,1304,N/A,56,6
9,N/A,N/A,N/A,1275,1284,N/A,60,4
1,N/A,N/A,N/A,1274,1275,N/A,63,1
17,N/A,N/A,N/A,1257,1274,N/A,68,6
3,N/A,N/A,N/A,1254,1257,N/A,71,3
16,N/A,N/A,N/A,1238,1254,N/A,74,6
2,N/A,N/A,N/A,1236,1238,N/A,80,0
13,N/A,N/A,N/A,1223,1236,N/A,84,4
1,N/A,N/A,N/A,1222,1223,N/A,87,1
17,N/A,N/A,N/A,1205,1222,N/A,91,5
13,N/A,N/A,N/A,1192,1205,N/A,97,5
3,N/A,N/A,N/A,1189,1192,N/A,100,2
10,N/A,N/A,N/A,1179,1189,N/A,103,5
17,N/A,N/A,N/A,1162,1179,N/A,109,5
15,N/A,N/A,N/A,1147,1162,N/A,115,5
8,N/A,N/A,N/A,1139,1147,N/A,120,4
1,N/A,N/A,N/A,1138,1139,N/A,123,1
1,N/A,N/A,N/A,1137,1138,N/A,129,1
15,N/A,N/A,N/A,544,559,N/A,5,5
3,N/A,N/A,N/A,541,544,N/A,9,3
3,N/A,N/A,N/A,538,541,N/A,15,3
2,N/A,N/A,N/A,536,538,N/A,21,3
19,N/A,N/A,N/A,517,536,N/A,24,6
10,N/A,N/A,N/A,507,517,N/A,29,5
2,N/A,N/A,N/A,505,507,N/A,32,2
16,N/A,N/A,N/A,489,505,N/A,35,5
4,N/A,N/A,N/A,485,489,N/A,39,3
1,N/A,N/A,N/A,484,485,N/A,43,1
20,N/A,N/A,N/A,464,484,N/A,48,6
1,N/A,N/A,N/A,463,464,N/A,54,0
13,N/A,N/A,N/A,450,463,N/A,60,6
4,N/A,N/A,N/A,446,450,N/A,63,3
2,N/A,N/A,N/A,444,446,N/A,67,1
15,N/A,N/A,N/A,429,444,N/A,71,5
2,N/A,N/A,N/A,427,429,N/A,74,2
2,N/A,N/A,N/A,425,427,N/A,79,1
2,N/A,N/A,N/A,423,425,N/A,85,1
13,N/A,N/A,N/A,410,423,N/A,89,5
7,N/A,N/A,N/A,403,410,N/A,94,4
3,N/A,N/A,N/A,400,403,N/A,99,3
4,N/A,N/A,N/A,396,400,N/A,105,3
2,N/A,N/A,N/A,394,396,N/A,109,1
12,N/A,N/A,N/A,382,394,N/A,112,4
14,N/A,N/A,N/A,368,382,N/A,118,4
3,N/A,N/A,N/A,365,368,N/A,123,3
3,N/A,N/A,N/A,362,365,N/A,128,2
15,N/A,N/A,N/A,347,362,N/A,131,5
13,N/A,N/A,N/A,334,347,N/A,137,5
2,N/A,N/A,N/A,1430,1432,N/A,4,1
12,N/A,N/A,N/A,1418,1430,N/A,7,4
2,N/A,N/A,N/A,1416,1418,N/A,12,3
3,N/A,N/A,N/A,1413,1416,N/A,17,2
17,N/A,N/A,N/A,1396,1413,N/A,20,5
3,N/A,N/A,N/A,1393,1396,N/A,24,3
4,N/A,N/A,N/A,1389,1393,N/A,29,2
2,N/A,N/A,N/A,1387,1389,N/A,34,1
14,N/A,N/A,N/A,1373,1387,N/A,39,6
2,N/A,N/A,N/A,1371,1373,N/A,45,0
4,N/A,N/A,N/A,1367,1371,N/A,48,3
4,N/A,N/A,N/A,1363,1367,N/A,54,3
18,N/A,N/A,N/A,1345,1363,N/A,57,6
10,N/A,N/A,N/A,1335,1345,N/A,62,5
11,N/A,N/A,N/A,1324,1335,N/A,67,4
1,N/A,N/A,N/A,1323,1324,N/A,70,1
2,N/A,N/A,N/A,1321,1323,N/A,76,1
14,N/A,N/A,N/A,1307,1321,N/A,81,6
1,N/A,N/A,N/A,1306,1307,N/A,87,0
2,N/A,N/A,N/A,1304,1306,N/A,90,3
1,N/A,N/A,N/A,1303,1304,N/A,94,1
1,N/A,N/A,N/A,1302,1303,N/A,100,1
16,N/A,N/A,N/A,1286,1302,N/A,104,5
8,N/A,N/A,N/A,1278,1286,N/A,109,4
4,N/A,N/A,N/A,1274,1278,N/A,113,2
15,N/A,N/A,N/A,1259,1274,N/A,116,5
19,N/A,N/A,N/A,1240,1259,N/A,122,5
3,N/A,N/A,N/A,1237,1240,N/A,126,3
18,N/A,N/A,N/A,1219,1237,N/A,129,6
4,N/A,N/A,N/A,1215,1219,N/A,132,3
12,N/A,N/A,N/A,573,585,N/A,3,6
17,N/A,N/A,N/A,556,573,N/A,8,5
12,N/A,N/A,N/A,544,556,N/A,14,5
4,N/A,N/A,N/A,540,544,N/A,18,3
18,N/A,N/A,N/A,522,540,N/A,21,6
5,N/A,N/A,N/A,517,522,N/A,25,4
3,N/A,N/A,N/A,514,517,N/A,29,2
18,N/A,N/A,N/A,496,514,N/A,32,5
3,N/A,N/A,N/A,493,496,N/A,35,2
10,N/A,N/A,N/A,483,493,N/A,38,5
11,N/A,N/A,N/A,472,483,N/A,44,5
7,N/A,N/A,N/A,465,472,N/A,49,4
3,N/A,N/A,N/A,462,465,N/A,53,2
16,N/A,N/A,N/A,446,462,N/A,57,6
2,N/A,N/A,N/A,444,446,N/A,60,3
2,N/A,N/A,N/A,442,444,N/A,64,1
17,N/A,N/A,N/A,425,442,N/A,68,5
5,N/A,N/A,N/A,420,425,N/A,73,4
3,N/A,N/A,N/A,417,420,N/A,77,2
1,N/A,N/A,N/A,416,417,N/A,82,1
9,N/A,N/A,N/A,407,416,N/A,85,4
6,N/A,N/A,N/A,401,407,N/A,91,4
11,N/A,N/A,N/A,390,401,N/A,97,4
4,N/A,N/A,N/A,386,390,N/A,101,2
1,N/A,N/A,N/A,385,386,N/A,106,1
1,N/A,N/A,N/A,384,385,N/A,112,1
15,N/A,N/A,N/A,369,384,N/A,116,5
3,N/A,N/A,N/A,366,369,N/A,119,2
17,N/A,N/A,N/A,349,366,N/A,122,5
2,N/A,N/A,N/A,347,349,N/A,126,3
3,N/A,N/A,N/A,927,930,N/A,5,3
3,N/A,N/A,N/A,924,927,N/A,11,3
19,N/A,N/A,N/A,905,924,N/A,14,6
11,N/A,N/A,N/A,894,905,N/A,19,5
9,N/A,N/A,N/A,885,894,N/A,24,4
3,N/A,N/A,N/A,882,885,N/A,28,2
2,N/A,N/A,N/A,880,882,N/A,33,1
2,N/A,N/A,N/A,878,880,N/A,39,1
16,N/A,N/A,N/A,862,878,N/A,44,6
16,N/A,N/A,N/A,846,862,N/A,49,5
4,N/A,N/A,N/A,842,846,N/A,53,3
18,N/A,N/A,N/A,824,842,N/A,56,6
2,N/A,N/A,N/A,822,824,N/A,62,0
19,N/A,N/A,N/A,803,822,N/A,68,6
13,N/A,N/A,N/A,790,803,N/A,72,4
2,N/A,N/A,N/A,788,790,N/A,77,3
3,N/A,N/A,N/A,785,788,N/A,82,2
4,N/A,N/A,N/A,781,785,N/A,88,2
16,N/A,N/A,N/A,765,781,N/A,91,5
14,N/A,N/A,N/A,751,765,N/A,96,4
11,N/A,N/A,N/A,740,751,N/A,102,4
2,N/A,N/A,N/A,738,740,N/A,107,3
2,N/A,N/A,N/A,736,738,N/A,112,2
14,N/A,N/A,N/A,722,736,N/A,115,5
4,N/A,N/A,N/A,718,722,N/A,118,2
12,N/A,N/A,N/A,706,718,N/A,122,6
2,N/A,N/A,N/A,704,706,N/A,125,3
2,N/A,N/A,N/A,702,704,N/A,131,3
4,N/A,N/A,N/A,698,702,N/A,136,2
14,N/A,N/A,N/A,684,698,N/A,140,6
18,N/A,N/A,N/A,346,364,N/A,3,5
18,N/A,N/A,N/A,328,346,N/A,9,5
4,N/A,N/A,N/A,324,328,N/A,12,2
15,N/A,N/A,N/A,309,324,N/A,16,6
2,N/A,N/A,N/A,307,309,N/A,22,0
11,N/A,N/A,N/A,296,307,N/A,26,4
12,N/A,N/A,N/A,284,296,N/A,32,4
6,N/A,N/A,N/A,278,284,N/A,38,4
1,N/A,N/A,N/A,277,278,N/A,41,1
11,N/A,N/A,N/A,266,277,N/A,45,5
4,N/A,N/A,N/A,262,266,N/A,48,2
16,N/A,N/A,N/A,246,262,N/A,51,5
9,N/A,N/A,N/A,237,246,N/A,56,4
4,N/A,N/A,N/A,233,237,N/A,60,2
19,N/A,N/A,N/A,214,233,N/A,64,6
13,N/A,N/A,N/A,201,214,N/A,69,5
18,N/A,N/A,N/A,183,201,N/A,75,5
18,N/A,N/A,N/A,165,183,N/A,81,5
2,N/A,N/A,N/A,163,165,N/A,84,2
20,N/A,N/A,N/A,143,163,N/A,88,6
3,N/A,N/A,N/A,140,143,N/A,91,3
2,N/A,N/A,N/A,138,140,N/A,96,2
10,N/A,N/A,N/A,128,138,N/A,99,5
8,N/A,N/A,N/A,120,128,N/A,104,4
13,N/A,N/A,N/A,107,120,N/A,110,4
1,N/A,N/A,N/A,106,107,N/A,113,1
14,N/A,N/A,N/A,92,106,N/A,117,5
17,N/A,N/A,N/A,75,92,N/A,123,5
4,N/A,N/A,N/A,71,75,N/A,126,2
19,N/A,N/A,N/A,52,71,N/A,130,6
1,N/A,N/A,N/A,981,982,N/A,5,1
18,N/A,N/A,N/A,963,981,N/A,10,6
19,N/A,N/A,N/A,944,963,N/A,15,5
13,N/A,N/A,N/A,931,944,N/A,20,4
13,N/A,N/A,N/A,918,931,N/A,26,4
13,N/A,N/A,N/A,905,918,N/A,32,4
2,N/A,N/A,N/A,903,905,N/A,35,1
9,N/A,N/A,N/A,894,903,N/A,38,4
4,N/A,N/A,N/A,890,894,N/A,42,2
12,N/A,N/A,N/A,878,890,N/A,46,6
1,N/A,N/A,N/A,877,878,N/A,52,0
13,N/A,N/A,N/A,864,877,N/A,58,6
4,N/A,N/A,N/A,860,864,N/A,61,3
4,N/A,N/A,N/A,856,860,N/A,66,2
2,N/A,N/A,N/A,854,856,N/A,72,2
1,N/A,N/A,N/A,853,854,N/A,77,1
9,N/A,N/A,N/A,844,853,N/A,80,4
9,N/A,N/A,N/A,835,844,N/A,86,4
10,N/A,N/A,N/A,825,835,N/A,92,4
1,N/A,N/A,N/A,824,825,N/A,95,1
1,N/A,N/A,N/A,823,824,N/A,101,1
2,N/A,N/A,N/A,821,823,N/A,107,1
13,N/A,N/A,N/A,808,821,N/A,110,4
2,N/A,N/A,N/A,806,808,N/A,113,1
2,N/A,N/A,N/A,804,806,N/A,119,1
18,N/A,N/A,N/A,786,804,N/A,124,6
2,N/A,N/A,N/A,784,786,N/A,127,3
3,N/A,N/A,N/A,781,784,N/A,132,2
11,N/A,N/A,N/A,770,781,N/A,136,6
1,N/A,N/A,N/A,769,770,N/A,142,0
18,N/A,N/A,N/A,915,933,N/A,3,6
13,N/A,N/A,N/A,902,915,N/A,7,4
4,N/A,N/A,N/A,898,902,N/A,11,2
1,N/A,N/A,N/A,897,898,N/A,16,1
15,N/A,N/A,N/A,882,897,N/A,21,6
1,N/A,N/A,N/A,881,882,N/A,27,0
9,N/A,N/A,N/A,872,881,N/A,31,4
5,N/A,N/A,N/A,867,872,N/A,37,4
2,N/A,N/A,N/A,865,867,N/A,41,2
12,N/A,N/A,N/A,853,865,N/A,45,6
11,N/A,N/A,N/A,842,853,N/A,49,4
1,N/A,N/A,N/A,841,842,N/A,52,1
2,N/A,N/A,N/A,839,841,N/A,58,1
14,N/A,N/A,N/A,825,839,N/A,63,6
13,N/A,N/A,N/A,812,825,N/A,68,5
19,N/A,N/A,N/A,793,812,N/A,74,5
4,N/A,N/A,N/A,789,793,N/A,78,3
4,N/A,N/A,N/A,785,789,N/A,83,2
2,N/A,N/A,N/A,783,785,N/A,88,1
5,N/A,N/A,N/A,778,783,N/A,91,4
4,N/A,N/A,N/A,774,778,N/A,96,3
1,N/A,N/A,N/A,773,774,N/A,100,1
2,N/A,N/A,N/A,771,773,N/A,106,1
13,N/A,N/A,N/A,758,771,N/A,111,6
1,N/A,N/A,N/A,757,758,N/A,117,0
18,N/A,N/A,N/A,739,757,N/A,123,6
10,N/A,N/A,N/A,729,739,N/A,128,5
8,N/A,N/A,N/A,721,729,N/A,133,4
10,N/A,N/A,N/A,711,721,N/A,139,4
3,N/A,N/A,N/A,708,711,N/A,144,3
3,N/A,N/A,N/A,1275,1278,N/A,5,3
3,N/A,N/A,N/A,1272,1275,N/A,11,3
2,N/A,N/A,N/A,1270,1272,N/A,15,1
16,N/A,N/A,N/A,1254,1270,N/A,20,6
16,N/A,N/A,N/A,1238,1254,N/A,25,5
3,N/A,N/A,N/A,1235,1238,N/A,28,2
1,N/A,N/A,N/A,1234,1235,N/A,33,1
1,N/A,N/A,N/A,1233,1234,N/A,39,1
14,N/A,N/A,N/A,1219,1233,N/A,44,6
2,N/A,N/A,N/A,1217,1219,N/A,50,0
17,N/A,N/A,N/A,1200,1217,N/A,55,5
9,N/A,N/A,N/A,1191,1200,N/A,60,4
3,N/A,N/A,N/A,1188,1191,N/A,64,2
4,N/A,N/A,N/A,1184,1188,N/A,70,2
16,N/A,N/A,N/A,1168,1184,N/A,73,5
7,N/A,N/A,N/A,1161,1168,N/A,78,4
11,N/A,N/A,N/A,1150,1161,N/A,84,4
3,N/A,N/A,N/A,1147,1150,N/A,88,2
17,N/A,N/A,N/A,1130,1147,N/A,91,5
2,N/A,N/A,N/A,1128,1130,N/A,94,2
2,N/A,N/A,N/A,1126,1128,N/A,99,1
19,N/A,N/A,N/A,1107,1126,N/A,104,6
17,N/A,N/A,N/A,1090,1107,N/A,109,5
2,N/A,N/A,N/A,1088,1090,N/A,113,3
11,N/A,N/A,N/A,1077,1088,N/A,116,6
3,N/A,N/A,N/A,1074,1077,N/A,119,3
14,N/A,N/A,N/A,1060,1074,N/A,122,6
12,N/A,N/A,N/A,1048,1060,N/A,126,4
2,N/A,N/A,N/A,1046,1048,N/A,130,2
15,N/A,N/A,N/A,1031,1046,N/A,133,5
1,N/A,N/A,N/A,1758,1759,N/A,3,1
1,N/A,N/A,N/A,1757,1758,N/A,9,1
7,N/A,N/A,N/A,1750,1757,N/A,12,4
4,N/A,N/A,N/A,1746,1750,N/A,17,3
2,N/A,N/A,N/A,1744,1746,N/A,21,1
12,N/A,N/A,N/A,1732,1744,N/A,26,6
12,N/A,N/A,N/A,1720,1732,N/A,31,5
17,N/A,N/A,N/A,1703,1720,N/A,37,5
4,N/A,N/A,N/A,1699,1703,N/A,41,3
3,N/A,N/A,N/A,1696,1699,N/A,47,3
1,N/A,N/A,N/A,1695,1696,N/A,51,1
17,N/A,N/A,N/A,1678,1695,N/A,56,6
6,N/A,N/A,N/A,1672,1678,N/A,60,4
10,N/A,N/A,N/A,1662,1672,N/A,66,4
2,N/A,N/A,N/A,1660,1662,N/A,71,3
3,N/A,N/A,N/A,1657,1660,N/A,76,2
1,N/A,N/A,N/A,1656,1657,N/A,81,1
19,N/A,N/A,N/A,1637,1656,N/A,86,6
17,N/A,N/A,N/A,1620,1637,N/A,91,5
13,N/A,N/A,N/A,1607,1620,N/A,96,4
7,N/A,N/A,N/A,1600,1607,N/A,102,4
3,N/A,N/A,N/A,1597,1600,N/A,107,3
2,N/A,N/A,N/A,1595,1597,N/A,112,2
11,N/A,N/A,N/A,1584,1595,N/A,116,6
2,N/A,N/A,N/A,1582,1584,N/A,122,0
15,N/A,N/A,N/A,1567,1582,N/A,127,5
5,N/A,N/A,N/A,1562,1567,N/A,132,4
8,N/A,N/A,N/A,1554,1562,N/A,138,4
1,N/A,N/A,N/A,1553,1554,N/A,141,1
18,N/A,N/A,N/A,1535,1553,N/A,146,6
19,N/A,N/A,N/A,718,737,N/A,5,5
2,N/A,N/A,N/A,716,718,N/A,9,3
2,N/A,N/A,N/A,714,716,N/A,13,1
2,N/A,N/A,N/A,712,714,N/A,19,1
13,N/A,N/A,N/A,699,712,N/A,22,4
4,N/A,N/A,N/A,695,699,N/A,26,2
3,N/A,N/A,N/A,692,695,N/A,32,2
2,N/A,N/A,N/A,690,692,N/A,37,1
5,N/A,N/A,N/A,685,690,N/A,40,4
3,N/A,N/A,N/A,682,685,N/A,45,3
18,N/A,N/A,N/A,664,682,N/A,48,6
2,N/A,N/A,N/A,662,664,N/A,51,3
1,N/A,N/A,N/A,661,662,N/A,55,1
17,N/A,N/A,N/A,644,661,N/A,60,6
4,N/A,N/A,N/A,640,644,N/A,63,3
2,N/A,N/A,N/A,638,640,N/A,67,1
14,N/A,N/A,N/A,624,638,N/A,71,5
18,N/A,N/A,N/A,606,624,N/A,77,5
13,N/A,N/A,N/A,593,606,N/A,82,4
2,N/A,N/A,N/A,591,593,N/A,85,1
13,N/A,N/A,N/A,578,591,N/A,88,4
2,N/A,N/A,N/A,576,578,N/A,92,2
10,N/A,N/A,N/A,566,576,N/A,95,5
18,N/A,N/A,N/A,548,566,N/A,101,5
4,N/A,N/A,N/A,544,548,N/A,105,3
4,N/A,N/A,N/A,540,544,N/A,110,2
18,N/A,N/A,N/A,522,540,N/A,113,5
4,N/A,N/A,N/A,518,522,N/A,117,3
3,N/A,N/A,N/A,515,518,N/A,123,3
2,N/A,N/A,N/A,513,515,N/A,128,2
16,N/A,N/A,N/A,1642,1658,N/A,6,6
2,N/A,N/A,N/A,1640,1642,N/A,9,3
4,N/A,N/A,N/A,1636,1640,N/A,14,2
13,N/A,N/A,N/A,1623,1636,N/A,17,5
2,N/A,N/A,N/A,1621,1623,N/A,20,2
12,N/A,N/A,N/A,1609,1621,N/A,24,6
10,N/A,N/A,N/A,1599,1609,N/A,28,4
3,N/A,N/A,N/A,1596,1599,N/A,33,3
3,N/A,N/A,N/A,1593,1596,N/A,39,3
3,N/A,N/A,N/A,1590,1593,N/A,44,2
2,N/A,N/A,N/A,1588,1590,N/A,49,1
13,N/A,N/A,N/A,1575,1588,N/A,53,5
12,N/A,N/A,N/A,1563,1575,N/A,58,4
4,N/A,N/A,N/A,1559,1563,N/A,62,2
3,N/A,N/A,N/A,1556,1559,N/A,68,2
3,N/A,N/A,N/A,1553,1556,N/A,74,2
1,N/A,N/A,N/A,1552,1553,N/A,79,1
8,N/A,N/A,N/A,1544,1552,N/A,82,4
4,N/A,N/A,N/A,1540,1544,N/A,86,2
16,N/A,N/A,N/A,1524,1540,N/A,89,5
14,N/A,N/A,N/A,1510,1524,N/A,94,4
3,N/A,N/A,N/A,1507,1510,N/A,98,2
1,N/A,N/A,N/A,1506,1507,N/A,103,1
14,N/A,N/A,N/A,1492,1506,N/A,106,4
3,N/A,N/A,N/A,1489,1492,N/A,110,2
2,N/A,N/A,N/A,1487,1489,N/A,115,1
1,N/A,N/A,N/A,1486,1487,N/A,121,1
13,N/A,N/A,N/A,1473,1486,N/A,124,4
2,N/A,N/A,N/A,1471,1473,N/A,128,2
15,N/A,N/A,N/A,1456,1471,N/A,131,5
9,N/A,N/A,N/A,744,753,N/A,3,4
2,N/A,N/A,N/A,742,744,N/A,7,2
2,N/A,N/A,N/A,740,742,N/A,12,1
10,N/A,N/A,N/A,730,740,N/A,16,5
17,N/A,N/A,N/A,713,730,N/A,22,5
14,N/A,N/A,N/A,699,713,N/A,28,5
2,N/A,N/A,N/A,697,699,N/A,32,3
2,N/A,N/A,N/A,695,697,N/A,38,3
11,N/A,N/A,N/A,684,695,N/A,41,6
14,N/A,N/A,N/A,670,684,N/A,46,5
13,N/A,N/A,N/A,657,670,N/A,51,4
2,N/A,N/A,N/A,655,657,N/A,54,1
11,N/A,N/A,N/A,644,655,N/A,57,4
2,N/A,N/A,N/A,642,644,N/A,60,1
13,N/A,N/A,N/A,629,642,N/A,63,4
1,N/A,N/A,N/A,628,629,N/A,66,1
17,N/A,N/A,N/A,611,628,N/A,70,5
3,N/A,N/A,N/A,608,611,N/A,73,2
4,N/A,N/A,N/A,604,608,N/A,79,2
3,N/A,N/A,N/A,601,604,N/A,85,2
18,N/A,N/A,N/A,583,601,N/A,89,6
2,N/A,N/A,N/A,581,583,N/A,92,3
3,N/A,N/A,N/A,578,581,N/A,98,3
4,N/A,N/A,N/A,574,578,N/A,104,3
2,N/A,N/A,N/A,572,574,N/A,109,2
2,N/A,N/A,N/A,570,572,N/A,114,1
13,N/A,N/A,N/A,557,570,N/A,118,5
3,N/A,N/A,N/A,554,557,N/A,121,2
2,N/A,N/A,N/A,552,554,N/A,126,1
16,N/A,N/A,N/A,536,552,N/A,130,5
19,N/A,N/A,N/A,557,576,N/A,4,6
9,N/A,N/A,N/A,548,557,N/A,8,4
4,N/A,N/A,N/A,544,548,N/A,12,2
14,N/A,N/A,N/A,530,544,N/A,15,5
5,N/A,N/A,N/A,525,530,N/A,20,4
2,N/A,N/A,N/A,523,525,N/A,25,3
2,N/A,N/A,N/A,521,523,N/A,29,1
1,N/A,N/A,N/A,520,521,N/A,35,1
14,N/A,N/A,N/A,506,520,N/A,38,4
2,N/A,N/A,N/A,504,506,N/A,42,2
11,N/A,N/A,N/A,493,504,N/A,45,5
11,N/A,N/A,N/A,482,493,N/A,50,4
3,N/A,N/A,N/A,479,482,N/A,54,2
2,N/A,N/A,N/A,477,479,N/A,59,1
5,N/A,N/A,N/A,472,477,N/A,62,4
8,N/A,N/A,N/A,464,472,N/A,68,4
6,N/A,N/A,N/A,458,464,N/A,74,4
2,N/A,N/A,N/A,456,458,N/A,78,2
20,N/A,N/A,N/A,436,456,N/A,82,6
3,N/A,N/A,N/A,433,436,N/A,85,3
15,N/A,N/A,N/A,418,433,N/A,88,6
11,N/A,N/A,N/A,407,418,N/A,92,4
13,N/A,N/A,N/A,394,407,N/A,98,4
4,N/A,N/A,N/A,390,394,N/A,102,2
19,N/A,N/A,N/A,371,390,N/A,105,5
8,N/A,N/A,N/A,363,371,N/A,110,4
3,N/A,N/A,N/A,360,363,N/A,114,2
17,N/A,N/A,N/A,343,360,N/A,117,5
11,N/A,N/A,N/A,332,343,N/A,123,5
13,N/A,N/A,N/A,319,332,N/A,129,5
1,N/A,N/A,N/A,1599,1600,N/A,5,1
2,N/A,N/A,N/A,1597,1599,N/A,11,1
2,N/A,N/A,N/A,1595,1597,N/A,17,1
13,N/A,N/A,N/A,1582,1595,N/A,20,4
12,N/A,N/A,N/A,1570,1582,N/A,26,4
4,N/A,N/A,N/A,1566,1570,N/A,30,2
20,N/A,N/A,N/A,1546,1566,N/A,34,6
3,N/A,N/A,N/A,1543,1546,N/A,37,3
19,N/A,N/A,N/A,1524,1543,N/A,40,6
2,N/A,N/A,N/A,1522,1524,N/A,46,0
17,N/A,N/A,N/A,1505,1522,N/A,52,6
4,N/A,N/A,N/A,1501,1505,N/A,55,3
2,N/A,N/A,N/A,1499,1501,N/A,60,2
2,N/A,N/A,N/A,1497,1499,N/A,66,2
3,N/A,N/A,N/A,1494,1497,N/A,72,2
2,N/A,N/A,N/A,1492,1494,N/A,77,1
1,N/A,N/A,N/A,1491,1492,N/A,83,1
18,N/A,N/A,N/A,1473,1491,N/A,88,6
7,N/A,N/A,N/A,1466,1473,N/A,92,4
3,N/A,N/A,N/A,1463,1466,N/A,97,3
1,N/A,N/A,N/A,1462,1463,N/A,101,1
10,N/A,N/A,N/A,1452,1462,N/A,104,4
2,N/A,N/A,N/A,1450,1452,N/A,109,3
11,N/A,N/A,N/A,1439,1450,N/A,112,6
13,N/A,N/A,N/A,1426,1439,N/A,116,4
9,N/A,N/A,N/A,1417,1426,N/A,122,4
8,N/A,N/A,N/A,1409,1417,N/A,128,4
3,N/A,N/A,N/A,1406,1409,N/A,132,2
16,N/A,N/A,N/A,1390,1406,N/A,136,6
17,N/A,N/A,N/A,1373,1390,N/A,141,5
2,N/A,N/A,N/A,872,874,N/A,5,3
4,N/A,N/A,N/A,868,872,N/A,11,3
2,N/A,N/A,N/A,866,868,N/A,16,2
2,N/A,N/A,N/A,864,866,N/A,21,1
13,N/A,N/A,N/A,851,864,N/A,26,6
1,N/A,N/A,N/A,850,851,N/A,32,0
13,N/A,N/A,N/A,837,850,N/A,38,6
2,N/A,N/A,N/A,835,837,N/A,44,0
16,N/A,N/A,N/A,819,835,N/A,50,6
16,N/A,N/A,N/A,803,819,N/A,55,5
3,N/A,N/A,N/A,800,803,N/A,58,2
18,N/A,N/A,N/A,782,800,N/A,62,6
12,N/A,N/A,N/A,770,782,N/A,67,5
9,N/A,N/A,N/A,761,770,N/A,72,4
5,N/A,N/A,N/A,756,761,N/A,78,4
2,N/A,N/A,N/A,754,756,N/A,82,2
3,N/A,N/A,N/A,751,754,N/A,88,2
2,N/A,N/A,N/A,749,751,N/A,93,1
13,N/A,N/A,N/A,736,749,N/A,97,5
4,N/A,N/A,N/A,732,736,N/A,101,3
2,N/A,N/A,N/A,730,732,N/A,107,3
3,N/A,N/A,N/A,727,730,N/A,112,2
1,N/A,N/A,N/A,726,727,N/A,117,1
13,N/A,N/A,N/A,713,726,N/A,120,4
2,N/A,N/A,N/A,711,713,N/A,124,2
16,N/A,N/A,N/A,695,711,N/A,128,6
2,N/A,N/A,N/A,693,695,N/A,131,3
2,N/A,N/A,N/A,691,693,N/A,135,1
12,N/A,N/A,N/A,679,691,N/A,139,5
4,N/A,N/A,N/A,675,679,N/A,143,3
13,N/A,N/A,N/A,573,586,N/A,5,6
4,N/A,N/A,N/A,569,573,N/A,8,3
4,N/A,N/A,N/A,565,569,N/A,13,2
10,N/A,N/A,N/A,555,565,N/A,16,5
14,N/A,N/A,N/A,541,555,N/A,21,4
1,N/A,N/A,N/A,540,541,N/A,24,1
2,N/A,N/A,N/A,538,540,N/A,30,1
5,N/A,N/A,N/A,533,538,N/A,33,4
2,N/A,N/A,N/A,531,533,N/A,36,1
1,N/A,N/A,N/A,530,531,N/A,42,1
18,N/A,N/A,N/A,512,530,N/A,47,6
11,N/A,N/A,N/A,501,512,N/A,52,5
2,N/A,N/A,N/A,499,501,N/A,56,3
3,N/A,N/A,N/A,496,499,N/A,61,2
18,N/A,N/A,N/A,478,496,N/A,65,6
5,N/A,N/A,N/A,473,478,N/A,69,4
4,N/A,N/A,N/A,469,473,N/A,73,2
2,N/A,N/A,N/A,467,469,N/A,79,2
13,N/A,N/A,N/A,454,467,N/A,82,5
2,N/A,N/A,N/A,452,454,N/A,85,2
16,N/A,N/A,N/A,436,452,N/A,89,6
2,N/A,N/A,N/A,434,436,N/A,92,3
2,N/A,N/A,N/A,432,434,N/A,98,3
1,N/A,N/A,N/A,431,432,N/A,102,1
12,N/A,N/A,N/A,419,431,N/A,107,6
3,N/A,N/A,N/A,416,419,N/A,110,3
2,N/A,N/A,N/A,414,416,N/A,114,1
2,N/A,N/A,N/A,412,414,N/A,120,1
1,N/A,N/A,N/A,411,412,N/A,126,1
15,N/A,N/A,N/A,396,411,N/A,131,6
12,N/A,N/A,N/A,792,804,N/A,5,5
4,N/A,N/A,N/A,788,792,N/A,9,3
3,N/A,N/A,N/A,785,788,N/A,15,3
2,N/A,N/A,N/A,783,785,N/A,20,2
3,N/A,N/A,N/A,780,783,N/A,26,2
10,N/A,N/A,N/A,770,780,N/A,29,5
3,N/A,N/A,N/A,767,770,N/A,32,2
13,N/A,N/A,N/A,754,767,N/A,36,6
1,N/A,N/A,N/A,753,754,N/A,42,0
20,N/A,N/A,N/A,733,753,N/A,48,6
4,N/A,N/A,N/A,729,733,N/A,51,3
11,N/A,N/A,N/A,718,729,N/A,54,6
4,N/A,N/A,N/A,714,718,N/A,57,3
1,N/A,N/A,N/A,713,714,N/A,61,1
14,N/A,N/A,N/A,699,713,N/A,65,5
2,N/A,N/A,N/A,697,699,N/A,68,2
15,N/A,N/A,N/A,682,697,N/A,71,5
2,N/A,N/A,N/A,680,682,N/A,75,3
17,N/A,N/A,N/A,663,680,N/A,78,6
3,N/A,N/A,N/A,660,663,N/A,81,3
4,N/A,N/A,N/A,656,660,N/A,86,2
4,N/A,N/A,N/A,652,656,N/A,92,2
2,N/A,N/A,N/A,650,652,N/A,97,1
17,N/A,N/A,N/A,633,650,N/A,102,6
18,N/A,N/A,N/A,615,633,N/A,107,5
8,N/A,N/A,N/A,607,615,N/A,112,4
2,N/A,N/A,N/A,605,607,N/A,116,2
14,N/A,N/A,N/A,591,605,N/A,120,6
4,N/A,N/A,N/A,587,591,N/A,123,3
2,N/A,N/A,N/A,585,587,N/A,128,2
2,N/A,N/A,N/A,1566,1568,N/A,5,1
12,N/A,N/A,N/A,1554,1566,N/A,8,4
4,N/A,N/A,N/A,1550,1554,N/A,12,2
2,N/A,N/A,N/A,1548,1550,N/A,18,2
15,N/A,N/A,N/A,1533,1548,N/A,22,6
18,N/A,N/A,N/A,1515,1533,N/A,27,5
4,N/A,N/A,N/A,1511,1515,N/A,31,3
2,N/A,N/A,N/A,1509,1511,N/A,35,1
18,N/A,N/A,N/A,1491,1509,N/A,40,6
14,N/A,N/A,N/A,1477,1491,N/A,45,5
3,N/A,N/A,N/A,1474,1477,N/A,48,2
11,N/A,N/A,N/A,1463,1474,N/A,51,5
2,N/A,N/A,N/A,1461,1463,N/A,54,2
1,N/A,N/A,N/A,1460,1461,N/A,59,1
1,N/A,N/A,N/A,1459,1460,N/A,65,1
9,N/A,N/A,N/A,1450,1459,N/A,68,4
3,N/A,N/A,N/A,1447,1450,N/A,72,2
2,N/A,N/A,N/A,1445,1447,N/A,78,2
2,N/A,N/A,N/A,1443,1445,N/A,83,1
16,N/A,N/A,N/A,1427,1443,N/A,87,5
17,N/A,N/A,N/A,1410,1427,N/A,93,5
18,N/A,N/A,N/A,1392,1410,N/A,99,5
3,N/A,N/A,N/A,1389,1392,N/A,102,2
11,N/A,N/A,N/A,1378,1389,N/A,106,6
2,N/A,N/A,N/A,1376,1378,N/A,112,0
10,N/A,N/A,N/A,1366,1376,N/A,117,5
4,N/A,N/A,N/A,1362,1366,N/A,120,2
12,N/A,N/A,N/A,1350,1362,N/A,124,6
2,N/A,N/A,N/A,1348,1350,N/A,127,3
3,N/A,N/A,N/A,1345,1348,N/A,132,2
13,N/A,N/A,N/A,1390,1403,N/A,4,4
2,N/A,N/A,N/A,1388,1390,N/A,9,3
2,N/A,N/A,N/A,1386,1388,N/A,14,2
15,N/A,N/A,N/A,1371,1386,N/A,17,5
14,N/A,N/A,N/A,1357,1371,N/A,23,5
5,N/A,N/A,N/A,1352,1357,N/A,28,4
4,N/A,N/A,N/A,1348,1352,N/A,33,3
20,N/A,N/A,N/A,1328,1348,N/A,36,6
2,N/A,N/A,N/A,1326,1328,N/A,39,3
2,N/A,N/A,N/A,1324,1326,N/A,43,1
2,N/A,N/A,N/A,1322,1324,N/A,49,1
10,N/A,N/A,N/A,1312,1322,N/A,53,5
16,N/A,N/A,N/A,1296,1312,N/A,59,5
12,N/A,N/A,N/A,1284,1296,N/A,64,4
3,N/A,N/A,N/A,1281,1284,N/A,69,3
4,N/A,N/A,N/A,1277,1281,N/A,74,2
1,N/A,N/A,N/A,1276,1277,N/A,79,1
18,N/A,N/A,N/A,1258,1276,N/A,84,6
4,N/A,N/A,N/A,1254,1258,N/A,87,3
2,N/A,N/A,N/A,1252,1254,N/A,91,1
10,N/A,N/A,N/A,1242,1252,N/A,94,4
12,N/A,N/A,N/A,1230,1242,N/A,100,4
2,N/A,N/A,N/A,1228,1230,N/A,104,2
2,N/A,N/A,N/A,1226,1228,N/A,110,2
14,N/A,N/A,N/A,1212,1226,N/A,114,6
11,N/A,N/A,N/A,1201,1212,N/A,119,5
2,N/A,N/A,N/A,1199,1201,N/A,123,3
11,N/A,N/A,N/A,1188,1199,N/A,126,6
8,N/A,N/A,N/A,1180,1188,N/A,130,4
2,N/A,N/A,N/A,1178,1180,N/A,135,3
4,N/A,N/A,N/A,309,313,N/A,4,3
15,N/A,N/A,N/A,294,309,N/A,7,6
2,N/A,N/A,N/A,292,294,N/A,13,0
16,N/A,N/A,N/A,276,292,N/A,19,6
11,N/A,N/A,N/A,265,276,N/A,24,5
4,N/A,N/A,N/A,261,265,N/A,27,2
2,N/A,N/A,N/A,259,261,N/A,33,2
20,N/A,N/A,N/A,239,259,N/A,37,6
14,N/A,N/A,N/A,225,239,N/A,41,4
1,N/A,N/A,N/A,224,225,N/A,44,1
11,N/A,N/A,N/A,213,224,N/A,48,5
3,N/A,N/A,N/A,210,213,N/A,52,3
1,N/A,N/A,N/A,209,210,N/A,56,1
10,N/A,N/A,N/A,199,209,N/A,60,5
4,N/A,N/A,N/A,195,199,N/A,63,2
2,N/A,N/A,N/A,193,195,N/A,69,2
2,N/A,N/A,N/A,191,193,N/A,74,1
15,N/A,N/A,N/A,176,191,N/A,79,6
2,N/A,N/A,N/A,174,176,N/A,82,3
3,N/A,N/A,N/A,171,174,N/A,88,3
2,N/A,N/A,N/A,169,171,N/A,93,2
2,N/A,N/A,N/A,167,169,N/A,98,1
12,N/A,N/A,N/A,155,167,N/A,103,6
1,N/A,N/A,N/A,154,155,N/A,109,0
3,N/A,N/A,N/A,151,154,N/A,112,3
3,N/A,N/A,N/A,148,151,N/A,118,3
2,N/A,N/A,N/A,146,148,N/A,124,3
3,N/A,N/A,N/A,143,146,N/A,130,3
17,N/A,N/A,N/A,126,143,N/A,133,6
11,N/A,N/A,N/A,115,126,N/A,138,5
1,N/A,N/A,N/A,1843,1844,N/A,3,1
7,N/A,N/A,N/A,1836,1843,N/A,6,4
1,N/A,N/A,N/A,1835,1836,N/A,9,1
18,N/A,N/A,N/A,1817,1835,N/A,14,6
2,N/A,N/A,N/A,1815,1817,N/A,17,3
2,N/A,N/A,N/A,1813,1815,N/A,22,2
14,N/A,N/A,N/A,1799,1813,N/A,26,6
2,N/A,N/A,N/A,1797,1799,N/A,32,0
14,N/A,N/A,N/A,1783,1797,N/A,38,6
13,N/A,N/A,N/A,1770,1783,N/A,42,4
3,N/A,N/A,N/A,1767,1770,N/A,47,3
2,N/A,N/A,N/A,1765,1767,N/A,51,1
14,N/A,N/A,N/A,1751,1765,N/A,56,6
2,N/A,N/A,N/A,1749,1751,N/A,62,0
3,N/A,N/A,N/A,1746,1749,N/A,65,3
16,N/A,N/A,N/A,1730,1746,N/A,68,6
2,N/A,N/A,N/A,1728,1730,N/A,71,3
2,N/A,N/A,N/A,1726,1728,N/A,76,2
11,N/A,N/A,N/A,1715,1726,N/A,80,6
2,N/A,N/A,N/A,1713,1715,N/A,83,3
17,N/A,N/A,N/A,1696,1713,N/A,86,6
2,N/A,N/A,N/A,1694,1696,N/A,92,0
14,N/A,N/A,N/A,1680,1694,N/A,96,4
1,N/A,N/A,N/A,1679,1680,N/A,99,1
18,N/A,N/A,N/A,1661,1679,N/A,104,6
4,N/A,N/A,N/A,1657,1661,N/A,107,3
2,N/A,N/A,N/A,1655,1657,N/A,111,1
11,N/A,N/A,N/A,1644,1655,N/A,114,4
3,N/A,N/A,N/A,1641,1644,N/A,118,2
13,N/A,N/A,N/A,1628,1641,N/A,121,5
2,N/A,N/A,N/A,624,626,N/A,5,1
2,N/A,N/A,N/A,622,624,N/A,11,1
14,N/A,N/A,N/A,608,622,N/A,14,4
3,N/A,N/A,N/A,605,608,N/A,19,3
4,N/A,N/A,N/A,601,605,N/A,25,3
2,N/A,N/A,N/A,599,601,N/A,29,1
13,N/A,N/A,N/A,586,599,N/A,32,4
4,N/A,N/A,N/A,582,586,N/A,36,2
11,N/A,N/A,N/A,571,582,N/A,39,5
4,N/A,N/A,N/A,567,571,N/A,43,3
4,N/A,N/A,N/A,563,567,N/A,49,3
4,N/A,N/A,N/A,559,563,N/A,55,3
3,N/A,N/A,N/A,556,559,N/A,60,2
11,N/A,N/A,N/A,545,556,N/A,64,6
8,N/A,N/A,N/A,537,545,N/A,68,4
2,N/A,N/A,N/A,535,537,N/A,72,2
17,N/A,N/A,N/A,518,535,N/A,76,6
14,N/A,N/A,N/A,504,518,N/A,80,4
6,N/A,N/A,N/A,498,504,N/A,86,4
3,N/A,N/A,N/A,495,498,N/A,90,2
20,N/A,N/A,N/A,475,495,N/A,94,6
15,N/A,N/A,N/A,460,475,N/A,99,5
2,N/A,N/A,N/A,458,460,N/A,102,2
14,N/A,N/A,N/A,444,458,N/A,105,5
10,N/A,N/A,N/A,434,444,N/A,111,5
12,N/A,N/A,N/A,422,434,N/A,116,4
2,N/A,N/A,N/A,420,422,N/A,121,3
2,N/A,N/A,N/A,418,420,N/A,126,2
1,N/A,N/A,N/A,417,418,N/A,131,1
2,N/A,N/A,N/A,415,417,N/A,137,1
18,N/A,N/A,N/A,804,822,N/A,6,6
3,N/A,N/A,N/A,801,804,N/A,9,3
2,N/A,N/A,N/A,799,801,N/A,15,3
1,N/A,N/A,N/A,798,799,N/A,19,1
19,N/A,N/A,N/A,779,798,N/A,23,5
4,N/A,N/A,N/A,775,779,N/A,27,3
1,N/A,N/A,N/A,774,775,N/A,31,1
12,N/A,N/A,N/A,762,774,N/A,36,6
4,N/A,N/A,N/A,758,762,N/A,39,3
2,N/A,N/A,N/A,756,758,N/A,43,1
11,N/A,N/A,N/A,745,756,N/A,47,5
8,N/A,N/A,N/A,737,745,N/A,52,4
8,N/A,N/A,N/A,729,737,N/A,58,4
13,N/A,N/A,N/A,716,729,N/A,64,4
1,N/A,N/A,N/A,715,716,N/A,67,1
12,N/A,N/A,N/A,703,715,N/A,72,6
3,N/A,N/A,N/A,700,703,N/A,75,3
4,N/A,N/A,N/A,696,700,N/A,81,3
1,N/A,N/A,N/A,695,696,N/A,85,1
13,N/A,N/A,N/A,682,695,N/A,89,5
2,N/A,N/A,N/A,680,682,N/A,93,3
2,N/A,N/A,N/A,678,680,N/A,97,1
1,N/A,N/A,N/A,677,678,N/A,103,1
11,N/A,N/A,N/A,666,677,N/A,106,4
2,N/A,N/A,N/A,664,666,N/A,110,2
16,N/A,N/A,N/A,648,664,N/A,113,5
3,N/A,N/A,N/A,645,648,N/A,117,3
2,N/A,N/A,N/A,643,645,N/A,122,2
17,N/A,N/A,N/A,626,643,N/A,126,6
2,N/A,N/A,N/A,624,626,N/A,129,3
18,N/A,N/A,N/A,611,629,N/A,3,5
17,N/A,N/A,N/A,594,611,N/A,9,5
19,N/A,N/A,N/A,575,594,N/A,15,5
10,N/A,N/A,N/A,565,575,N/A,21,5
3,N/A,N/A,N/A,562,565,N/A,24,2
1,N/A,N/A,N/A,561,562,N/A,29,1
5,N/A,N/A,N/A,556,561,N/A,32,4
5,N/A,N/A,N/A,551,556,N/A,38,4
3,N/A,N/A,N/A,548,551,N/A,43,3
4,N/A,N/A,N/A,544,548,N/A,48,2
3,N/A,N/A,N/A,541,544,N/A,54,2
18,N/A,N/A,N/A,523,541,N/A,58,6
17,N/A,N/A,N/A,506,523,N/A,63,5
11,N/A,N/A,N/A,495,506,N/A,68,4
4,N/A,N/A,N/A,491,495,N/A,72,2
16,N/A,N/A,N/A,475,491,N/A,75,5
10,N/A,N/A,N/A,465,475,N/A,80,4
9,N/A,N/A,N/A,456,465,N/A,86,4
3,N/A,N/A,N/A,453,456,N/A,90,2
15,N/A,N/A,N/A,438,453,N/A,93,5
11,N/A,N/A,N/A,427,438,N/A,99,5
17,N/A,N/A,N/A,410,427,N/A,105,5
5,N/A,N/A,N/A,405,410,N/A,110,4
2,N/A,N/A,N/A,403,405,N/A,115,3
2,N/A,N/A,N/A,401,403,N/A,121,3
4,N/A,N/A,N/A,397,401,N/A,127,3
15,N/A,N/A,N/A,382,397,N/A,130,6
17,N/A,N/A,N/A,365,382,N/A,135,5
4,N/A,N/A,N/A,361,365,N/A,138,2
11,N/A,N/A,N/A,350,361,N/A,142,6
4,N/A,N/A,N/A,1558,1562,N/A,5,3
14,N/A,N/A,N/A,1544,1558,N/A,8,6
12,N/A,N/A,N/A,1532,1544,N/A,12,4
7,N/A,N/A,N/A,1525,1532,N/A,18,4
6,N/A,N/A,N/A,1519,1525,N/A,24,4
2,N/A,N/A,N/A,1517,1519,N/A,28,2
17,N/A,N/A,N/A,1500,1517,N/A,31,5
4,N/A,N/A,N/A,1496,1500,N/A,34,2
20,N/A,N/A,N/A,1476,1496,N/A,38,6
1,N/A,N/A,N/A,1475,1476,N/A,44,0
4,N/A,N/A,N/A,1471,1475,N/A,47,3
3,N/A,N/A,N/A,1468,1471,N/A,53,3
4,N/A,N/A,N/A,1464,1468,N/A,58,2
2,N/A,N/A,N/A,1462,1464,N/A,63,1
10,N/A,N/A,N/A,1452,1462,N/A,66,4
3,N/A,N/A,N/A,1449,1452,N/A,70,2
14,N/A,N/A,N/A,1435,1449,N/A,73,5
11,N/A,N/A,N/A,1424,1435,N/A,79,5
3,N/A,N/A,N/A,1421,1424,N/A,82,2
11,N/A,N/A,N/A,1410,1421,N/A,86,6
8,N/A,N/A,N/A,1402,1410,N/A,90,4
2,N/A,N/A,N/A,1400,1402,N/A,95,3
16,N/A,N/A,N/A,1384,1400,N/A,98,6
2,N/A,N/A,N/A,1382,1384,N/A,104,0
17,N/A,N/A,N/A,1365,1382,N/A,110,6
13,N/A,N/A,N/A,1352,1365,N/A,115,5
3,N/A,N/A,N/A,1349,1352,N/A,118,2
10,N/A,N/A,N/A,1339,1349,N/A,121,5
6,N/A,N/A,N/A,1333,1339,N/A,126,4
1,N/A,N/A,N/A,1332,1333,N/A,129,1
2,N/A,N/A,N/A,1692,1694,N/A,6,3
3,N/A,N/A,N/A,1689,1692,N/A,11,2
2,N/A,N/A,N/A,1687,1689,N/A,17,2
2,N/A,N/A,N/A,1685,1687,N/A,23,2
2,N/A,N/A,N/A,1683,1685,N/A,28,1
1,N/A,N/A,N/A,1682,1683,N/A,34,1
1,N/A,N/A,N/A,1681,1682,N/A,40,1
16,N/A,N/A,N/A,1665,1681,N/A,44,5
2,N/A,N/A,N/A,1663,1665,N/A,48,3
3,N/A,N/A,N/A,1660,1663,N/A,54,3
2,N/A,N/A,N/A,1658,1660,N/A,60,3
4,N/A,N/A,N/A,1654,1658,N/A,66,3
4,N/A,N/A,N/A,1650,1654,N/A,72,3
4,N/A,N/A,N/A,1646,1650,N/A,78,3
2,N/A,N/A,N/A,1644,1646,N/A,84,3
4,N/A,N/A,N/A,1640,1644,N/A,90,3
12,N/A,N/A,N/A,1628,1640,N/A,93,6
4,N/A,N/A,N/A,1624,1628,N/A,96,3
19,N/A,N/A,N/A,1605,1624,N/A,99,6
1,N/A,N/A,N/A,1604,1605,N/A,105,0
2,N/A,N/A,N/A,1602,1604,N/A,108,3
2,N/A,N/A,N/A,1600,1602,N/A,114,3
15,N/A,N/A,N/A,1585,1600,N/A,117,6
13,N/A,N/A,N/A,1572,1585,N/A,121,4
5,N/A,N/A,N/A,1567,1572,N/A,127,4
9,N/A,N/A,N/A,1558,1567,N/A,133,4
4,N/A,N/A,N/A,1554,1558,N/A,138,3
2,N/A,N/A,N/A,1552,1554,N/A,142,1
13,N/A,N/A,N/A,1539,1552,N/A,145,4
3,N/A,N/A,N/A,1536,1539,N/A,149,2
12,N/A,N/A,N/A,414,426,N/A,5,5
10,N/A,N/A,N/A,404,414,N/A,10,4
1,N/A,N/A,N/A,403,404,N/A,13,1
11,N/A,N/A,N/A,392,403,N/A,17,5
3,N/A,N/A,N/A,389,392,N/A,21,3
3,N/A,N/A,N/A,386,389,N/A,27,3
4,N/A,N/A,N/A,382,386,N/A,33,3
3,N/A,N/A,N/A,379,382,N/A,38,2
13,N/A,N/A,N/A,366,379,N/A,42,6
1,N/A,N/A,N/A,365,366,N/A,48,0
13,N/A,N/A,N/A,352,365,N/A,52,4
1,N/A,N/A,N/A,351,352,N/A,55,1
12,N/A,N/A,N/A,339,351,N/A,60,6
10,N/A,N/A,N/A,329,339,N/A,65,5
2,N/A,N/A,N/A,327,329,N/A,69,3
1,N/A,N/A,N/A,326,327,N/A,73,1
2,N/A,N/A,N/A,324,326,N/A,79,1
1,N/A,N/A,N/A,323,324,N/A,85,1
16,N/A,N/A,N/A,307,323,N/A,90,6
4,N/A,N/A,N/A,303,307,N/A,93,3
19,N/A,N/A,N/A,284,303,N/A,96,6
2,N/A,N/A,N/A,282,284,N/A,99,3
15,N/A,N/A,N/A,267,282,N/A,102,6
6,N/A,N/A,N/A,261,267,N/A,106,4
2,N/A,N/A,N/A,259,261,N/A,109,1
16,N/A,N/A,N/A,243,259,N/A,113,5
4,N/A,N/A,N/A,239,243,N/A,117,3
2,N/A,N/A,N/A,237,239,N/A,122,2
10,N/A,N/A,N/A,227,237,N/A,125,5
16,N/A,N/A,N/A,211,227,N/A,131,5
3,N/A,N/A,N/A,1216,1219,N/A,4,3
16,N/A,N/A,N/A,1200,1216,N/A,7,6
2,N/A,N/A,N/A,1198,1200,N/A,13,0
4,N/A,N/A,N/A,1194,1198,N/A,16,3
2,N/A,N/A,N/A,1192,1194,N/A,21,2
2,N/A,N/A,N/A,1190,1192,N/A,26,1
10,N/A,N/A,N/A,1180,1190,N/A,30,5
15,N/A,N/A,N/A,1165,1180,N/A,36,5
11,N/A,N/A,N/A,1154,1165,N/A,42,5
2,N/A,N/A,N/A,1152,1154,N/A,45,2
12,N/A,N/A,N/A,1140,1152,N/A,49,6
2,N/A,N/A,N/A,1138,1140,N/A,52,3
17,N/A,N/A,N/A,1121,1138,N/A,55,6
2,N/A,N/A,N/A,1119,1121,N/A,61,0
4,N/A,N/A,N/A,1115,1119,N/A,64,3
1,N/A,N/A,N/A,1114,1115,N/A,68,1
15,N/A,N/A,N/A,1099,1114,N/A,73,6
15,N/A,N/A,N/A,1084,1099,N/A,78,5
13,N/A,N/A,N/A,1071,1084,N/A,83,4
2,N/A,N/A,N/A,1069,1071,N/A,86,1
12,N/A,N/A,N/A,1057,1069,N/A,90,5
4,N/A,N/A,N/A,1053,1057,N/A,93,2
4,N/A,N/A,N/A,1049,1053,N/A,99,2
2,N/A,N/A,N/A,1047,1049,N/A,105,2
3,N/A,N/A,N/A,1044,1047,N/A,111,2
10,N/A,N/A,N/A,1034,1044,N/A,114,5
2,N/A,N/A,N/A,1032,1034,N/A,117,2
2,N/A,N/A,N/A,1030,1032,N/A,123,2
13,N/A,N/A,N/A,1017,1030,N/A,127,6
4,N/A,N/A,N/A,1013,1017,N/A,130,3
3,N/A,N/A,N/A,838,841,N/A,3,3
20,N/A,N/A,N/A,818,838,N/A,6,6
4,N/A,N/A,N/A,814,818,N/A,9,3
18,N/A,N/A,N/A,796,814,N/A,12,6
5,N/A,N/A,N/A,791,796,N/A,16,4
14,N/A,N/A,N/A,777,791,N/A,22,4
3,N/A,N/A,N/A,774,777,N/A,27,3
3,N/A,N/A,N/A,771,774,N/A,32,2
16,N/A,N/A,N/A,755,771,N/A,35,5
19,N/A,N/A,N/A,736,755,N/A,41,5
3,N/A,N/A,N/A,733,736,N/A,44,2
1,N/A,N/A,N/A,732,733,N/A,49,1
16,N/A,N/A,N/A,716,732,N/A,54,6
4,N/A,N/A,N/A,712,716,N/A,57,3
4,N/A,N/A,N/A,708,712,N/A,63,3
19,N/A,N/A,N/A,689,708,N/A,66,6
4,N/A,N/A,N/A,685,689,N/A,69,3
1,N/A,N/A,N/A,684,685,N/A,73,1
19,N/A,N/A,N/A,665,684,N/A,77,5
10,N/A,N/A,N/A,655,665,N/A,82,4
11,N/A,N/A,N/A,644,655,N/A,88,4
1,N/A,N/A,N/A,643,644,N/A,91,1
2,N/A,N/A,N/A,641,643,N/A,97,1
12,N/A,N/A,N/A,629,641,N/A,101,5
19,N/A,N/A,N/A,610,629,N/A,107,5
3,N/A,N/A,N/A,607,610,N/A,111,3
2,N/A,N/A,N/A,605,607,N/A,117,3
4,N/A,N/A,N/A,601,605,N/A,122,2
14,N/A,N/A,N/A,587,601,N/A,126,6
10,N/A,N/A,N/A,577,587,N/A,130,4
13,N/A,N/A,N/A,1298,1311,N/A,3,5
6,N/A,N/A,N/A,1292,1298,N/A,8,4
3,N/A,N/A,N/A,1289,1292,N/A,12,2
13,N/A,N/A,N/A,1276,1289,N/A,16,6
10,N/A,N/A,N/A,1266,1276,N/A,20,4
3,N/A,N/A,N/A,1263,1266,N/A,24,2
12,N/A,N/A,N/A,1251,1263,N/A,27,5
2,N/A,N/A,N/A,1249,1251,N/A,30,2
1,N/A,N/A,N/A,1248,1249,N/A,35,1
14,N/A,N/A,N/A,1234,1248,N/A,38,4
4,N/A,N/A,N/A,1230,1234,N/A,43,3
1,N/A,N/A,N/A,1229,1230,N/A,47,1
2,N/A,N/A,N/A,1227,1229,N/A,53,1
15,N/A,N/A,N/A,1212,1227,N/A,57,5
2,N/A,N/A,N/A,1210,1212,N/A,61,3
13,N/A,N/A,N/A,1197,1210,N/A,64,6
15,N/A,N/A,N/A,1182,1197,N/A,69,5
2,N/A,N/A,N/A,1180,1182,N/A,73,3
1,N/A,N/A,N/A,1179,1180,N/A,77,1
13,N/A,N/A,N/A,1166,1179,N/A,81,5
13,N/A,N/A,N/A,1153,1166,N/A,86,4
2,N/A,N/A,N/A,1151,1153,N/A,89,1
13,N/A,N/A,N/A,1138,1151,N/A,93,5
3,N/A,N/A,N/A,1135,1138,N/A,96,2
18,N/A,N/A,N/A,1117,1135,N/A,99,5
11,N/A,N/A,N/A,1106,1117,N/A,105,5
12,N/A,N/A,N/A,1094,1106,N/A,111,5
3,N/A,N/A,N/A,1091,1094,N/A,115,3
4,N/A,N/A,N/A,1087,1091,N/A,121,3
2,N/A,N/A,N/A,1085,1087,N/A,125,1
2,N/A,N/A,N/A,1620,1622,N/A,3,2
2,N/A,N/A,N/A,1618,1620,N/A,9,2
2,N/A,N/A,N/A,1616,1618,N/A,15,2
16,N/A,N/A,N/A,1600,1616,N/A,18,5
4,N/A,N/A,N/A,1596,1600,N/A,21,2
20,N/A,N/A,N/A,1576,1596,N/A,25,6
17,N/A,N/A,N/A,1559,1576,N/A,30,5
16,N/A,N/A,N/A,1543,1559,N/A,36,5
3,N/A,N/A,N/A,1540,1543,N/A,40,3
1,N/A,N/A,N/A,1539,1540,N/A,44,1
6,N/A,N/A,N/A,1533,1539,N/A,47,4
4,N/A,N/A,N/A,1529,1533,N/A,51,2
12,N/A,N/A,N/A,1517,1529,N/A,55,6
15,N/A,N/A,N/A,1502,1517,N/A,60,5
12,N/A,N/A,N/A,1490,1502,N/A,66,5
4,N/A,N/A,N/A,1486,1490,N/A,70,3
4,N/A,N/A,N/A,1482,1486,N/A,75,2
2,N/A,N/A,N/A,1480,1482,N/A,80,1
18,N/A,N/A,N/A,1462,1480,N/A,84,5
18,N/A,N/A,N/A,1444,1462,N/A,90,5
5,N/A,N/A,N/A,1439,1444,N/A,95,4
2,N/A,N/A,N/A,1437,1439,N/A,100,3
2,N/A,N/A,N/A,1435,1437,N/A,104,1
14,N/A,N/A,N/A,1421,1435,N/A,109,6
2,N/A,N/A,N/A,1419,1421,N/A,115,0
16,N/A,N/A,N/A,1403,1419,N/A,121,6
10,N/A,N/A,N/A,1393,1403,N/A,125,4
3,N/A,N/A,N/A,1390,1393,N/A,130,3
4,N/A,N/A,N/A,1386,1390,N/A,136,3
2,N/A,N/A,N/A,1384,1386,N/A,140,1
9,N/A,N/A,N/A,1578,1587,N/A,3,4
3,N/A,N/A,N/A,1575,1578,N/A,8,3
2,N/A,N/A,N/A,1573,1575,N/A,12,1
19,N/A,N/A,N/A,1554,1573,N/A,16,5
4,N/A,N/A,N/A,1550,1554,N/A,19,2
19,N/A,N/A,N/A,1531,1550,N/A,23,6
8,N/A,N/A,N/A,1523,1531,N/A,27,4
1,N/A,N/A,N/A,1522,1523,N/A,30,1
2,N/A,N/A,N/A,1520,1522,N/A,36,1
16,N/A,N/A,N/A,1504,1520,N/A,40,5
13,N/A,N/A,N/A,1491,1504,N/A,46,5
16,N/A,N/A,N/A,1475,1491,N/A,52,5
2,N/A,N/A,N/A,1473,1475,N/A,56,3
19,N/A,N/A,N/A,1454,1473,N/A,59,6
14,N/A,N/A,N/A,1440,1454,N/A,64,5
16,N/A,N/A,N/A,1424,1440,N/A,70,5
15,N/A,N/A,N/A,1409,1424,N/A,76,5
8,N/A,N/A,N/A,1401,1409,N/A,81,4
4,N/A,N/A,N/A,1397,1401,N/A,86,3
13,N/A,N/A,N/A,1384,1397,N/A,89,6
12,N/A,N/A,N/A,1372,1384,N/A,93,4
2,N/A,N/A,N/A,1370,1372,N/A,98,3
1,N/A,N/A,N/A,1369,1370,N/A,102,1
19,N/A,N/A,N/A,1350,1369,N/A,107,6
18,N/A,N/A,N/A,1332,1350,N/A,112,5
3,N/A,N/A,N/A,1329,1332,N/A,115,2
13,N/A,N/A,N/A,1316,1329,N/A,119,6
9,N/A,N/A,N/A,1307,1316,N/A,123,4
4,N/A,N/A,N/A,1303,1307,N/A,128,3
3,N/A,N/A,N/A,1300,1303,N/A,134,3
3,N/A,N/A,N/A,1250,1253,N/A,6,3
2,N/A,N/A,N/A,1248,1250,N/A,10,1
2,N/A,N/A,N/A,1246,1248,N/A,16,1
12,N/A,N/A,N/A,1234,1246,N/A,20,5
3,N/A,N/A,N/A,1231,1234,N/A,24,3
2,N/A,N/A,N/A,1229,1231,N/A,28,1
10,N/A,N/A,N/A,1219,1229,N/A,32,5
4,N/A,N/A,N/A,1215,1219,N/A,35,2
17,N/A,N/A,N/A,1198,1215,N/A,39,6
3,N/A,N/A,N/A,1195,1198,N/A,42,3
2,N/A,N/A,N/A,1193,1195,N/A,46,1
16,N/A,N/A,N/A,1177,1193,N/A,50,5
4,N/A,N/A,N/A,1173,1177,N/A,54,3
3,N/A,N/A,N/A,1170,1173,N/A,59,2
2,N/A,N/A,N/A,1168,1170,N/A,64,1
1,N/A,N/A,N/A,1167,1168,N/A,70,1
15,N/A,N/A,N/A,1152,1167,N/A,75,6
6,N/A,N/A,N/A,1146,1152,N/A,79,4
3,N/A,N/A,N/A,1143,1146,N/A,83,2
3,N/A,N/A,N/A,1140,1143,N/A,89,2
13,N/A,N/A,N/A,1127,1140,N/A,92,5
4,N/A,N/A,N/A,1123,1127,N/A,96,3
3,N/A,N/A,N/A,1120,1123,N/A,101,2
11,N/A,N/A,N/A,1109,1120,N/A,104,5
19,N/A,N/A,N/A,1090,1109,N/A,110,5
2,N/A,N/A,N/A,1088,1090,N/A,114,3
14,N/A,N/A,N/A,1074,1088,N/A,117,6
3,N/A,N/A,N/A,1071,1074,N/A,120,3
2,N/A,N/A,N/A,1069,1071,N/A,126,3
20,N/A,N/A,N/A,1049,1069,N/A,129,6
14,N/A,N/A,N/A,818,832,N/A,3,5
13,N/A,N/A,N/A,805,818,N/A,8,4
2,N/A,N/A,N/A,803,805,N/A,11,1
13,N/A,N/A,N/A,790,803,N/A,16,6
2,N/A,N/A,N/A,788,790,N/A,22,0
10,N/A,N/A,N/A,778,788,N/A,27,5
3,N/A,N/A,N/A,775,778,N/A,30,2
1,N/A,N/A,N/A,774,775,N/A,35,1
9,N/A,N/A,N/A,765,774,N/A,38,4
13,N/A,N/A,N/A,752,765,N/A,44,4
2,N/A,N/A,N/A,750,752,N/A,49,3
2,N/A,N/A,N/A,748,750,N/A,54,2
19,N/A,N/A,N/A,729,748,N/A,58,6
1,N/A,N/A,N/A,728,729,N/A,64,0
6,N/A,N/A,N/A,722,728,N/A,68,4
2,N/A,N/A,N/A,720,722,N/A,72,2
2,N/A,N/A,N/A,718,720,N/A,77,1
2,N/A,N/A,N/A,716,718,N/A,83,1
5,N/A,N/A,N/A,711,716,N/A,86,4
12,N/A,N/A,N/A,699,711,N/A,92,4
2,N/A,N/A,N/A,697,699,N/A,96,2
2,N/A,N/A,N/A,695,697,N/A,101,1
1,N/A,N/A,N/A,694,695,N/A,107,1
12,N/A,N/A,N/A,682,694,N/A,110,4
4,N/A,N/A,N/A,678,682,N/A,115,3
4,N/A,N/A,N/A,674,678,N/A,121,3
1,N/A,N/A,N/A,673,674,N/A,125,1
2,N/A,N/A,N/A,671,673,N/A,131,1
12,N/A,N/A,N/A,659,671,N/A,135,5
4,N/A,N/A,N/A,655,659,N/A,138,2
4,N/A,N/A,N/A,1039,1043,N/A,6,3
2,N/A,N/A,N/A,1037,1039,N/A,11,2
11,N/A,N/A,N/A,1026,1037,N/A,15,6
3,N/A,N/A,N/A,1023,1026,N/A,18,3
14,N/A,N/A,N/A,1009,1023,N/A,21,6
1,N/A,N/A,N/A,1008,1009,N/A,27,0
3,N/A,N/A,N/A,1005,1008,N/A,30,3
4,N/A,N/A,N/A,1001,1005,N/A,36,3
2,N/A,N/A,N/A,999,1001,N/A,42,3
1,N/A,N/A,N/A,998,999,N/A,46,1
17,N/A,N/A,N/A,981,998,N/A,50,5
15,N/A,N/A,N/A,966,981,N/A,56,5
10,N/A,N/A,N/A,956,966,N/A,62,5
4,N/A,N/A,N/A,952,956,N/A,66,3
2,N/A,N/A,N/A,950,952,N/A,70,1
16,N/A,N/A,N/A,934,950,N/A,74,5
11,N/A,N/A,N/A,923,934,N/A,79,4
2,N/A,N/A,N/A,921,923,N/A,82,1
20,N/A,N/A,N/A,901,921,N/A,87,6
13,N/A,N/A,N/A,888,901,N/A,92,5
4,N/A,N/A,N/A,884,888,N/A,95,2
2,N/A,N/A,N/A,882,884,N/A,100,1
12,N/A,N/A,N/A,870,882,N/A,105,6
2,N/A,N/A,N/A,868,870,N/A,108,3
20,N/A,N/A,N/A,848,868,N/A,111,6
10,N/A,N/A,N/A,838,848,N/A,116,5
12,N/A,N/A,N/A,826,838,N/A,121,4
2,N/A,N/A,N/A,824,826,N/A,125,2
13,N/A,N/A,N/A,811,824,N/A,129,6
1,N/A,N/A,N/A,810,811,N/A,135,0
15,N/A,N/A,N/A,1316,1331,N/A,5,5
8,N/A,N/A,N/A,1308,1316,N/A,10,4
4,N/A,N/A,N/A,1304,1308,N/A,15,3
3,N/A,N/A,N/A,1301,1304,N/A,21,3
4,N/A,N/A,N/A,1297,1301,N/A,26,2
2,N/A,N/A,N/A,1295,1297,N/A,31,1
15,N/A,N/A,N/A,1280,1295,N/A,36,6
12,N/A,N/A,N/A,1268,1280,N/A,40,4
4,N/A,N/A,N/A,1264,1268,N/A,45,3
2,N/A,N/A,N/A,1262,1264,N/A,49,1
7,N/A,N/A,N/A,1255,1262,N/A,52,4
4,N/A,N/A,N/A,1251,1255,N/A,57,3
17,N/A,N/A,N/A,1234,1251,N/A,60,6
2,N/A,N/A,N/A,1232,1234,N/A,66,0
13,N/A,N/A,N/A,1219,1232,N/A,71,5
4,N/A,N/A,N/A,1215,1219,N/A,75,3
4,N/A,N/A,N/A,1211,1215,N/A,81,3
3,N/A,N/A,N/A,1208,1211,N/A,86,2
2,N/A,N/A,N/A,1206,1208,N/A,91,1
7,N/A,N/A,N/A,1199,1206,N/A,94,4
2,N/A,N/A,N/A,1197,1199,N/A,99,3
19,N/A,N/A,N/A,1178,1197,N/A,102,6
14,N/A,N/A,N/A,1164,1178,N/A,106,4
3,N/A,N/A,N/A,1161,1164,N/A,110,2
18,N/A,N/A,N/A,1143,1161,N/A,114,6
4,N/A,N/A,N/A,1139,1143,N/A,117,3
3,N/A,N/A,N/A,1136,1139,N/A,123,3
4,N/A,N/A,N/A,1132,1136,N/A,128,2
2,N/A,N/A,N/A,1130,1132,N/A,133,1
1,N/A,N/A,N/A,1129,1130,N/A,139,1
18,N/A,N/A,N/A,367,385,N/A,3,6
16,N/A,N/A,N/A,351,367,N/A,8,5
3,N/A,N/A,N/A,348,351,N/A,12,3
3,N/A,N/A,N/A,345,348,N/A,18,3
13,N/A,N/A,N/A,332,345,N/A,21,6
14,N/A,N/A,N/A,318,332,N/A,26,5
3,N/A,N/A,N/A,315,318,N/A,29,2
2,N/A,N/A,N/A,313,315,N/A,34,1
2,N/A,N/A,N/A,311,313,N/A,40,1
11,N/A,N/A,N/A,300,311,N/A,45,6
2,N/A,N/A,N/A,298,300,N/A,48,3
1,N/A,N/A,N/A,297,298,N/A,52,1
17,N/A,N/A,N/A,280,297,N/A,56,5
4,N/A,N/A,N/A,276,280,N/A,60,3
2,N/A,N/A,N/A,274,276,N/A,65,2
2,N/A,N/A,N/A,272,274,N/A,70,1
13,N/A,N/A,N/A,259,272,N/A,74,5
3,N/A,N/A,N/A,256,259,N/A,77,2
16,N/A,N/A,N/A,240,256,N/A,81,6
2,N/A,N/A,N/A,238,240,N/A,87,0
14,N/A,N/A,N/A,224,238,N/A,92,5
9,N/A,N/A,N/A,215,224,N/A,97,4
3,N/A,N/A,N/A,212,215,N/A,102,3
1,N/A,N/A,N/A,211,212,N/A,106,1
16,N/A,N/A,N/A,195,211,N/A,111,6
14,N/A,N/A,N/A,181,195,N/A,116,5
3,N/A,N/A,N/A,178,181,N/A,120,3
3,N/A,N/A,N/A,175,178,N/A,125,2
1,N/A,N/A,N/A,174,175,N/A,130,1
14,N/A,N/A,N/A,160,174,N/A,134,5
2,N/A,N/A,N/A,942,944,N/A,5,2
12,N/A,N/A,N/A,930,942,N/A,8,5
3,N/A,N/A,N/A,927,930,N/A,11,2
1,N/A,N/A,N/A,926,927,N/A,16,1
15,N/A,N/A,N/A,911,926,N/A,20,5
10,N/A,N/A,N/A,901,911,N/A,26,5
5,N/A,N/A,N/A,896,901,N/A,31,4
4,N/A,N/A,N/A,892,896,N/A,35,2
18,N/A,N/A,N/A,874,892,N/A,39,6
5,N/A,N/A,N/A,869,874,N/A,43,4
9,N/A,N/A,N/A,860,869,N/A,49,4
2,N/A,N/A,N/A,858,860,N/A,53,2
13,N/A,N/A,N/A,845,858,N/A,56,5
3,N/A,N/A,N/A,842,845,N/A,59,2
18,N/A,N/A,N/A,824,842,N/A,62,5
3,N/A,N/A,N/A,821,824,N/A,65,2
12,N/A,N/A,N/A,809,821,N/A,69,6
17,N/A,N/A,N/A,792,809,N/A,74,5
8,N/A,N/A,N/A,784,792,N/A,79,4
2,N/A,N/A,N/A,782,784,N/A,83,2
18,N/A,N/A,N/A,764,782,N/A,86,5
7,N/A,N/A,N/A,757,764,N/A,91,4
4,N/A,N/A,N/A,753,757,N/A,95,2
2,N/A,N/A,N/A,751,753,N/A,100,1
2,N/A,N/A,N/A,749,751,N/A,106,1
2,N/A,N/A,N/A,747,749,N/A,112,1
16,N/A,N/A,N/A,731,747,N/A,117,6
14,N/A,N/A,N/A,717,731,N/A,122,5
4,N/A,N/A,N/A,713,717,N/A,125,2
17,N/A,N/A,N/A,696,713,N/A,129,6
20,N/A,N/A,N/A,767,787,N/A,4,6
12,N/A,N/A,N/A,755,767,N/A,9,5
10,N/A,N/A,N/A,745,755,N/A,14,4
2,N/A,N/A,N/A,743,745,N/A,18,2
2,N/A,N/A,N/A,741,743,N/A,23,1
12,N/A,N/A,N/A,729,741,N/A,28,6
3,N/A,N/A,N/A,726,729,N/A,31,3
2,N/A,N/A,N/A,724,726,N/A,37,3
14,N/A,N/A,N/A,710,724,N/A,40,6
2,N/A,N/A,N/A,708,710,N/A,43,3
3,N/A,N/A,N/A,705,708,N/A,48,2
2,N/A,N/A,N/A,703,705,N/A,53,1
2,N/A,N/A,N/A,701,703,N/A,59,1
16,N/A,N/A,N/A,685,701,N/A,64,6
2,N/A,N/A,N/A,683,685,N/A,70,0
10,N/A,N/A,N/A,673,683,N/A,74,4
3,N/A,N/A,N/A,670,673,N/A,78,2
19,N/A,N/A,N/A,651,670,N/A,82,6
2,N/A,N/A,N/A,649,651,N/A,85,3
4,N/A,N/A,N/A,645,649,N/A,91,3
1,N/A,N/A,N/A,644,645,N/A,95,1
1,N/A,N/A,N/A,643,644,N/A,101,1
2,N/A,N/A,N/A,641,643,N/A,107,1
13,N/A,N/A,N/A,628,641,N/A,111,5
5,N/A,N/A,N/A,623,628,N/A,116,4
2,N/A,N/A,N/A,621,623,N/A,119,1
1,N/A,N/A,N/A,620,621,N/A,125,1
8,N/A,N/A,N/A,612,620,N/A,128,4
2,N/A,N/A,N/A,610,612,N/A,132,2
1,N/A,N/A,N/A,609,610,N/A,137,1
2,N/A,N/A,N/A,1986,1988,N/A,6,1
12,N/A,N/A,N/A,1974,1986,N/A,9,4
4,N/A,N/A,N/A,1970,1974,N/A,13,2
14,N/A,N/A,N/A,1956,1970,N/A,16,5
10,N/A,N/A,N/A,1946,1956,N/A,21,4
14,N/A,N/A,N/A,1932,1946,N/A,27,4
7,N/A,N/A,N/A,1925,1932,N/A,33,4
4,N/A,N/A,N/A,1921,1925,N/A,38,3
4,N/A,N/A,N/A,1917,1921,N/A,44,3
3,N/A,N/A,N/A,1914,1917,N/A,49,2
2,N/A,N/A,N/A,1912,1914,N/A,55,2
1,N/A,N/A,N/A,1911,1912,N/A,60,1
2,N/A,N/A,N/A,1909,1911,N/A,66,1
6,N/A,N/A,N/A,1903,1909,N/A,69,4
1,N/A,N/A,N/A,1902,1903,N/A,72,1
12,N/A,N/A,N/A,1890,1902,N/A,75,4
14,N/A,N/A,N/A,1876,1890,N/A,81,4
1,N/A,N/A,N/A,1875,1876,N/A,84,1
2,N/A,N/A,N/A,1873,1875,N/A,90,1
7,N/A,N/A,N/A,1866,1873,N/A,93,4
1,N/A,N/A,N/A,1865,1866,N/A,96,1
17,N/A,N/A,N/A,1848,1865,N/A,101,6
4,N/A,N/A,N/A,1844,1848,N/A,104,3
12,N/A,N/A,N/A,1832,1844,N/A,107,6
10,N/A,N/A,N/A,1822,1832,N/A,111,4
3,N/A,N/A,N/A,1819,1822,N/A,116,3
2,N/A,N/A,N/A,1817,1819,N/A,122,3
2,N/A,N/A,N/A,1815,1817,N/A,126,1
14,N/A,N/A,N/A,1801,1815,N/A,130,5
2,N/A,N/A,N/A,1799,1801,N/A,134,3
9,N/A,N/A,N/A,546,555,N/A,6,4
1,N/A,N/A,N/A,545,546,N/A,9,1
16,N/A,N/A,N/A,529,545,N/A,13,5
4,N/A,N/A,N/A,525,529,N/A,16,2
16,N/A,N/A,N/A,509,525,N/A,19,5
19,N/A,N/A,N/A,490,509,N/A,25,5
3,N/A,N/A,N/A,487,490,N/A,28,2
14,N/A,N/A,N/A,473,487,N/A,32,6
4,N/A,N/A,N/A,469,473,N/A,35,3
13,N/A,N/A,N/A,456,469,N/A,38,6
4,N/A,N/A,N/A,452,456,N/A,41,3
19,N/A,N/A,N/A,433,452,N/A,44,6
5,N/A,N/A,N/A,428,433,N/A,48,4
3,N/A,N/A,N/A,425,428,N/A,53,3
18,N/A,N/A,N/A,407,425,N/A,56,6
2,N/A,N/A,N/A,405,407,N/A,62,0
19,N/A,N/A,N/A,386,405,N/A,67,5
2,N/A,N/A,N/A,384,386,N/A,71,3
11,N/A,N/A,N/A,373,384,N/A,74,6
2,N/A,N/A,N/A,371,373,N/A,80,0
15,N/A,N/A,N/A,356,371,N/A,85,5
14,N/A,N/A,N/A,342,356,N/A,91,5
4,N/A,N/A,N/A,338,342,N/A,94,2
2,N/A,N/A,N/A,336,338,N/A,99,1
18,N/A,N/A,N/A,318,336,N/A,104,6
3,N/A,N/A,N/A,315,318,N/A,107,3
1,N/A,N/A,N/A,314,315,N/A,111,1
2,N/A,N/A,N/A,312,314,N/A,117,1
18,N/A,N/A,N/A,294,312,N/A,122,6
13,N/A,N/A,N/A,281,294,N/A,126,4
2,N/A,N/A,N/A,1627,1629,N/A,3,1
12,N/A,N/A,N/A,1615,1627,N/A,8,6
10,N/A,N/A,N/A,1605,1615,N/A,12,4
1,N/A,N/A,N/A,1604,1605,N/A,15,1
18,N/A,N/A,N/A,1586,1604,N/A,19,5
11,N/A,N/A,N/A,1575,1586,N/A,25,5
3,N/A,N/A,N/A,1572,1575,N/A,29,3
16,N/A,N/A,N/A,1556,1572,N/A,32,6
4,N/A,N/A,N/A,1552,1556,N/A,35,3
4,N/A,N/A,N/A,1548,1552,N/A,40,2
1,N/A,N/A,N/A,1547,1548,N/A,45,1
10,N/A,N/A,N/A,1537,1547,N/A,48,4
2,N/A,N/A,N/A,1535,1537,N/A,53,3
2,N/A,N/A,N/A,1533,1535,N/A,57,1
15,N/A,N/A,N/A,1518,1533,N/A,61,5
10,N/A,N/A,N/A,1508,1518,N/A,67,5
3,N/A,N/A,N/A,1505,1508,N/A,70,2
3,N/A,N/A,N/A,1502,1505,N/A,76,2
4,N/A,N/A,N/A,1498,1502,N/A,82,2
15,N/A,N/A,N/A,1483,1498,N/A,85,5
3,N/A,N/A,N/A,1480,1483,N/A,88,2
4,N/A,N/A,N/A,1476,1480,N/A,94,2
1,N/A,N/A,N/A,1475,1476,N/A,99,1
2,N/A,N/A,N/A,1473,1475,N/A,105,1
15,N/A,N/A,N/A,1458,1473,N/A,109,5
3,N/A,N/A,N/A,1455,1458,N/A,112,2
16,N/A,N/A,N/A,1439,1455,N/A,115,5
3,N/A,N/A,N/A,1436,1439,N/A,118,2
12,N/A,N/A,N/A,1424,1436,N/A,122,6
13,N/A,N/A,N/A,1411,1424,N/A,126,4
3,N/A,N/A,N/A,1985,1988,N/A,5,3
15,N/A,N/A,N/A,1970,1985,N/A,8,6
2,N/A,N/A,N/A,1968,1970,N/A,14,0
18,N/A,N/A,N/A,1950,1968,N/A,19,5
3,N/A,N/A,N/A,1947,1950,N/A,22,2
4,N/A,N/A,N/A,1943,1947,N/A,28,2
1,N/A,N/A,N/A,1942,1943,N/A,33,1
1,N/A,N/A,N/A,1941,1942,N/A,39,1
15,N/A,N/A,N/A,1926,1941,N/A,44,6
4,N/A,N/A,N/A,1922,1926,N/A,47,3
11,N/A,N/A,N/A,1911,1922,N/A,50,6
2,N/A,N/A,N/A,1909,1911,N/A,56,0
11,N/A,N/A,N/A,1898,1909,N/A,61,5
3,N/A,N/A,N/A,1895,1898,N/A,65,3
3,N/A,N/A,N/A,1892,1895,N/A,70,2
2,N/A,N/A,N/A,1890,1892,N/A,75,1
1,N/A,N/A,N/A,1889,1890,N/A,81,1
11,N/A,N/A,N/A,1878,1889,N/A,86,6
2,N/A,N/A,N/A,1876,1878,N/A,92,0
2,N/A,N/A,N/A,1874,1876,N/A,95,3
19,N/A,N/A,N/A,1855,1874,N/A,98,6
1,N/A,N/A,N/A,1854,1855,N/A,104,0
3,N/A,N/A,N/A,1851,1854,N/A,107,3
2,N/A,N/A,N/A,1849,1851,N/A,111,1
12,N/A,N/A,N/A,1837,1849,N/A,116,6
4,N/A,N/A,N/A,1833,1837,N/A,119,3
18,N/A,N/A,N/A,1815,1833,N/A,122,6
15,N/A,N/A,N/A,1800,1815,N/A,127,5
13,N/A,N/A,N/A,1787,1800,N/A,133,5
13,N/A,N/A,N/A,1774,1787,N/A,139,5
2,N/A,N/A,N/A,1386,1388,N/A,6,3
4,N/A,N/A,N/A,1382,1386,N/A,11,2
2,N/A,N/A,N/A,1380,1382,N/A,17,2
17,N/A,N/A,N/A,1363,1380,N/A,20,5
3,N/A,N/A,N/A,1360,1363,N/A,23,2
2,N/A,N/A,N/A,1358,1360,N/A,28,1
15,N/A,N/A,N/A,1343,1358,N/A,32,5
19,N/A,N/A,N/A,1324,1343,N/A,38,5
2,N/A,N/A,N/A,1322,1324,N/A,42,3
20,N/A,N/A,N/A,1302,1322,N/A,45,6
12,N/A,N/A,N/A,1290,1302,N/A,49,4
11,N/A,N/A,N/A,1279,1290,N/A,55,4
9,N/A,N/A,N/A,1270,1279,N/A,61,4
3,N/A,N/A,N/A,1267,1270,N/A,66,3
16,N/A,N/A,N/A,1251,1267,N/A,69,6
18,N/A,N/A,N/A,1233,1251,N/A,74,5
3,N/A,N/A,N/A,1230,1233,N/A,77,2
2,N/A,N/A,N/A,1228,1230,N/A,83,2
4,N/A,N/A,N/A,1224,1228,N/A,89,2
2,N/A,N/A,N/A,1222,1224,N/A,95,2
3,N/A,N/A,N/A,1219,1222,N/A,101,2
15,N/A,N/A,N/A,1204,1219,N/A,105,6
10,N/A,N/A,N/A,1194,1204,N/A,109,4
2,N/A,N/A,N/A,1192,1194,N/A,114,3
4,N/A,N/A,N/A,1188,1192,N/A,120,3
14,N/A,N/A,N/A,1174,1188,N/A,123,6
2,N/A,N/A,N/A,1172,1174,N/A,126,3
3,N/A,N/A,N/A,1169,1172,N/A,132,3
12,N/A,N/A,N/A,1157,1169,N/A,135,6
1,N/A,N/A,N/A,1156,1157,N/A,141,0
11,N/A,N/A,N/A,1297,1308,N/A,3,5
18,N/A,N/A,N/A,1279,1297,N/A,9,5
15,N/A,N/A,N/A,1264,1279,N/A,15,5
4,N/A,N/A,N/A,1260,1264,N/A,18,2
18,N/A,N/A,N/A,1242,1260,N/A,22,6
3,N/A,N/A,N/A,1239,1242,N/A,25,3
2,N/A,N/A,N/A,1237,1239,N/A,29,1
16,N/A,N/A,N/A,1221,1237,N/A,33,5
6,N/A,N/A,N/A,1215,1221,N/A,38,4
1,N/A,N/A,N/A,1214,1215,N/A,41,1
18,N/A,N/A,N/A,1196,1214,N/A,45,5
12,N/A,N/A,N/A,1184,1196,N/A,50,4
3,N/A,N/A,N/A,1181,1184,N/A,55,3
12,N/A,N/A,N/A,1169,1181,N/A,58,6
14,N/A,N/A,N/A,1155,1169,N/A,62,4
2,N/A,N/A,N/A,1153,1155,N/A,65,1
14,N/A,N/A,N/A,1139,1153,N/A,69,5
16,N/A,N/A,N/A,1123,1139,N/A,75,5
13,N/A,N/A,N/A,1110,1123,N/A,80,4
4,N/A,N/A,N/A,1106,1110,N/A,84,2
19,N/A,N/A,N/A,1087,1106,N/A,88,6
2,N/A,N/A,N/A,1085,1087,N/A,94,0
9,N/A,N/A,N/A,1076,1085,N/A,98,4
4,N/A,N/A,N/A,1072,1076,N/A,102,2
2,N/A,N/A,N/A,1070,1072,N/A,108,2
1,N/A,N/A,N/A,1069,1070,N/A,113,1
20,N/A,N/A,N/A,1049,1069,N/A,118,6
2,N/A,N/A,N/A,1047,1049,N/A,121,3
18,N/A,N/A,N/A,1029,1047,N/A,124,6
5,N/A,N/A,N/A,1024,1029,N/A,128,4
1,N/A,N/A,N/A,1059,1060,N/A,6,1
1,N/A,N/A,N/A,1058,1059,N/A,12,1
8,N/A,N/A,N/A,1050,1058,N/A,15,4
4,N/A,N/A,N/A,1046,1050,N/A,19,2
16,N/A,N/A,N/A,1030,1046,N/A,23,6
4,N/A,N/A,N/A,1026,1030,N/A,26,3
18,N/A,N/A,N/A,1008,1026,N/A,29,6
5,N/A,N/A,N/A,1003,1008,N/A,33,4
3,N/A,N/A,N/A,1000,1003,N/A,38,3
11,N/A,N/A,N/A,989,1000,N/A,41,6
11,N/A,N/A,N/A,978,989,N/A,46,5
5,N/A,N/A,N/A,973,978,N/A,51,4
1,N/A,N/A,N/A,972,973,N/A,54,1
13,N/A,N/A,N/A,959,972,N/A,59,6
2,N/A,N/A,N/A,957,959,N/A,62,3
2,N/A,N/A,N/A,955,957,N/A,66,1
2,N/A,N/A,N/A,953,955,N/A,72,1
14,N/A,N/A,N/A,939,953,N/A,75,4
1,N/A,N/A,N/A,938,939,N/A,78,1
18,N/A,N/A,N/A,920,938,N/A,83,6
18,N/A,N/A,N/A,902,920,N/A,88,5
14,N/A,N/A,N/A,888,902,N/A,93,4
2,N/A,N/A,N/A,886,888,N/A,96,1
14,N/A,N/A,N/A,872,886,N/A,100,5
13,N/A,N/A,N/A,859,872,N/A,105,4
2,N/A,N/A,N/A,857,859,N/A,110,3
1,N/A,N/A,N/A,856,857,N/A,114,1
1,N/A,N/A,N/A,855,856,N/A,120,1
2,N/A,N/A,N/A,853,855,N/A,126,1
14,N/A,N/A,N/A,839,853,N/A,131,6
12,N/A,N/A,N/A,545,557,N/A,3,4
3,N/A,N/A,N/A,542,545,N/A,7,2
16,N/A,N/A,N/A,526,542,N/A,11,6
2,N/A,N/A,N/A,524,526,N/A,14,3
2,N/A,N/A,N/A,522,524,N/A,19,2
1,N/A,N/A,N/A,521,522,N/A,24,1
12,N/A,N/A,N/A,509,521,N/A,28,5
14,N/A,N/A,N/A,495,509,N/A,34,5
14,N/A,N/A,N/A,481,495,N/A,40,5
4,N/A,N/A,N/A,477,481,N/A,43,2
20,N/A,N/A,N/A,457,477,N/A,47,6
3,N/A,N/A,N/A,454,457,N/A,50,3
13,N/A,N/A,N/A,441,454,N/A,53,6
17,N/A,N/A,N/A,424,441,N/A,58,5
13,N/A,N/A,N/A,411,424,N/A,64,5
14,N/A,N/A,N/A,397,411,N/A,69,4
14,N/A,N/A,N/A,383,397,N/A,75,4
6,N/A,N/A,N/A,377,383,N/A,81,4
4,N/A,N/A,N/A,373,377,N/A,85,2
11,N/A,N/A,N/A,362,373,N/A,89,6
2,N/A,N/A,N/A,360,362,N/A,95,0
4,N/A,N/A,N/A,356,360,N/A,98,3
14,N/A,N/A,N/A,342,356,N/A,101,6
2,N/A,N/A,N/A,340,342,N/A,107,0
13,N/A,N/A,N/A,327,340,N/A,111,4
2,N/A,N/A,N/A,325,327,N/A,114,1
18,N/A,N/A,N/A,307,325,N/A,119,6
12,N/A,N/A,N/A,295,307,N/A,123,4
2,N/A,N/A,N/A,293,295,N/A,128,3
1,N/A,N/A,N/A,292,293,N/A,132,1
16,N/A,N/A,N/A,1609,1625,N/A,4,5
11,N/A,N/A,N/A,1598,1609,N/A,10,5
11,N/A,N/A,N/A,1587,1598,N/A,16,5
2,N/A,N/A,N/A,1585,1587,N/A,20,3
11,N/A,N/A,N/A,1574,1585,N/A,23,6
2,N/A,N/A,N/A,1572,1574,N/A,29,0
11,N/A,N/A,N/A,1561,1572,N/A,34,5
17,N/A,N/A,N/A,1544,1561,N/A,40,5
13,N/A,N/A,N/A,1531,1544,N/A,45,4
2,N/A,N/A,N/A,1529,1531,N/A,49,2
16,N/A,N/A,N/A,1513,1529,N/A,52,5
13,N/A,N/A,N/A,1500,1513,N/A,57,4
11,N/A,N/A,N/A,1489,1500,N/A,63,4
4,N/A,N/A,N/A,1485,1489,N/A,68,3
17,N/A,N/A,N/A,1468,1485,N/A,71,6
12,N/A,N/A,N/A,1456,1468,N/A,76,5
18,N/A,N/A,N/A,1438,1456,N/A,82,5
14,N/A,N/A,N/A,1424,1438,N/A,87,4
3,N/A,N/A,N/A,1421,1424,N/A,91,2
2,N/A,N/A,N/A,1419,1421,N/A,96,1
7,N/A,N/A,N/A,1412,1419,N/A,99,4
3,N/A,N/A,N/A,1409,1412,N/A,104,3
2,N/A,N/A,N/A,1407,1409,N/A,110,3
20,N/A,N/A,N/A,1387,1407,N/A,113,6
8,N/A,N/A,N/A,1379,1387,N/A,117,4
8,N/A,N/A,N/A,1371,1379,N/A,123,4
1,N/A,N/A,N/A,1370,1371,N/A,126,1
13,N/A,N/A,N/A,1357,1370,N/A,130,5
4,N/A,N/A,N/A,1353,1357,N/A,134,3
3,N/A,N/A,N/A,1350,1353,N/A,140,3
2,N/A,N/A,N/A,1255,1257,N/A,3,2
3,N/A,N/A,N/A,1252,1255,N/A,9,2
2,N/A,N/A,N/A,1250,1252,N/A,14,1
16,N/A,N/A,N/A,1234,1250,N/A,18,5
17,N/A,N/A,N/A,1217,1234,N/A,24,5
6,N/A,N/A,N/A,1211,1217,N/A,29,4
2,N/A,N/A,N/A,1209,1211,N/A,34,3
11,N/A,N/A,N/A,1198,1209,N/A,37,6
4,N/A,N/A,N/A,1194,1198,N/A,40,3
12,N/A,N/A,N/A,1182,1194,N/A,43,6
11,N/A,N/A,N/A,1171,1182,N/A,47,4
1,N/A,N/A,N/A,1170,1171,N/A,50,1
1,N/A,N/A,N/A,1169,1170,N/A,56,1
16,N/A,N/A,N/A,1153,1169,N/A,61,6
13,N/A,N/A,N/A,1140,1153,N/A,66,5
3,N/A,N/A,N/A,1137,1140,N/A,69,2
2,N/A,N/A,N/A,1135,1137,N/A,74,1
16,N/A,N/A,N/A,1119,1135,N/A,78,5
19,N/A,N/A,N/A,1100,1119,N/A,84,5
15,N/A,N/A,N/A,1085,1100,N/A,90,5
11,N/A,N/A,N/A,1074,1085,N/A,96,5
14,N/A,N/A,N/A,1060,1074,N/A,102,5
4,N/A,N/A,N/A,1056,1060,N/A,105,2
2,N/A,N/A,N/A,1054,1056,N/A,110,1
7,N/A,N/A,N/A,1047,1054,N/A,113,4
2,N/A,N/A,N/A,1045,1047,N/A,116,1
9,N/A,N/A,N/A,1036,1045,N/A,119,4
2,N/A,N/A,N/A,1034,1036,N/A,124,3
19,N/A,N/A,N/A,1015,1034,N/A,127,6
14,N/A,N/A,N/A,1001,1015,N/A,131,4
4,N/A,N/A,N/A,725,729,N/A,5,3
2,N/A,N/A,N/A,723,725,N/A,9,1
1,N/A,N/A,N/A,722,723,N/A,15,1
18,N/A,N/A,N/A,704,722,N/A,19,5
2,N/A,N/A,N/A,702,704,N/A,23,3
2,N/A,N/A,N/A,700,702,N/A,29,3
20,N/A,N/A,N/A,680,700,N/A,32,6
6,N/A,N/A,N/A,674,680,N/A,36,4
1,N/A,N/A,N/A,673,674,N/A,39,1
2,N/A,N/A,N/A,671,673,N/A,45,1
13,N/A,N/A,N/A,658,671,N/A,48,4
2,N/A,N/A,N/A,656,658,N/A,51,1
1,N/A,N/A,N/A,655,656,N/A,57,1
2,N/A,N/A,N/A,653,655,N/A,63,1
8,N/A,N/A,N/A,645,653,N/A,66,4
14,N/A,N/A,N/A,631,645,N/A,72,4
1,N/A,N/A,N/A,630,631,N/A,75,1
2,N/A,N/A,N/A,628,630,N/A,81,1
18,N/A,N/A,N/A,610,628,N/A,86,6
1,N/A,N/A,N/A,609,610,N/A,92,0
19,N/A,N/A,N/A,590,609,N/A,97,5
17,N/A,N/A,N/A,573,590,N/A,103,5
4,N/A,N/A,N/A,569,573,N/A,106,2
18,N/A,N/A,N/A,551,569,N/A,109,5
9,N/A,N/A,N/A,542,551,N/A,114,4
6,N/A,N/A,N/A,536,542,N/A,120,4
4,N/A,N/A,N/A,532,536,N/A,124,2
4,N/A,N/A,N/A,528,532,N/A,130,2
4,N/A,N/A,N/A,524,528,N/A,136,2
1,N/A,N/A,N/A,523,524,N/A,141,1
13,N/A,N/A,N/A,1041,1054,N/A,5,5
13,N/A,N/A,N/A,1028,1041,N/A,10,4
3,N/A,N/A,N/A,1025,1028,N/A,14,2
17,N/A,N/A,N/A,1008,1025,N/A,17,5
12,N/A,N/A,N/A,996,1008,N/A,22,4
1,N/A,N/A,N/A,995,996,N/A,25,1
12,N/A,N/A,N/A,983,995,N/A,30,6
12,N/A,N/A,N/A,971,983,N/A,35,5
9,N/A,N/A,N/A,962,971,N/A,40,4
4,N/A,N/A,N/A,958,962,N/A,44,2
2,N/A,N/A,N/A,956,958,N/A,49,1
7,N/A,N/A,N/A,949,956,N/A,52,4
4,N/A,N/A,N/A,945,949,N/A,56,2
16,N/A,N/A,N/A,929,945,N/A,60,6
2,N/A,N/A,N/A,927,929,N/A,63,3
3,N/A,N/A,N/A,924,927,N/A,69,3
4,N/A,N/A,N/A,920,924,N/A,75,3
2,N/A,N/A,N/A,918,920,N/A,80,2
17,N/A,N/A,N/A,901,918,N/A,83,5
14,N/A,N/A,N/A,887,901,N/A,89,5
5,N/A,N/A,N/A,882,887,N/A,94,4
2,N/A,N/A,N/A,880,882,N/A,98,2
2,N/A,N/A,N/A,878,880,N/A,104,2
15,N/A,N/A,N/A,863,878,N/A,107,5
2,N/A,N/A,N/A,861,863,N/A,111,3
2,N/A,N/A,N/A,859,861,N/A,115,1
9,N/A,N/A,N/A,850,859,N/A,118,4
5,N/A,N/A,N/A,845,850,N/A,124,4
3,N/A,N/A,N/A,842,845,N/A,128,2
3,N/A,N/A,N/A,839,842,N/A,134,2
16,N/A,N/A,N/A,1452,1468,N/A,6,5
2,N/A,N/A,N/A,1450,1452,N/A,10,3
13,N/A,N/A,N/A,1437,1450,N/A,13,6
2,N/A,N/A,N/A,1435,1437,N/A,19,0
12,N/A,N/A,N/A,1423,1435,N/A,25,6
13,N/A,N/A,N/A,1410,1423,N/A,30,5
7,N/A,N/A,N/A,1403,1410,N/A,35,4
2,N/A,N/A,N/A,1401,1403,N/A,39,2
1,N/A,N/A,N/A,1400,1401,N/A,44,1
19,N/A,N/A,N/A,1381,1400,N/A,49,6
14,N/A,N/A,N/A,1367,1381,N/A,54,5
10,N/A,N/A,N/A,1357,1367,N/A,60,5
13,N/A,N/A,N/A,1344,1357,N/A,66,5
17,N/A,N/A,N/A,1327,1344,N/A,72,5
14,N/A,N/A,N/A,1313,1327,N/A,78,5
3,N/A,N/A,N/A,1310,1313,N/A,81,2
3,N/A,N/A,N/A,1307,1310,N/A,87,2
14,N/A,N/A,N/A,1293,1307,N/A,90,5
3,N/A,N/A,N/A,1290,1293,N/A,93,2
2,N/A,N/A,N/A,1288,1290,N/A,99,2
18,N/A,N/A,N/A,1270,1288,N/A,103,6
10,N/A,N/A,N/A,1260,1270,N/A,107,4
7,N/A,N/A,N/A,1253,1260,N/A,113,4
1,N/A,N/A,N/A,1252,1253,N/A,116,1
1,N/A,N/A,N/A,1251,1252,N/A,122,1
1,N/A,N/A,N/A,1250,1251,N/A,128,1
1,N/A,N/A,N/A,1249,1250,N/A,134,1
12,N/A,N/A,N/A,1237,1249,N/A,138,5
14,N/A,N/A,N/A,1223,1237,N/A,143,4
1,N/A,N/A,N/A,1222,1223,N/A,146,1
2,N/A,N/A,N/A,1433,1435,N/A,6,2
1,N/A,N/A,N/A,1432,1433,N/A,11,1
2,N/A,N/A,N/A,1430,1432,N/A,17,1
8,N/A,N/A,N/A,1422,1430,N/A,20,4
3,N/A,N/A,N/A,1419,1422,N/A,24,2
4,N/A,N/A,N/A,1415,1419,N/A,30,2
16,N/A,N/A,N/A,1399,1415,N/A,33,5
6,N/A,N/A,N/A,1393,1399,N/A,38,4
2,N/A,N/A,N/A,1391,1393,N/A,43,3
2,N/A,N/A,N/A,1389,1391,N/A,49,3
2,N/A,N/A,N/A,1387,1389,N/A,53,1
2,N/A,N/A,N/A,1385,1387,N/A,59,1
1,N/A,N/A,N/A,1384,1385,N/A,65,1
13,N/A,N/A,N/A,1371,1384,N/A,68,4
4,N/A,N/A,N/A,1367,1371,N/A,72,2
16,N/A,N/A,N/A,1351,1367,N/A,75,5
11,N/A,N/A,N/A,1340,1351,N/A,80,4
2,N/A,N/A,N/A,1338,1340,N/A,83,1
13,N/A,N/A,N/A,1325,1338,N/A,88,6
3,N/A,N/A,N/A,1322,1325,N/A,91,3
1,N/A,N/A,N/A,1321,1322,N/A,95,1
7,N/A,N/A,N/A,1314,1321,N/A,98,4
3,N/A,N/A,N/A,1311,1314,N/A,102,2
1,N/A,N/A,N/A,1310,1311,N/A,107,1
1,N/A,N/A,N/A,1309,1310,N/A,113,1
17,N/A,N/A,N/A,1292,1309,N/A,117,5
15,N/A,N/A,N/A,1277,1292,N/A,123,5
5,N/A,N/A,N/A,1272,1277,N/A,128,4
3,N/A,N/A,N/A,1269,1272,N/A,132,2
2,N/A,N/A,N/A,1267,1269,N/A,138,2
4,N/A,N/A,N/A,1763,1767,N/A,3,2
1,N/A,N/A,N/A,1762,1763,N/A,8,1
19,N/A,N/A,N/A,1743,1762,N/A,12,5
4,N/A,N/A,N/A,1739,1743,N/A,15,2
2,N/A,N/A,N/A,1737,1739,N/A,20,1
18,N/A,N/A,N/A,1719,1737,N/A,24,5
2,N/A,N/A,N/A,1717,1719,N/A,28,3
4,N/A,N/A,N/A,1713,1717,N/A,33,2
2,N/A,N/A,N/A,1711,1713,N/A,39,2
19,N/A,N/A,N/A,1692,1711,N/A,43,6
4,N/A,N/A,N/A,1688,1692,N/A,46,3
4,N/A,N/A,N/A,1684,1688,N/A,52,3
15,N/A,N/A,N/A,1669,1684,N/A,55,6
12,N/A,N/A,N/A,1657,1669,N/A,60,5
4,N/A,N/A,N/A,1653,1657,N/A,63,2
1,N/A,N/A,N/A,1652,1653,N/A,68,1
1,N/A,N/A,N/A,1651,1652,N/A,74,1
12,N/A,N/A,N/A,1639,1651,N/A,78,5
18,N/A,N/A,N/A,1621,1639,N/A,84,5
2,N/A,N/A,N/A,1619,1621,N/A,87,2
1,N/A,N/A,N/A,1618,1619,N/A,92,1
8,N/A,N/A,N/A,1610,1618,N/A,95,4
3,N/A,N/A,N/A,1607,1610,N/A,100,3
4,N/A,N/A,N/A,1603,1607,N/A,106,3
17,N/A,N/A,N/A,1586,1603,N/A,109,6
2,N/A,N/A,N/A,1584,1586,N/A,112,3
2,N/A,N/A,N/A,1582,1584,N/A,118,3
4,N/A,N/A,N/A,1578,1582,N/A,124,3
2,N/A,N/A,N/A,1576,1578,N/A,128,1
16,N/A,N/A,N/A,1560,1576,N/A,132,5
2,N/A,N/A,N/A,992,994,N/A,5,1
10,N/A,N/A,N/A,982,992,N/A,9,5
3,N/A,N/A,N/A,979,982,N/A,13,3
16,N/A,N/A,N/A,963,979,N/A,16,6
5,N/A,N/A,N/A,958,963,N/A,20,4
3,N/A,N/A,N/A,955,958,N/A,24,2
17,N/A,N/A,N/A,938,955,N/A,27,5
4,N/A,N/A,N/A,934,938,N/A,31,3
4,N/A,N/A,N/A,930,934,N/A,37,3
2,N/A,N/A,N/A,928,930,N/A,42,2
2,N/A,N/A,N/A,926,928,N/A,47,1
1,N/A,N/A,N/A,925,926,N/A,53,1
1,N/A,N/A,N/A,924,925,N/A,59,1
15,N/A,N/A,N/A,909,924,N/A,64,6
4,N/A,N/A,N/A,905,909,N/A,67,3
2,N/A,N/A,N/A,903,905,N/A,72,2
3,N/A,N/A,N/A,900,903,N/A,78,2
19,N/A,N/A,N/A,881,900,N/A,82,6
18,N/A,N/A,N/A,863,881,N/A,87,5
19,N/A,N/A,N/A,844,863,N/A,93,5
3,N/A,N/A,N/A,841,844,N/A,96,2
1,N/A,N/A,N/A,840,841,N/A,101,1
12,N/A,N/A,N/A,828,840,N/A,105,5
3,N/A,N/A,N/A,825,828,N/A,109,3
1,N/A,N/A,N/A,824,825,N/A,113,1
6,N/A,N/A,N/A,818,824,N/A,116,4
4,N/A,N/A,N/A,814,818,N/A,120,2
2,N/A,N/A,N/A,812,814,N/A,126,2
1,N/A,N/A,N/A,811,812,N/A,131,1
10,N/A,N/A,N/A,801,811,N/A,135,5
3,N/A,N/A,N/A,1969,1972,N/A,6,2
3,N/A,N/A,N/A,1966,1969,N/A,12,2
17,N/A,N/A,N/A,1949,1966,N/A,15,5
3,N/A,N/A,N/A,1946,1949,N/A,18,2
18,N/A,N/A,N/A,1928,1946,N/A,22,6
6,N/A,N/A,N/A,1922,1928,N/A,26,4
3,N/A,N/A,N/A,1919,1922,N/A,30,2
14,N/A,N/A,N/A,1905,1919,N/A,34,6
3,N/A,N/A,N/A,1902,1905,N/A,37,3
3,N/A,N/A,N/A,1899,1902,N/A,43,3
2,N/A,N/A,N/A,1897,1899,N/A,48,2
18,N/A,N/A,N/A,1879,1897,N/A,52,6
16,N/A,N/A,N/A,1863,1879,N/A,57,5
3,N/A,N/A,N/A,1860,1863,N/A,61,3
2,N/A,N/A,N/A,1858,1860,N/A,66,2
3,N/A,N/A,N/A,1855,1858,N/A,72,2
16,N/A,N/A,N/A,1839,1855,N/A,75,5
2,N/A,N/A,N/A,1837,1839,N/A,79,3
1,N/A,N/A,N/A,1836,1837,N/A,83,1
11,N/A,N/A,N/A,1825,1836,N/A,86,4
2,N/A,N/A,N/A,1823,1825,N/A,91,3
3,N/A,N/A,N/A,1820,1823,N/A,97,3
2,N/A,N/A,N/A,1818,1820,N/A,103,3
4,N/A,N/A,N/A,1814,1818,N/A,109,3
1,N/A,N/A,N/A,1813,1814,N/A,113,1
11,N/A,N/A,N/A,1802,1813,N/A,118,6
11,N/A,N/A,N/A,1791,1802,N/A,123,5
2,N/A,N/A,N/A,1789,1791,N/A,126,2
11,N/A,N/A,N/A,1778,1789,N/A,130,6
3,N/A,N/A,N/A,1775,1778,N/A,133,3
15,N/A,N/A,N/A,630,645,N/A,5,5
4,N/A,N/A,N/A,626,630,N/A,9,3
19,N/A,N/A,N/A,607,626,N/A,12,6
3,N/A,N/A,N/A,604,607,N/A,15,3
19,N/A,N/A,N/A,585,604,N/A,18,6
1,N/A,N/A,N/A,584,585,N/A,24,0
6,N/A,N/A,N/A,578,584,N/A,28,4
2,N/A,N/A,N/A,576,578,N/A,31,1
10,N/A,N/A,N/A,566,576,N/A,35,5
4,N/A,N/A,N/A,562,566,N/A,38,2
4,N/A,N/A,N/A,558,562,N/A,44,2
2,N/A,N/A,N/A,556,558,N/A,50,2
17,N/A,N/A,N/A,539,556,N/A,53,5
3,N/A,N/A,N/A,536,539,N/A,57,3
2,N/A,N/A,N/A,534,536,N/A,62,2
10,N/A,N/A,N/A,524,534,N/A,65,5
3,N/A,N/A,N/A,521,524,N/A,68,2
2,N/A,N/A,N/A,519,521,N/A,73,1
13,N/A,N/A,N/A,506,519,N/A,78,6
2,N/A,N/A,N/A,504,506,N/A,81,3
2,N/A,N/A,N/A,502,504,N/A,87,3
1,N/A,N/A,N/A,501,502,N/A,91,1
1,N/A,N/A,N/A,500,501,N/A,97,1
2,N/A,N/A,N/A,498,500,N/A,103,1
2,N/A,N/A,N/A,496,498,N/A,109,1
2,N/A,N/A,N/A,494,496,N/A,115,1
14,N/A,N/A,N/A,480,494,N/A,118,4
10,N/A,N/A,N/A,470,480,N/A,124,4
1,N/A,N/A,N/A,469,470,N/A,127,1
14,N/A,N/A,N/A,455,469,N/A,132,6
2,N/A,N/A,N/A,1392,1394,N/A,4,1
16,N/A,N/A,N/A,1376,1392,N/A,9,6
17,N/A,N/A,N/A,1359,1376,N/A,14,5
3,N/A,N/A,N/A,1356,1359,N/A,17,2
15,N/A,N/A,N/A,1341,1356,N/A,20,5
3,N/A,N/A,N/A,1338,1341,N/A,24,3
2,N/A,N/A,N/A,1336,1338,N/A,28,1
18,N/A,N/A,N/A,1318,1336,N/A,33,6
2,N/A,N/A,N/A,1316,1318,N/A,36,3
3,N/A,N/A,N/A,1313,1316,N/A,41,2
1,N/A,N/A,N/A,1312,1313,N/A,46,1
1,N/A,N/A,N/A,1311,1312,N/A,52,1
12,N/A,N/A,N/A,1299,1311,N/A,57,6
1,N/A,N/A,N/A,1298,1299,N/A,63,0
11,N/A,N/A,N/A,1287,1298,N/A,69,6
4,N/A,N/A,N/A,1283,1287,N/A,72,3
2,N/A,N/A,N/A,1281,1283,N/A,78,3
1,N/A,N/A,N/A,1280,1281,N/A,82,1
15,N/A,N/A,N/A,1265,1280,N/A,87,6
15,N/A,N/A,N/A,1250,1265,N/A,92,5
4,N/A,N/A,N/A,1246,1250,N/A,95,2
1,N/A,N/A,N/A,1245,1246,N/A,100,1
18,N/A,N/A,N/A,1227,1245,N/A,104,5
12,N/A,N/A,N/A,1215,1227,N/A,110,5
18,N/A,N/A,N/A,1197,1215,N/A,116,5
15,N/A,N/A,N/A,1182,1197,N/A,122,5
18,N/A,N/A,N/A,1164,1182,N/A,128,5
4,N/A,N/A,N/A,1160,1164,N/A,131,2
2,N/A,N/A,N/A,1158,1160,N/A,136,1
12,N/A,N/A,N/A,1146,1158,N/A,141,6
17,N/A,N/A,N/A,1709,1726,N/A,4,6
7,N/A,N/A,N/A,1702,1709,N/A,8,4
4,N/A,N/A,N/A,1698,1702,N/A,13,3
4,N/A,N/A,N/A,1694,1698,N/A,18,2
15,N/A,N/A,N/A,1679,1694,N/A,21,5
3,N/A,N/A,N/A,1676,1679,N/A,24,2
14,N/A,N/A,N/A,1662,1676,N/A,27,5
16,N/A,N/A,N/A,1646,1662,N/A,33,5
9,N/A,N/A,N/A,1637,1646,N/A,38,4
2,N/A,N/A,N/A,1635,1637,N/A,43,3
2,N/A,N/A,N/A,1633,1635,N/A,47,1
1,N/A,N/A,N/A,1632,1633,N/A,53,1
16,N/A,N/A,N/A,1616,1632,N/A,57,5
2,N/A,N/A,N/A,1614,1616,N/A,61,3
3,N/A,N/A,N/A,1611,1614,N/A,66,2
4,N/A,N/A,N/A,1607,1611,N/A,72,2
1,N/A,N/A,N/A,1606,1607,N/A,77,1
1,N/A,N/A,N/A,1605,1606,N/A,83,1
19,N/A,N/A,N/A,1586,1605,N/A,87,5
17,N/A,N/A,N/A,1569,1586,N/A,93,5
11,N/A,N/A,N/A,1558,1569,N/A,99,5
4,N/A,N/A,N/A,1554,1558,N/A,102,2
10,N/A,N/A,N/A,1544,1554,N/A,105,5
4,N/A,N/A,N/A,1540,1544,N/A,108,2
3,N/A,N/A,N/A,1537,1540,N/A,114,2
14,N/A,N/A,N/A,1523,1537,N/A,118,6
2,N/A,N/A,N/A,1521,1523,N/A,124,0
17,N/A,N/A,N/A,1504,1521,N/A,129,5
3,N/A,N/A,N/A,1501,1504,N/A,133,3
12,N/A,N/A,N/A,1489,1501,N/A,136,6
11,N/A,N/A,N/A,349,360,N/A,6,5
8,N/A,N/A,N/A,341,349,N/A,11,4
6,N/A,N/A,N/A,335,341,N/A,17,4
1,N/A,N/A,N/A,334,335,N/A,20,1
2,N/A,N/A,N/A,332,334,N/A,26,1
11,N/A,N/A,N/A,321,332,N/A,29,4
8,N/A,N/A,N/A,313,321,N/A,35,4
4,N/A,N/A,N/A,309,313,N/A,40,3
2,N/A,N/A,N/A,307,309,N/A,44,1
18,N/A,N/A,N/A,289,307,N/A,49,6
10,N/A,N/A,N/A,279,289,N/A,54,5
12,N/A,N/A,N/A,267,279,N/A,60,5
4,N/A,N/A,N/A,263,267,N/A,64,3
2,N/A,N/A,N/A,261,263,N/A,68,1
18,N/A,N/A,N/A,243,261,N/A,72,5
2,N/A,N/A,N/A,241,243,N/A,76,3
3,N/A,N/A,N/A,238,241,N/A,82,3
3,N/A,N/A,N/A,235,238,N/A,88,3
2,N/A,N/A,N/A,233,235,N/A,92,1
12,N/A,N/A,N/A,221,233,N/A,95,4
12,N/A,N/A,N/A,209,221,N/A,101,4
1,N/A,N/A,N/A,208,209,N/A,104,1
11,N/A,N/A,N/A,197,208,N/A,108,5
3,N/A,N/A,N/A,194,197,N/A,111,2
1,N/A,N/A,N/A,193,194,N/A,116,1
9,N/A,N/A,N/A,184,193,N/A,119,4
12,N/A,N/A,N/A,172,184,N/A,125,4
2,N/A,N/A,N/A,170,172,N/A,128,1
13,N/A,N/A,N/A,157,170,N/A,131,4
9,N/A,N/A,N/A,148,157,N/A,137,4
4,N/A,N/A,N/A,990,994,N/A,3,2
3,N/A,N/A,N/A,987,990,N/A,9,2
1,N/A,N/A,N/A,986,987,N/A,14,1
16,N/A,N/A,N/A,970,986,N/A,18,5
18,N/A,N/A,N/A,952,970,N/A,24,5
3,N/A,N/A,N/A,949,952,N/A,27,2
14,N/A,N/A,N/A,935,949,N/A,31,6
1,N/A,N/A,N/A,934,935,N/A,37,0
13,N/A,N/A,N/A,921,934,N/A,42,5
4,N/A,N/A,N/A,917,921,N/A,45,2
2,N/A,N/A,N/A,915,917,N/A,50,1
12,N/A,N/A,N/A,903,915,N/A,55,6
8,N/A,N/A,N/A,895,903,N/A,59,4
2,N/A,N/A,N/A,893,895,N/A,64,3
18,N/A,N/A,N/A,875,893,N/A,67,6
2,N/A,N/A,N/A,873,875,N/A,73,0
3,N/A,N/A,N/A,870,873,N/A,76,3
4,N/A,N/A,N/A,866,870,N/A,82,3
4,N/A,N/A,N/A,862,866,N/A,88,3
3,N/A,N/A,N/A,859,862,N/A,93,2
2,N/A,N/A,N/A,857,859,N/A,99,2
4,N/A,N/A,N/A,853,857,N/A,105,2
20,N/A,N/A,N/A,833,853,N/A,109,6
12,N/A,N/A,N/A,821,833,N/A,114,5
4,N/A,N/A,N/A,817,821,N/A,118,3
16,N/A,N/A,N/A,801,817,N/A,121,6
15,N/A,N/A,N/A,786,801,N/A,126,5
16,N/A,N/A,N/A,770,786,N/A,132,5
3,N/A,N/A,N/A,767,770,N/A,136,3
14,N/A,N/A,N/A,753,767,N/A,139,6
5,N/A,N/A,N/A,1532,1537,N/A,6,4
3,N/A,N/A,N/A,1529,1532,N/A,11,3
2,N/A,N/A,N/A,1527,1529,N/A,17,3
2,N/A,N/A,N/A,1525,1527,N/A,23,3
2,N/A,N/A,N/A,1523,1525,N/A,27,1
1,N/A,N/A,N/A,1522,1523,N/A,33,1
16,N/A,N/A,N/A,1506,1522,N/A,37,5
2,N/A,N/A,N/A,1504,1506,N/A,41,3
20,N/A,N/A,N/A,1484,1504,N/A,44,6
3,N/A,N/A,N/A,1481,1484,N/A,47,3
3,N/A,N/A,N/A,1478,1481,N/A,53,3
2,N/A,N/A,N/A,1476,1478,N/A,57,1
1,N/A,N/A,N/A,1475,1476,N/A,63,1
11,N/A,N/A,N/A,1464,1475,N/A,67,5
3,N/A,N/A,N/A,1461,1464,N/A,70,2
3,N/A,N/A,N/A,1458,1461,N/A,76,2
13,N/A,N/A,N/A,1445,1458,N/A,80,6
3,N/A,N/A,N/A,1442,1445,N/A,83,3
14,N/A,N/A,N/A,1428,1442,N/A,86,6
3,N/A,N/A,N/A,1425,1428,N/A,89,3
14,N/A,N/A,N/A,1411,1425,N/A,92,6
12,N/A,N/A,N/A,1399,1411,N/A,97,5
15,N/A,N/A,N/A,1384,1399,N/A,103,5
2,N/A,N/A,N/A,1382,1384,N/A,106,2
2,N/A,N/A,N/A,1380,1382,N/A,111,1
11,N/A,N/A,N/A,1369,1380,N/A,116,6
4,N/A,N/A,N/A,1365,1369,N/A,119,3
1,N/A,N/A,N/A,1364,1365,N/A,123,1
14,N/A,N/A,N/A,1350,1364,N/A,126,4
2,N/A,N/A,N/A,1348,1350,N/A,130,2
6,N/A,N/A,N/A,1881,1887,N/A,4,4
4,N/A,N/A,N/A,1877,1881,N/A,9,3
12,N/A,N/A,N/A,1865,1877,N/A,12,6
12,N/A,N/A,N/A,1853,1865,N/A,16,4
2,N/A,N/A,N/A,1851,1853,N/A,19,1
16,N/A,N/A,N/A,1835,1851,N/A,24,6
2,N/A,N/A,N/A,1833,1835,N/A,30,0
6,N/A,N/A,N/A,1827,1833,N/A,34,4
2,N/A,N/A,N/A,1825,1827,N/A,38,2
17,N/A,N/A,N/A,1808,1825,N/A,41,5
4,N/A,N/A,N/A,1804,1808,N/A,45,3
18,N/A,N/A,N/A,1786,1804,N/A,48,6
13,N/A,N/A,N/A,1773,1786,N/A,53,5
2,N/A,N/A,N/A,1771,1773,N/A,57,3
4,N/A,N/A,N/A,1767,1771,N/A,63,3
1,N/A,N/A,N/A,1766,1767,N/A,67,1
8,N/A,N/A,N/A,1758,1766,N/A,70,4
1,N/A,N/A,N/A,1757,1758,N/A,73,1
15,N/A,N/A,N/A,1742,1757,N/A,78,6
1,N/A,N/A,N/A,1741,1742,N/A,84,0
8,N/A,N/A,N/A,1733,1741,N/A,88,4
4,N/A,N/A,N/A,1729,1733,N/A,93,3
1,N/A,N/A,N/A,1728,1729,N/A,97,1
1,N/A,N/A,N/A,1727,1728,N/A,103,1
7,N/A,N/A,N/A,1720,1727,N/A,106,4
5,N/A,N/A,N/A,1715,1720,N/A,112,4
3,N/A,N/A,N/A,1712,1715,N/A,117,3
3,N/A,N/A,N/A,1709,1712,N/A,122,2
11,N/A,N/A,N/A,1698,1709,N/A,126,6
2,N/A,N/A,N/A,1696,1698,N/A,132,0
4,N/A,N/A,N/A,1444,1448,N/A,6,3
2,N/A,N/A,N/A,1442,1444,N/A,11,2
15,N/A,N/A,N/A,1427,1442,N/A,14,5
4,N/A,N/A,N/A,1423,1427,N/A,18,3
4,N/A,N/A,N/A,1419,1423,N/A,24,3
2,N/A,N/A,N/A,1417,1419,N/A,28,1
18,N/A,N/A,N/A,1399,1417,N/A,32,5
5,N/A,N/A,N/A,1394,1399,N/A,37,4
1,N/A,N/A,N/A,1393,1394,N/A,40,1
10,N/A,N/A,N/A,1383,1393,N/A,44,5
2,N/A,N/A,N/A,1381,1383,N/A,47,2
12,N/A,N/A,N/A,1369,1381,N/A,51,6
12,N/A,N/A,N/A,1357,1369,N/A,56,5
2,N/A,N/A,N/A,1355,1357,N/A,60,3
2,N/A,N/A,N/A,1353,1355,N/A,65,2
11,N/A,N/A,N/A,1342,1353,N/A,68,5
3,N/A,N/A,N/A,1339,1342,N/A,72,3
2,N/A,N/A,N/A,1337,1339,N/A,76,1
11,N/A,N/A,N/A,1326,1337,N/A,79,4
1,N/A,N/A,N/A,1325,1326,N/A,82,1
1,N/A,N/A,N/A,1324,1325,N/A,88,1
1,N/A,N/A,N/A,1323,1324,N/A,94,1
11,N/A,N/A,N/A,1312,1323,N/A,98,5
14,N/A,N/A,N/A,1298,1312,N/A,104,5
3,N/A,N/A,N/A,1295,1298,N/A,107,2
1,N/A,N/A,N/A,1294,1295,N/A,112,1
19,N/A,N/A,N/A,1275,1294,N/A,116,5
2,N/A,N/A,N/A,1273,1275,N/A,120,3
3,N/A,N/A,N/A,1270,1273,N/A,125,2
17,N/A,N/A,N/A,1253,1270,N/A,128,5
2,N/A,N/A,N/A,455,457,N/A,3,1
12,N/A,N/A,N/A,443,455,N/A,7,5
3,N/A,N/A,N/A,440,443,N/A,11,3
2,N/A,N/A,N/A,438,440,N/A,16,2
17,N/A,N/A,N/A,421,438,N/A,20,6
2,N/A,N/A,N/A,419,421,N/A,26,0
4,N/A,N/A,N/A,415,419,N/A,29,3
4,N/A,N/A,N/A,411,415,N/A,34,2
2,N/A,N/A,N/A,409,411,N/A,40,2
10,N/A,N/A,N/A,399,409,N/A,43,5
11,N/A,N/A,N/A,388,399,N/A,49,5
14,N/A,N/A,N/A,374,388,N/A,55,5
3,N/A,N/A,N/A,371,374,N/A,59,3
2,N/A,N/A,N/A,369,371,N/A,63,1
5,N/A,N/A,N/A,364,369,N/A,66,4
2,N/A,N/A,N/A,362,364,N/A,70,2
18,N/A,N/A,N/A,344,362,N/A,74,6
2,N/A,N/A,N/A,342,344,N/A,80,0
14,N/A,N/A,N/A,328,342,N/A,86,6
2,N/A,N/A,N/A,326,328,N/A,89,3
2,N/A,N/A,N/A,324,326,N/A,93,1
11,N/A,N/A,N/A,313,324,N/A,96,4
1,N/A,N/A,N/A,312,313,N/A,99,1
11,N/A,N/A,N/A,301,312,N/A,102,4
3,N/A,N/A,N/A,298,301,N/A,106,2
1,N/A,N/A,N/A,297,298,N/A,111,1
15,N/A,N/A,N/A,282,297,N/A,115,5
12,N/A,N/A,N/A,270,282,N/A,120,4
2,N/A,N/A,N/A,268,270,N/A,124,2
11,N/A,N/A,N/A,257,268,N/A,128,6
16,N/A,N/A,N/A,711,727,N/A,3,6
3,N/A,N/A,N/A,708,711,N/A,6,3
2,N/A,N/A,N/A,706,708,N/A,12,3
1,N/A,N/A,N/A,705,706,N/A,16,1
12,N/A,N/A,N/A,693,705,N/A,19,4
11,N/A,N/A,N/A,682,693,N/A,25,4
4,N/A,N/A,N/A,678,682,N/A,30,3
2,N/A,N/A,N/A,676,678,N/A,35,2
3,N/A,N/A,N/A,673,676,N/A,41,2
19,N/A,N/A,N/A,654,673,N/A,45,6
13,N/A,N/A,N/A,641,654,N/A,49,4
4,N/A,N/A,N/A,637,641,N/A,53,2
15,N/A,N/A,N/A,622,637,N/A,56,5
2,N/A,N/A,N/A,620,622,N/A,59,2
4,N/A,N/A,N/A,616,620,N/A,65,2
16,N/A,N/A,N/A,600,616,N/A,68,5
14,N/A,N/A,N/A,586,600,N/A,73,4
2,N/A,N/A,N/A,584,586,N/A,78,3
4,N/A,N/A,N/A,580,584,N/A,84,3
4,N/A,N/A,N/A,576,580,N/A,89,2
12,N/A,N/A,N/A,564,576,N/A,93,6
13,N/A,N/A,N/A,551,564,N/A,98,5
2,N/A,N/A,N/A,549,551,N/A,102,3
2,N/A,N/A,N/A,547,549,N/A,106,1
14,N/A,N/A,N/A,533,547,N/A,110,5
3,N/A,N/A,N/A,530,533,N/A,113,2
16,N/A,N/A,N/A,514,530,N/A,116,5
18,N/A,N/A,N/A,496,514,N/A,122,5
11,N/A,N/A,N/A,485,496,N/A,127,4
1,N/A,N/A,N/A,484,485,N/A,130,1
18,N/A,N/A,N/A,411,429,N/A,6,5
4,N/A,N/A,N/A,407,411,N/A,9,2
2,N/A,N/A,N/A,405,407,N/A,14,1
13,N/A,N/A,N/A,392,405,N/A,17,4
4,N/A,N/A,N/A,388,392,N/A,22,3
3,N/A,N/A,N/A,385,388,N/A,27,2
2,N/A,N/A,N/A,383,385,N/A,33,2
1,N/A,N/A,N/A,382,383,N/A,38,1
10,N/A,N/A,N/A,372,382,N/A,41,4
2,N/A,N/A,N/A,370,372,N/A,44,1
8,N/A,N/A,N/A,362,370,N/A,47,4
2,N/A,N/A,N/A,360,362,N/A,50,1
18,N/A,N/A,N/A,342,360,N/A,55,6
13,N/A,N/A,N/A,329,342,N/A,59,4
3,N/A,N/A,N/A,326,329,N/A,63,2
10,N/A,N/A,N/A,316,326,N/A,66,5
8,N/A,N/A,N/A,308,316,N/A,71,4
1,N/A,N/A,N/A,307,308,N/A,74,1
9,N/A,N/A,N/A,298,307,N/A,77,4
10,N/A,N/A,N/A,288,298,N/A,83,4
5,N/A,N/A,N/A,283,288,N/A,89,4
2,N/A,N/A,N/A,281,283,N/A,93,2
4,N/A,N/A,N/A,277,281,N/A,99,2
17,N/A,N/A,N/A,260,277,N/A,103,6
11,N/A,N/A,N/A,249,260,N/A,108,5
2,N/A,N/A,N/A,247,249,N/A,111,2
3,N/A,N/A,N/A,244,247,N/A,117,2
3,N/A,N/A,N/A,241,244,N/A,123,2
2,N/A,N/A,N/A,239,241,N/A,128,1
5,N/A,N/A,N/A,234,239,N/A,131,4
2,N/A,N/A,N/A,1018,1020,N/A,5,3
20,N/A,N/A,N/A,998,1018,N/A,8,6
2,N/A,N/A,N/A,996,998,N/A,14,0
6,N/A,N/A,N/A,990,996,N/A,18,4
3,N/A,N/A,N/A,987,990,N/A,22,2
11,N/A,N/A,N/A,976,987,N/A,25,5
10,N/A,N/A,N/A,966,976,N/A,31,5
19,N/A,N/A,N/A,947,966,N/A,37,5
13,N/A,N/A,N/A,934,947,N/A,43,5
3,N/A,N/A,N/A,931,934,N/A,46,2
3,N/A,N/A,N/A,928,931,N/A,52,2
2,N/A,N/A,N/A,926,928,N/A,57,1
12,N/A,N/A,N/A,914,926,N/A,60,4
11,N/A,N/A,N/A,903,914,N/A,66,4
8,N/A,N/A,N/A,895,903,N/A,72,4
4,N/A,N/A,N/A,891,895,N/A,77,3
18,N/A,N/A,N/A,873,891,N/A,80,6
8,N/A,N/A,N/A,865,873,N/A,84,4
9,N/A,N/A,N/A,856,865,N/A,90,4
2,N/A,N/A,N/A,854,856,N/A,93,1
14,N/A,N/A,N/A,840,854,N/A,98,6
2,N/A,N/A,N/A,838,840,N/A,101,3
2,N/A,N/A,N/A,836,838,N/A,105,1
13,N/A,N/A,N/A,823,836,N/A,110,6
3,N/A,N/A,N/A,820,823,N/A,113,3
18,N/A,N/A,N/A,802,820,N/A,116,6
1,N/A,N/A,N/A,801,802,N/A,122,0
13,N/A,N/A,N/A,788,801,N/A,127,5
4,N/A,N/A,N/A,784,788,N/A,130,2
15,N/A,N/A,N/A,769,784,N/A,134,6
2,N/A,N/A,N/A,1160,1162,N/A,6,1
2,N/A,N/A,N/A,1158,1160,N/A,12,1
5,N/A,N/A,N/A,1153,1158,N/A,15,4
4,N/A,N/A,N/A,1149,1153,N/A,20,3
3,N/A,N/A,N/A,1146,1149,N/A,26,3
2,N/A,N/A,N/A,1144,1146,N/A,32,3
1,N/A,N/A,N/A,1143,1144,N/A,36,1
12,N/A,N/A,N/A,1131,1143,N/A,41,6
8,N/A,N/A,N/A,1123,1131,N/A,45,4
2,N/A,N/A,N/A,1121,1123,N/A,50,3
2,N/A,N/A,N/A,1119,1121,N/A,56,3
3,N/A,N/A,N/A,1116,1119,N/A,62,3
4,N/A,N/A,N/A,1112,1116,N/A,68,3
18,N/A,N/A,N/A,1094,1112,N/A,71,6
10,N/A,N/A,N/A,1084,1094,N/A,76,5
10,N/A,N/A,N/A,1074,1084,N/A,82,5
10,N/A,N/A,N/A,1064,1074,N/A,87,4
6,N/A,N/A,N/A,1058,1064,N/A,93,4
7,N/A,N/A,N/A,1051,1058,N/A,99,4
4,N/A,N/A,N/A,1047,1051,N/A,103,2
15,N/A,N/A,N/A,1032,1047,N/A,106,5
18,N/A,N/A,N/A,1014,1032,N/A,112,5
3,N/A,N/A,N/A,1011,1014,N/A,116,3
4,N/A,N/A,N/A,1007,1011,N/A,122,3
19,N/A,N/A,N/A,988,1007,N/A,125,6
19,N/A,N/A,N/A,969,988,N/A,130,5
2,N/A,N/A,N/A,967,969,N/A,133,2
2,N/A,N/A,N/A,965,967,N/A,138,1
18,N/A,N/A,N/A,947,965,N/A,142,5
9,N/A,N/A,N/A,938,947,N/A,147,4
17,N/A,N/A,N/A,1005,1022,N/A,5,6
16,N/A,N/A,N/A,989,1005,N/A,10,5
14,N/A,N/A,N/A,975,989,N/A,16,5
3,N/A,N/A,N/A,972,975,N/A,19,2
14,N/A,N/A,N/A,958,972,N/A,22,5
3,N/A,N/A,N/A,955,958,N/A,25,2
2,N/A,N/A,N/A,953,955,N/A,31,2
2,N/A,N/A,N/A,951,953,N/A,37,2
1,N/A,N/A,N/A,950,951,N/A,42,1
13,N/A,N/A,N/A,937,950,N/A,47,6
13,N/A,N/A,N/A,924,937,N/A,51,4
2,N/A,N/A,N/A,922,924,N/A,56,3
16,N/A,N/A,N/A,906,922,N/A,59,6
3,N/A,N/A,N/A,903,906,N/A,62,3
1,N/A,N/A,N/A,902,903,N/A,66,1
10,N/A,N/A,N/A,892,902,N/A,69,4
4,N/A,N/A,N/A,888,892,N/A,74,3
2,N/A,N/A,N/A,886,888,N/A,80,3
3,N/A,N/A,N/A,883,886,N/A,85,2
12,N/A,N/A,N/A,871,883,N/A,89,6
1,N/A,N/A,N/A,870,871,N/A,95,0
9,N/A,N/A,N/A,861,870,N/A,99,4
4,N/A,N/A,N/A,857,861,N/A,103,2
10,N/A,N/A,N/A,847,857,N/A,106,5
3,N/A,N/A,N/A,844,847,N/A,109,2
1,N/A,N/A,N/A,843,844,N/A,114,1
11,N/A,N/A,N/A,832,843,N/A,117,4
4,N/A,N/A,N/A,828,832,N/A,121,2
1,N/A,N/A,N/A,827,828,N/A,126,1
10,N/A,N/A,N/A,817,827,N/A,129,4
19,N/A,N/A,N/A,1459,1478,N/A,5,6
2,N/A,N/A,N/A,1457,1459,N/A,11,0
4,N/A,N/A,N/A,1453,1457,N/A,14,3
4,N/A,N/A,N/A,1449,1453,N/A,19,2
2,N/A,N/A,N/A,1447,1449,N/A,25,2
14,N/A,N/A,N/A,1433,1447,N/A,29,6
4,N/A,N/A,N/A,1429,1433,N/A,32,3
2,N/A,N/A,N/A,1427,1429,N/A,37,2
2,N/A,N/A,N/A,1425,1427,N/A,42,1
13,N/A,N/A,N/A,1412,1425,N/A,46,5
2,N/A,N/A,N/A,1410,1412,N/A,50,3
3,N/A,N/A,N/A,1407,1410,N/A,56,3
2,N/A,N/A,N/A,1405,1407,N/A,60,1
10,N/A,N/A,N/A,1395,1405,N/A,64,5
2,N/A,N/A,N/A,1393,1395,N/A,68,3
2,N/A,N/A,N/A,1391,1393,N/A,72,1
1,N/A,N/A,N/A,1390,1391,N/A,78,1
1,N/A,N/A,N/A,1389,1390,N/A,84,1
12,N/A,N/A,N/A,1377,1389,N/A,88,5
3,N/A,N/A,N/A,1374,1377,N/A,91,2
4,N/A,N/A,N/A,1370,1374,N/A,97,2
3,N/A,N/A,N/A,1367,1370,N/A,103,2
2,N/A,N/A,N/A,1365,1367,N/A,109,2
17,N/A,N/A,N/A,1348,1365,N/A,112,5
2,N/A,N/A,N/A,1346,1348,N/A,116,3
1,N/A,N/A,N/A,1345,1346,N/A,120,1
18,N/A,N/A,N/A,1327,1345,N/A,124,5
16,N/A,N/A,N/A,1311,1327,N/A,130,5
2,N/A,N/A,N/A,1309,1311,N/A,134,3
2,N/A,N/A,N/A,1307,1309,N/A,138,1
17,N/A,N/A,N/A,785,802,N/A,5,5
13,N/A,N/A,N/A,772,785,N/A,10,4
3,N/A,N/A,N/A,769,772,N/A,14,2
12,N/A,N/A,N/A,757,769,N/A,17,5
4,N/A,N/A,N/A,753,757,N/A,20,2
11,N/A,N/A,N/A,742,753,N/A,23,5
2,N/A,N/A,N/A,740,742,N/A,27,3
2,N/A,N/A,N/A,738,740,N/A,32,2
17,N/A,N/A,N/A,721,738,N/A,36,6
15,N/A,N/A,N/A,706,721,N/A,41,5
4,N/A,N/A,N/A,702,706,N/A,45,3
17,N/A,N/A,N/A,685,702,N/A,48,6
17,N/A,N/A,N/A,668,685,N/A,53,5
6,N/A,N/A,N/A,662,668,N/A,58,4
11,N/A,N/A,N/A,651,662,N/A,64,4
2,N/A,N/A,N/A,649,651,N/A,69,3
2,N/A,N/A,N/A,647,649,N/A,73,1
15,N/A,N/A,N/A,632,647,N/A,78,6
2,N/A,N/A,N/A,630,632,N/A,84,0
16,N/A,N/A,N/A,614,630,N/A,90,6
4,N/A,N/A,N/A,610,614,N/A,93,3
20,N/A,N/A,N/A,590,610,N/A,96,6
4,N/A,N/A,N/A,586,590,N/A,99,3
16,N/A,N/A,N/A,570,586,N/A,102,6
14,N/A,N/A,N/A,556,570,N/A,107,5
3,N/A,N/A,N/A,553,556,N/A,111,3
1,N/A,N/A,N/A,552,553,N/A,115,1
18,N/A,N/A,N/A,534,552,N/A,120,6
2,N/A,N/A,N/A,532,534,N/A,126,0
6,N/A,N/A,N/A,526,532,N/A,130,4
2,N/A,N/A,N/A,1997,1999,N/A,3,2
15,N/A,N/A,N/A,1982,1997,N/A,7,6
7,N/A,N/A,N/A,1975,1982,N/A,11,4
11,N/A,N/A,N/A,1964,1975,N/A,17,4
8,N/A,N/A,N/A,1956,1964,N/A,23,4
11,N/A,N/A,N/A,1945,1956,N/A,29,4
3,N/A,N/A,N/A,1942,1945,N/A,34,3
17,N/A,N/A,N/A,1925,1942,N/A,37,6
4,N/A,N/A,N/A,1921,1925,N/A,40,3
1,N/A,N/A,N/A,1920,1921,N/A,44,1
8,N/A,N/A,N/A,1912,1920,N/A,47,4
2,N/A,N/A,N/A,1910,1912,N/A,52,3
2,N/A,N/A,N/A,1908,1910,N/A,56,1
11,N/A,N/A,N/A,1897,1908,N/A,61,6
13,N/A,N/A,N/A,1884,1897,N/A,65,4
2,N/A,N/A,N/A,1882,1884,N/A,68,1
11,N/A,N/A,N/A,1871,1882,N/A,72,5
12,N/A,N/A,N/A,1859,1871,N/A,77,4
3,N/A,N/A,N/A,1856,1859,N/A,82,3
4,N/A,N/A,N/A,1852,1856,N/A,88,3
4,N/A,N/A,N/A,1848,1852,N/A,94,3
2,N/A,N/A,N/A,1846,1848,N/A,98,1
2,N/A,N/A,N/A,1844,1846,N/A,104,1
2,N/A,N/A,N/A,1842,1844,N/A,110,1
15,N/A,N/A,N/A,1827,1842,N/A,114,5
4,N/A,N/A,N/A,1823,1827,N/A,118,3
2,N/A,N/A,N/A,1821,1823,N/A,123,2
17,N/A,N/A,N/A,1804,1821,N/A,126,5
12,N/A,N/A,N/A,1792,1804,N/A,131,4
14,N/A,N/A,N/A,1778,1792,N/A,137,4
10,N/A,N/A,N/A,804,814,N/A,6,5
2,N/A,N/A,N/A,802,804,N/A,9,2
17,N/A,N/A,N/A,785,802,N/A,12,5
15,N/A,N/A,N/A,770,785,N/A,18,5
2,N/A,N/A,N/A,768,770,N/A,21,2
3,N/A,N/A,N/A,765,768,N/A,27,2
18,N/A,N/A,N/A,747,765,N/A,30,5
2,N/A,N/A,N/A,745,747,N/A,34,3
15,N/A,N/A,N/A,730,745,N/A,37,6
2,N/A,N/A,N/A,728,730,N/A,43,0
14,N/A,N/A,N/A,714,728,N/A,48,5
4,N/A,N/A,N/A,710,714,N/A,52,3
4,N/A,N/A,N/A,706,710,N/A,58,3
2,N/A,N/A,N/A,704,706,N/A,63,2
18,N/A,N/A,N/A,686,704,N/A,66,5
16,N/A,N/A,N/A,670,686,N/A,72,5
3,N/A,N/A,N/A,667,670,N/A,76,3
4,N/A,N/A,N/A,663,667,N/A,81,2
4,N/A,N/A,N/A,659,663,N/A,87,2
1,N/A,N/A,N/A,658,659,N/A,92,1
16,N/A,N/A,N/A,642,658,N/A,97,6
1,N/A,N/A,N/A,641,642,N/A,103,0
3,N/A,N/A,N/A,638,641,N/A,106,3
4,N/A,N/A,N/A,634,638,N/A,111,2
14,N/A,N/A,N/A,620,634,N/A,114,5
14,N/A,N/A,N/A,606,620,N/A,119,4
4,N/A,N/A,N/A,602,606,N/A,123,2
2,N/A,N/A,N/A,600,602,N/A,129,2
1,N/A,N/A,N/A,599,600,N/A,134,1
8,N/A,N/A,N/A,591,599,N/A,137,4
1,N/A,N/A,N/A,1430,1431,N/A,3,1
15,N/A,N/A,N/A,1415,1430,N/A,7,5
3,N/A,N/A,N/A,1412,1415,N/A,11,3
2,N/A,N/A,N/A,1410,1412,N/A,16,2
1,N/A,N/A,N/A,1409,1410,N/A,21,1
14,N/A,N/A,N/A,1395,1409,N/A,25,5
4,N/A,N/A,N/A,1391,1395,N/A,28,2
2,N/A,N/A,N/A,1389,1391,N/A,34,2
2,N/A,N/A,N/A,1387,1389,N/A,39,1
13,N/A,N/A,N/A,1374,1387,N/A,44,6
4,N/A,N/A,N/A,1370,1374,N/A,47,3
2,N/A,N/A,N/A,1368,1370,N/A,52,2
4,N/A,N/A,N/A,1364,1368,N/A,58,2
3,N/A,N/A,N/A,1361,1364,N/A,64,2
2,N/A,N/A,N/A,1359,1361,N/A,69,1
18,N/A,N/A,N/A,1341,1359,N/A,73,5
4,N/A,N/A,N/A,1337,1341,N/A,77,3
20,N/A,N/A,N/A,1317,1337,N/A,80,6
1,N/A,N/A,N/A,1316,1317,N/A,86,0
4,N/A,N/A,N/A,1312,1316,N/A,89,3
1,N/A,N/A,N/A,1311,1312,N/A,93,1
20,N/A,N/A,N/A,1291,1311,N/A,98,6
12,N/A,N/A,N/A,1279,1291,N/A,102,4
2,N/A,N/A,N/A,1277,1279,N/A,107,3
2,N/A,N/A,N/A,1275,1277,N/A,111,1
20,N/A,N/A,N/A,1255,1275,N/A,116,6
6,N/A,N/A,N/A,1249,1255,N/A,120,4
2,N/A,N/A,N/A,1247,1249,N/A,124,2
15,N/A,N/A,N/A,1232,1247,N/A,127,5
12,N/A,N/A,N/A,1220,1232,N/A,132,4
4,N/A,N/A,N/A,1268,1272,N/A,5,2
2,N/A,N/A,N/A,1266,1268,N/A,10,1
11,N/A,N/A,N/A,1255,1266,N/A,14,5
11,N/A,N/A,N/A,1244,1255,N/A,20,5
3,N/A,N/A,N/A,1241,1244,N/A,23,2
2,N/A,N/A,N/A,1239,1241,N/A,29,2
3,N/A,N/A,N/A,1236,1239,N/A,35,2
16,N/A,N/A,N/A,1220,1236,N/A,39,6
14,N/A,N/A,N/A,1206,1220,N/A,43,4
2,N/A,N/A,N/A,1204,1206,N/A,46,1
2,N/A,N/A,N/A,1202,1204,N/A,52,1
16,N/A,N/A,N/A,1186,1202,N/A,56,5
3,N/A,N/A,N/A,1183,1186,N/A,59,2
3,N/A,N/A,N/A,1180,1183,N/A,65,2
2,N/A,N/A,N/A,1178,1180,N/A,70,1
7,N/A,N/A,N/A,1171,1178,N/A,73,4
4,N/A,N/A,N/A,1167,1171,N/A,77,2
3,N/A,N/A,N/A,1164,1167,N/A,83,2
2,N/A,N/A,N/A,1162,1164,N/A,88,1
7,N/A,N/A,N/A,1155,1162,N/A,91,4
3,N/A,N/A,N/A,1152,1155,N/A,96,3
13,N/A,N/A,N/A,1139,1152,N/A,99,6
4,N/A,N/A,N/A,1135,1139,N/A,102,3
4,N/A,N/A,N/A,1131,1135,N/A,107,2
3,N/A,N/A,N/A,1128,1131,N/A,113,2
15,N/A,N/A,N/A,1113,1128,N/A,116,5
4,N/A,N/A,N/A,1109,1113,N/A,119,2
18,N/A,N/A,N/A,1091,1109,N/A,122,5
14,N/A,N/A,N/A,1077,1091,N/A,127,4
2,N/A,N/A,N/A,1075,1077,N/A,131,2
4,N/A,N/A,N/A,1656,1660,N/A,3,3
3,N/A,N/A,N/A,1653,1656,N/A,8,2
12,N/A,N/A,N/A,1641,1653,N/A,12,6
14,N/A,N/A,N/A,1627,1641,N/A,16,4
3,N/A,N/A,N/A,1624,1627,N/A,21,3
18,N/A,N/A,N/A,1606,1624,N/A,24,6
10,N/A,N/A,N/A,1596,1606,N/A,29,5
19,N/A,N/A,N/A,1577,1596,N/A,35,5
4,N/A,N/A,N/A,1573,1577,N/A,39,3
2,N/A,N/A,N/A,1571,1573,N/A,44,2
14,N/A,N/A,N/A,1557,1571,N/A,47,5
3,N/A,N/A,N/A,1554,1557,N/A,51,3
2,N/A,N/A,N/A,1552,1554,N/A,55,1
14,N/A,N/A,N/A,1538,1552,N/A,59,5
2,N/A,N/A,N/A,1536,1538,N/A,63,3
3,N/A,N/A,N/A,1533,1536,N/A,68,2
3,N/A,N/A,N/A,1530,1533,N/A,74,2
15,N/A,N/A,N/A,1515,1530,N/A,77,5
7,N/A,N/A,N/A,1508,1515,N/A,82,4
8,N/A,N/A,N/A,1500,1508,N/A,88,4
4,N/A,N/A,N/A,1496,1500,N/A,92,2
4,N/A,N/A,N/A,1492,1496,N/A,98,2
2,N/A,N/A,N/A,1490,1492,N/A,104,2
16,N/A,N/A,N/A,1474,1490,N/A,107,5
6,N/A,N/A,N/A,1468,1474,N/A,112,4
4,N/A,N/A,N/A,1464,1468,N/A,116,2
2,N/A,N/A,N/A,1462,1464,N/A,121,1
1,N/A,N/A,N/A,1461,1462,N/A,127,1
19,N/A,N/A,N/A,1442,1461,N/A,131,5
18,N/A,N/A,N/A,1424,1442,N/A,137,5
1,N/A,N/A,N/A,1626,1627,N/A,3,1
1,N/A,N/A,N/A,1625,1626,N/A,9,1
2,N/A,N/A,N/A,1623,1625,N/A,15,1
1,N/A,N/A,N/A,1622,1623,N/A,21,1
16,N/A,N/A,N/A,1606,1622,N/A,26,6
4,N/A,N/A,N/A,1602,1606,N/A,29,3
12,N/A,N/A,N/A,1590,1602,N/A,32,6
17,N/A,N/A,N/A,1573,1590,N/A,37,5
3,N/A,N/A,N/A,1570,1573,N/A,40,2
11,N/A,N/A,N/A,1559,1570,N/A,44,6
6,N/A,N/A,N/A,1553,1559,N/A,48,4
14,N/A,N/A,N/A,1539,1553,N/A,54,4
2,N/A,N/A,N/A,1537,1539,N/A,58,2
15,N/A,N/A,N/A,1522,1537,N/A,62,6
4,N/A,N/A,N/A,1518,1522,N/A,65,3
2,N/A,N/A,N/A,1516,1518,N/A,70,2
2,N/A,N/A,N/A,1514,1516,N/A,76,2
2,N/A,N/A,N/A,1512,1514,N/A,81,1
2,N/A,N/A,N/A,1510,1512,N/A,87,1
7,N/A,N/A,N/A,1503,1510,N/A,90,4
3,N/A,N/A,N/A,1500,1503,N/A,94,2
12,N/A,N/A,N/A,1488,1500,N/A,97,5
10,N/A,N/A,N/A,1478,1488,N/A,102,4
2,N/A,N/A,N/A,1476,1478,N/A,107,3
14,N/A,N/A,N/A,1462,1476,N/A,110,6
1,N/A,N/A,N/A,1461,1462,N/A,116,0
19,N/A,N/A,N/A,1442,1461,N/A,122,6
3,N/A,N/A,N/A,1439,1442,N/A,125,3
1,N/A,N/A,N/A,1438,1439,N/A,129,1
12,N/A,N/A,N/A,1426,1438,N/A,132,4
13,N/A,N/A,N/A,1638,1651,N/A,3,4
2,N/A,N/A,N/A,1636,1638,N/A,7,2
15,N/A,N/A,N/A,1621,1636,N/A,10,5
3,N/A,N/A,N/A,1618,1621,N/A,14,3
14,N/A,N/A,N/A,1604,1618,N/A,17,6
4,N/A,N/A,N/A,1600,1604,N/A,20,3
2,N/A,N/A,N/A,1598,1600,N/A,26,3
2,N/A,N/A,N/A,1596,1598,N/A,32,3
14,N/A,N/A,N/A,1582,1596,N/A,35,6
1,N/A,N/A,N/A,1581,1582,N/A,41,0
12,N/A,N/A,N/A,1569,1581,N/A,47,6
2,N/A,N/A,N/A,1567,1569,N/A,53,0
19,N/A,N/A,N/A,1548,1567,N/A,59,6
12,N/A,N/A,N/A,1536,1548,N/A,64,5
3,N/A,N/A,N/A,1533,1536,N/A,68,3
2,N/A,N/A,N/A,1531,1533,N/A,73,2
11,N/A,N/A,N/A,1520,1531,N/A,77,6
4,N/A,N/A,N/A,1516,1520,N/A,80,3
14,N/A,N/A,N/A,1502,1516,N/A,83,6
2,N/A,N/A,N/A,1500,1502,N/A,89,0
11,N/A,N/A,N/A,1489,1500,N/A,93,4
2,N/A,N/A,N/A,1487,1489,N/A,96,1
10,N/A,N/A,N/A,1477,1487,N/A,100,5
2,N/A,N/A,N/A,1475,1477,N/A,104,3
14,N/A,N/A,N/A,1461,1475,N/A,107,6
1,N/A,N/A,N/A,1460,1461,N/A,113,0
12,N/A,N/A,N/A,1448,1460,N/A,118,5
3,N/A,N/A,N/A,1445,1448,N/A,122,3
2,N/A,N/A,N/A,1443,1445,N/A,127,2
13,N/A,N/A,N/A,1430,1443,N/A,131,6
2,N/A,N/A,N/A,932,934,N/A,3,1
2,N/A,N/A,N/A,930,932,N/A,9,1
13,N/A,N/A,N/A,917,930,N/A,13,5
9,N/A,N/A,N/A,908,917,N/A,18,4
3,N/A,N/A,N/A,905,908,N/A,23,3
4,N/A,N/A,N/A,901,905,N/A,28,2
11,N/A,N/A,N/A,890,901,N/A,32,6
19,N/A,N/A,N/A,871,890,N/A,37,5
10,N/A,N/A,N/A,861,871,N/A,43,5
4,N/A,N/A,N/A,857,861,N/A,46,2
18,N/A,N/A,N/A,839,857,N/A,49,5
2,N/A,N/A,N/A,837,839,N/A,52,2
19,N/A,N/A,N/A,818,837,N/A,56,6
4,N/A,N/A,N/A,814,818,N/A,59,3
1,N/A,N/A,N/A,813,814,N/A,63,1
2,N/A,N/A,N/A,811,813,N/A,69,1
8,N/A,N/A,N/A,803,811,N/A,72,4
9,N/A,N/A,N/A,794,803,N/A,78,4
14,N/A,N/A,N/A,780,794,N/A,84,4
10,N/A,N/A,N/A,770,780,N/A,90,4
4,N/A,N/A,N/A,766,770,N/A,94,2
15,N/A,N/A,N/A,751,766,N/A,98,6
6,N/A,N/A,N/A,745,751,N/A,102,4
1,N/A,N/A,N/A,744,745,N/A,105,1
2,N/A,N/A,N/A,742,744,N/A,111,1
2,N/A,N/A,N/A,740,742,N/A,117,1
7,N/A,N/A,N/A,733,740,N/A,120,4
4,N/A,N/A,N/A,729,733,N/A,125,3
4,N/A,N/A,N/A,725,729,N/A,131,3
2,N/A,N/A,N/A,723,725,N/A,136,2
18,N/A,N/A,N/A,947,965,N/A,4,5
2,N/A,N/A,N/A,945,947,N/A,8,3
18,N/A,N/A,N/A,927,945,N/A,11,6
14,N/A,N/A,N/A,913,927,N/A,16,5
4,N/A,N/A,N/A,909,913,N/A,20,3
2,N/A,N/A,N/A,907,909,N/A,24,1
15,N/A,N/A,N/A,892,907,N/A,28,5
4,N/A,N/A,N/A,888,892,N/A,32,3
2,N/A,N/A,N/A,886,888,N/A,38,3
3,N/A,N/A,N/A,883,886,N/A,43,2
1,N/A,N/A,N/A,882,883,N/A,48,1
13,N/A,N/A,N/A,869,882,N/A,53,6
2,N/A,N/A,N/A,867,869,N/A,59,0
16,N/A,N/A,N/A,851,867,N/A,64,5
2,N/A,N/A,N/A,849,851,N/A,68,3
4,N/A,N/A,N/A,845,849,N/A,73,2
2,N/A,N/A,N/A,843,845,N/A,78,1
13,N/A,N/A,N/A,830,843,N/A,81,4
4,N/A,N/A,N/A,826,830,N/A,86,3
1,N/A,N/A,N/A,825,826,N/A,90,1
15,N/A,N/A,N/A,810,825,N/A,95,6
17,N/A,N/A,N/A,793,810,N/A,100,5
17,N/A,N/A,N/A,776,793,N/A,106,5
13,N/A,N/A,N/A,763,776,N/A,111,4
3,N/A,N/A,N/A,760,763,N/A,115,2
1,N/A,N/A,N/A,759,760,N/A,120,1
15,N/A,N/A,N/A,744,759,N/A,124,5
4,N/A,N/A,N/A,740,744,N/A,128,3
4,N/A,N/A,N/A,736,740,N/A,134,3
1,N/A,N/A,N/A,735,736,N/A,138,1
2,N/A,N/A,N/A,1430,1432,N/A,4,3
3,N/A,N/A,N/A,1427,1430,N/A,9,2
15,N/A,N/A,N/A,1412,1427,N/A,13,6
8,N/A,N/A,N/A,1404,1412,N/A,17,4
4,N/A,N/A,N/A,1400,1404,N/A,21,2
2,N/A,N/A,N/A,1398,1400,N/A,27,2
1,N/A,N/A,N/A,1397,1398,N/A,32,1
15,N/A,N/A,N/A,1382,1397,N/A,37,6
1,N/A,N/A,N/A,1381,1382,N/A,43,0
14,N/A,N/A,N/A,1367,1381,N/A,48,5
5,N/A,N/A,N/A,1362,1367,N/A,53,4
2,N/A,N/A,N/A,1360,1362,N/A,56,1
12,N/A,N/A,N/A,1348,1360,N/A,61,6
1,N/A,N/A,N/A,1347,1348,N/A,67,0
11,N/A,N/A,N/A,1336,1347,N/A,71,4
7,N/A,N/A,N/A,1329,1336,N/A,77,4
4,N/A,N/A,N/A,1325,1329,N/A,81,2
2,N/A,N/A,N/A,1323,1325,N/A,86,1
11,N/A,N/A,N/A,1312,1323,N/A,89,4
4,N/A,N/A,N/A,1308,1312,N/A,93,2
14,N/A,N/A,N/A,1294,1308,N/A,97,6
1,N/A,N/A,N/A,1293,1294,N/A,103,0
12,N/A,N/A,N/A,1281,1293,N/A,108,5
4,N/A,N/A,N/A,1277,1281,N/A,112,3
3,N/A,N/A,N/A,1274,1277,N/A,118,3
3,N/A,N/A,N/A,1271,1274,N/A,123,2
10,N/A,N/A,N/A,1261,1271,N/A,126,5
13,N/A,N/A,N/A,1248,1261,N/A,132,5
14,N/A,N/A,N/A,1234,1248,N/A,138,5
12,N/A,N/A,N/A,1222,1234,N/A,144,5
2,N/A,N/A,N/A,831,833,N/A,6,2
2,N/A,N/A,N/A,829,831,N/A,12,2
2,N/A,N/A,N/A,827,829,N/A,18,2
11,N/A,N/A,N/A,816,827,N/A,22,6
2,N/A,N/A,N/A,814,816,N/A,28,0
18,N/A,N/A,N/A,796,814,N/A,34,6
8,N/A,N/A,N/A,788,796,N/A,38,4
1,N/A,N/A,N/A,787,788,N/A,41,1
19,N/A,N/A,N/A,768,787,N/A,45,5
4,N/A,N/A,N/A,764,768,N/A,49,3
3,N/A,N/A,N/A,761,764,N/A,54,2
20,N/A,N/A,N/A,741,761,N/A,58,6
18,N/A,N/A,N/A,723,741,N/A,63,5
4,N/A,N/A,N/A,719,723,N/A,67,3
4,N/A,N/A,N/A,715,719,N/A,72,2
1,N/A,N/A,N/A,714,715,N/A,77,1
7,N/A,N/A,N/A,707,714,N/A,80,4
3,N/A,N/A,N/A,704,707,N/A,84,2
4,N/A,N/A,N/A,700,704,N/A,90,2
2,N/A,N/A,N/A,698,700,N/A,95,1
9,N/A,N/A,N/A,689,698,N/A,98,4
1,N/A,N/A,N/A,688,689,N/A,101,1
2,N/A,N/A,N/A,686,688,N/A,107,1
2,N/A,N/A,N/A,684,686,N/A,113,1
11,N/A,N/A,N/A,673,684,N/A,118,6
2,N/A,N/A,N/A,671,673,N/A,124,0
2,N/A,N/A,N/A,669,671,N/A,127,3
16,N/A,N/A,N/A,653,669,N/A,130,6
11,N/A,N/A,N/A,642,653,N/A,134,4
12,N/A,N/A,N/A,630,642,N/A,140,4
4,N/A,N/A,N/A,1779,1783,N/A,6,3
3,N/A,N/A,N/A,1776,1779,N/A,12,3
20,N/A,N/A,N/A,1756,1776,N/A,15,6
4,N/A,N/A,N/A,1752,1756,N/A,18,3
3,N/A,N/A,N/A,1749,1752,N/A,24,3
2,N/A,N/A,N/A,1747,1749,N/A,30,3
4,N/A,N/A,N/A,1743,1747,N/A,35,2
2,N/A,N/A,N/A,1741,1743,N/A,41,2
1,N/A,N/A,N/A,1740,1741,N/A,46,1
11,N/A,N/A,N/A,1729,1740,N/A,51,6
2,N/A,N/A,N/A,1727,1729,N/A,57,0
2,N/A,N/A,N/A,1725,1727,N/A,60,3
3,N/A,N/A,N/A,1722,1725,N/A,66,3
2,N/A,N/A,N/A,1720,1722,N/A,71,2
2,N/A,N/A,N/A,1718,1720,N/A,76,1
1,N/A,N/A,N/A,1717,1718,N/A,82,1
2,N/A,N/A,N/A,1715,1717,N/A,88,1
19,N/A,N/A,N/A,1696,1715,N/A,92,5
6,N/A,N/A,N/A,1690,1696,N/A,97,4
7,N/A,N/A,N/A,1683,1690,N/A,103,4
10,N/A,N/A,N/A,1673,1683,N/A,109,4
4,N/A,N/A,N/A,1669,1673,N/A,113,2
20,N/A,N/A,N/A,1649,1669,N/A,117,6
2,N/A,N/A,N/A,1647,1649,N/A,120,3
4,N/A,N/A,N/A,1643,1647,N/A,126,3
18,N/A,N/A,N/A,1625,1643,N/A,129,6
3,N/A,N/A,N/A,1622,1625,N/A,132,3
2,N/A,N/A,N/A,1620,1622,N/A,137,2
3,N/A,N/A,N/A,1617,1620,N/A,143,2
3,N/A,N/A,N/A,1614,1617,N/A,149,2
7,N/A,N/A,N/A,1680,1687,N/A,3,4
7,N/A,N/A,N/A,1673,1680,N/A,9,4
2,N/A,N/A,N/A,1671,1673,N/A,13,2
4,N/A,N/A,N/A,1667,1671,N/A,19,2
12,N/A,N/A,N/A,1655,1667,N/A,23,6
4,N/A,N/A,N/A,1651,1655,N/A,26,3
4,N/A,N/A,N/A,1647,1651,N/A,31,2
4,N/A,N/A,N/A,1643,1647,N/A,37,2
2,N/A,N/A,N/A,1641,1643,N/A,43,2
4,N/A,N/A,N/A,1637,1641,N/A,49,2
18,N/A,N/A,N/A,1619,1637,N/A,52,5
3,N/A,N/A,N/A,1616,1619,N/A,55,2
1,N/A,N/A,N/A,1615,1616,N/A,60,1
5,N/A,N/A,N/A,1610,1615,N/A,63,4
4,N/A,N/A,N/A,1606,1610,N/A,68,3
13,N/A,N/A,N/A,1593,1606,N/A,71,6
15,N/A,N/A,N/A,1578,1593,N/A,76,5
4,N/A,N/A,N/A,1574,1578,N/A,79,2
2,N/A,N/A,N/A,1572,1574,N/A,84,1
11,N/A,N/A,N/A,1561,1572,N/A,89,6
9,N/A,N/A,N/A,1552,1561,N/A,93,4
8,N/A,N/A,N/A,1544,1552,N/A,99,4
14,N/A,N/A,N/A,1530,1544,N/A,105,4
4,N/A,N/A,N/A,1526,1530,N/A,110,3
2,N/A,N/A,N/A,1524,1526,N/A,115,2
16,N/A,N/A,N/A,1508,1524,N/A,119,6
13,N/A,N/A,N/A,1495,1508,N/A,123,4
2,N/A,N/A,N/A,1493,1495,N/A,126,1
18,N/A,N/A,N/A,1475,1493,N/A,131,6
6,N/A,N/A,N/A,1469,1475,N/A,135,4
6,N/A,N/A,N/A,376,382,N/A,3,4
1,N/A,N/A,N/A,375,376,N/A,6,1
13,N/A,N/A,N/A,362,375,N/A,10,5
6,N/A,N/A,N/A,356,362,N/A,15,4
2,N/A,N/A,N/A,354,356,N/A,18,1
12,N/A,N/A,N/A,342,354,N/A,22,5
10,N/A,N/A,N/A,332,342,N/A,28,5
3,N/A,N/A,N/A,329,332,N/A,32,3
2,N/A,N/A,N/A,327,329,N/A,38,3
11,N/A,N/A,N/A,316,327,N/A,41,6
19,N/A,N/A,N/A,297,316,N/A,46,5
4,N/A,N/A,N/A,293,297,N/A,49,2
2,N/A,N/A,N/A,291,293,N/A,54,1
12,N/A,N/A,N/A,279,291,N/A,57,4
14,N/A,N/A,N/A,265,279,N/A,63,4
2,N/A,N/A,N/A,263,265,N/A,67,2
4,N/A,N/A,N/A,259,263,N/A,73,2
2,N/A,N/A,N/A,257,259,N/A,79,2
2,N/A,N/A,N/A,255,257,N/A,85,2
15,N/A,N/A,N/A,240,255,N/A,88,5
2,N/A,N/A,N/A,238,240,N/A,91,2
15,N/A,N/A,N/A,223,238,N/A,94,5
3,N/A,N/A,N/A,220,223,N/A,97,2
13,N/A,N/A,N/A,207,220,N/A,100,5
4,N/A,N/A,N/A,203,207,N/A,104,3
3,N/A,N/A,N/A,200,203,N/A,109,2
4,N/A,N/A,N/A,196,200,N/A,115,2
1,N/A,N/A,N/A,195,196,N/A,120,1
13,N/A,N/A,N/A,182,195,N/A,123,4
2,N/A,N/A,N/A,180,182,N/A,128,3
18,N/A,N/A,N/A,562,580,N/A,5,5
4,N/A,N/A,N/A,558,562,N/A,9,3
3,N/A,N/A,N/A,555,558,N/A,15,3
2,N/A,N/A,N/A,553,555,N/A,19,1
18,N/A,N/A,N/A,535,553,N/A,24,6
10,N/A,N/A,N/A,525,535,N/A,29,5
2,N/A,N/A,N/A,523,525,N/A,32,2
13,N/A,N/A,N/A,510,523,N/A,35,5
3,N/A,N/A,N/A,507,510,N/A,39,3
1,N/A,N/A,N/A,506,507,N/A,43,1
17,N/A,N/A,N/A,489,506,N/A,48,6
2,N/A,N/A,N/A,487,489,N/A,54,0
2,N/A,N/A,N/A,485,487,N/A,57,3
15,N/A,N/A,N/A,470,485,N/A,60,6
14,N/A,N/A,N/A,456,470,N/A,64,4
2,N/A,N/A,N/A,454,456,N/A,69,3
13,N/A,N/A,N/A,441,454,N/A,72,6
17,N/A,N/A,N/A,424,441,N/A,77,5
3,N/A,N/A,N/A,421,424,N/A,81,3
3,N/A,N/A,N/A,418,421,N/A,87,3
19,N/A,N/A,N/A,399,418,N/A,90,6
16,N/A,N/A,N/A,383,399,N/A,95,5
2,N/A,N/A,N/A,381,383,N/A,99,3
2,N/A,N/A,N/A,379,381,N/A,104,2
4,N/A,N/A,N/A,375,379,N/A,110,2
3,N/A,N/A,N/A,372,375,N/A,116,2
2,N/A,N/A,N/A,370,372,N/A,121,1
15,N/A,N/A,N/A,355,370,N/A,126,6
1,N/A,N/A,N/A,354,355,N/A,132,0
14,N/A,N/A,N/A,340,354,N/A,138,6
18,N/A,N/A,N/A,1611,1629,N/A,3,5
11,N/A,N/A,N/A,1600,1611,N/A,8,4
4,N/A,N/A,N/A,1596,1600,N/A,12,2
2,N/A,N/A,N/A,1594,1596,N/A,17,1
15,N/A,N/A,N/A,1579,1594,N/A,22,6
2,N/A,N/A,N/A,1577,1579,N/A,25,3
16,N/A,N/A,N/A,1561,1577,N/A,28,6
15,N/A,N/A,N/A,1546,1561,N/A,33,5
3,N/A,N/A,N/A,1543,1546,N/A,36,2
4,N/A,N/A,N/A,1539,1543,N/A,42,2
17,N/A,N/A,N/A,1522,1539,N/A,46,6
1,N/A,N/A,N/A,1521,1522,N/A,52,0
11,N/A,N/A,N/A,1510,1521,N/A,56,4
2,N/A,N/A,N/A,1508,1510,N/A,59,1
12,N/A,N/A,N/A,1496,1508,N/A,62,4
2,N/A,N/A,N/A,1494,1496,N/A,67,3
3,N/A,N/A,N/A,1491,1494,N/A,73,3
13,N/A,N/A,N/A,1478,1491,N/A,76,6
7,N/A,N/A,N/A,1471,1478,N/A,80,4
3,N/A,N/A,N/A,1468,1471,N/A,84,2
1,N/A,N/A,N/A,1467,1468,N/A,89,1
2,N/A,N/A,N/A,1465,1467,N/A,95,1
1,N/A,N/A,N/A,1464,1465,N/A,101,1
2,N/A,N/A,N/A,1462,1464,N/A,107,1
2,N/A,N/A,N/A,1460,1462,N/A,113,1
7,N/A,N/A,N/A,1453,1460,N/A,116,4
2,N/A,N/A,N/A,1451,1453,N/A,121,3
4,N/A,N/A,N/A,1447,1451,N/A,126,2
2,N/A,N/A,N/A,1445,1447,N/A,132,2
2,N/A,N/A,N/A,1443,1445,N/A,137,1
6,N/A,N/A,N/A,1356,1362,N/A,3,4
1,N/A,N/A,N/A,1355,1356,N/A,6,1
13,N/A,N/A,N/A,1342,1355,N/A,9,4
1,N/A,N/A,N/A,1341,1342,N/A,12,1
15,N/A,N/A,N/A,1326,1341,N/A,17,6
1,N/A,N/A,N/A,1325,1326,N/A,23,0
17,N/A,N/A,N/A,1308,1325,N/A,29,6
7,N/A,N/A,N/A,1301,1308,N/A,33,4
4,N/A,N/A,N/A,1297,1301,N/A,37,2
1,N/A,N/A,N/A,1296,1297,N/A,42,1
13,N/A,N/A,N/A,1283,1296,N/A,45,4
4,N/A,N/A,N/A,1279,1283,N/A,50,3
2,N/A,N/A,N/A,1277,1279,N/A,54,1
12,N/A,N/A,N/A,1265,1277,N/A,58,5
2,N/A,N/A,N/A,1263,1265,N/A,61,2
3,N/A,N/A,N/A,1260,1263,N/A,67,2
1,N/A,N/A,N/A,1259,1260,N/A,72,1
17,N/A,N/A,N/A,1242,1259,N/A,77,6
7,N/A,N/A,N/A,1235,1242,N/A,81,4
12,N/A,N/A,N/A,1223,1235,N/A,87,4
2,N/A,N/A,N/A,1221,1223,N/A,92,3
16,N/A,N/A,N/A,1205,1221,N/A,95,6
2,N/A,N/A,N/A,1203,1205,N/A,101,0
19,N/A,N/A,N/A,1184,1203,N/A,107,6
14,N/A,N/A,N/A,1170,1184,N/A,111,4
2,N/A,N/A,N/A,1168,1170,N/A,116,3
3,N/A,N/A,N/A,1165,1168,N/A,122,3
15,N/A,N/A,N/A,1150,1165,N/A,125,6
12,N/A,N/A,N/A,1138,1150,N/A,130,5
3,N/A,N/A,N/A,1135,1138,N/A,134,3
4,N/A,N/A,N/A,773,777,N/A,6,3
17,N/A,N/A,N/A,756,773,N/A,9,6
2,N/A,N/A,N/A,754,756,N/A,15,0
19,N/A,N/A,N/A,735,754,N/A,20,5
4,N/A,N/A,N/A,731,735,N/A,23,2
3,N/A,N/A,N/A,728,731,N/A,29,2
12,N/A,N/A,N/A,716,728,N/A,32,5
2,N/A,N/A,N/A,714,716,N/A,35,2
18,N/A,N/A,N/A,696,714,N/A,38,5
2,N/A,N/A,N/A,694,696,N/A,41,2
1,N/A,N/A,N/A,693,694,N/A,46,1
8,N/A,N/A,N/A,685,693,N/A,49,4
5,N/A,N/A,N/A,680,685,N/A,55,4
6,N/A,N/A,N/A,674,680,N/A,61,4
3,N/A,N/A,N/A,671,674,N/A,66,3
2,N/A,N/A,N/A,669,671,N/A,70,1
12,N/A,N/A,N/A,657,669,N/A,75,6
9,N/A,N/A,N/A,648,657,N/A,79,4
4,N/A,N/A,N/A,644,648,N/A,83,2
2,N/A,N/A,N/A,642,644,N/A,88,1
18,N/A,N/A,N/A,624,642,N/A,92,5
2,N/A,N/A,N/A,622,624,N/A,96,3
2,N/A,N/A,N/A,620,622,N/A,100,1
13,N/A,N/A,N/A,607,620,N/A,104,5
14,N/A,N/A,N/A,593,607,N/A,109,4
4,N/A,N/A,N/A,589,593,N/A,114,3
2,N/A,N/A,N/A,587,589,N/A,120,3
2,N/A,N/A,N/A,585,587,N/A,124,1
9,N/A,N/A,N/A,576,585,N/A,127,4
3,N/A,N/A,N/A,573,576,N/A,131,2
11,N/A,N/A,N/A,1080,1091,N/A,6,6
5,N/A,N/A,N/A,1075,1080,N/A,10,4
2,N/A,N/A,N/A,1073,1075,N/A,14,2
1,N/A,N/A,N/A,1072,1073,N/A,19,1
11,N/A,N/A,N/A,1061,1072,N/A,24,6
1,N/A,N/A,N/A,1060,1061,N/A,30,0
3,N/A,N/A,N/A,1057,1060,N/A,33,3
14,N/A,N/A,N/A,1043,1057,N/A,36,6
10,N/A,N/A,N/A,1033,1043,N/A,40,4
8,N/A,N/A,N/A,1025,1033,N/A,46,4
6,N/A,N/A,N/A,1019,1025,N/A,52,4
2,N/A,N/A,N/A,1017,1019,N/A,55,1
11,N/A,N/A,N/A,1006,1017,N/A,58,4
2,N/A,N/A,N/A,1004,1006,N/A,61,1
2,N/A,N/A,N/A,1002,1004,N/A,67,1
20,N/A,N/A,N/A,982,1002,N/A,72,6
10,N/A,N/A,N/A,972,982,N/A,76,4
2,N/A,N/A,N/A,970,972,N/A,81,3
2,N/A,N/A,N/A,968,970,N/A,85,1
20,N/A,N/A,N/A,948,968,N/A,90,6
11,N/A,N/A,N/A,937,948,N/A,94,4
2,N/A,N/A,N/A,935,937,N/A,97,1
11,N/A,N/A,N/A,924,935,N/A,101,5
2,N/A,N/A,N/A,922,924,N/A,105,3
12,N/A,N/A,N/A,910,922,N/A,108,6
1,N/A,N/A,N/A,909,910,N/A,114,0
18,N/A,N/A,N/A,891,909,N/A,120,6
13,N/A,N/A,N/A,878,891,N/A,124,4
6,N/A,N/A,N/A,872,878,N/A,130,4
4,N/A,N/A,N/A,868,872,N/A,134,2
17,N/A,N/A,N/A,1472,1489,N/A,4,5
3,N/A,N/A,N/A,1469,1472,N/A,7,2
2,N/A,N/A,N/A,1467,1469,N/A,12,1
11,N/A,N/A,N/A,1456,1467,N/A,17,6
14,N/A,N/A,N/A,1442,1456,N/A,22,5
19,N/A,N/A,N/A,1423,1442,N/A,28,5
10,N/A,N/A,N/A,1413,1423,N/A,34,5
8,N/A,N/A,N/A,1405,1413,N/A,39,4
1,N/A,N/A,N/A,1404,1405,N/A,42,1
11,N/A,N/A,N/A,1393,1404,N/A,47,6
4,N/A,N/A,N/A,1389,1393,N/A,50,3
2,N/A,N/A,N/A,1387,1389,N/A,56,3
20,N/A,N/A,N/A,1367,1387,N/A,59,6
15,N/A,N/A,N/A,1352,1367,N/A,64,5
2,N/A,N/A,N/A,1350,1352,N/A,67,2
18,N/A,N/A,N/A,1332,1350,N/A,70,5
3,N/A,N/A,N/A,1329,1332,N/A,73,2
2,N/A,N/A,N/A,1327,1329,N/A,78,1
15,N/A,N/A,N/A,1312,1327,N/A,82,5
4,N/A,N/A,N/A,1308,1312,N/A,85,2
15,N/A,N/A,N/A,1293,1308,N/A,88,5
7,N/A,N/A,N/A,1286,1293,N/A,93,4
8,N/A,N/A,N/A,1278,1286,N/A,99,4
4,N/A,N/A,N/A,1274,1278,N/A,104,3
1,N/A,N/A,N/A,1273,1274,N/A,108,1
13,N/A,N/A,N/A,1260,1273,N/A,113,6
9,N/A,N/A,N/A,1251,1260,N/A,117,4
5,N/A,N/A,N/A,1246,1251,N/A,123,4
8,N/A,N/A,N/A,1238,1246,N/A,129,4
3,N/A,N/A,N/A,1235,1238,N/A,134,3
13,N/A,N/A,N/A,1341,1354,N/A,4,5
10,N/A,N/A,N/A,1331,1341,N/A,9,4
3,N/A,N/A,N/A,1328,1331,N/A,14,3
2,N/A,N/A,N/A,1326,1328,N/A,18,1
11,N/A,N/A,N/A,1315,1326,N/A,23,6
14,N/A,N/A,N/A,1301,1315,N/A,27,4
4,N/A,N/A,N/A,1297,1301,N/A,32,3
2,N/A,N/A,N/A,1295,1297,N/A,38,3
4,N/A,N/A,N/A,1291,1295,N/A,43,2
15,N/A,N/A,N/A,1276,1291,N/A,46,5
3,N/A,N/A,N/A,1273,1276,N/A,49,2
2,N/A,N/A,N/A,1271,1273,N/A,54,1
12,N/A,N/A,N/A,1259,1271,N/A,59,6
3,N/A,N/A,N/A,1256,1259,N/A,62,3
3,N/A,N/A,N/A,1253,1256,N/A,67,2
13,N/A,N/A,N/A,1240,1253,N/A,71,6
8,N/A,N/A,N/A,1232,1240,N/A,75,4
10,N/A,N/A,N/A,1222,1232,N/A,81,4
2,N/A,N/A,N/A,1220,1222,N/A,85,2
16,N/A,N/A,N/A,1204,1220,N/A,89,6
13,N/A,N/A,N/A,1191,1204,N/A,93,4
4,N/A,N/A,N/A,1187,1191,N/A,97,2
2,N/A,N/A,N/A,1185,1187,N/A,103,2
2,N/A,N/A,N/A,1183,1185,N/A,109,2
3,N/A,N/A,N/A,1180,1183,N/A,115,2
2,N/A,N/A,N/A,1178,1180,N/A,121,2
12,N/A,N/A,N/A,1166,1178,N/A,125,6
2,N/A,N/A,N/A,1164,1166,N/A,131,0
9,N/A,N/A,N/A,1155,1164,N/A,135,4
4,N/A,N/A,N/A,1151,1155,N/A,140,3
2,N/A,N/A,N/A,1655,1657,N/A,3,1
1,N/A,N/A,N/A,1654,1655,N/A,9,1
19,N/A,N/A,N/A,1635,1654,N/A,13,5
2,N/A,N/A,N/A,1633,1635,N/A,16,2
13,N/A,N/A,N/A,1620,1633,N/A,20,6
13,N/A,N/A,N/A,1607,1620,N/A,25,5
13,N/A,N/A,N/A,1594,1607,N/A,31,5
13,N/A,N/A,N/A,1581,1594,N/A,36,4
4,N/A,N/A,N/A,1577,1581,N/A,40,2
2,N/A,N/A,N/A,1575,1577,N/A,45,1
18,N/A,N/A,N/A,1557,1575,N/A,49,5
6,N/A,N/A,N/A,1551,1557,N/A,54,4
1,N/A,N/A,N/A,1550,1551,N/A,57,1
10,N/A,N/A,N/A,1540,1550,N/A,60,4
4,N/A,N/A,N/A,1536,1540,N/A,64,2
2,N/A,N/A,N/A,1534,1536,N/A,69,1
10,N/A,N/A,N/A,1524,1534,N/A,72,4
2,N/A,N/A,N/A,1522,1524,N/A,76,2
3,N/A,N/A,N/A,1519,1522,N/A,82,2
17,N/A,N/A,N/A,1502,1519,N/A,85,5
2,N/A,N/A,N/A,1500,1502,N/A,89,3
1,N/A,N/A,N/A,1499,1500,N/A,93,1
5,N/A,N/A,N/A,1494,1499,N/A,96,4
4,N/A,N/A,N/A,1490,1494,N/A,100,2
17,N/A,N/A,N/A,1473,1490,N/A,103,5
18,N/A,N/A,N/A,1455,1473,N/A,109,5
11,N/A,N/A,N/A,1444,1455,N/A,115,5
11,N/A,N/A,N/A,1433,1444,N/A,121,5
3,N/A,N/A,N/A,1430,1433,N/A,124,2
18,N/A,N/A,N/A,1412,1430,N/A,127,5
11,N/A,N/A,N/A,1266,1277,N/A,4,5
12,N/A,N/A,N/A,1254,1266,N/A,9,4
10,N/A,N/A,N/A,1244,1254,N/A,15,4
7,N/A,N/A,N/A,1237,1244,N/A,21,4
2,N/A,N/A,N/A,1235,1237,N/A,25,2
3,N/A,N/A,N/A,1232,1235,N/A,31,2
20,N/A,N/A,N/A,1212,1232,N/A,35,6
2,N/A,N/A,N/A,1210,1212,N/A,41,0
15,N/A,N/A,N/A,1195,1210,N/A,47,6
6,N/A,N/A,N/A,1189,1195,N/A,51,4
2,N/A,N/A,N/A,1187,1189,N/A,55,2
4,N/A,N/A,N/A,1183,1187,N/A,61,2
2,N/A,N/A,N/A,1181,1183,N/A,66,1
16,N/A,N/A,N/A,1165,1181,N/A,70,5
15,N/A,N/A,N/A,1150,1165,N/A,76,5
7,N/A,N/A,N/A,1143,1150,N/A,81,4
2,N/A,N/A,N/A,1141,1143,N/A,86,3
1,N/A,N/A,N/A,1140,1141,N/A,90,1
5,N/A,N/A,N/A,1135,1140,N/A,93,4
13,N/A,N/A,N/A,1122,1135,N/A,99,4
2,N/A,N/A,N/A,1120,1122,N/A,103,2
2,N/A,N/A,N/A,1118,1120,N/A,108,1
12,N/A,N/A,N/A,1106,1118,N/A,113,6
11,N/A,N/A,N/A,1095,1106,N/A,118,5
13,N/A,N/A,N/A,1082,1095,N/A,124,5
13,N/A,N/A,N/A,1069,1082,N/A,130,5
4,N/A,N/A,N/A,1065,1069,N/A,133,2
15,N/A,N/A,N/A,1050,1065,N/A,136,5
16,N/A,N/A,N/A,1034,1050,N/A,142,5
3,N/A,N/A,N/A,1031,1034,N/A,145,2
4,N/A,N/A,N/A,1400,1404,N/A,6,3
4,N/A,N/A,N/A,1396,1400,N/A,11,2
4,N/A,N/A,N/A,1392,1396,N/A,17,2
17,N/A,N/A,N/A,1375,1392,N/A,21,6
12,N/A,N/A,N/A,1363,1375,N/A,25,4
3,N/A,N/A,N/A,1360,1363,N/A,30,3
1,N/A,N/A,N/A,1359,1360,N/A,34,1
14,N/A,N/A,N/A,1345,1359,N/A,38,5
15,N/A,N/A,N/A,1330,1345,N/A,44,5
18,N/A,N/A,N/A,1312,1330,N/A,50,5
3,N/A,N/A,N/A,1309,1312,N/A,53,2
1,N/A,N/A,N/A,1308,1309,N/A,58,1
2,N/A,N/A,N/A,1306,1308,N/A,64,1
11,N/A,N/A,N/A,1295,1306,N/A,69,6
1,N/A,N/A,N/A,1294,1295,N/A,75,0
20,N/A,N/A,N/A,1274,1294,N/A,81,6
14,N/A,N/A,N/A,1260,1274,N/A,85,4
3,N/A,N/A,N/A,1257,1260,N/A,90,3
3,N/A,N/A,N/A,1254,1257,N/A,95,2
3,N/A,N/A,N/A,1251,1254,N/A,101,2
3,N/A,N/A,N/A,1248,1251,N/A,107,2
1,N/A,N/A,N/A,1247,1248,N/A,112,1
2,N/A,N/A,N/A,1245,1247,N/A,118,1
6,N/A,N/A,N/A,1239,1245,N/A,121,4
4,N/A,N/A,N/A,1235,1239,N/A,126,3
3,N/A,N/A,N/A,1232,1235,N/A,132,3
17,N/A,N/A,N/A,1215,1232,N/A,135,6
5,N/A,N/A,N/A,1210,1215,N/A,139,4
6,N/A,N/A,N/A,1204,1210,N/A,145,4
4,N/A,N/A,N/A,1200,1204,N/A,149,2
2,N/A,N/A,N/A,736,738,N/A,4,1
6,N/A,N/A,N/A,730,736,N/A,7,4
3,N/A,N/A,N/A,727,730,N/A,12,3
1,N/A,N/A,N/A,726,727,N/A,16,1
1,N/A,N/A,N/A,725,726,N/A,22,1
12,N/A,N/A,N/A,713,725,N/A,26,5
9,N/A,N/A,N/A,704,713,N/A,31,4
1,N/A,N/A,N/A,703,704,N/A,34,1
12,N/A,N/A,N/A,691,703,N/A,37,4
3,N/A,N/A,N/A,688,691,N/A,42,3
4,N/A,N/A,N/A,684,688,N/A,48,3
2,N/A,N/A,N/A,682,684,N/A,53,2
17,N/A,N/A,N/A,665,682,N/A,56,5
3,N/A,N/A,N/A,662,665,N/A,59,2
4,N/A,N/A,N/A,658,662,N/A,65,2
2,N/A,N/A,N/A,656,658,N/A,71,2
2,N/A,N/A,N/A,654,656,N/A,76,1
13,N/A,N/A,N/A,641,654,N/A,80,5
2,N/A,N/A,N/A,639,641,N/A,83,2
1,N/A,N/A,N/A,638,639,N/A,88,1
19,N/A,N/A,N/A,619,638,N/A,92,5
2,N/A,N/A,N/A,617,619,N/A,96,3
4,N/A,N/A,N/A,613,617,N/A,101,2
1,N/A,N/A,N/A,612,613,N/A,106,1
13,N/A,N/A,N/A,599,612,N/A,111,6
10,N/A,N/A,N/A,589,599,N/A,115,4
3,N/A,N/A,N/A,586,589,N/A,119,2
17,N/A,N/A,N/A,569,586,N/A,122,5
8,N/A,N/A,N/A,561,569,N/A,127,4
9,N/A,N/A,N/A,552,561,N/A,133,4
4,N/A,N/A,N/A,1523,1527,N/A,6,2
2,N/A,N/A,N/A,1521,1523,N/A,11,1
11,N/A,N/A,N/A,1510,1521,N/A,15,5
10,N/A,N/A,N/A,1500,1510,N/A,20,4
11,N/A,N/A,N/A,1489,1500,N/A,26,4
2,N/A,N/A,N/A,1487,1489,N/A,30,2
15,N/A,N/A,N/A,1472,1487,N/A,34,6
1,N/A,N/A,N/A,1471,1472,N/A,40,0
8,N/A,N/A,N/A,1463,1471,N/A,44,4
2,N/A,N/A,N/A,1461,1463,N/A,47,1
16,N/A,N/A,N/A,1445,1461,N/A,51,5
14,N/A,N/A,N/A,1431,1445,N/A,56,4
4,N/A,N/A,N/A,1427,1431,N/A,61,3
1,N/A,N/A,N/A,1426,1427,N/A,65,1
18,N/A,N/A,N/A,1408,1426,N/A,69,5
2,N/A,N/A,N/A,1406,1408,N/A,73,3
2,N/A,N/A,N/A,1404,1406,N/A,77,1
7,N/A,N/A,N/A,1397,1404,N/A,80,4
12,N/A,N/A,N/A,1385,1397,N/A,86,4
2,N/A,N/A,N/A,1383,1385,N/A,89,1
18,N/A,N/A,N/A,1365,1383,N/A,93,5
14,N/A,N/A,N/A,1351,1365,N/A,99,5
2,N/A,N/A,N/A,1349,1351,N/A,103,3
4,N/A,N/A,N/A,1345,1349,N/A,108,2
18,N/A,N/A,N/A,1327,1345,N/A,112,6
2,N/A,N/A,N/A,1325,1327,N/A,115,3
4,N/A,N/A,N/A,1321,1325,N/A,121,3
2,N/A,N/A,N/A,1319,1321,N/A,125,1
12,N/A,N/A,N/A,1307,1319,N/A,130,6
3,N/A,N/A,N/A,1304,1307,N/A,133,3
2,N/A,N/A,N/A,398,400,N/A,3,2
16,N/A,N/A,N/A,382,398,N/A,6,5
4,N/A,N/A,N/A,378,382,N/A,9,2
2,N/A,N/A,N/A,376,378,N/A,15,2
2,N/A,N/A,N/A,374,376,N/A,21,2
3,N/A,N/A,N/A,371,374,N/A,27,2
14,N/A,N/A,N/A,357,371,N/A,31,6
2,N/A,N/A,N/A,355,357,N/A,34,3
2,N/A,N/A,N/A,353,355,N/A,38,1
11,N/A,N/A,N/A,342,353,N/A,43,6
2,N/A,N/A,N/A,340,342,N/A,49,0
5,N/A,N/A,N/A,335,340,N/A,53,4
2,N/A,N/A,N/A,333,335,N/A,58,3
4,N/A,N/A,N/A,329,333,N/A,63,2
4,N/A,N/A,N/A,325,329,N/A,69,2
19,N/A,N/A,N/A,306,325,N/A,73,6
3,N/A,N/A,N/A,303,306,N/A,76,3
19,N/A,N/A,N/A,284,303,N/A,79,6
1,N/A,N/A,N/A,283,284,N/A,85,0
12,N/A,N/A,N/A,271,283,N/A,90,5
2,N/A,N/A,N/A,269,271,N/A,93,2
17,N/A,N/A,N/A,252,269,N/A,97,6
2,N/A,N/A,N/A,250,252,N/A,103,0
4,N/A,N/A,N/A,246,250,N/A,106,3
4,N/A,N/A,N/A,242,246,N/A,111,2
4,N/A,N/A,N/A,238,242,N/A,117,2
12,N/A,N/A,N/A,226,238,N/A,120,5
3,N/A,N/A,N/A,223,226,N/A,124,3
11,N/A,N/A,N/A,212,223,N/A,127,6
3,N/A,N/A,N/A,209,212,N/A,130,3
11,N/A,N/A,N/A,1260,1271,N/A,4,4
2,N/A,N/A,N/A,1258,1260,N/A,8,2
18,N/A,N/A,N/A,1240,1258,N/A,11,5
14,N/A,N/A,N/A,1226,1240,N/A,17,5
2,N/A,N/A,N/A,1224,1226,N/A,21,3
19,N/A,N/A,N/A,1205,1224,N/A,24,6
2,N/A,N/A,N/A,1203,1205,N/A,30,0
12,N/A,N/A,N/A,1191,1203,N/A,36,6
15,N/A,N/A,N/A,1176,1191,N/A,41,5
4,N/A,N/A,N/A,1172,1176,N/A,44,2
17,N/A,N/A,N/A,1155,1172,N/A,47,5
2,N/A,N/A,N/A,1153,1155,N/A,50,2
2,N/A,N/A,N/A,1151,1153,N/A,56,2
3,N/A,N/A,N/A,1148,1151,N/A,62,2
4,N/A,N/A,N/A,1144,1148,N/A,68,2
2,N/A,N/A,N/A,1142,1144,N/A,74,2
2,N/A,N/A,N/A,1140,1142,N/A,79,1
15,N/A,N/A,N/A,1125,1140,N/A,83,5
2,N/A,N/A,N/A,1123,1125,N/A,86,2
12,N/A,N/A,N/A,1111,1123,N/A,90,6
2,N/A,N/A,N/A,1109,1111,N/A,96,0
2,N/A,N/A,N/A,1107,1109,N/A,99,3
2,N/A,N/A,N/A,1105,1107,N/A,103,1
12,N/A,N/A,N/A,1093,1105,N/A,108,6
4,N/A,N/A,N/A,1089,1093,N/A,111,3
3,N/A,N/A,N/A,1086,1089,N/A,117,3
3,N/A,N/A,N/A,1083,1086,N/A,122,2
2,N/A,N/A,N/A,1081,1083,N/A,127,1
16,N/A,N/A,N/A,1065,1081,N/A,132,6
18,N/A,N/A,N/A,1047,1065,N/A,137,5
2,N/A,N/A,N/A,375,377,N/A,6,3
17,N/A,N/A,N/A,358,375,N/A,9,6
2,N/A,N/A,N/A,356,358,N/A,15,0
17,N/A,N/A,N/A,339,356,N/A,21,6
5,N/A,N/A,N/A,334,339,N/A,25,4
3,N/A,N/A,N/A,331,334,N/A,30,3
2,N/A,N/A,N/A,329,331,N/A,35,2
18,N/A,N/A,N/A,311,329,N/A,39,6
11,N/A,N/A,N/A,300,311,N/A,43,4
4,N/A,N/A,N/A,296,300,N/A,47,2
2,N/A,N/A,N/A,294,296,N/A,53,2
15,N/A,N/A,N/A,279,294,N/A,56,5
2,N/A,N/A,N/A,277,279,N/A,60,3
3,N/A,N/A,N/A,274,277,N/A,66,3
2,N/A,N/A,N/A,272,274,N/A,71,2
2,N/A,N/A,N/A,270,272,N/A,76,1
18,N/A,N/A,N/A,252,270,N/A,81,6
1,N/A,N/A,N/A,251,252,N/A,87,0
14,N/A,N/A,N/A,237,251,N/A,91,4
4,N/A,N/A,N/A,233,237,N/A,96,3
3,N/A,N/A,N/A,230,233,N/A,102,3
2,N/A,N/A,N/A,228,230,N/A,106,1
13,N/A,N/A,N/A,215,228,N/A,109,4
4,N/A,N/A,N/A,211,215,N/A,114,3
2,N/A,N/A,N/A,209,211,N/A,118,1
2,N/A,N/A,N/A,207,209,N/A,124,1
8,N/A,N/A,N/A,199,207,N/A,127,4
4,N/A,N/A,N/A,195,199,N/A,131,2
3,N/A,N/A,N/A,192,195,N/A,137,2
2,N/A,N/A,N/A,190,192,N/A,143,2
15,N/A,N/A,N/A,749,764,N/A,4,6
3,N/A,N/A,N/A,746,749,N/A,7,3
17,N/A,N/A,N/A,729,746,N/A,10,6
10,N/A,N/A,N/A,719,729,N/A,15,5
2,N/A,N/A,N/A,717,719,N/A,18,2
2,N/A,N/A,N/A,715,717,N/A,23,1
2,N/A,N/A,N/A,713,715,N/A,29,1
12,N/A,N/A,N/A,701,713,N/A,34,6
5,N/A,N/A,N/A,696,701,N/A,38,4
4,N/A,N/A,N/A,692,696,N/A,43,3
3,N/A,N/A,N/A,689,692,N/A,48,2
2,N/A,N/A,N/A,687,689,N/A,53,1
6,N/A,N/A,N/A,681,687,N/A,56,4
11,N/A,N/A,N/A,670,681,N/A,62,4
2,N/A,N/A,N/A,668,670,N/A,65,1
10,N/A,N/A,N/A,658,668,N/A,69,5
17,N/A,N/A,N/A,641,658,N/A,75,5
5,N/A,N/A,N/A,636,641,N/A,80,4
8,N/A,N/A,N/A,628,636,N/A,86,4
2,N/A,N/A,N/A,626,628,N/A,90,2
15,N/A,N/A,N/A,611,626,N/A,94,6
5,N/A,N/A,N/A,606,611,N/A,98,4
14,N/A,N/A,N/A,592,606,N/A,104,4
6,N/A,N/A,N/A,586,592,N/A,110,4
2,N/A,N/A,N/A,584,586,N/A,115,3
2,N/A,N/A,N/A,582,584,N/A,119,1
1,N/A,N/A,N/A,581,582,N/A,125,1
12,N/A,N/A,N/A,569,581,N/A,130,6
15,N/A,N/A,N/A,554,569,N/A,135,5
12,N/A,N/A,N/A,542,554,N/A,140,4
18,N/A,N/A,N/A,990,1008,N/A,3,5
6,N/A,N/A,N/A,984,990,N/A,8,4
5,N/A,N/A,N/A,979,984,N/A,14,4
6,N/A,N/A,N/A,973,979,N/A,20,4
3,N/A,N/A,N/A,970,973,N/A,24,2
18,N/A,N/A,N/A,952,970,N/A,27,5
4,N/A,N/A,N/A,948,952,N/A,30,2
3,N/A,N/A,N/A,945,948,N/A,36,2
4,N/A,N/A,N/A,941,945,N/A,42,2
4,N/A,N/A,N/A,937,941,N/A,48,2
4,N/A,N/A,N/A,933,937,N/A,54,2
1,N/A,N/A,N/A,932,933,N/A,59,1
17,N/A,N/A,N/A,915,932,N/A,63,5
18,N/A,N/A,N/A,897,915,N/A,69,5
11,N/A,N/A,N/A,886,897,N/A,75,5
18,N/A,N/A,N/A,868,886,N/A,81,5
4,N/A,N/A,N/A,864,868,N/A,84,2
1,N/A,N/A,N/A,863,864,N/A,89,1
2,N/A,N/A,N/A,861,863,N/A,95,1
12,N/A,N/A,N/A,849,861,N/A,98,4
10,N/A,N/A,N/A,839,849,N/A,104,4
2,N/A,N/A,N/A,837,839,N/A,107,1
13,N/A,N/A,N/A,824,837,N/A,112,6
16,N/A,N/A,N/A,808,824,N/A,117,5
11,N/A,N/A,N/A,797,808,N/A,122,4
1,N/A,N/A,N/A,796,797,N/A,125,1
2,N/A,N/A,N/A,794,796,N/A,131,1
2,N/A,N/A,N/A,792,794,N/A,137,1
9,N/A,N/A,N/A,783,792,N/A,140,4
2,N/A,N/A,N/A,781,783,N/A,145,3
11,N/A,N/A,N/A,658,669,N/A,3,6
2,N/A,N/A,N/A,656,658,N/A,9,0
14,N/A,N/A,N/A,642,656,N/A,15,6
2,N/A,N/A,N/A,640,642,N/A,18,3
4,N/A,N/A,N/A,636,640,N/A,23,2
16,N/A,N/A,N/A,620,636,N/A,27,6
14,N/A,N/A,N/A,606,620,N/A,31,4
6,N/A,N/A,N/A,600,606,N/A,37,4
14,N/A,N/A,N/A,586,600,N/A,43,4
2,N/A,N/A,N/A,584,586,N/A,46,1
12,N/A,N/A,N/A,572,584,N/A,51,6
2,N/A,N/A,N/A,570,572,N/A,57,0
12,N/A,N/A,N/A,558,570,N/A,62,5
5,N/A,N/A,N/A,553,558,N/A,67,4
1,N/A,N/A,N/A,552,553,N/A,70,1
18,N/A,N/A,N/A,534,552,N/A,74,5
2,N/A,N/A,N/A,532,534,N/A,77,2
2,N/A,N/A,N/A,530,532,N/A,82,1
16,N/A,N/A,N/A,514,530,N/A,87,6
3,N/A,N/A,N/A,511,514,N/A,90,3
14,N/A,N/A,N/A,497,511,N/A,93,6
6,N/A,N/A,N/A,491,497,N/A,97,4
2,N/A,N/A,N/A,489,491,N/A,100,1
17,N/A,N/A,N/A,472,489,N/A,105,6
8,N/A,N/A,N/A,464,472,N/A,109,4
2,N/A,N/A,N/A,462,464,N/A,114,3
14,N/A,N/A,N/A,448,462,N/A,117,6
2,N/A,N/A,N/A,446,448,N/A,123,0
19,N/A,N/A,N/A,427,446,N/A,129,6
16,N/A,N/A,N/A,411,427,N/A,134,5
2,N/A,N/A,N/A,864,866,N/A,5,1
10,N/A,N/A,N/A,854,864,N/A,8,4
3,N/A,N/A,N/A,851,854,N/A,13,3
4,N/A,N/A,N/A,847,851,N/A,19,3
2,N/A,N/A,N/A,845,847,N/A,23,1
18,N/A,N/A,N/A,827,845,N/A,28,6
5,N/A,N/A,N/A,822,827,N/A,32,4
2,N/A,N/A,N/A,820,822,N/A,36,2
3,N/A,N/A,N/A,817,820,N/A,42,2
4,N/A,N/A,N/A,813,817,N/A,48,2
2,N/A,N/A,N/A,811,813,N/A,53,1
1,N/A,N/A,N/A,810,811,N/A,59,1
12,N/A,N/A,N/A,798,810,N/A,63,5
7,N/A,N/A,N/A,791,798,N/A,68,4
2,N/A,N/A,N/A,789,791,N/A,73,3
11,N/A,N/A,N/A,778,789,N/A,76,6
17,N/A,N/A,N/A,761,778,N/A,81,5
4,N/A,N/A,N/A,757,761,N/A,84,2
19,N/A,N/A,N/A,738,757,N/A,88,6
16,N/A,N/A,N/A,722,738,N/A,93,5
2,N/A,N/A,N/A,720,722,N/A,96,2
3,N/A,N/A,N/A,717,720,N/A,102,2
2,N/A,N/A,N/A,715,717,N/A,107,1
2,N/A,N/A,N/A,713,715,N/A,113,1
12,N/A,N/A,N/A,701,713,N/A,116,4
1,N/A,N/A,N/A,700,701,N/A,119,1
2,N/A,N/A,N/A,698,700,N/A,125,1
19,N/A,N/A,N/A,679,698,N/A,129,5
2,N/A,N/A,N/A,677,679,N/A,132,2
2,N/A,N/A,N/A,675,677,N/A,138,2
11,N/A,N/A,N/A,1369,1380,N/A,3,4
3,N/A,N/A,N/A,1366,1369,N/A,7,2
2,N/A,N/A,N/A,1364,1366,N/A,12,1
11,N/A,N/A,N/A,1353,1364,N/A,17,6
2,N/A,N/A,N/A,1351,1353,N/A,23,0
14,N/A,N/A,N/A,1337,1351,N/A,27,4
4,N/A,N/A,N/A,1333,1337,N/A,31,2
1,N/A,N/A,N/A,1332,1333,N/A,36,1
1,N/A,N/A,N/A,1331,1332,N/A,42,1
11,N/A,N/A,N/A,1320,1331,N/A,47,6
2,N/A,N/A,N/A,1318,1320,N/A,50,3
2,N/A,N/A,N/A,1316,1318,N/A,54,1
1,N/A,N/A,N/A,1315,1316,N/A,60,1
2,N/A,N/A,N/A,1313,1315,N/A,66,1
12,N/A,N/A,N/A,1301,1313,N/A,70,5
3,N/A,N/A,N/A,1298,1301,N/A,74,3
2,N/A,N/A,N/A,1296,1298,N/A,78,1
2,N/A,N/A,N/A,1294,1296,N/A,84,1
11,N/A,N/A,N/A,1283,1294,N/A,89,6
4,N/A,N/A,N/A,1279,1283,N/A,92,3
13,N/A,N/A,N/A,1266,1279,N/A,95,6
8,N/A,N/A,N/A,1258,1266,N/A,99,4
2,N/A,N/A,N/A,1256,1258,N/A,104,3
14,N/A,N/A,N/A,1242,1256,N/A,107,6
1,N/A,N/A,N/A,1241,1242,N/A,113,0
11,N/A,N/A,N/A,1230,1241,N/A,119,6
13,N/A,N/A,N/A,1217,1230,N/A,123,4
9,N/A,N/A,N/A,1208,1217,N/A,129,4
7,N/A,N/A,N/A,1201,1208,N/A,135,4
1,N/A,N/A,N/A,1200,1201,N/A,138,1
1,N/A,N/A,N/A,1851,1852,N/A,4,1
1,N/A,N/A,N/A,1850,1851,N/A,10,1
5,N/A,N/A,N/A,1845,1850,N/A,13,4
1,N/A,N/A,N/A,1844,1845,N/A,16,1
2,N/A,N/A,N/A,1842,1844,N/A,22,1
12,N/A,N/A,N/A,1830,1842,N/A,25,4
14,N/A,N/A,N/A,1816,1830,N/A,31,4
11,N/A,N/A,N/A,1805,1816,N/A,37,4
1,N/A,N/A,N/A,1804,1805,N/A,40,1
8,N/A,N/A,N/A,1796,1804,N/A,43,4
12,N/A,N/A,N/A,1784,1796,N/A,49,4
5,N/A,N/A,N/A,1779,1784,N/A,55,4
4,N/A,N/A,N/A,1775,1779,N/A,60,3
2,N/A,N/A,N/A,1773,1775,N/A,66,3
3,N/A,N/A,N/A,1770,1773,N/A,71,2
18,N/A,N/A,N/A,1752,1770,N/A,75,6
10,N/A,N/A,N/A,1742,1752,N/A,79,4
2,N/A,N/A,N/A,1740,1742,N/A,82,1
15,N/A,N/A,N/A,1725,1740,N/A,87,6
2,N/A,N/A,N/A,1723,1725,N/A,93,0
11,N/A,N/A,N/A,1712,1723,N/A,98,5
12,N/A,N/A,N/A,1700,1712,N/A,104,5
15,N/A,N/A,N/A,1685,1700,N/A,110,5
19,N/A,N/A,N/A,1666,1685,N/A,116,5
4,N/A,N/A,N/A,1662,1666,N/A,120,3
20,N/A,N/A,N/A,1642,1662,N/A,123,6
1,N/A,N/A,N/A,1641,1642,N/A,129,0
13,N/A,N/A,N/A,1628,1641,N/A,135,6
9,N/A,N/A,N/A,1619,1628,N/A,139,4
6,N/A,N/A,N/A,1613,1619,N/A,145,4
4,N/A,N/A,N/A,783,787,N/A,6,2
4,N/A,N/A,N/A,779,783,N/A,12,2
2,N/A,N/A,N/A,777,779,N/A,17,1
11,N/A,N/A,N/A,766,777,N/A,21,5
4,N/A,N/A,N/A,762,766,N/A,25,3
1,N/A,N/A,N/A,761,762,N/A,29,1
1,N/A,N/A,N/A,760,761,N/A,35,1
12,N/A,N/A,N/A,748,760,N/A,40,6
1,N/A,N/A,N/A,747,748,N/A,46,0
16,N/A,N/A,N/A,731,747,N/A,51,5
3,N/A,N/A,N/A,728,731,N/A,54,2
19,N/A,N/A,N/A,709,728,N/A,57,5
14,N/A,N/A,N/A,695,709,N/A,62,4
3,N/A,N/A,N/A,692,695,N/A,67,3
1,N/A,N/A,N/A,691,692,N/A,71,1
9,N/A,N/A,N/A,682,691,N/A,74,4
3,N/A,N/A,N/A,679,682,N/A,78,2
12,N/A,N/A,N/A,667,679,N/A,81,5
3,N/A,N/A,N/A,664,667,N/A,84,2
16,N/A,N/A,N/A,648,664,N/A,87,5
12,N/A,N/A,N/A,636,648,N/A,92,4
4,N/A,N/A,N/A,632,636,N/A,97,3
2,N/A,N/A,N/A,630,632,N/A,102,2
1,N/A,N/A,N/A,629,630,N/A,107,1
16,N/A,N/A,N/A,613,629,N/A,112,6
2,N/A,N/A,N/A,611,613,N/A,115,3
1,N/A,N/A,N/A,610,611,N/A,119,1
1,N/A,N/A,N/A,609,610,N/A,125,1
12,N/A,N/A,N/A,597,609,N/A,128,4
3,N/A,N/A,N/A,594,597,N/A,133,3
12,N/A,N/A,N/A,498,510,N/A,6,5
2,N/A,N/A,N/A,496,498,N/A,9,2
18,N/A,N/A,N/A,478,496,N/A,12,5
4,N/A,N/A,N/A,474,478,N/A,16,3
3,N/A,N/A,N/A,471,474,N/A,22,3
16,N/A,N/A,N/A,455,471,N/A,25,6
9,N/A,N/A,N/A,446,455,N/A,29,4
2,N/A,N/A,N/A,444,446,N/A,33,2
2,N/A,N/A,N/A,442,444,N/A,38,1
12,N/A,N/A,N/A,430,442,N/A,41,4
9,N/A,N/A,N/A,421,430,N/A,47,4
1,N/A,N/A,N/A,420,421,N/A,50,1
2,N/A,N/A,N/A,418,420,N/A,56,1
2,N/A,N/A,N/A,416,418,N/A,62,1
12,N/A,N/A,N/A,404,416,N/A,66,5
4,N/A,N/A,N/A,400,404,N/A,69,2
2,N/A,N/A,N/A,398,400,N/A,75,2
11,N/A,N/A,N/A,387,398,N/A,79,6
15,N/A,N/A,N/A,372,387,N/A,84,5
2,N/A,N/A,N/A,370,372,N/A,88,3
16,N/A,N/A,N/A,354,370,N/A,91,6
4,N/A,N/A,N/A,350,354,N/A,94,3
4,N/A,N/A,N/A,346,350,N/A,99,2
14,N/A,N/A,N/A,332,346,N/A,102,5
3,N/A,N/A,N/A,329,332,N/A,106,3
19,N/A,N/A,N/A,310,329,N/A,109,6
2,N/A,N/A,N/A,308,310,N/A,115,0
14,N/A,N/A,N/A,294,308,N/A,119,4
4,N/A,N/A,N/A,290,294,N/A,123,2
1,N/A,N/A,N/A,289,290,N/A,128,1
5,N/A,N/A,N/A,1324,1329,N/A,6,4
4,N/A,N/A,N/A,1320,1324,N/A,11,3
4,N/A,N/A,N/A,1316,1320,N/A,17,3
1,N/A,N/A,N/A,1315,1316,N/A,21,1
11,N/A,N/A,N/A,1304,1315,N/A,24,4
4,N/A,N/A,N/A,1300,1304,N/A,28,2
1,N/A,N/A,N/A,1299,1300,N/A,33,1
17,N/A,N/A,N/A,1282,1299,N/A,37,5
2,N/A,N/A,N/A,1280,1282,N/A,40,2
2,N/A,N/A,N/A,1278,1280,N/A,46,2
17,N/A,N/A,N/A,1261,1278,N/A,50,6
13,N/A,N/A,N/A,1248,1261,N/A,54,4
1,N/A,N/A,N/A,1247,1248,N/A,57,1
1,N/A,N/A,N/A,1246,1247,N/A,63,1
10,N/A,N/A,N/A,1236,1246,N/A,67,5
15,N/A,N/A,N/A,1221,1236,N/A,73,5
9,N/A,N/A,N/A,1212,1221,N/A,78,4
3,N/A,N/A,N/A,1209,1212,N/A,82,2
12,N/A,N/A,N/A,1197,1209,N/A,86,6
8,N/A,N/A,N/A,1189,1197,N/A,90,4
4,N/A,N/A,N/A,1185,1189,N/A,94,2
2,N/A,N/A,N/A,1183,1185,N/A,99,1
16,N/A,N/A,N/A,1167,1183,N/A,103,5
14,N/A,N/A,N/A,1153,1167,N/A,108,4
3,N/A,N/A,N/A,1150,1153,N/A,113,3
18,N/A,N/A,N/A,1132,1150,N/A,116,6
4,N/A,N/A,N/A,1128,1132,N/A,119,3
1,N/A,N/A,N/A,1127,1128,N/A,123,1
16,N/A,N/A,N/A,1111,1127,N/A,128,6
6,N/A,N/A,N/A,1105,1111,N/A,132,4
17,N/A,N/A,N/A,1721,1738,N/A,4,5
9,N/A,N/A,N/A,1712,1721,N/A,9,4
4,N/A,N/A,N/A,1708,1712,N/A,14,3
1,N/A,N/A,N/A,1707,1708,N/A,18,1
2,N/A,N/A,N/A,1705,1707,N/A,24,1
8,N/A,N/A,N/A,1697,1705,N/A,27,4
2,N/A,N/A,N/A,1695,1697,N/A,30,1
1,N/A,N/A,N/A,1694,1695,N/A,36,1
14,N/A,N/A,N/A,1680,1694,N/A,39,4
4,N/A,N/A,N/A,1676,1680,N/A,43,2
14,N/A,N/A,N/A,1662,1676,N/A,47,6
4,N/A,N/A,N/A,1658,1662,N/A,50,3
2,N/A,N/A,N/A,1656,1658,N/A,56,3
3,N/A,N/A,N/A,1653,1656,N/A,61,2
13,N/A,N/A,N/A,1640,1653,N/A,64,5
15,N/A,N/A,N/A,1625,1640,N/A,70,5
3,N/A,N/A,N/A,1622,1625,N/A,74,3
2,N/A,N/A,N/A,1620,1622,N/A,78,1
13,N/A,N/A,N/A,1607,1620,N/A,82,5
5,N/A,N/A,N/A,1602,1607,N/A,87,4
2,N/A,N/A,N/A,1600,1602,N/A,90,1
1,N/A,N/A,N/A,1599,1600,N/A,96,1
1,N/A,N/A,N/A,1598,1599,N/A,102,1
10,N/A,N/A,N/A,1588,1598,N/A,106,5
8,N/A,N/A,N/A,1580,1588,N/A,111,4
5,N/A,N/A,N/A,1575,1580,N/A,117,4
2,N/A,N/A,N/A,1573,1575,N/A,122,3
4,N/A,N/A,N/A,1569,1573,N/A,127,2
12,N/A,N/A,N/A,1557,1569,N/A,130,5
14,N/A,N/A,N/A,1543,1557,N/A,136,5
15,N/A,N/A,N/A,683,698,N/A,5,6
2,N/A,N/A,N/A,681,683,N/A,8,3
2,N/A,N/A,N/A,679,681,N/A,12,1
2,N/A,N/A,N/A,677,679,N/A,18,1
19,N/A,N/A,N/A,658,677,N/A,22,5
2,N/A,N/A,N/A,656,658,N/A,26,3
19,N/A,N/A,N/A,637,656,N/A,29,6
4,N/A,N/A,N/A,633,637,N/A,32,3
15,N/A,N/A,N/A,618,633,N/A,35,6
4,N/A,N/A,N/A,614,618,N/A,38,3
2,N/A,N/A,N/A,612,614,N/A,43,2
1,N/A,N/A,N/A,611,612,N/A,48,1
14,N/A,N/A,N/A,597,611,N/A,53,6
1,N/A,N/A,N/A,596,597,N/A,59,0
8,N/A,N/A,N/A,588,596,N/A,63,4
1,N/A,N/A,N/A,587,588,N/A,66,1
14,N/A,N/A,N/A,573,587,N/A,71,6
12,N/A,N/A,N/A,561,573,N/A,76,5
14,N/A,N/A,N/A,547,561,N/A,82,5
4,N/A,N/A,N/A,543,547,N/A,85,2
2,N/A,N/A,N/A,541,543,N/A,90,1
12,N/A,N/A,N/A,529,541,N/A,93,4
4,N/A,N/A,N/A,525,529,N/A,98,3
3,N/A,N/A,N/A,522,525,N/A,103,2
2,N/A,N/A,N/A,520,522,N/A,108,1
15,N/A,N/A,N/A,505,520,N/A,113,6
1,N/A,N/A,N/A,504,505,N/A,119,0
4,N/A,N/A,N/A,500,504,N/A,122,3
4,N/A,N/A,N/A,496,500,N/A,128,3
3,N/A,N/A,N/A,493,496,N/A,134,3
4,N/A,N/A,N/A,1216,1220,N/A,5,2
15,N/A,N/A,N/A,1201,1216,N/A,8,5
19,N/A,N/A,N/A,1182,1201,N/A,14,5
3,N/A,N/A,N/A,1179,1182,N/A,18,3
2,N/A,N/A,N/A,1177,1179,N/A,22,1
1,N/A,N/A,N/A,1176,1177,N/A,28,1
1,N/A,N/A,N/A,1175,1176,N/A,34,1
1,N/A,N/A,N/A,1174,1175,N/A,40,1
17,N/A,N/A,N/A,1157,1174,N/A,44,5
13,N/A,N/A,N/A,1144,1157,N/A,50,5
3,N/A,N/A,N/A,1141,1144,N/A,53,2
11,N/A,N/A,N/A,1130,1141,N/A,57,6
2,N/A,N/A,N/A,1128,1130,N/A,63,0
18,N/A,N/A,N/A,1110,1128,N/A,68,5
2,N/A,N/A,N/A,1108,1110,N/A,72,3
14,N/A,N/A,N/A,1094,1108,N/A,75,6
3,N/A,N/A,N/A,1091,1094,N/A,78,3
3,N/A,N/A,N/A,1088,1091,N/A,84,3
14,N/A,N/A,N/A,1074,1088,N/A,87,6
2,N/A,N/A,N/A,1072,1074,N/A,93,0
2,N/A,N/A,N/A,1070,1072,N/A,96,3
2,N/A,N/A,N/A,1068,1070,N/A,101,2
3,N/A,N/A,N/A,1065,1068,N/A,107,2
1,N/A,N/A,N/A,1064,1065,N/A,112,1
16,N/A,N/A,N/A,1048,1064,N/A,116,5
3,N/A,N/A,N/A,1045,1048,N/A,120,3
2,N/A,N/A,N/A,1043,1045,N/A,124,1
14,N/A,N/A,N/A,1029,1043,N/A,128,5
2,N/A,N/A,N/A,1027,1029,N/A,131,2
18,N/A,N/A,N/A,1009,1027,N/A,134,5
4,N/A,N/A,N/A,571,575,N/A,3,2
1,N/A,N/A,N/A,570,571,N/A,8,1
12,N/A,N/A,N/A,558,570,N/A,11,4
3,N/A,N/A,N/A,555,558,N/A,16,3
4,N/A,N/A,N/A,551,555,N/A,22,3
2,N/A,N/A,N/A,549,551,N/A,26,1
14,N/A,N/A,N/A,535,549,N/A,30,5
16,N/A,N/A,N/A,519,535,N/A,36,5
18,N/A,N/A,N/A,501,519,N/A,42,5
4,N/A,N/A,N/A,497,501,N/A,45,2
2,N/A,N/A,N/A,495,497,N/A,50,1
16,N/A,N/A,N/A,479,495,N/A,55,6
1,N/A,N/A,N/A,478,479,N/A,61,0
2,N/A,N/A,N/A,476,478,N/A,64,3
2,N/A,N/A,N/A,474,476,N/A,68,1
1,N/A,N/A,N/A,473,474,N/A,74,1
17,N/A,N/A,N/A,456,473,N/A,79,6
2,N/A,N/A,N/A,454,456,N/A,85,0
14,N/A,N/A,N/A,440,454,N/A,89,4
4,N/A,N/A,N/A,436,440,N/A,94,3
3,N/A,N/A,N/A,433,436,N/A,99,2
4,N/A,N/A,N/A,429,433,N/A,105,2
2,N/A,N/A,N/A,427,429,N/A,110,1
13,N/A,N/A,N/A,414,427,N/A,113,4
8,N/A,N/A,N/A,406,414,N/A,119,4
4,N/A,N/A,N/A,402,406,N/A,124,3
3,N/A,N/A,N/A,399,402,N/A,129,2
16,N/A,N/A,N/A,383,399,N/A,132,5
2,N/A,N/A,N/A,381,383,N/A,135,2
2,N/A,N/A,N/A,379,381,N/A,140,1
2,N/A,N/A,N/A,1888,1890,N/A,4,1
10,N/A,N/A,N/A,1878,1888,N/A,8,5
2,N/A,N/A,N/A,1876,1878,N/A,12,3
3,N/A,N/A,N/A,1873,1876,N/A,18,3
4,N/A,N/A,N/A,1869,1873,N/A,23,2
17,N/A,N/A,N/A,1852,1869,N/A,26,5
2,N/A,N/A,N/A,1850,1852,N/A,29,2
1,N/A,N/A,N/A,1849,1850,N/A,34,1
2,N/A,N/A,N/A,1847,1849,N/A,40,1
19,N/A,N/A,N/A,1828,1847,N/A,45,6
10,N/A,N/A,N/A,1818,1828,N/A,50,5
3,N/A,N/A,N/A,1815,1818,N/A,54,3
4,N/A,N/A,N/A,1811,1815,N/A,60,3
3,N/A,N/A,N/A,1808,1811,N/A,66,3
2,N/A,N/A,N/A,1806,1808,N/A,70,1
1,N/A,N/A,N/A,1805,1806,N/A,76,1
12,N/A,N/A,N/A,1793,1805,N/A,81,6
5,N/A,N/A,N/A,1788,1793,N/A,85,4
2,N/A,N/A,N/A,1786,1788,N/A,89,2
16,N/A,N/A,N/A,1770,1786,N/A,92,5
3,N/A,N/A,N/A,1767,1770,N/A,96,3
2,N/A,N/A,N/A,1765,1767,N/A,100,1
9,N/A,N/A,N/A,1756,1765,N/A,103,4
2,N/A,N/A,N/A,1754,1756,N/A,106,1
11,N/A,N/A,N/A,1743,1754,N/A,109,4
3,N/A,N/A,N/A,1740,1743,N/A,113,2
2,N/A,N/A,N/A,1738,1740,N/A,119,2
1,N/A,N/A,N/A,1737,1738,N/A,124,1
11,N/A,N/A,N/A,1726,1737,N/A,128,5
4,N/A,N/A,N/A,1722,1726,N/A,132,3
1,N/A,N/A,N/A,598,599,N/A,3,1
2,N/A,N/A,N/A,596,598,N/A,9,1
11,N/A,N/A,N/A,585,596,N/A,13,5
3,N/A,N/A,N/A,582,585,N/A,16,2
1,N/A,N/A,N/A,581,582,N/A,21,1
16,N/A,N/A,N/A,565,581,N/A,25,5
10,N/A,N/A,N/A,555,565,N/A,30,4
4,N/A,N/A,N/A,551,555,N/A,35,3
3,N/A,N/A,N/A,548,551,N/A,40,2
2,N/A,N/A,N/A,546,548,N/A,45,1
2,N/A,N/A,N/A,544,546,N/A,51,1
2,N/A,N/A,N/A,542,544,N/A,57,1
1,N/A,N/A,N/A,541,542,N/A,63,1
1,N/A,N/A,N/A,540,541,N/A,69,1
12,N/A,N/A,N/A,528,540,N/A,72,4
1,N/A,N/A,N/A,527,528,N/A,75,1
18,N/A,N/A,N/A,509,527,N/A,80,6
13,N/A,N/A,N/A,496,509,N/A,84,4
1,N/A,N/A,N/A,495,496,N/A,87,1
2,N/A,N/A,N/A,493,495,N/A,93,1
17,N/A,N/A,N/A,476,493,N/A,97,5
15,N/A,N/A,N/A,461,476,N/A,103,5
4,N/A,N/A,N/A,457,461,N/A,106,2
15,N/A,N/A,N/A,442,457,N/A,109,5
12,N/A,N/A,N/A,430,442,N/A,114,4
3,N/A,N/A,N/A,427,430,N/A,119,3
4,N/A,N/A,N/A,423,427,N/A,125,3
1,N/A,N/A,N/A,422,423,N/A,129,1
16,N/A,N/A,N/A,406,422,N/A,134,6
1,N/A,N/A,N/A,405,406,N/A,140,0
6,N/A,N/A,N/A,948,954,N/A,5,4
3,N/A,N/A,N/A,945,948,N/A,10,3
3,N/A,N/A,N/A,942,945,N/A,16,3
3,N/A,N/A,N/A,939,942,N/A,21,2
14,N/A,N/A,N/A,925,939,N/A,24,5
11,N/A,N/A,N/A,914,925,N/A,30,5
16,N/A,N/A,N/A,898,914,N/A,36,5
2,N/A,N/A,N/A,896,898,N/A,40,3
1,N/A,N/A,N/A,895,896,N/A,44,1
11,N/A,N/A,N/A,884,895,N/A,47,4
7,N/A,N/A,N/A,877,884,N/A,53,4
4,N/A,N/A,N/A,873,877,N/A,58,3
4,N/A,N/A,N/A,869,873,N/A,64,3
2,N/A,N/A,N/A,867,869,N/A,70,3
1,N/A,N/A,N/A,866,867,N/A,74,1
5,N/A,N/A,N/A,861,866,N/A,77,4
2,N/A,N/A,N/A,859,861,N/A,81,2
16,N/A,N/A,N/A,843,859,N/A,85,6
15,N/A,N/A,N/A,828,843,N/A,90,5
2,N/A,N/A,N/A,826,828,N/A,93,2
13,N/A,N/A,N/A,813,826,N/A,97,6
7,N/A,N/A,N/A,806,813,N/A,101,4
3,N/A,N/A,N/A,803,806,N/A,106,3
3,N/A,N/A,N/A,800,803,N/A,112,3
2,N/A,N/A,N/A,798,800,N/A,116,1
1,N/A,N/A,N/A,797,798,N/A,122,1
14,N/A,N/A,N/A,783,797,N/A,126,5
13,N/A,N/A,N/A,770,783,N/A,132,5
12,N/A,N/A,N/A,758,770,N/A,138,5
7,N/A,N/A,N/A,751,758,N/A,143,4
13,N/A,N/A,N/A,1444,1457,N/A,3,4
5,N/A,N/A,N/A,1439,1444,N/A,9,4
2,N/A,N/A,N/A,1437,1439,N/A,12,1
10,N/A,N/A,N/A,1427,1437,N/A,15,4
13,N/A,N/A,N/A,1414,1427,N/A,21,4
11,N/A,N/A,N/A,1403,1414,N/A,27,4
1,N/A,N/A,N/A,1402,1403,N/A,30,1
13,N/A,N/A,N/A,1389,1402,N/A,34,5
3,N/A,N/A,N/A,1386,1389,N/A,37,2
13,N/A,N/A,N/A,1373,1386,N/A,40,5
9,N/A,N/A,N/A,1364,1373,N/A,45,4
13,N/A,N/A,N/A,1351,1364,N/A,51,4
2,N/A,N/A,N/A,1349,1351,N/A,56,3
1,N/A,N/A,N/A,1348,1349,N/A,60,1
2,N/A,N/A,N/A,1346,1348,N/A,66,1
5,N/A,N/A,N/A,1341,1346,N/A,69,4
2,N/A,N/A,N/A,1339,1341,N/A,74,3
20,N/A,N/A,N/A,1319,1339,N/A,77,6
2,N/A,N/A,N/A,1317,1319,N/A,80,3
2,N/A,N/A,N/A,1315,1317,N/A,84,1
12,N/A,N/A,N/A,1303,1315,N/A,88,5
13,N/A,N/A,N/A,1290,1303,N/A,94,5
10,N/A,N/A,N/A,1280,1290,N/A,100,5
4,N/A,N/A,N/A,1276,1280,N/A,103,2
19,N/A,N/A,N/A,1257,1276,N/A,107,6
4,N/A,N/A,N/A,1253,1257,N/A,110,3
17,N/A,N/A,N/A,1236,1253,N/A,113,6
9,N/A,N/A,N/A,1227,1236,N/A,117,4
2,N/A,N/A,N/A,1225,1227,N/A,121,2
15,N/A,N/A,N/A,1210,1225,N/A,125,6
3,N/A,N/A,N/A,1492,1495,N/A,6,2
2,N/A,N/A,N/A,1490,1492,N/A,11,1
20,N/A,N/A,N/A,1470,1490,N/A,16,6
4,N/A,N/A,N/A,1466,1470,N/A,19,3
19,N/A,N/A,N/A,1447,1466,N/A,22,6
3,N/A,N/A,N/A,1444,1447,N/A,25,3
4,N/A,N/A,N/A,1440,1444,N/A,30,2
11,N/A,N/A,N/A,1429,1440,N/A,34,6
12,N/A,N/A,N/A,1417,1429,N/A,38,4
10,N/A,N/A,N/A,1407,1417,N/A,44,4
1,N/A,N/A,N/A,1406,1407,N/A,47,1
16,N/A,N/A,N/A,1390,1406,N/A,51,5
2,N/A,N/A,N/A,1388,1390,N/A,55,3
4,N/A,N/A,N/A,1384,1388,N/A,60,2
3,N/A,N/A,N/A,1381,1384,N/A,66,2
1,N/A,N/A,N/A,1380,1381,N/A,71,1
14,N/A,N/A,N/A,1366,1380,N/A,76,6
1,N/A,N/A,N/A,1365,1366,N/A,82,0
2,N/A,N/A,N/A,1363,1365,N/A,85,3
1,N/A,N/A,N/A,1362,1363,N/A,89,1
15,N/A,N/A,N/A,1347,1362,N/A,93,5
2,N/A,N/A,N/A,1345,1347,N/A,96,2
12,N/A,N/A,N/A,1333,1345,N/A,100,6
8,N/A,N/A,N/A,1325,1333,N/A,104,4
2,N/A,N/A,N/A,1323,1325,N/A,107,1
1,N/A,N/A,N/A,1322,1323,N/A,113,1
17,N/A,N/A,N/A,1305,1322,N/A,118,6
15,N/A,N/A,N/A,1290,1305,N/A,123,5
2,N/A,N/A,N/A,1288,1290,N/A,126,2
17,N/A,N/A,N/A,1271,1288,N/A,130,6
11,N/A,N/A,N/A,1086,1097,N/A,6,4
3,N/A,N/A,N/A,1083,1086,N/A,10,2
3,N/A,N/A,N/A,1080,1083,N/A,16,2
4,N/A,N/A,N/A,1076,1080,N/A,22,2
16,N/A,N/A,N/A,1060,1076,N/A,26,6
12,N/A,N/A,N/A,1048,1060,N/A,30,4
9,N/A,N/A,N/A,1039,1048,N/A,36,4
4,N/A,N/A,N/A,1035,1039,N/A,41,3
14,N/A,N/A,N/A,1021,1035,N/A,44,6
2,N/A,N/A,N/A,1019,1021,N/A,50,0
11,N/A,N/A,N/A,1008,1019,N/A,55,5
13,N/A,N/A,N/A,995,1008,N/A,61,5
3,N/A,N/A,N/A,992,995,N/A,64,2
11,N/A,N/A,N/A,981,992,N/A,67,5
5,N/A,N/A,N/A,976,981,N/A,72,4
13,N/A,N/A,N/A,963,976,N/A,78,4
1,N/A,N/A,N/A,962,963,N/A,81,1
8,N/A,N/A,N/A,954,962,N/A,84,4
2,N/A,N/A,N/A,952,954,N/A,87,1
13,N/A,N/A,N/A,939,952,N/A,92,6
4,N/A,N/A,N/A,935,939,N/A,95,3
4,N/A,N/A,N/A,931,935,N/A,101,3
1,N/A,N/A,N/A,930,931,N/A,105,1
10,N/A,N/A,N/A,920,930,N/A,108,4
2,N/A,N/A,N/A,918,920,N/A,112,2
1,N/A,N/A,N/A,917,918,N/A,117,1
2,N/A,N/A,N/A,915,917,N/A,123,1
10,N/A,N/A,N/A,905,915,N/A,127,5
18,N/A,N/A,N/A,887,905,N/A,133,5
3,N/A,N/A,N/A,884,887,N/A,137,3
11,N/A,N/A,N/A,565,576,N/A,6,5
4,N/A,N/A,N/A,561,565,N/A,9,2
20,N/A,N/A,N/A,541,561,N/A,13,6
19,N/A,N/A,N/A,522,541,N/A,18,5
2,N/A,N/A,N/A,520,522,N/A,21,2
11,N/A,N/A,N/A,509,520,N/A,24,5
3,N/A,N/A,N/A,506,509,N/A,27,2
19,N/A,N/A,N/A,487,506,N/A,30,5
11,N/A,N/A,N/A,476,487,N/A,35,4
8,N/A,N/A,N/A,468,476,N/A,41,4
4,N/A,N/A,N/A,464,468,N/A,46,3
3,N/A,N/A,N/A,461,464,N/A,51,2
4,N/A,N/A,N/A,457,461,N/A,57,2
1,N/A,N/A,N/A,456,457,N/A,62,1
12,N/A,N/A,N/A,444,456,N/A,67,6
10,N/A,N/A,N/A,434,444,N/A,71,4
4,N/A,N/A,N/A,430,434,N/A,76,3
2,N/A,N/A,N/A,428,430,N/A,82,3
3,N/A,N/A,N/A,425,428,N/A,87,2
12,N/A,N/A,N/A,413,425,N/A,91,6
12,N/A,N/A,N/A,401,413,N/A,95,4
1,N/A,N/A,N/A,400,401,N/A,98,1
16,N/A,N/A,N/A,384,400,N/A,103,6
17,N/A,N/A,N/A,367,384,N/A,108,5
3,N/A,N/A,N/A,364,367,N/A,111,2
15,N/A,N/A,N/A,349,364,N/A,114,5
2,N/A,N/A,N/A,347,349,N/A,118,3
2,N/A,N/A,N/A,345,347,N/A,122,1
1,N/A,N/A,N/A,344,345,N/A,128,1
10,N/A,N/A,N/A,334,344,N/A,132,5
3,N/A,N/A,N/A,627,630,N/A,6,3
3,N/A,N/A,N/A,624,627,N/A,12,3
11,N/A,N/A,N/A,613,624,N/A,15,6
13,N/A,N/A,N/A,600,613,N/A,20,5
4,N/A,N/A,N/A,596,600,N/A,23,2
4,N/A,N/A,N/A,592,596,N/A,29,2
18,N/A,N/A,N/A,574,592,N/A,32,5
3,N/A,N/A,N/A,571,574,N/A,35,2
20,N/A,N/A,N/A,551,571,N/A,39,6
17,N/A,N/A,N/A,534,551,N/A,44,5
2,N/A,N/A,N/A,532,534,N/A,47,2
1,N/A,N/A,N/A,531,532,N/A,52,1
14,N/A,N/A,N/A,517,531,N/A,55,4
12,N/A,N/A,N/A,505,517,N/A,61,4
3,N/A,N/A,N/A,502,505,N/A,66,3
2,N/A,N/A,N/A,500,502,N/A,71,2
2,N/A,N/A,N/A,498,500,N/A,77,2
3,N/A,N/A,N/A,495,498,N/A,83,2
2,N/A,N/A,N/A,493,495,N/A,88,1
6,N/A,N/A,N/A,487,493,N/A,91,4
4,N/A,N/A,N/A,483,487,N/A,95,2
3,N/A,N/A,N/A,480,483,N/A,101,2
2,N/A,N/A,N/A,478,480,N/A,106,1
12,N/A,N/A,N/A,466,478,N/A,110,5
2,N/A,N/A,N/A,464,466,N/A,114,3
15,N/A,N/A,N/A,449,464,N/A,117,6
3,N/A,N/A,N/A,446,449,N/A,120,3
2,N/A,N/A,N/A,444,446,N/A,126,3
3,N/A,N/A,N/A,441,444,N/A,131,2
4,N/A,N/A,N/A,437,441,N/A,137,2
13,N/A,N/A,N/A,999,1012,N/A,5,4
1,N/A,N/A,N/A,998,999,N/A,8,1
8,N/A,N/A,N/A,990,998,N/A,11,4
3,N/A,N/A,N/A,987,990,N/A,16,3
2,N/A,N/A,N/A,985,987,N/A,20,1
11,N/A,N/A,N/A,974,985,N/A,25,6
13,N/A,N/A,N/A,961,974,N/A,29,4
10,N/A,N/A,N/A,951,961,N/A,35,4
2,N/A,N/A,N/A,949,951,N/A,38,1
8,N/A,N/A,N/A,941,949,N/A,41,4
12,N/A,N/A,N/A,929,941,N/A,47,4
3,N/A,N/A,N/A,926,929,N/A,52,3
2,N/A,N/A,N/A,924,926,N/A,57,2
20,N/A,N/A,N/A,904,924,N/A,61,6
3,N/A,N/A,N/A,901,904,N/A,64,3
20,N/A,N/A,N/A,881,901,N/A,67,6
4,N/A,N/A,N/A,877,881,N/A,70,3
2,N/A,N/A,N/A,875,877,N/A,75,2
1,N/A,N/A,N/A,874,875,N/A,80,1
12,N/A,N/A,N/A,862,874,N/A,85,6
7,N/A,N/A,N/A,855,862,N/A,89,4
1,N/A,N/A,N/A,854,855,N/A,92,1
7,N/A,N/A,N/A,847,854,N/A,95,4
2,N/A,N/A,N/A,845,847,N/A,100,3
17,N/A,N/A,N/A,828,845,N/A,103,6
15,N/A,N/A,N/A,813,828,N/A,108,5
3,N/A,N/A,N/A,810,813,N/A,111,2
12,N/A,N/A,N/A,798,810,N/A,114,5
13,N/A,N/A,N/A,785,798,N/A,119,4
2,N/A,N/A,N/A,783,785,N/A,122,1
9,N/A,N/A,N/A,1627,1636,N/A,3,4
1,N/A,N/A,N/A,1626,1627,N/A,6,1
2,N/A,N/A,N/A,1624,1626,N/A,12,1
17,N/A,N/A,N/A,1607,1624,N/A,17,6
2,N/A,N/A,N/A,1605,1607,N/A,23,0
13,N/A,N/A,N/A,1592,1605,N/A,29,6
3,N/A,N/A,N/A,1589,1592,N/A,32,3
2,N/A,N/A,N/A,1587,1589,N/A,37,2
2,N/A,N/A,N/A,1585,1587,N/A,42,1
16,N/A,N/A,N/A,1569,1585,N/A,47,6
1,N/A,N/A,N/A,1568,1569,N/A,53,0
18,N/A,N/A,N/A,1550,1568,N/A,58,5
13,N/A,N/A,N/A,1537,1550,N/A,64,5
3,N/A,N/A,N/A,1534,1537,N/A,68,3
1,N/A,N/A,N/A,1533,1534,N/A,72,1
2,N/A,N/A,N/A,1531,1533,N/A,78,1
13,N/A,N/A,N/A,1518,1531,N/A,81,4
3,N/A,N/A,N/A,1515,1518,N/A,86,3
4,N/A,N/A,N/A,1511,1515,N/A,91,2
17,N/A,N/A,N/A,1494,1511,N/A,94,5
3,N/A,N/A,N/A,1491,1494,N/A,98,3
2,N/A,N/A,N/A,1489,1491,N/A,102,1
1,N/A,N/A,N/A,1488,1489,N/A,108,1
2,N/A,N/A,N/A,1486,1488,N/A,114,1
16,N/A,N/A,N/A,1470,1486,N/A,119,6
13,N/A,N/A,N/A,1457,1470,N/A,124,5
3,N/A,N/A,N/A,1454,1457,N/A,127,2
2,N/A,N/A,N/A,1452,1454,N/A,132,1
2,N/A,N/A,N/A,1450,1452,N/A,138,1
6,N/A,N/A,N/A,1444,1450,N/A,141,4
8,N/A,N/A,N/A,1426,1434,N/A,3,4
4,N/A,N/A,N/A,1422,1426,N/A,7,2
17,N/A,N/A,N/A,1405,1422,N/A,10,5
11,N/A,N/A,N/A,1394,1405,N/A,15,4
13,N/A,N/A,N/A,1381,1394,N/A,21,4
4,N/A,N/A,N/A,1377,1381,N/A,26,3
19,N/A,N/A,N/A,1358,1377,N/A,29,6
3,N/A,N/A,N/A,1355,1358,N/A,32,3
4,N/A,N/A,N/A,1351,1355,N/A,38,3
3,N/A,N/A,N/A,1348,1351,N/A,44,3
3,N/A,N/A,N/A,1345,1348,N/A,49,2
1,N/A,N/A,N/A,1344,1345,N/A,54,1
1,N/A,N/A,N/A,1343,1344,N/A,60,1
1,N/A,N/A,N/A,1342,1343,N/A,66,1
14,N/A,N/A,N/A,1328,1342,N/A,69,4
7,N/A,N/A,N/A,1321,1328,N/A,75,4
8,N/A,N/A,N/A,1313,1321,N/A,81,4
3,N/A,N/A,N/A,1310,1313,N/A,85,2
2,N/A,N/A,N/A,1308,1310,N/A,91,2
12,N/A,N/A,N/A,1296,1308,N/A,94,5
3,N/A,N/A,N/A,1293,1296,N/A,97,2
4,N/A,N/A,N/A,1289,1293,N/A,103,2
19,N/A,N/A,N/A,1270,1289,N/A,106,5
4,N/A,N/A,N/A,1266,1270,N/A,110,3
2,N/A,N/A,N/A,1264,1266,N/A,116,3
3,N/A,N/A,N/A,1261,1264,N/A,121,2
2,N/A,N/A,N/A,1259,1261,N/A,126,1
1,N/A,N/A,N/A,1258,1259,N/A,132,1
2,N/A,N/A,N/A,1256,1258,N/A,138,1
2,N/A,N/A,N/A,1254,1256,N/A,144,1
11,N/A,N/A,N/A,1422,1433,N/A,3,5
11,N/A,N/A,N/A,1411,1422,N/A,8,4
4,N/A,N/A,N/A,1407,1411,N/A,13,3
3,N/A,N/A,N/A,1404,1407,N/A,18,2
17,N/A,N/A,N/A,1387,1404,N/A,22,6
16,N/A,N/A,N/A,1371,1387,N/A,27,5
2,N/A,N/A,N/A,1369,1371,N/A,30,2
1,N/A,N/A,N/A,1368,1369,N/A,35,1
2,N/A,N/A,N/A,1366,1368,N/A,41,1
17,N/A,N/A,N/A,1349,1366,N/A,45,5
3,N/A,N/A,N/A,1346,1349,N/A,48,2
1,N/A,N/A,N/A,1345,1346,N/A,53,1
1,N/A,N/A,N/A,1344,1345,N/A,59,1
18,N/A,N/A,N/A,1326,1344,N/A,64,6
17,N/A,N/A,N/A,1309,1326,N/A,69,5
3,N/A,N/A,N/A,1306,1309,N/A,72,2
14,N/A,N/A,N/A,1292,1306,N/A,76,6
11,N/A,N/A,N/A,1281,1292,N/A,80,4
3,N/A,N/A,N/A,1278,1281,N/A,84,2
18,N/A,N/A,N/A,1260,1278,N/A,88,6
16,N/A,N/A,N/A,1244,1260,N/A,93,5
2,N/A,N/A,N/A,1242,1244,N/A,96,2
13,N/A,N/A,N/A,1229,1242,N/A,99,5
4,N/A,N/A,N/A,1225,1229,N/A,103,3
4,N/A,N/A,N/A,1221,1225,N/A,108,2
1,N/A,N/A,N/A,1220,1221,N/A,113,1
14,N/A,N/A,N/A,1206,1220,N/A,118,6
5,N/A,N/A,N/A,1201,1206,N/A,122,4
4,N/A,N/A,N/A,1197,1201,N/A,126,2
1,N/A,N/A,N/A,1196,1197,N/A,131,1
15,N/A,N/A,N/A,1310,1325,N/A,5,5
19,N/A,N/A,N/A,1291,1310,N/A,11,5
11,N/A,N/A,N/A,1280,1291,N/A,16,4
11,N/A,N/A,N/A,1269,1280,N/A,22,4
1,N/A,N/A,N/A,1268,1269,N/A,25,1
8,N/A,N/A,N/A,1260,1268,N/A,28,4
6,N/A,N/A,N/A,1254,1260,N/A,34,4
3,N/A,N/A,N/A,1251,1254,N/A,38,2
16,N/A,N/A,N/A,1235,1251,N/A,42,6
2,N/A,N/A,N/A,1233,1235,N/A,48,0
16,N/A,N/A,N/A,1217,1233,N/A,54,6
3,N/A,N/A,N/A,1214,1217,N/A,57,3
15,N/A,N/A,N/A,1199,1214,N/A,60,6
12,N/A,N/A,N/A,1187,1199,N/A,65,5
3,N/A,N/A,N/A,1184,1187,N/A,68,2
4,N/A,N/A,N/A,1180,1184,N/A,74,2
2,N/A,N/A,N/A,1178,1180,N/A,80,2
18,N/A,N/A,N/A,1160,1178,N/A,84,6
11,N/A,N/A,N/A,1149,1160,N/A,89,5
4,N/A,N/A,N/A,1145,1149,N/A,93,3
2,N/A,N/A,N/A,1143,1145,N/A,98,2
4,N/A,N/A,N/A,1139,1143,N/A,104,2
12,N/A,N/A,N/A,1127,1139,N/A,108,6
6,N/A,N/A,N/A,1121,1127,N/A,112,4
4,N/A,N/A,N/A,1117,1121,N/A,116,2
2,N/A,N/A,N/A,1115,1117,N/A,121,1
16,N/A,N/A,N/A,1099,1115,N/A,126,6
13,N/A,N/A,N/A,1086,1099,N/A,131,5
18,N/A,N/A,N/A,1068,1086,N/A,137,5
9,N/A,N/A,N/A,1059,1068,N/A,142,4
4,N/A,N/A,N/A,1921,1925,N/A,6,3
2,N/A,N/A,N/A,1919,1921,N/A,11,2
16,N/A,N/A,N/A,1903,1919,N/A,14,5
12,N/A,N/A,N/A,1891,1903,N/A,19,4
4,N/A,N/A,N/A,1887,1891,N/A,24,3
13,N/A,N/A,N/A,1874,1887,N/A,27,6
4,N/A,N/A,N/A,1870,1874,N/A,30,3
2,N/A,N/A,N/A,1868,1870,N/A,35,2
20,N/A,N/A,N/A,1848,1868,N/A,39,6
10,N/A,N/A,N/A,1838,1848,N/A,43,4
3,N/A,N/A,N/A,1835,1838,N/A,47,2
3,N/A,N/A,N/A,1832,1835,N/A,53,2
14,N/A,N/A,N/A,1818,1832,N/A,56,5
4,N/A,N/A,N/A,1814,1818,N/A,59,2
20,N/A,N/A,N/A,1794,1814,N/A,63,6
17,N/A,N/A,N/A,1777,1794,N/A,68,5
3,N/A,N/A,N/A,1774,1777,N/A,72,3
2,N/A,N/A,N/A,1772,1774,N/A,76,1
13,N/A,N/A,N/A,1759,1772,N/A,81,6
4,N/A,N/A,N/A,1755,1759,N/A,84,3
2,N/A,N/A,N/A,1753,1755,N/A,89,2
11,N/A,N/A,N/A,1742,1753,N/A,92,5
4,N/A,N/A,N/A,1738,1742,N/A,95,2
15,N/A,N/A,N/A,1723,1738,N/A,99,6
4,N/A,N/A,N/A,1719,1723,N/A,102,3
20,N/A,N/A,N/A,1699,1719,N/A,105,6
2,N/A,N/A,N/A,1697,1699,N/A,111,0
18,N/A,N/A,N/A,1679,1697,N/A,117,6
11,N/A,N/A,N/A,1668,1679,N/A,122,5
3,N/A,N/A,N/A,1665,1668,N/A,125,2
1,N/A,N/A,N/A,610,611,N/A,3,1
2,N/A,N/A,N/A,608,610,N/A,9,1
17,N/A,N/A,N/A,591,608,N/A,14,6
6,N/A,N/A,N/A,585,591,N/A,18,4
3,N/A,N/A,N/A,582,585,N/A,22,2
2,N/A,N/A,N/A,580,582,N/A,28,2
2,N/A,N/A,N/A,578,580,N/A,34,2
1,N/A,N/A,N/A,577,578,N/A,39,1
13,N/A,N/A,N/A,564,577,N/A,44,6
17,N/A,N/A,N/A,547,564,N/A,49,5
3,N/A,N/A,N/A,544,547,N/A,52,2
17,N/A,N/A,N/A,527,544,N/A,55,5
2,N/A,N/A,N/A,525,527,N/A,59,3
11,N/A,N/A,N/A,514,525,N/A,62,6
1,N/A,N/A,N/A,513,514,N/A,68,0
3,N/A,N/A,N/A,510,513,N/A,71,3
2,N/A,N/A,N/A,508,510,N/A,75,1
14,N/A,N/A,N/A,494,508,N/A,79,5
2,N/A,N/A,N/A,492,494,N/A,83,3
3,N/A,N/A,N/A,489,492,N/A,89,3
1,N/A,N/A,N/A,488,489,N/A,93,1
6,N/A,N/A,N/A,482,488,N/A,96,4
2,N/A,N/A,N/A,480,482,N/A,101,3
3,N/A,N/A,N/A,477,480,N/A,107,3
2,N/A,N/A,N/A,475,477,N/A,113,3
16,N/A,N/A,N/A,459,475,N/A,116,6
13,N/A,N/A,N/A,446,459,N/A,120,4
4,N/A,N/A,N/A,442,446,N/A,125,3
13,N/A,N/A,N/A,429,442,N/A,128,6
14,N/A,N/A,N/A,415,429,N/A,132,4
1,N/A,N/A,N/A,609,610,N/A,4,1
7,N/A,N/A,N/A,602,609,N/A,7,4
3,N/A,N/A,N/A,599,602,N/A,11,2
2,N/A,N/A,N/A,597,599,N/A,16,1
2,N/A,N/A,N/A,595,597,N/A,22,1
13,N/A,N/A,N/A,582,595,N/A,26,5
15,N/A,N/A,N/A,567,582,N/A,32,5
3,N/A,N/A,N/A,564,567,N/A,35,2
14,N/A,N/A,N/A,550,564,N/A,38,5
4,N/A,N/A,N/A,546,550,N/A,41,2
3,N/A,N/A,N/A,543,546,N/A,47,2
4,N/A,N/A,N/A,539,543,N/A,53,2
16,N/A,N/A,N/A,523,539,N/A,56,5
2,N/A,N/A,N/A,521,523,N/A,59,2
15,N/A,N/A,N/A,506,521,N/A,62,5
14,N/A,N/A,N/A,492,506,N/A,68,5
9,N/A,N/A,N/A,483,492,N/A,73,4
5,N/A,N/A,N/A,478,483,N/A,79,4
2,N/A,N/A,N/A,476,478,N/A,82,1
17,N/A,N/A,N/A,459,476,N/A,87,6
1,N/A,N/A,N/A,458,459,N/A,93,0
15,N/A,N/A,N/A,443,458,N/A,99,6
4,N/A,N/A,N/A,439,443,N/A,102,3
2,N/A,N/A,N/A,437,439,N/A,107,2
13,N/A,N/A,N/A,424,437,N/A,110,5
2,N/A,N/A,N/A,422,424,N/A,114,3
3,N/A,N/A,N/A,419,422,N/A,119,2
19,N/A,N/A,N/A,400,419,N/A,123,6
2,N/A,N/A,N/A,398,400,N/A,129,0
17,N/A,N/A,N/A,381,398,N/A,134,5
1,N/A,N/A,N/A,464,465,N/A,6,1
10,N/A,N/A,N/A,454,464,N/A,10,5
3,N/A,N/A,N/A,451,454,N/A,13,2
2,N/A,N/A,N/A,449,451,N/A,18,1
11,N/A,N/A,N/A,438,449,N/A,21,4
2,N/A,N/A,N/A,436,438,N/A,24,1
1,N/A,N/A,N/A,435,436,N/A,30,1
13,N/A,N/A,N/A,422,435,N/A,34,5
3,N/A,N/A,N/A,419,422,N/A,38,3
1,N/A,N/A,N/A,418,419,N/A,42,1
9,N/A,N/A,N/A,409,418,N/A,45,4
2,N/A,N/A,N/A,407,409,N/A,48,1
2,N/A,N/A,N/A,405,407,N/A,54,1
20,N/A,N/A,N/A,385,405,N/A,59,6
2,N/A,N/A,N/A,383,385,N/A,65,0
2,N/A,N/A,N/A,381,383,N/A,68,3
3,N/A,N/A,N/A,378,381,N/A,74,3
1,N/A,N/A,N/A,377,378,N/A,78,1
12,N/A,N/A,N/A,365,377,N/A,81,4
9,N/A,N/A,N/A,356,365,N/A,87,4
2,N/A,N/A,N/A,354,356,N/A,90,1
11,N/A,N/A,N/A,343,354,N/A,95,6
19,N/A,N/A,N/A,324,343,N/A,100,5
4,N/A,N/A,N/A,320,324,N/A,104,3
4,N/A,N/A,N/A,316,320,N/A,110,3
3,N/A,N/A,N/A,313,316,N/A,115,2
12,N/A,N/A,N/A,301,313,N/A,119,6
13,N/A,N/A,N/A,288,301,N/A,124,5
13,N/A,N/A,N/A,275,288,N/A,129,4
2,N/A,N/A,N/A,273,275,N/A,132,1
7,N/A,N/A,N/A,554,561,N/A,4,4
3,N/A,N/A,N/A,551,554,N/A,8,2
2,N/A,N/A,N/A,549,551,N/A,14,2
16,N/A,N/A,N/A,533,549,N/A,18,6
1,N/A,N/A,N/A,532,533,N/A,24,0
18,N/A,N/A,N/A,514,532,N/A,30,6
3,N/A,N/A,N/A,511,514,N/A,33,3
18,N/A,N/A,N/A,493,511,N/A,36,6
1,N/A,N/A,N/A,492,493,N/A,42,0
4,N/A,N/A,N/A,488,492,N/A,45,3
12,N/A,N/A,N/A,476,488,N/A,48,6
2,N/A,N/A,N/A,474,476,N/A,54,0
12,N/A,N/A,N/A,462,474,N/A,60,6
9,N/A,N/A,N/A,453,462,N/A,64,4
9,N/A,N/A,N/A,444,453,N/A,70,4
4,N/A,N/A,N/A,440,444,N/A,75,3
4,N/A,N/A,N/A,436,440,N/A,81,3
2,N/A,N/A,N/A,434,436,N/A,86,2
1,N/A,N/A,N/A,433,434,N/A,91,1
19,N/A,N/A,N/A,414,433,N/A,96,6
1,N/A,N/A,N/A,413,414,N/A,102,0
10,N/A,N/A,N/A,403,413,N/A,106,4
10,N/A,N/A,N/A,393,403,N/A,112,4
2,N/A,N/A,N/A,391,393,N/A,115,1
2,N/A,N/A,N/A,389,391,N/A,121,1
10,N/A,N/A,N/A,379,389,N/A,124,4
2,N/A,N/A,N/A,377,379,N/A,127,1
7,N/A,N/A,N/A,370,377,N/A,130,4
5,N/A,N/A,N/A,365,370,N/A,136,4
10,N/A,N/A,N/A,355,365,N/A,142,4
13,N/A,N/A,N/A,566,579,N/A,3,6
1,N/A,N/A,N/A,565,566,N/A,9,0
19,N/A,N/A,N/A,546,565,N/A,14,5
4,N/A,N/A,N/A,542,546,N/A,17,2
14,N/A,N/A,N/A,528,542,N/A,20,5
2,N/A,N/A,N/A,526,528,N/A,23,2
13,N/A,N/A,N/A,513,526,N/A,26,5
3,N/A,N/A,N/A,510,513,N/A,30,3
14,N/A,N/A,N/A,496,510,N/A,33,6
2,N/A,N/A,N/A,494,496,N/A,39,0
6,N/A,N/A,N/A,488,494,N/A,43,4
12,N/A,N/A,N/A,476,488,N/A,49,4
2,N/A,N/A,N/A,474,476,N/A,52,1
16,N/A,N/A,N/A,458,474,N/A,57,6
10,N/A,N/A,N/A,448,458,N/A,61,4
2,N/A,N/A,N/A,446,448,N/A,64,1
1,N/A,N/A,N/A,445,446,N/A,70,1
2,N/A,N/A,N/A,443,445,N/A,76,1
5,N/A,N/A,N/A,438,443,N/A,79,4
3,N/A,N/A,N/A,435,438,N/A,83,2
11,N/A,N/A,N/A,424,435,N/A,86,5
4,N/A,N/A,N/A,420,424,N/A,89,2
14,N/A,N/A,N/A,406,420,N/A,93,6
13,N/A,N/A,N/A,393,406,N/A,97,4
4,N/A,N/A,N/A,389,393,N/A,102,3
4,N/A,N/A,N/A,385,389,N/A,108,3
3,N/A,N/A,N/A,382,385,N/A,114,3
4,N/A,N/A,N/A,378,382,N/A,119,2
1,N/A,N/A,N/A,377,378,N/A,124,1
1,N/A,N/A,N/A,376,377,N/A,130,1
2,N/A,N/A,N/A,1440,1442,N/A,5,1
10,N/A,N/A,N/A,1430,1440,N/A,9,5
13,N/A,N/A,N/A,1417,1430,N/A,15,5
14,N/A,N/A,N/A,1403,1417,N/A,20,4
1,N/A,N/A,N/A,1402,1403,N/A,23,1
2,N/A,N/A,N/A,1400,1402,N/A,29,1
10,N/A,N/A,N/A,1390,1400,N/A,32,4
3,N/A,N/A,N/A,1387,1390,N/A,36,2
10,N/A,N/A,N/A,1377,1387,N/A,39,5
2,N/A,N/A,N/A,1375,1377,N/A,43,3
2,N/A,N/A,N/A,1373,1375,N/A,49,3
3,N/A,N/A,N/A,1370,1373,N/A,55,3
1,N/A,N/A,N/A,1369,1370,N/A,59,1
16,N/A,N/A,N/A,1353,1369,N/A,64,6
3,N/A,N/A,N/A,1350,1353,N/A,67,3
16,N/A,N/A,N/A,1334,1350,N/A,70,6
4,N/A,N/A,N/A,1330,1334,N/A,73,3
18,N/A,N/A,N/A,1312,1330,N/A,76,6
1,N/A,N/A,N/A,1311,1312,N/A,82,0
15,N/A,N/A,N/A,1296,1311,N/A,88,6
1,N/A,N/A,N/A,1295,1296,N/A,94,0
2,N/A,N/A,N/A,1293,1295,N/A,97,3
2,N/A,N/A,N/A,1291,1293,N/A,101,1
19,N/A,N/A,N/A,1272,1291,N/A,105,5
19,N/A,N/A,N/A,1253,1272,N/A,111,5
14,N/A,N/A,N/A,1239,1253,N/A,117,5
2,N/A,N/A,N/A,1237,1239,N/A,120,2
11,N/A,N/A,N/A,1226,1237,N/A,123,5
2,N/A,N/A,N/A,1224,1226,N/A,127,3
3,N/A,N/A,N/A,1221,1224,N/A,133,3
18,N/A,N/A,N/A,772,790,N/A,3,5
4,N/A,N/A,N/A,768,772,N/A,6,2
1,N/A,N/A,N/A,767,768,N/A,11,1
2,N/A,N/A,N/A,765,767,N/A,17,1
8,N/A,N/A,N/A,757,765,N/A,20,4
4,N/A,N/A,N/A,753,757,N/A,24,2
20,N/A,N/A,N/A,733,753,N/A,28,6
11,N/A,N/A,N/A,722,733,N/A,33,5
4,N/A,N/A,N/A,718,722,N/A,37,3
2,N/A,N/A,N/A,716,718,N/A,43,3
17,N/A,N/A,N/A,699,716,N/A,46,6
1,N/A,N/A,N/A,698,699,N/A,52,0
19,N/A,N/A,N/A,679,698,N/A,57,5
5,N/A,N/A,N/A,674,679,N/A,62,4
13,N/A,N/A,N/A,661,674,N/A,68,4
1,N/A,N/A,N/A,660,661,N/A,71,1
5,N/A,N/A,N/A,655,660,N/A,74,4
4,N/A,N/A,N/A,651,655,N/A,78,2
16,N/A,N/A,N/A,635,651,N/A,81,5
13,N/A,N/A,N/A,622,635,N/A,86,4
7,N/A,N/A,N/A,615,622,N/A,92,4
1,N/A,N/A,N/A,614,615,N/A,95,1
17,N/A,N/A,N/A,597,614,N/A,99,5
3,N/A,N/A,N/A,594,597,N/A,102,2
4,N/A,N/A,N/A,590,594,N/A,108,2
17,N/A,N/A,N/A,573,590,N/A,112,6
2,N/A,N/A,N/A,571,573,N/A,115,3
16,N/A,N/A,N/A,555,571,N/A,118,6
14,N/A,N/A,N/A,541,555,N/A,123,5
2,N/A,N/A,N/A,539,541,N/A,127,3
2,N/A,N/A,N/A,1898,1900,N/A,3,2
11,N/A,N/A,N/A,1887,1898,N/A,7,6
4,N/A,N/A,N/A,1883,1887,N/A,10,3
3,N/A,N/A,N/A,1880,1883,N/A,15,2
16,N/A,N/A,N/A,1864,1880,N/A,19,6
4,N/A,N/A,N/A,1860,1864,N/A,22,3
3,N/A,N/A,N/A,1857,1860,N/A,28,3
3,N/A,N/A,N/A,1854,1857,N/A,33,2
12,N/A,N/A,N/A,1842,1854,N/A,36,5
11,N/A,N/A,N/A,1831,1842,N/A,42,5
15,N/A,N/A,N/A,1816,1831,N/A,48,5
4,N/A,N/A,N/A,1812,1816,N/A,51,2
3,N/A,N/A,N/A,1809,1812,N/A,57,2
13,N/A,N/A,N/A,1796,1809,N/A,61,6
4,N/A,N/A,N/A,1792,1796,N/A,64,3
4,N/A,N/A,N/A,1788,1792,N/A,70,3
4,N/A,N/A,N/A,1784,1788,N/A,75,2
19,N/A,N/A,N/A,1765,1784,N/A,79,6
4,N/A,N/A,N/A,1761,1765,N/A,82,3
1,N/A,N/A,N/A,1760,1761,N/A,86,1
14,N/A,N/A,N/A,1746,1760,N/A,89,4
8,N/A,N/A,N/A,1738,1746,N/A,95,4
3,N/A,N/A,N/A,1735,1738,N/A,100,3
3,N/A,N/A,N/A,1732,1735,N/A,105,2
2,N/A,N/A,N/A,1730,1732,N/A,110,1
10,N/A,N/A,N/A,1720,1730,N/A,113,4
4,N/A,N/A,N/A,1716,1720,N/A,118,3
2,N/A,N/A,N/A,1714,1716,N/A,123,2
3,N/A,N/A,N/A,1711,1714,N/A,129,2
18,N/A,N/A,N/A,1693,1711,N/A,132,5
3,N/A,N/A,N/A,1566,1569,N/A,4,3
3,N/A,N/A,N/A,1563,1566,N/A,10,3
3,N/A,N/A,N/A,1560,1563,N/A,15,2
10,N/A,N/A,N/A,1550,1560,N/A,18,5
14,N/A,N/A,N/A,1536,1550,N/A,23,4
4,N/A,N/A,N/A,1532,1536,N/A,27,2
1,N/A,N/A,N/A,1531,1532,N/A,32,1
15,N/A,N/A,N/A,1516,1531,N/A,37,6
2,N/A,N/A,N/A,1514,1516,N/A,43,0
18,N/A,N/A,N/A,1496,1514,N/A,49,6
17,N/A,N/A,N/A,1479,1496,N/A,54,5
3,N/A,N/A,N/A,1476,1479,N/A,57,2
17,N/A,N/A,N/A,1459,1476,N/A,60,5
15,N/A,N/A,N/A,1444,1459,N/A,66,5
4,N/A,N/A,N/A,1440,1444,N/A,70,3
2,N/A,N/A,N/A,1438,1440,N/A,76,3
13,N/A,N/A,N/A,1425,1438,N/A,79,6
14,N/A,N/A,N/A,1411,1425,N/A,83,4
3,N/A,N/A,N/A,1408,1411,N/A,87,2
15,N/A,N/A,N/A,1393,1408,N/A,90,5
2,N/A,N/A,N/A,1391,1393,N/A,94,3
2,N/A,N/A,N/A,1389,1391,N/A,98,1
17,N/A,N/A,N/A,1372,1389,N/A,103,6
2,N/A,N/A,N/A,1370,1372,N/A,106,3
4,N/A,N/A,N/A,1366,1370,N/A,112,3
2,N/A,N/A,N/A,1364,1366,N/A,117,2
3,N/A,N/A,N/A,1361,1364,N/A,123,2
4,N/A,N/A,N/A,1357,1361,N/A,129,2
19,N/A,N/A,N/A,1338,1357,N/A,132,5
12,N/A,N/A,N/A,1326,1338,N/A,138,5
4,N/A,N/A,N/A,990,994,N/A,3,3
2,N/A,N/A,N/A,988,990,N/A,7,1
13,N/A,N/A,N/A,975,988,N/A,12,6
12,N/A,N/A,N/A,963,975,N/A,17,5
2,N/A,N/A,N/A,961,963,N/A,20,2
2,N/A,N/A,N/A,959,961,N/A,26,2
11,N/A,N/A,N/A,948,959,N/A,30,6
4,N/A,N/A,N/A,944,948,N/A,33,3
16,N/A,N/A,N/A,928,944,N/A,36,6
1,N/A,N/A,N/A,927,928,N/A,42,0
19,N/A,N/A,N/A,908,927,N/A,47,5
2,N/A,N/A,N/A,906,908,N/A,51,3
1,N/A,N/A,N/A,905,906,N/A,55,1
8,N/A,N/A,N/A,897,905,N/A,58,4
13,N/A,N/A,N/A,884,897,N/A,64,4
5,N/A,N/A,N/A,879,884,N/A,70,4
3,N/A,N/A,N/A,876,879,N/A,75,3
2,N/A,N/A,N/A,874,876,N/A,80,2
19,N/A,N/A,N/A,855,874,N/A,84,6
10,N/A,N/A,N/A,845,855,N/A,89,5
12,N/A,N/A,N/A,833,845,N/A,94,4
2,N/A,N/A,N/A,831,833,N/A,97,1
2,N/A,N/A,N/A,829,831,N/A,103,1
14,N/A,N/A,N/A,815,829,N/A,107,5
15,N/A,N/A,N/A,800,815,N/A,113,5
17,N/A,N/A,N/A,783,800,N/A,119,5
3,N/A,N/A,N/A,780,783,N/A,122,2
20,N/A,N/A,N/A,760,780,N/A,126,6
2,N/A,N/A,N/A,758,760,N/A,132,0
2,N/A,N/A,N/A,756,758,N/A,135,3
3,N/A,N/A,N/A,1376,1379,N/A,3,2
15,N/A,N/A,N/A,1361,1376,N/A,6,5
4,N/A,N/A,N/A,1357,1361,N/A,10,3
3,N/A,N/A,N/A,1354,1357,N/A,15,2
15,N/A,N/A,N/A,1339,1354,N/A,19,6
12,N/A,N/A,N/A,1327,1339,N/A,23,4
2,N/A,N/A,N/A,1325,1327,N/A,26,1
7,N/A,N/A,N/A,1318,1325,N/A,29,4
2,N/A,N/A,N/A,1316,1318,N/A,32,1
9,N/A,N/A,N/A,1307,1316,N/A,35,4
11,N/A,N/A,N/A,1296,1307,N/A,41,4
3,N/A,N/A,N/A,1293,1296,N/A,46,3
15,N/A,N/A,N/A,1278,1293,N/A,49,6
2,N/A,N/A,N/A,1276,1278,N/A,55,0
19,N/A,N/A,N/A,1257,1276,N/A,60,5
16,N/A,N/A,N/A,1241,1257,N/A,66,5
3,N/A,N/A,N/A,1238,1241,N/A,70,3
2,N/A,N/A,N/A,1236,1238,N/A,75,2
3,N/A,N/A,N/A,1233,1236,N/A,81,2
11,N/A,N/A,N/A,1222,1233,N/A,84,5
18,N/A,N/A,N/A,1204,1222,N/A,90,5
3,N/A,N/A,N/A,1201,1204,N/A,94,3
4,N/A,N/A,N/A,1197,1201,N/A,100,3
2,N/A,N/A,N/A,1195,1197,N/A,104,1
12,N/A,N/A,N/A,1183,1195,N/A,108,5
3,N/A,N/A,N/A,1180,1183,N/A,112,3
2,N/A,N/A,N/A,1178,1180,N/A,116,1
14,N/A,N/A,N/A,1164,1178,N/A,120,5
11,N/A,N/A,N/A,1153,1164,N/A,125,4
2,N/A,N/A,N/A,1151,1153,N/A,130,3
1,N/A,N/A,N/A,1747,1748,N/A,6,1
16,N/A,N/A,N/A,1731,1747,N/A,11,6
2,N/A,N/A,N/A,1729,1731,N/A,17,0
11,N/A,N/A,N/A,1718,1729,N/A,22,5
9,N/A,N/A,N/A,1709,1718,N/A,27,4
3,N/A,N/A,N/A,1706,1709,N/A,32,3
4,N/A,N/A,N/A,1702,1706,N/A,37,2
11,N/A,N/A,N/A,1691,1702,N/A,41,6
2,N/A,N/A,N/A,1689,1691,N/A,44,3
1,N/A,N/A,N/A,1688,1689,N/A,48,1
1,N/A,N/A,N/A,1687,1688,N/A,54,1
16,N/A,N/A,N/A,1671,1687,N/A,58,5
9,N/A,N/A,N/A,1662,1671,N/A,63,4
7,N/A,N/A,N/A,1655,1662,N/A,69,4
2,N/A,N/A,N/A,1653,1655,N/A,72,1
11,N/A,N/A,N/A,1642,1653,N/A,76,5
5,N/A,N/A,N/A,1637,1642,N/A,81,4
1,N/A,N/A,N/A,1636,1637,N/A,84,1
14,N/A,N/A,N/A,1622,1636,N/A,89,6
14,N/A,N/A,N/A,1608,1622,N/A,94,5
3,N/A,N/A,N/A,1605,1608,N/A,98,3
4,N/A,N/A,N/A,1601,1605,N/A,104,3
2,N/A,N/A,N/A,1599,1601,N/A,108,1
5,N/A,N/A,N/A,1594,1599,N/A,111,4
1,N/A,N/A,N/A,1593,1594,N/A,114,1
13,N/A,N/A,N/A,1580,1593,N/A,117,4
12,N/A,N/A,N/A,1568,1580,N/A,123,4
3,N/A,N/A,N/A,1565,1568,N/A,128,3
2,N/A,N/A,N/A,1563,1565,N/A,133,2
19,N/A,N/A,N/A,1544,1563,N/A,136,5
1,N/A,N/A,N/A,1211,1212,N/A,6,1
2,N/A,N/A,N/A,1209,1211,N/A,12,1
2,N/A,N/A,N/A,1207,1209,N/A,18,1
2,N/A,N/A,N/A,1205,1207,N/A,24,1
2,N/A,N/A,N/A,1203,1205,N/A,30,1
14,N/A,N/A,N/A,1189,1203,N/A,34,5
15,N/A,N/A,N/A,1174,1189,N/A,40,5
14,N/A,N/A,N/A,1160,1174,N/A,46,5
3,N/A,N/A,N/A,1157,1160,N/A,49,2
14,N/A,N/A,N/A,1143,1157,N/A,53,6
3,N/A,N/A,N/A,1140,1143,N/A,56,3
2,N/A,N/A,N/A,1138,1140,N/A,60,1
2,N/A,N/A,N/A,1136,1138,N/A,66,1
14,N/A,N/A,N/A,1122,1136,N/A,70,5
5,N/A,N/A,N/A,1117,1122,N/A,75,4
1,N/A,N/A,N/A,1116,1117,N/A,78,1
11,N/A,N/A,N/A,1105,1116,N/A,82,5
2,N/A,N/A,N/A,1103,1105,N/A,86,3
4,N/A,N/A,N/A,1099,1103,N/A,91,2
1,N/A,N/A,N/A,1098,1099,N/A,96,1
11,N/A,N/A,N/A,1087,1098,N/A,99,4
11,N/A,N/A,N/A,1076,1087,N/A,105,4
6,N/A,N/A,N/A,1070,1076,N/A,111,4
6,N/A,N/A,N/A,1064,1070,N/A,117,4
2,N/A,N/A,N/A,1062,1064,N/A,121,2
1,N/A,N/A,N/A,1061,1062,N/A,126,1
17,N/A,N/A,N/A,1044,1061,N/A,131,6
3,N/A,N/A,N/A,1041,1044,N/A,134,3
19,N/A,N/A,N/A,1022,1041,N/A,137,6
2,N/A,N/A,N/A,1020,1022,N/A,140,3
1,N/A,N/A,N/A,642,643,N/A,3,1
2,N/A,N/A,N/A,640,642,N/A,9,1
17,N/A,N/A,N/A,623,640,N/A,14,6
11,N/A,N/A,N/A,612,623,N/A,18,4
2,N/A,N/A,N/A,610,612,N/A,23,3
2,N/A,N/A,N/A,608,610,N/A,28,2
2,N/A,N/A,N/A,606,608,N/A,34,2
1,N/A,N/A,N/A,605,606,N/A,39,1
18,N/A,N/A,N/A,587,605,N/A,44,6
9,N/A,N/A,N/A,578,587,N/A,48,4
3,N/A,N/A,N/A,575,578,N/A,53,3
2,N/A,N/A,N/A,573,575,N/A,58,2
1,N/A,N/A,N/A,572,573,N/A,63,1
6,N/A,N/A,N/A,566,572,N/A,66,4
3,N/A,N/A,N/A,563,566,N/A,71,3
14,N/A,N/A,N/A,549,563,N/A,74,6
10,N/A,N/A,N/A,539,549,N/A,78,4
10,N/A,N/A,N/A,529,539,N/A,84,4
5,N/A,N/A,N/A,524,529,N/A,90,4
9,N/A,N/A,N/A,515,524,N/A,96,4
14,N/A,N/A,N/A,501,515,N/A,102,4
2,N/A,N/A,N/A,499,501,N/A,107,3
18,N/A,N/A,N/A,481,499,N/A,110,6
16,N/A,N/A,N/A,465,481,N/A,115,5
10,N/A,N/A,N/A,455,465,N/A,120,4
3,N/A,N/A,N/A,452,455,N/A,125,3
2,N/A,N/A,N/A,450,452,N/A,129,1
6,N/A,N/A,N/A,444,450,N/A,132,4
2,N/A,N/A,N/A,442,444,N/A,135,1
18,N/A,N/A,N/A,424,442,N/A,139,5
2,N/A,N/A,N/A,1825,1827,N/A,4,3
2,N/A,N/A,N/A,1823,1825,N/A,10,3
18,N/A,N/A,N/A,1805,1823,N/A,13,6
3,N/A,N/A,N/A,1802,1805,N/A,16,3
2,N/A,N/A,N/A,1800,1802,N/A,20,1
13,N/A,N/A,N/A,1787,1800,N/A,24,5
19,N/A,N/A,N/A,1768,1787,N/A,30,5
12,N/A,N/A,N/A,1756,1768,N/A,35,4
3,N/A,N/A,N/A,1753,1756,N/A,39,2
1,N/A,N/A,N/A,1752,1753,N/A,44,1
10,N/A,N/A,N/A,1742,1752,N/A,48,5
4,N/A,N/A,N/A,1738,1742,N/A,51,2
1,N/A,N/A,N/A,1737,1738,N/A,56,1
18,N/A,N/A,N/A,1719,1737,N/A,61,6
5,N/A,N/A,N/A,1714,1719,N/A,65,4
3,N/A,N/A,N/A,1711,1714,N/A,70,3
1,N/A,N/A,N/A,1710,1711,N/A,74,1
8,N/A,N/A,N/A,1702,1710,N/A,77,4
3,N/A,N/A,N/A,1699,1702,N/A,81,2
2,N/A,N/A,N/A,1697,1699,N/A,87,2
2,N/A,N/A,N/A,1695,1697,N/A,92,1
20,N/A,N/A,N/A,1675,1695,N/A,97,6
14,N/A,N/A,N/A,1661,1675,N/A,102,5
5,N/A,N/A,N/A,1656,1661,N/A,107,4
3,N/A,N/A,N/A,1653,1656,N/A,111,2
17,N/A,N/A,N/A,1636,1653,N/A,114,5
7,N/A,N/A,N/A,1629,1636,N/A,119,4
2,N/A,N/A,N/A,1627,1629,N/A,124,3
1,N/A,N/A,N/A,1626,1627,N/A,128,1
10,N/A,N/A,N/A,1616,1626,N/A,131,4
4,N/A,N/A,N/A,973,977,N/A,6,3
15,N/A,N/A,N/A,958,973,N/A,9,6
4,N/A,N/A,N/A,954,958,N/A,12,3
1,N/A,N/A,N/A,953,954,N/A,16,1
15,N/A,N/A,N/A,938,953,N/A,21,6
1,N/A,N/A,N/A,937,938,N/A,27,0
9,N/A,N/A,N/A,928,937,N/A,31,4
1,N/A,N/A,N/A,927,928,N/A,34,1
1,N/A,N/A,N/A,926,927,N/A,40,1
17,N/A,N/A,N/A,909,926,N/A,45,6
10,N/A,N/A,N/A,899,909,N/A,49,4
4,N/A,N/A,N/A,895,899,N/A,54,3
2,N/A,N/A,N/A,893,895,N/A,60,3
2,N/A,N/A,N/A,891,893,N/A,64,1
5,N/A,N/A,N/A,886,891,N/A,67,4
10,N/A,N/A,N/A,876,886,N/A,73,4
3,N/A,N/A,N/A,873,876,N/A,77,2
19,N/A,N/A,N/A,854,873,N/A,80,5
16,N/A,N/A,N/A,838,854,N/A,86,5
2,N/A,N/A,N/A,836,838,N/A,90,3
2,N/A,N/A,N/A,834,836,N/A,94,1
20,N/A,N/A,N/A,814,834,N/A,99,6
13,N/A,N/A,N/A,801,814,N/A,104,5
7,N/A,N/A,N/A,794,801,N/A,109,4
2,N/A,N/A,N/A,792,794,N/A,112,1
9,N/A,N/A,N/A,783,792,N/A,115,4
1,N/A,N/A,N/A,782,783,N/A,118,1
18,N/A,N/A,N/A,764,782,N/A,123,6
2,N/A,N/A,N/A,762,764,N/A,129,0
6,N/A,N/A,N/A,756,762,N/A,133,4
1,N/A,N/A,N/A,560,561,N/A,4,1
19,N/A,N/A,N/A,541,560,N/A,9,6
15,N/A,N/A,N/A,526,541,N/A,14,5
4,N/A,N/A,N/A,522,526,N/A,17,2
1,N/A,N/A,N/A,521,522,N/A,22,1
2,N/A,N/A,N/A,519,521,N/A,28,1
16,N/A,N/A,N/A,503,519,N/A,33,6
13,N/A,N/A,N/A,490,503,N/A,37,4
2,N/A,N/A,N/A,488,490,N/A,42,3
2,N/A,N/A,N/A,486,488,N/A,48,3
2,N/A,N/A,N/A,484,486,N/A,52,1
16,N/A,N/A,N/A,468,484,N/A,57,6
2,N/A,N/A,N/A,466,468,N/A,63,0
5,N/A,N/A,N/A,461,466,N/A,67,4
2,N/A,N/A,N/A,459,461,N/A,70,1
18,N/A,N/A,N/A,441,459,N/A,74,5
8,N/A,N/A,N/A,433,441,N/A,79,4
9,N/A,N/A,N/A,424,433,N/A,85,4
10,N/A,N/A,N/A,414,424,N/A,91,4
4,N/A,N/A,N/A,410,414,N/A,95,2
17,N/A,N/A,N/A,393,410,N/A,99,6
14,N/A,N/A,N/A,379,393,N/A,104,5
5,N/A,N/A,N/A,374,379,N/A,109,4
3,N/A,N/A,N/A,371,374,N/A,114,3
4,N/A,N/A,N/A,367,371,N/A,120,3
1,N/A,N/A,N/A,366,367,N/A,124,1
14,N/A,N/A,N/A,352,366,N/A,128,5
4,N/A,N/A,N/A,348,352,N/A,131,2
19,N/A,N/A,N/A,329,348,N/A,134,5
9,N/A,N/A,N/A,320,329,N/A,139,4
2,N/A,N/A,N/A,330,332,N/A,5,3
2,N/A,N/A,N/A,328,330,N/A,9,1
1,N/A,N/A,N/A,327,328,N/A,15,1
2,N/A,N/A,N/A,325,327,N/A,21,1
8,N/A,N/A,N/A,317,325,N/A,24,4
2,N/A,N/A,N/A,315,317,N/A,28,2
15,N/A,N/A,N/A,300,315,N/A,31,5
5,N/A,N/A,N/A,295,300,N/A,36,4
2,N/A,N/A,N/A,293,295,N/A,40,2
18,N/A,N/A,N/A,275,293,N/A,43,5
4,N/A,N/A,N/A,271,275,N/A,46,2
19,N/A,N/A,N/A,252,271,N/A,49,5
4,N/A,N/A,N/A,248,252,N/A,52,2
18,N/A,N/A,N/A,230,248,N/A,55,5
4,N/A,N/A,N/A,226,230,N/A,58,2
1,N/A,N/A,N/A,225,226,N/A,63,1
6,N/A,N/A,N/A,219,225,N/A,66,4
3,N/A,N/A,N/A,216,219,N/A,70,2
13,N/A,N/A,N/A,203,216,N/A,73,5
2,N/A,N/A,N/A,201,203,N/A,76,2
3,N/A,N/A,N/A,198,201,N/A,82,2
16,N/A,N/A,N/A,182,198,N/A,85,5
6,N/A,N/A,N/A,176,182,N/A,90,4
5,N/A,N/A,N/A,171,176,N/A,96,4
1,N/A,N/A,N/A,170,171,N/A,99,1
1,N/A,N/A,N/A,169,170,N/A,105,1
1,N/A,N/A,N/A,168,169,N/A,111,1
1,N/A,N/A,N/A,167,168,N/A,117,1
19,N/A,N/A,N/A,148,167,N/A,122,6
18,N/A,N/A,N/A,130,148,N/A,127,5
4,N/A,N/A,N/A,1356,1360,N/A,5,3
4,N/A,N/A,N/A,1352,1356,N/A,11,3
1,N/A,N/A,N/A,1351,1352,N/A,15,1
14,N/A,N/A,N/A,1337,1351,N/A,19,5
14,N/A,N/A,N/A,1323,1337,N/A,24,4
2,N/A,N/A,N/A,1321,1323,N/A,29,3
2,N/A,N/A,N/A,1319,1321,N/A,33,1
6,N/A,N/A,N/A,1313,1319,N/A,36,4
3,N/A,N/A,N/A,1310,1313,N/A,40,2
2,N/A,N/A,N/A,1308,1310,N/A,46,2
2,N/A,N/A,N/A,1306,1308,N/A,52,2
4,N/A,N/A,N/A,1302,1306,N/A,58,2
11,N/A,N/A,N/A,1291,1302,N/A,62,6
8,N/A,N/A,N/A,1283,1291,N/A,66,4
3,N/A,N/A,N/A,1280,1283,N/A,71,3
13,N/A,N/A,N/A,1267,1280,N/A,74,6
4,N/A,N/A,N/A,1263,1267,N/A,77,3
3,N/A,N/A,N/A,1260,1263,N/A,83,3
2,N/A,N/A,N/A,1258,1260,N/A,87,1
1,N/A,N/A,N/A,1257,1258,N/A,93,1
11,N/A,N/A,N/A,1246,1257,N/A,96,4
2,N/A,N/A,N/A,1244,1246,N/A,99,1
12,N/A,N/A,N/A,1232,1244,N/A,103,5
13,N/A,N/A,N/A,1219,1232,N/A,109,5
16,N/A,N/A,N/A,1203,1219,N/A,115,5
2,N/A,N/A,N/A,1201,1203,N/A,118,2
12,N/A,N/A,N/A,1189,1201,N/A,122,6
7,N/A,N/A,N/A,1182,1189,N/A,126,4
3,N/A,N/A,N/A,1179,1182,N/A,130,2
11,N/A,N/A,N/A,1168,1179,N/A,133,5
11,N/A,N/A,N/A,1719,1730,N/A,3,4
14,N/A,N/A,N/A,1705,1719,N/A,9,4
14,N/A,N/A,N/A,1691,1705,N/A,15,4
1,N/A,N/A,N/A,1690,1691,N/A,18,1
12,N/A,N/A,N/A,1678,1690,N/A,22,5
11,N/A,N/A,N/A,1667,1678,N/A,28,5
3,N/A,N/A,N/A,1664,1667,N/A,31,2
4,N/A,N/A,N/A,1660,1664,N/A,37,2
4,N/A,N/A,N/A,1656,1660,N/A,43,2
11,N/A,N/A,N/A,1645,1656,N/A,46,5
4,N/A,N/A,N/A,1641,1645,N/A,50,3
1,N/A,N/A,N/A,1640,1641,N/A,54,1
1,N/A,N/A,N/A,1639,1640,N/A,60,1
14,N/A,N/A,N/A,1625,1639,N/A,64,5
4,N/A,N/A,N/A,1621,1625,N/A,67,2
20,N/A,N/A,N/A,1601,1621,N/A,71,6
6,N/A,N/A,N/A,1595,1601,N/A,75,4
10,N/A,N/A,N/A,1585,1595,N/A,81,4
4,N/A,N/A,N/A,1581,1585,N/A,85,2
16,N/A,N/A,N/A,1565,1581,N/A,89,6
1,N/A,N/A,N/A,1564,1565,N/A,95,0
2,N/A,N/A,N/A,1562,1564,N/A,98,3
1,N/A,N/A,N/A,1561,1562,N/A,102,1
2,N/A,N/A,N/A,1559,1561,N/A,108,1
9,N/A,N/A,N/A,1550,1559,N/A,111,4
2,N/A,N/A,N/A,1548,1550,N/A,115,2
3,N/A,N/A,N/A,1545,1548,N/A,121,2
3,N/A,N/A,N/A,1542,1545,N/A,127,2
11,N/A,N/A,N/A,1531,1542,N/A,131,6
2,N/A,N/A,N/A,1529,1531,N/A,137,0
12,N/A,N/A,N/A,567,579,N/A,5,5
19,N/A,N/A,N/A,548,567,N/A,11,5
12,N/A,N/A,N/A,536,548,N/A,16,4
14,N/A,N/A,N/A,522,536,N/A,22,4
1,N/A,N/A,N/A,521,522,N/A,25,1
19,N/A,N/A,N/A,502,521,N/A,29,5
19,N/A,N/A,N/A,483,502,N/A,35,5
3,N/A,N/A,N/A,480,483,N/A,38,2
3,N/A,N/A,N/A,477,480,N/A,44,2
19,N/A,N/A,N/A,458,477,N/A,47,5
18,N/A,N/A,N/A,440,458,N/A,53,5
2,N/A,N/A,N/A,438,440,N/A,56,2
12,N/A,N/A,N/A,426,438,N/A,60,6
1,N/A,N/A,N/A,425,426,N/A,66,0
8,N/A,N/A,N/A,417,425,N/A,70,4
1,N/A,N/A,N/A,416,417,N/A,73,1
17,N/A,N/A,N/A,399,416,N/A,78,6
2,N/A,N/A,N/A,397,399,N/A,84,0
3,N/A,N/A,N/A,394,397,N/A,87,3
4,N/A,N/A,N/A,390,394,N/A,92,2
17,N/A,N/A,N/A,373,390,N/A,95,5
11,N/A,N/A,N/A,362,373,N/A,100,4
3,N/A,N/A,N/A,359,362,N/A,104,2
1,N/A,N/A,N/A,358,359,N/A,109,1
10,N/A,N/A,N/A,348,358,N/A,112,4
2,N/A,N/A,N/A,346,348,N/A,116,2
2,N/A,N/A,N/A,344,346,N/A,121,1
12,N/A,N/A,N/A,332,344,N/A,125,5
3,N/A,N/A,N/A,329,332,N/A,128,2
2,N/A,N/A,N/A,327,329,N/A,134,2
12,N/A,N/A,N/A,1013,1025,N/A,4,6
4,N/A,N/A,N/A,1009,1013,N/A,7,3
18,N/A,N/A,N/A,991,1009,N/A,10,6
2,N/A,N/A,N/A,989,991,N/A,16,0
14,N/A,N/A,N/A,975,989,N/A,21,5
3,N/A,N/A,N/A,972,975,N/A,25,3
19,N/A,N/A,N/A,953,972,N/A,28,6
4,N/A,N/A,N/A,949,953,N/A,31,3
4,N/A,N/A,N/A,945,949,N/A,37,3
17,N/A,N/A,N/A,928,945,N/A,40,6
7,N/A,N/A,N/A,921,928,N/A,44,4
2,N/A,N/A,N/A,919,921,N/A,47,1
8,N/A,N/A,N/A,911,919,N/A,50,4
6,N/A,N/A,N/A,905,911,N/A,56,4
4,N/A,N/A,N/A,901,905,N/A,60,2
3,N/A,N/A,N/A,898,901,N/A,66,2
2,N/A,N/A,N/A,896,898,N/A,71,1
14,N/A,N/A,N/A,882,896,N/A,74,4
4,N/A,N/A,N/A,878,882,N/A,78,2
3,N/A,N/A,N/A,875,878,N/A,84,2
1,N/A,N/A,N/A,874,875,N/A,89,1
1,N/A,N/A,N/A,873,874,N/A,95,1
7,N/A,N/A,N/A,866,873,N/A,98,4
10,N/A,N/A,N/A,856,866,N/A,104,4
9,N/A,N/A,N/A,847,856,N/A,110,4
1,N/A,N/A,N/A,846,847,N/A,113,1
17,N/A,N/A,N/A,829,846,N/A,118,6
3,N/A,N/A,N/A,826,829,N/A,121,3
15,N/A,N/A,N/A,811,826,N/A,124,6
3,N/A,N/A,N/A,808,811,N/A,127,3
2,N/A,N/A,N/A,711,713,N/A,3,1
12,N/A,N/A,N/A,699,711,N/A,8,6
14,N/A,N/A,N/A,685,699,N/A,12,4
4,N/A,N/A,N/A,681,685,N/A,16,2
18,N/A,N/A,N/A,663,681,N/A,20,6
2,N/A,N/A,N/A,661,663,N/A,23,3
2,N/A,N/A,N/A,659,661,N/A,27,1
13,N/A,N/A,N/A,646,659,N/A,32,6
1,N/A,N/A,N/A,645,646,N/A,38,0
20,N/A,N/A,N/A,625,645,N/A,44,6
2,N/A,N/A,N/A,623,625,N/A,47,3
2,N/A,N/A,N/A,621,623,N/A,52,2
2,N/A,N/A,N/A,619,621,N/A,58,2
13,N/A,N/A,N/A,606,619,N/A,62,6
1,N/A,N/A,N/A,605,606,N/A,68,0
5,N/A,N/A,N/A,600,605,N/A,72,4
7,N/A,N/A,N/A,593,600,N/A,78,4
4,N/A,N/A,N/A,589,593,N/A,83,3
4,N/A,N/A,N/A,585,589,N/A,88,2
1,N/A,N/A,N/A,584,585,N/A,93,1
12,N/A,N/A,N/A,572,584,N/A,96,4
2,N/A,N/A,N/A,570,572,N/A,101,3
3,N/A,N/A,N/A,567,570,N/A,106,2
14,N/A,N/A,N/A,553,567,N/A,110,6
7,N/A,N/A,N/A,546,553,N/A,114,4
5,N/A,N/A,N/A,541,546,N/A,120,4
4,N/A,N/A,N/A,537,541,N/A,125,3
11,N/A,N/A,N/A,526,537,N/A,128,6
5,N/A,N/A,N/A,521,526,N/A,132,4
8,N/A,N/A,N/A,513,521,N/A,138,4
1,N/A,N/A,N/A,460,461,N/A,3,1
11,N/A,N/A,N/A,449,460,N/A,8,6
14,N/A,N/A,N/A,435,449,N/A,13,5
13,N/A,N/A,N/A,422,435,N/A,19,5
3,N/A,N/A,N/A,419,422,N/A,22,2
2,N/A,N/A,N/A,417,419,N/A,28,2
20,N/A,N/A,N/A,397,417,N/A,32,6
15,N/A,N/A,N/A,382,397,N/A,37,5
14,N/A,N/A,N/A,368,382,N/A,43,5
3,N/A,N/A,N/A,365,368,N/A,47,3
1,N/A,N/A,N/A,364,365,N/A,51,1
2,N/A,N/A,N/A,362,364,N/A,57,1
1,N/A,N/A,N/A,361,362,N/A,63,1
2,N/A,N/A,N/A,359,361,N/A,69,1
17,N/A,N/A,N/A,342,359,N/A,73,5
3,N/A,N/A,N/A,339,342,N/A,76,2
10,N/A,N/A,N/A,329,339,N/A,79,5
3,N/A,N/A,N/A,326,329,N/A,83,3
3,N/A,N/A,N/A,323,326,N/A,89,3
4,N/A,N/A,N/A,319,323,N/A,95,3
1,N/A,N/A,N/A,318,319,N/A,99,1
14,N/A,N/A,N/A,304,318,N/A,104,6
4,N/A,N/A,N/A,300,304,N/A,107,3
3,N/A,N/A,N/A,297,300,N/A,113,3
12,N/A,N/A,N/A,285,297,N/A,116,6
1,N/A,N/A,N/A,284,285,N/A,122,0
18,N/A,N/A,N/A,266,284,N/A,128,6
6,N/A,N/A,N/A,260,266,N/A,132,4
3,N/A,N/A,N/A,257,260,N/A,136,2
11,N/A,N/A,N/A,246,257,N/A,139,5
15,N/A,N/A,N/A,1708,1723,N/A,3,6
11,N/A,N/A,N/A,1697,1708,N/A,8,5
19,N/A,N/A,N/A,1678,1697,N/A,14,5
3,N/A,N/A,N/A,1675,1678,N/A,18,3
11,N/A,N/A,N/A,1664,1675,N/A,21,6
13,N/A,N/A,N/A,1651,1664,N/A,26,5
2,N/A,N/A,N/A,1649,1651,N/A,29,2
2,N/A,N/A,N/A,1647,1649,N/A,34,1
19,N/A,N/A,N/A,1628,1647,N/A,38,5
12,N/A,N/A,N/A,1616,1628,N/A,43,4
1,N/A,N/A,N/A,1615,1616,N/A,46,1
17,N/A,N/A,N/A,1598,1615,N/A,50,5
9,N/A,N/A,N/A,1589,1598,N/A,55,4
12,N/A,N/A,N/A,1577,1589,N/A,61,4
2,N/A,N/A,N/A,1575,1577,N/A,65,2
4,N/A,N/A,N/A,1571,1575,N/A,71,2
14,N/A,N/A,N/A,1557,1571,N/A,75,6
1,N/A,N/A,N/A,1556,1557,N/A,81,0
20,N/A,N/A,N/A,1536,1556,N/A,87,6
4,N/A,N/A,N/A,1532,1536,N/A,90,3
1,N/A,N/A,N/A,1531,1532,N/A,94,1
17,N/A,N/A,N/A,1514,1531,N/A,99,6
2,N/A,N/A,N/A,1512,1514,N/A,102,3
4,N/A,N/A,N/A,1508,1512,N/A,107,2
4,N/A,N/A,N/A,1504,1508,N/A,113,2
3,N/A,N/A,N/A,1501,1504,N/A,119,2
13,N/A,N/A,N/A,1488,1501,N/A,122,5
10,N/A,N/A,N/A,1478,1488,N/A,128,5
4,N/A,N/A,N/A,1474,1478,N/A,132,3
20,N/A,N/A,N/A,1454,1474,N/A,135,6
12,N/A,N/A,N/A,1308,1320,N/A,5,4
14,N/A,N/A,N/A,1294,1308,N/A,11,4
7,N/A,N/A,N/A,1287,1294,N/A,17,4
2,N/A,N/A,N/A,1285,1287,N/A,21,2
2,N/A,N/A,N/A,1283,1285,N/A,26,1
1,N/A,N/A,N/A,1282,1283,N/A,32,1
2,N/A,N/A,N/A,1280,1282,N/A,38,1
8,N/A,N/A,N/A,1272,1280,N/A,41,4
3,N/A,N/A,N/A,1269,1272,N/A,45,2
12,N/A,N/A,N/A,1257,1269,N/A,48,5
10,N/A,N/A,N/A,1247,1257,N/A,53,4
2,N/A,N/A,N/A,1245,1247,N/A,57,2
2,N/A,N/A,N/A,1243,1245,N/A,62,1
7,N/A,N/A,N/A,1236,1243,N/A,65,4
4,N/A,N/A,N/A,1232,1236,N/A,69,2
2,N/A,N/A,N/A,1230,1232,N/A,75,2
18,N/A,N/A,N/A,1212,1230,N/A,78,5
4,N/A,N/A,N/A,1208,1212,N/A,82,3
3,N/A,N/A,N/A,1205,1208,N/A,88,3
2,N/A,N/A,N/A,1203,1205,N/A,92,1
1,N/A,N/A,N/A,1202,1203,N/A,98,1
12,N/A,N/A,N/A,1190,1202,N/A,102,5
3,N/A,N/A,N/A,1187,1190,N/A,105,2
2,N/A,N/A,N/A,1185,1187,N/A,111,2
15,N/A,N/A,N/A,1170,1185,N/A,115,6
6,N/A,N/A,N/A,1164,1170,N/A,119,4
2,N/A,N/A,N/A,1162,1164,N/A,122,1
17,N/A,N/A,N/A,1145,1162,N/A,127,6
2,N/A,N/A,N/A,1143,1145,N/A,133,0
12,N/A,N/A,N/A,1131,1143,N/A,139,6
11,N/A,N/A,N/A,643,654,N/A,3,6
2,N/A,N/A,N/A,641,643,N/A,6,3
12,N/A,N/A,N/A,629,641,N/A,9,6
15,N/A,N/A,N/A,614,629,N/A,14,5
18,N/A,N/A,N/A,596,614,N/A,20,5
4,N/A,N/A,N/A,592,596,N/A,24,3
1,N/A,N/A,N/A,591,592,N/A,28,1
16,N/A,N/A,N/A,575,591,N/A,32,5
11,N/A,N/A,N/A,564,575,N/A,38,5
2,N/A,N/A,N/A,562,564,N/A,42,3
1,N/A,N/A,N/A,561,562,N/A,46,1
17,N/A,N/A,N/A,544,561,N/A,50,5
4,N/A,N/A,N/A,540,544,N/A,53,2
14,N/A,N/A,N/A,526,540,N/A,56,5
4,N/A,N/A,N/A,522,526,N/A,60,3
1,N/A,N/A,N/A,521,522,N/A,64,1
9,N/A,N/A,N/A,512,521,N/A,67,4
1,N/A,N/A,N/A,511,512,N/A,70,1
15,N/A,N/A,N/A,496,511,N/A,74,5
4,N/A,N/A,N/A,492,496,N/A,78,3
4,N/A,N/A,N/A,488,492,N/A,83,2
10,N/A,N/A,N/A,478,488,N/A,86,5
16,N/A,N/A,N/A,462,478,N/A,92,5
13,N/A,N/A,N/A,449,462,N/A,97,4
1,N/A,N/A,N/A,448,449,N/A,100,1
2,N/A,N/A,N/A,446,448,N/A,106,1
15,N/A,N/A,N/A,431,446,N/A,111,6
2,N/A,N/A,N/A,429,431,N/A,114,3
1,N/A,N/A,N/A,428,429,N/A,118,1
1,N/A,N/A,N/A,427,428,N/A,124,1
2,N/A,N/A,N/A,690,692,N/A,3,2
1,N/A,N/A,N/A,689,690,N/A,8,1
13,N/A,N/A,N/A,676,689,N/A,13,6
2,N/A,N/A,N/A,674,676,N/A,19,0
2,N/A,N/A,N/A,672,674,N/A,22,3
16,N/A,N/A,N/A,656,672,N/A,25,6
11,N/A,N/A,N/A,645,656,N/A,29,4
2,N/A,N/A,N/A,643,645,N/A,32,1
2,N/A,N/A,N/A,641,643,N/A,38,1
1,N/A,N/A,N/A,640,641,N/A,44,1
19,N/A,N/A,N/A,621,640,N/A,48,5
4,N/A,N/A,N/A,617,621,N/A,52,3
3,N/A,N/A,N/A,614,617,N/A,58,3
16,N/A,N/A,N/A,598,614,N/A,61,6
16,N/A,N/A,N/A,582,598,N/A,66,5
2,N/A,N/A,N/A,580,582,N/A,70,3
16,N/A,N/A,N/A,564,580,N/A,73,6
4,N/A,N/A,N/A,560,564,N/A,76,3
3,N/A,N/A,N/A,557,560,N/A,81,2
3,N/A,N/A,N/A,554,557,N/A,87,2
3,N/A,N/A,N/A,551,554,N/A,93,2
1,N/A,N/A,N/A,550,551,N/A,98,1
11,N/A,N/A,N/A,539,550,N/A,101,4
1,N/A,N/A,N/A,538,539,N/A,104,1
19,N/A,N/A,N/A,519,538,N/A,108,5
3,N/A,N/A,N/A,516,519,N/A,112,3
15,N/A,N/A,N/A,501,516,N/A,115,6
15,N/A,N/A,N/A,486,501,N/A,120,5
19,N/A,N/A,N/A,467,486,N/A,126,5
12,N/A,N/A,N/A,455,467,N/A,132,5
2,N/A,N/A,N/A,1478,1480,N/A,6,3
2,N/A,N/A,N/A,1476,1478,N/A,11,2
2,N/A,N/A,N/A,1474,1476,N/A,16,1
16,N/A,N/A,N/A,1458,1474,N/A,20,5
11,N/A,N/A,N/A,1447,1458,N/A,26,5
5,N/A,N/A,N/A,1442,1447,N/A,31,4
3,N/A,N/A,N/A,1439,1442,N/A,36,3
4,N/A,N/A,N/A,1435,1439,N/A,41,2
14,N/A,N/A,N/A,1421,1435,N/A,44,5
3,N/A,N/A,N/A,1418,1421,N/A,48,3
17,N/A,N/A,N/A,1401,1418,N/A,51,6
2,N/A,N/A,N/A,1399,1401,N/A,57,0
16,N/A,N/A,N/A,1383,1399,N/A,63,6
3,N/A,N/A,N/A,1380,1383,N/A,66,3
2,N/A,N/A,N/A,1378,1380,N/A,72,3
3,N/A,N/A,N/A,1375,1378,N/A,78,3
3,N/A,N/A,N/A,1372,1375,N/A,84,3
2,N/A,N/A,N/A,1370,1372,N/A,88,1
6,N/A,N/A,N/A,1364,1370,N/A,91,4
6,N/A,N/A,N/A,1358,1364,N/A,97,4
2,N/A,N/A,N/A,1356,1358,N/A,101,2
2,N/A,N/A,N/A,1354,1356,N/A,106,1
17,N/A,N/A,N/A,1337,1354,N/A,110,5
15,N/A,N/A,N/A,1322,1337,N/A,116,5
8,N/A,N/A,N/A,1314,1322,N/A,121,4
14,N/A,N/A,N/A,1300,1314,N/A,127,4
2,N/A,N/A,N/A,1298,1300,N/A,130,1
10,N/A,N/A,N/A,1288,1298,N/A,133,4
2,N/A,N/A,N/A,1286,1288,N/A,137,2
10,N/A,N/A,N/A,1276,1286,N/A,140,5
2,N/A,N/A,N/A,1279,1281,N/A,5,1
14,N/A,N/A,N/A,1265,1279,N/A,10,6
2,N/A,N/A,N/A,1263,1265,N/A,16,0
7,N/A,N/A,N/A,1256,1263,N/A,20,4
3,N/A,N/A,N/A,1253,1256,N/A,25,3
3,N/A,N/A,N/A,1250,1253,N/A,31,3
4,N/A,N/A,N/A,1246,1250,N/A,37,3
2,N/A,N/A,N/A,1244,1246,N/A,43,3
2,N/A,N/A,N/A,1242,1244,N/A,49,3
15,N/A,N/A,N/A,1227,1242,N/A,52,6
5,N/A,N/A,N/A,1222,1227,N/A,56,4
2,N/A,N/A,N/A,1220,1222,N/A,59,1
1,N/A,N/A,N/A,1219,1220,N/A,65,1
16,N/A,N/A,N/A,1203,1219,N/A,69,5
14,N/A,N/A,N/A,1189,1203,N/A,74,4
4,N/A,N/A,N/A,1185,1189,N/A,79,3
11,N/A,N/A,N/A,1174,1185,N/A,82,6
5,N/A,N/A,N/A,1169,1174,N/A,86,4
4,N/A,N/A,N/A,1165,1169,N/A,90,2
17,N/A,N/A,N/A,1148,1165,N/A,94,6
2,N/A,N/A,N/A,1146,1148,N/A,100,0
19,N/A,N/A,N/A,1127,1146,N/A,105,5
13,N/A,N/A,N/A,1114,1127,N/A,111,5
2,N/A,N/A,N/A,1112,1114,N/A,114,2
16,N/A,N/A,N/A,1096,1112,N/A,117,5
3,N/A,N/A,N/A,1093,1096,N/A,120,2
16,N/A,N/A,N/A,1077,1093,N/A,124,6
12,N/A,N/A,N/A,1065,1077,N/A,129,5
12,N/A,N/A,N/A,1053,1065,N/A,134,4
4,N/A,N/A,N/A,1049,1053,N/A,138,2
12,N/A,N/A,N/A,1358,1370,N/A,4,4
2,N/A,N/A,N/A,1356,1358,N/A,7,1
16,N/A,N/A,N/A,1340,1356,N/A,11,5
6,N/A,N/A,N/A,1334,1340,N/A,16,4
2,N/A,N/A,N/A,1332,1334,N/A,19,1
19,N/A,N/A,N/A,1313,1332,N/A,23,5
10,N/A,N/A,N/A,1303,1313,N/A,28,4
4,N/A,N/A,N/A,1299,1303,N/A,32,2
18,N/A,N/A,N/A,1281,1299,N/A,36,6
4,N/A,N/A,N/A,1277,1281,N/A,39,3
11,N/A,N/A,N/A,1266,1277,N/A,42,6
2,N/A,N/A,N/A,1264,1266,N/A,48,0
13,N/A,N/A,N/A,1251,1264,N/A,54,6
2,N/A,N/A,N/A,1249,1251,N/A,60,0
4,N/A,N/A,N/A,1245,1249,N/A,63,3
1,N/A,N/A,N/A,1244,1245,N/A,67,1
18,N/A,N/A,N/A,1226,1244,N/A,72,6
1,N/A,N/A,N/A,1225,1226,N/A,78,0
11,N/A,N/A,N/A,1214,1225,N/A,82,4
8,N/A,N/A,N/A,1206,1214,N/A,88,4
2,N/A,N/A,N/A,1204,1206,N/A,93,3
16,N/A,N/A,N/A,1188,1204,N/A,96,6
13,N/A,N/A,N/A,1175,1188,N/A,101,5
12,N/A,N/A,N/A,1163,1175,N/A,107,5
12,N/A,N/A,N/A,1151,1163,N/A,113,5
10,N/A,N/A,N/A,1141,1151,N/A,119,5
6,N/A,N/A,N/A,1135,1141,N/A,124,4
3,N/A,N/A,N/A,1132,1135,N/A,129,3
4,N/A,N/A,N/A,1128,1132,N/A,135,3
4,N/A,N/A,N/A,1124,1128,N/A,141,3
4,N/A,N/A,N/A,699,703,N/A,4,2
1,N/A,N/A,N/A,698,699,N/A,9,1
10,N/A,N/A,N/A,688,698,N/A,13,5
2,N/A,N/A,N/A,686,688,N/A,16,2
16,N/A,N/A,N/A,670,686,N/A,19,5
3,N/A,N/A,N/A,667,670,N/A,23,3
1,N/A,N/A,N/A,666,667,N/A,27,1
1,N/A,N/A,N/A,665,666,N/A,33,1
2,N/A,N/A,N/A,663,665,N/A,39,1
14,N/A,N/A,N/A,649,663,N/A,42,4
1,N/A,N/A,N/A,648,649,N/A,45,1
12,N/A,N/A,N/A,636,648,N/A,49,5
2,N/A,N/A,N/A,634,636,N/A,52,2
2,N/A,N/A,N/A,632,634,N/A,58,2
12,N/A,N/A,N/A,620,632,N/A,62,6
13,N/A,N/A,N/A,607,620,N/A,67,5
11,N/A,N/A,N/A,596,607,N/A,73,5
4,N/A,N/A,N/A,592,596,N/A,76,2
2,N/A,N/A,N/A,590,592,N/A,81,1
19,N/A,N/A,N/A,571,590,N/A,86,6
13,N/A,N/A,N/A,558,571,N/A,91,5
3,N/A,N/A,N/A,555,558,N/A,94,2
13,N/A,N/A,N/A,542,555,N/A,98,6
9,N/A,N/A,N/A,533,542,N/A,102,4
13,N/A,N/A,N/A,520,533,N/A,108,4
2,N/A,N/A,N/A,518,520,N/A,113,3
4,N/A,N/A,N/A,514,518,N/A,119,3
2,N/A,N/A,N/A,512,514,N/A,123,1
18,N/A,N/A,N/A,494,512,N/A,127,5
4,N/A,N/A,N/A,490,494,N/A,131,3
5,N/A,N/A,N/A,348,353,N/A,6,4
2,N/A,N/A,N/A,346,348,N/A,9,1
11,N/A,N/A,N/A,335,346,N/A,12,4
2,N/A,N/A,N/A,333,335,N/A,15,1
16,N/A,N/A,N/A,317,333,N/A,19,5
2,N/A,N/A,N/A,315,317,N/A,22,2
15,N/A,N/A,N/A,300,315,N/A,25,5
15,N/A,N/A,N/A,285,300,N/A,31,5
3,N/A,N/A,N/A,282,285,N/A,34,2
1,N/A,N/A,N/A,281,282,N/A,39,1
2,N/A,N/A,N/A,279,281,N/A,45,1
2,N/A,N/A,N/A,277,279,N/A,51,1
9,N/A,N/A,N/A,268,277,N/A,54,4
4,N/A,N/A,N/A,264,268,N/A,58,2
3,N/A,N/A,N/A,261,264,N/A,64,2
14,N/A,N/A,N/A,247,261,N/A,67,5
4,N/A,N/A,N/A,243,247,N/A,71,3
4,N/A,N/A,N/A,239,243,N/A,76,2
3,N/A,N/A,N/A,236,239,N/A,82,2
2,N/A,N/A,N/A,234,236,N/A,87,1
16,N/A,N/A,N/A,218,234,N/A,92,6
4,N/A,N/A,N/A,214,218,N/A,95,3
17,N/A,N/A,N/A,197,214,N/A,98,6
10,N/A,N/A,N/A,187,197,N/A,103,5
4,N/A,N/A,N/A,183,187,N/A,107,3
19,N/A,N/A,N/A,164,183,N/A,110,6
4,N/A,N/A,N/A,160,164,N/A,113,3
13,N/A,N/A,N/A,147,160,N/A,116,6
17,N/A,N/A,N/A,130,147,N/A,121,5
14,N/A,N/A,N/A,116,130,N/A,127,5
4,N/A,N/A,N/A,1258,1262,N/A,3,2
1,N/A,N/A,N/A,1257,1258,N/A,8,1
16,N/A,N/A,N/A,1241,1257,N/A,12,5
13,N/A,N/A,N/A,1228,1241,N/A,17,4
4,N/A,N/A,N/A,1224,1228,N/A,22,3
18,N/A,N/A,N/A,1206,1224,N/A,25,6
2,N/A,N/A,N/A,1204,1206,N/A,28,3
11,N/A,N/A,N/A,1193,1204,N/A,31,6
1,N/A,N/A,N/A,1192,1193,N/A,37,0
2,N/A,N/A,N/A,1190,1192,N/A,40,3
3,N/A,N/A,N/A,1187,1190,N/A,46,3
2,N/A,N/A,N/A,1185,1187,N/A,51,2
18,N/A,N/A,N/A,1167,1185,N/A,55,6
6,N/A,N/A,N/A,1161,1167,N/A,59,4
2,N/A,N/A,N/A,1159,1161,N/A,62,1
1,N/A,N/A,N/A,1158,1159,N/A,68,1
11,N/A,N/A,N/A,1147,1158,N/A,71,4
2,N/A,N/A,N/A,1145,1147,N/A,75,2
2,N/A,N/A,N/A,1143,1145,N/A,80,1
19,N/A,N/A,N/A,1124,1143,N/A,84,5
4,N/A,N/A,N/A,1120,1124,N/A,87,2
16,N/A,N/A,N/A,1104,1120,N/A,91,6
8,N/A,N/A,N/A,1096,1104,N/A,95,4
1,N/A,N/A,N/A,1095,1096,N/A,98,1
20,N/A,N/A,N/A,1075,1095,N/A,103,6
10,N/A,N/A,N/A,1065,1075,N/A,108,5
14,N/A,N/A,N/A,1051,1065,N/A,113,4
3,N/A,N/A,N/A,1048,1051,N/A,117,2
17,N/A,N/A,N/A,1031,1048,N/A,120,5
3,N/A,N/A,N/A,1028,1031,N/A,124,3
13,N/A,N/A,N/A,706,719,N/A,5,4
4,N/A,N/A,N/A,702,706,N/A,10,3
20,N/A,N/A,N/A,682,702,N/A,13,6
2,N/A,N/A,N/A,680,682,N/A,19,0
4,N/A,N/A,N/A,676,680,N/A,22,3
14,N/A,N/A,N/A,662,676,N/A,25,6
2,N/A,N/A,N/A,660,662,N/A,28,3
19,N/A,N/A,N/A,641,660,N/A,31,6
2,N/A,N/A,N/A,639,641,N/A,34,3
1,N/A,N/A,N/A,638,639,N/A,38,1
19,N/A,N/A,N/A,619,638,N/A,42,5
4,N/A,N/A,N/A,615,619,N/A,45,2
2,N/A,N/A,N/A,613,615,N/A,50,1
17,N/A,N/A,N/A,596,613,N/A,55,6
3,N/A,N/A,N/A,593,596,N/A,58,3
4,N/A,N/A,N/A,589,593,N/A,63,2
1,N/A,N/A,N/A,588,589,N/A,68,1
6,N/A,N/A,N/A,582,588,N/A,71,4
9,N/A,N/A,N/A,573,582,N/A,77,4
2,N/A,N/A,N/A,571,573,N/A,82,3
2,N/A,N/A,N/A,569,571,N/A,86,1
12,N/A,N/A,N/A,557,569,N/A,90,5
3,N/A,N/A,N/A,554,557,N/A,94,3
1,N/A,N/A,N/A,553,554,N/A,98,1
19,N/A,N/A,N/A,534,553,N/A,103,6
11,N/A,N/A,N/A,523,534,N/A,108,5
9,N/A,N/A,N/A,514,523,N/A,113,4
2,N/A,N/A,N/A,512,514,N/A,117,2
1,N/A,N/A,N/A,511,512,N/A,122,1
2,N/A,N/A,N/A,509,511,N/A,128,1
13,N/A,N/A,N/A,1195,1208,N/A,3,5
3,N/A,N/A,N/A,1192,1195,N/A,7,3
2,N/A,N/A,N/A,1190,1192,N/A,11,1
12,N/A,N/A,N/A,1178,1190,N/A,14,4
3,N/A,N/A,N/A,1175,1178,N/A,19,3
4,N/A,N/A,N/A,1171,1175,N/A,25,3
15,N/A,N/A,N/A,1156,1171,N/A,28,6
11,N/A,N/A,N/A,1145,1156,N/A,32,4
2,N/A,N/A,N/A,1143,1145,N/A,35,1
1,N/A,N/A,N/A,1142,1143,N/A,41,1
1,N/A,N/A,N/A,1141,1142,N/A,47,1
15,N/A,N/A,N/A,1126,1141,N/A,51,5
17,N/A,N/A,N/A,1109,1126,N/A,57,5
6,N/A,N/A,N/A,1103,1109,N/A,62,4
12,N/A,N/A,N/A,1091,1103,N/A,68,4
7,N/A,N/A,N/A,1084,1091,N/A,74,4
6,N/A,N/A,N/A,1078,1084,N/A,80,4
2,N/A,N/A,N/A,1076,1078,N/A,83,1
11,N/A,N/A,N/A,1065,1076,N/A,86,4
10,N/A,N/A,N/A,1055,1065,N/A,92,4
1,N/A,N/A,N/A,1054,1055,N/A,95,1
2,N/A,N/A,N/A,1052,1054,N/A,101,1
11,N/A,N/A,N/A,1041,1052,N/A,106,6
1,N/A,N/A,N/A,1040,1041,N/A,112,0
11,N/A,N/A,N/A,1029,1040,N/A,117,5
7,N/A,N/A,N/A,1022,1029,N/A,122,4
4,N/A,N/A,N/A,1018,1022,N/A,127,3
3,N/A,N/A,N/A,1015,1018,N/A,132,2
16,N/A,N/A,N/A,999,1015,N/A,135,5
3,N/A,N/A,N/A,996,999,N/A,138,2
11,N/A,N/A,N/A,319,330,N/A,6,6
10,N/A,N/A,N/A,309,319,N/A,10,4
1,N/A,N/A,N/A,308,309,N/A,13,1
1,N/A,N/A,N/A,307,308,N/A,19,1
16,N/A,N/A,N/A,291,307,N/A,24,6
16,N/A,N/A,N/A,275,291,N/A,29,5
2,N/A,N/A,N/A,273,275,N/A,32,2
13,N/A,N/A,N/A,260,273,N/A,35,5
17,N/A,N/A,N/A,243,260,N/A,41,5
4,N/A,N/A,N/A,239,243,N/A,44,2
1,N/A,N/A,N/A,238,239,N/A,49,1
13,N/A,N/A,N/A,225,238,N/A,54,6
4,N/A,N/A,N/A,221,225,N/A,57,3
3,N/A,N/A,N/A,218,221,N/A,62,2
1,N/A,N/A,N/A,217,218,N/A,67,1
15,N/A,N/A,N/A,202,217,N/A,72,6
9,N/A,N/A,N/A,193,202,N/A,76,4
13,N/A,N/A,N/A,180,193,N/A,82,4
4,N/A,N/A,N/A,176,180,N/A,87,3
1,N/A,N/A,N/A,175,176,N/A,91,1
1,N/A,N/A,N/A,174,175,N/A,97,1
19,N/A,N/A,N/A,155,174,N/A,102,6
19,N/A,N/A,N/A,136,155,N/A,107,5
2,N/A,N/A,N/A,134,136,N/A,111,3
1,N/A,N/A,N/A,133,134,N/A,115,1
9,N/A,N/A,N/A,124,133,N/A,118,4
3,N/A,N/A,N/A,121,124,N/A,122,2
19,N/A,N/A,N/A,102,121,N/A,125,5
4,N/A,N/A,N/A,98,102,N/A,129,3
2,N/A,N/A,N/A,96,98,N/A,135,3
4,N/A,N/A,N/A,1625,1629,N/A,6,2
2,N/A,N/A,N/A,1623,1625,N/A,11,1
15,N/A,N/A,N/A,1608,1623,N/A,15,5
6,N/A,N/A,N/A,1602,1608,N/A,20,4
4,N/A,N/A,N/A,1598,1602,N/A,24,2
1,N/A,N/A,N/A,1597,1598,N/A,29,1
14,N/A,N/A,N/A,1583,1597,N/A,33,5
6,N/A,N/A,N/A,1577,1583,N/A,38,4
10,N/A,N/A,N/A,1567,1577,N/A,44,4
4,N/A,N/A,N/A,1563,1567,N/A,49,3
19,N/A,N/A,N/A,1544,1563,N/A,52,6
10,N/A,N/A,N/A,1534,1544,N/A,56,4
6,N/A,N/A,N/A,1528,1534,N/A,62,4
2,N/A,N/A,N/A,1526,1528,N/A,65,1
11,N/A,N/A,N/A,1515,1526,N/A,69,5
2,N/A,N/A,N/A,1513,1515,N/A,73,3
2,N/A,N/A,N/A,1511,1513,N/A,78,2
12,N/A,N/A,N/A,1499,1511,N/A,81,5
2,N/A,N/A,N/A,1497,1499,N/A,85,3
4,N/A,N/A,N/A,1493,1497,N/A,90,2
12,N/A,N/A,N/A,1481,1493,N/A,93,5
15,N/A,N/A,N/A,1466,1481,N/A,99,5
14,N/A,N/A,N/A,1452,1466,N/A,105,5
3,N/A,N/A,N/A,1449,1452,N/A,108,2
2,N/A,N/A,N/A,1447,1449,N/A,113,1
9,N/A,N/A,N/A,1438,1447,N/A,116,4
13,N/A,N/A,N/A,1425,1438,N/A,122,4
2,N/A,N/A,N/A,1423,1425,N/A,125,1
19,N/A,N/A,N/A,1404,1423,N/A,130,6
1,N/A,N/A,N/A,1403,1404,N/A,136,0
17,N/A,N/A,N/A,1630,1647,N/A,5,5
16,N/A,N/A,N/A,1614,1630,N/A,11,5
4,N/A,N/A,N/A,1610,1614,N/A,15,3
2,N/A,N/A,N/A,1608,1610,N/A,19,1
19,N/A,N/A,N/A,1589,1608,N/A,23,5
3,N/A,N/A,N/A,1586,1589,N/A,27,3
4,N/A,N/A,N/A,1582,1586,N/A,32,2
4,N/A,N/A,N/A,1578,1582,N/A,38,2
19,N/A,N/A,N/A,1559,1578,N/A,42,6
2,N/A,N/A,N/A,1557,1559,N/A,48,0
16,N/A,N/A,N/A,1541,1557,N/A,54,6
3,N/A,N/A,N/A,1538,1541,N/A,57,3
14,N/A,N/A,N/A,1524,1538,N/A,60,6
7,N/A,N/A,N/A,1517,1524,N/A,64,4
2,N/A,N/A,N/A,1515,1517,N/A,69,3
3,N/A,N/A,N/A,1512,1515,N/A,75,3
2,N/A,N/A,N/A,1510,1512,N/A,79,1
10,N/A,N/A,N/A,1500,1510,N/A,82,4
6,N/A,N/A,N/A,1494,1500,N/A,88,4
2,N/A,N/A,N/A,1492,1494,N/A,91,1
16,N/A,N/A,N/A,1476,1492,N/A,96,6
1,N/A,N/A,N/A,1475,1476,N/A,102,0
12,N/A,N/A,N/A,1463,1475,N/A,107,5
15,N/A,N/A,N/A,1448,1463,N/A,113,5
9,N/A,N/A,N/A,1439,1448,N/A,118,4
2,N/A,N/A,N/A,1437,1439,N/A,121,1
2,N/A,N/A,N/A,1435,1437,N/A,127,1
15,N/A,N/A,N/A,1420,1435,N/A,131,5
8,N/A,N/A,N/A,1412,1420,N/A,136,4
4,N/A,N/A,N/A,1408,1412,N/A,140,2
1,N/A,N/A,N/A,702,703,N/A,6,1
14,N/A,N/A,N/A,688,702,N/A,9,4
4,N/A,N/A,N/A,684,688,N/A,14,3
4,N/A,N/A,N/A,680,684,N/A,19,2
15,N/A,N/A,N/A,665,680,N/A,23,6
3,N/A,N/A,N/A,662,665,N/A,26,3
3,N/A,N/A,N/A,659,662,N/A,31,2
18,N/A,N/A,N/A,641,659,N/A,34,5
13,N/A,N/A,N/A,628,641,N/A,40,5
2,N/A,N/A,N/A,626,628,N/A,44,3
4,N/A,N/A,N/A,622,626,N/A,49,2
2,N/A,N/A,N/A,620,622,N/A,54,1
1,N/A,N/A,N/A,619,620,N/A,60,1
2,N/A,N/A,N/A,617,619,N/A,66,1
16,N/A,N/A,N/A,601,617,N/A,70,5
4,N/A,N/A,N/A,597,601,N/A,74,3
2,N/A,N/A,N/A,595,597,N/A,79,2
4,N/A,N/A,N/A,591,595,N/A,85,2
19,N/A,N/A,N/A,572,591,N/A,88,5
10,N/A,N/A,N/A,562,572,N/A,93,4
2,N/A,N/A,N/A,560,562,N/A,98,3
1,N/A,N/A,N/A,559,560,N/A,102,1
11,N/A,N/A,N/A,548,559,N/A,105,4
1,N/A,N/A,N/A,547,548,N/A,108,1
6,N/A,N/A,N/A,541,547,N/A,111,4
2,N/A,N/A,N/A,539,541,N/A,115,2
17,N/A,N/A,N/A,522,539,N/A,119,6
4,N/A,N/A,N/A,518,522,N/A,122,3
12,N/A,N/A,N/A,506,518,N/A,125,6
4,N/A,N/A,N/A,502,506,N/A,128,3
2,N/A,N/A,N/A,409,411,N/A,4,2
18,N/A,N/A,N/A,391,409,N/A,7,5
8,N/A,N/A,N/A,383,391,N/A,12,4
2,N/A,N/A,N/A,381,383,N/A,15,1
6,N/A,N/A,N/A,375,381,N/A,18,4
2,N/A,N/A,N/A,373,375,N/A,23,3
2,N/A,N/A,N/A,371,373,N/A,29,3
2,N/A,N/A,N/A,369,371,N/A,34,2
16,N/A,N/A,N/A,353,369,N/A,37,5
11,N/A,N/A,N/A,342,353,N/A,43,5
14,N/A,N/A,N/A,328,342,N/A,48,4
2,N/A,N/A,N/A,326,328,N/A,52,2
2,N/A,N/A,N/A,324,326,N/A,58,2
13,N/A,N/A,N/A,311,324,N/A,62,6
9,N/A,N/A,N/A,302,311,N/A,66,4
2,N/A,N/A,N/A,300,302,N/A,69,1
2,N/A,N/A,N/A,298,300,N/A,75,1
12,N/A,N/A,N/A,286,298,N/A,80,6
3,N/A,N/A,N/A,283,286,N/A,83,3
3,N/A,N/A,N/A,280,283,N/A,88,2
11,N/A,N/A,N/A,269,280,N/A,92,6
8,N/A,N/A,N/A,261,269,N/A,96,4
2,N/A,N/A,N/A,259,261,N/A,101,3
16,N/A,N/A,N/A,243,259,N/A,104,6
2,N/A,N/A,N/A,241,243,N/A,110,0
15,N/A,N/A,N/A,226,241,N/A,115,5
6,N/A,N/A,N/A,220,226,N/A,120,4
3,N/A,N/A,N/A,217,220,N/A,125,3
3,N/A,N/A,N/A,214,217,N/A,130,2
16,N/A,N/A,N/A,198,214,N/A,133,5
4,N/A,N/A,N/A,792,796,N/A,4,3
4,N/A,N/A,N/A,788,792,N/A,10,3
19,N/A,N/A,N/A,769,788,N/A,13,6
19,N/A,N/A,N/A,750,769,N/A,18,5
15,N/A,N/A,N/A,735,750,N/A,24,5
11,N/A,N/A,N/A,724,735,N/A,30,5
8,N/A,N/A,N/A,716,724,N/A,35,4
2,N/A,N/A,N/A,714,716,N/A,40,3
2,N/A,N/A,N/A,712,714,N/A,45,2
15,N/A,N/A,N/A,697,712,N/A,48,5
7,N/A,N/A,N/A,690,697,N/A,53,4
7,N/A,N/A,N/A,683,690,N/A,59,4
2,N/A,N/A,N/A,681,683,N/A,64,3
3,N/A,N/A,N/A,678,681,N/A,70,3
19,N/A,N/A,N/A,659,678,N/A,73,6
11,N/A,N/A,N/A,648,659,N/A,77,4
1,N/A,N/A,N/A,647,648,N/A,80,1
2,N/A,N/A,N/A,645,647,N/A,86,1
1,N/A,N/A,N/A,644,645,N/A,92,1
13,N/A,N/A,N/A,631,644,N/A,96,5
2,N/A,N/A,N/A,629,631,N/A,99,2
1,N/A,N/A,N/A,628,629,N/A,104,1
18,N/A,N/A,N/A,610,628,N/A,109,6
12,N/A,N/A,N/A,598,610,N/A,114,5
11,N/A,N/A,N/A,587,598,N/A,120,5
10,N/A,N/A,N/A,577,587,N/A,126,5
2,N/A,N/A,N/A,575,577,N/A,129,2
1,N/A,N/A,N/A,574,575,N/A,134,1
13,N/A,N/A,N/A,561,574,N/A,137,4
2,N/A,N/A,N/A,559,561,N/A,141,2
16,N/A,N/A,N/A,338,354,N/A,6,5
4,N/A,N/A,N/A,334,338,N/A,9,2
12,N/A,N/A,N/A,322,334,N/A,13,6
12,N/A,N/A,N/A,310,322,N/A,18,5
17,N/A,N/A,N/A,293,310,N/A,24,5
13,N/A,N/A,N/A,280,293,N/A,29,4
9,N/A,N/A,N/A,271,280,N/A,35,4
4,N/A,N/A,N/A,267,271,N/A,39,2
15,N/A,N/A,N/A,252,267,N/A,42,5
2,N/A,N/A,N/A,250,252,N/A,46,3
2,N/A,N/A,N/A,248,250,N/A,50,1
1,N/A,N/A,N/A,247,248,N/A,56,1
13,N/A,N/A,N/A,234,247,N/A,61,6
12,N/A,N/A,N/A,222,234,N/A,65,4
4,N/A,N/A,N/A,218,222,N/A,70,3
15,N/A,N/A,N/A,203,218,N/A,73,6
3,N/A,N/A,N/A,200,203,N/A,76,3
1,N/A,N/A,N/A,199,200,N/A,80,1
1,N/A,N/A,N/A,198,199,N/A,86,1
11,N/A,N/A,N/A,187,198,N/A,89,4
4,N/A,N/A,N/A,183,187,N/A,93,2
1,N/A,N/A,N/A,182,183,N/A,98,1
2,N/A,N/A,N/A,180,182,N/A,104,1
2,N/A,N/A,N/A,178,180,N/A,110,1
12,N/A,N/A,N/A,166,178,N/A,113,4
2,N/A,N/A,N/A,164,166,N/A,116,1
11,N/A,N/A,N/A,153,164,N/A,121,6
4,N/A,N/A,N/A,149,153,N/A,124,3
3,N/A,N/A,N/A,146,149,N/A,130,3
1,N/A,N/A,N/A,145,146,N/A,134,1
12,N/A,N/A,N/A,314,326,N/A,5,4
3,N/A,N/A,N/A,311,314,N/A,10,3
2,N/A,N/A,N/A,309,311,N/A,14,1
2,N/A,N/A,N/A,307,309,N/A,20,1
8,N/A,N/A,N/A,299,307,N/A,23,4
3,N/A,N/A,N/A,296,299,N/A,27,2
1,N/A,N/A,N/A,295,296,N/A,32,1
10,N/A,N/A,N/A,285,295,N/A,36,5
4,N/A,N/A,N/A,281,285,N/A,39,2
17,N/A,N/A,N/A,264,281,N/A,42,5
14,N/A,N/A,N/A,250,264,N/A,48,5
4,N/A,N/A,N/A,246,250,N/A,51,2
2,N/A,N/A,N/A,244,246,N/A,57,2
2,N/A,N/A,N/A,242,244,N/A,62,1
1,N/A,N/A,N/A,241,242,N/A,68,1
18,N/A,N/A,N/A,223,241,N/A,72,5
7,N/A,N/A,N/A,216,223,N/A,77,4
14,N/A,N/A,N/A,202,216,N/A,83,4
8,N/A,N/A,N/A,194,202,N/A,89,4
2,N/A,N/A,N/A,192,194,N/A,93,2
18,N/A,N/A,N/A,174,192,N/A,96,5
18,N/A,N/A,N/A,156,174,N/A,102,5
12,N/A,N/A,N/A,144,156,N/A,108,5
10,N/A,N/A,N/A,134,144,N/A,113,4
4,N/A,N/A,N/A,130,134,N/A,117,2
16,N/A,N/A,N/A,114,130,N/A,121,6
4,N/A,N/A,N/A,110,114,N/A,124,3
4,N/A,N/A,N/A,106,110,N/A,130,3
2,N/A,N/A,N/A,104,106,N/A,134,1
11,N/A,N/A,N/A,93,104,N/A,138,5
3,N/A,N/A,N/A,1987,1990,N/A,5,2
2,N/A,N/A,N/A,1985,1987,N/A,10,1
5,N/A,N/A,N/A,1980,1985,N/A,13,4
14,N/A,N/A,N/A,1966,1980,N/A,19,4
12,N/A,N/A,N/A,1954,1966,N/A,25,4
2,N/A,N/A,N/A,1952,1954,N/A,30,3
3,N/A,N/A,N/A,1949,1952,N/A,36,3
2,N/A,N/A,N/A,1947,1949,N/A,41,2
18,N/A,N/A,N/A,1929,1947,N/A,45,6
2,N/A,N/A,N/A,1927,1929,N/A,48,3
2,N/A,N/A,N/A,1925,1927,N/A,54,3
2,N/A,N/A,N/A,1923,1925,N/A,59,2
12,N/A,N/A,N/A,1911,1923,N/A,63,6
5,N/A,N/A,N/A,1906,1911,N/A,67,4
4,N/A,N/A,N/A,1902,1906,N/A,71,2
18,N/A,N/A,N/A,1884,1902,N/A,75,6
3,N/A,N/A,N/A,1881,1884,N/A,78,3
15,N/A,N/A,N/A,1866,1881,N/A,81,6
14,N/A,N/A,N/A,1852,1866,N/A,86,5
14,N/A,N/A,N/A,1838,1852,N/A,91,4
3,N/A,N/A,N/A,1835,1838,N/A,96,3
1,N/A,N/A,N/A,1834,1835,N/A,100,1
2,N/A,N/A,N/A,1832,1834,N/A,106,1
1,N/A,N/A,N/A,1831,1832,N/A,112,1
1,N/A,N/A,N/A,1830,1831,N/A,118,1
20,N/A,N/A,N/A,1810,1830,N/A,123,6
2,N/A,N/A,N/A,1808,1810,N/A,129,0
3,N/A,N/A,N/A,1805,1808,N/A,132,3
3,N/A,N/A,N/A,1802,1805,N/A,137,2
2,N/A,N/A,N/A,1800,1802,N/A,142,1
13,N/A,N/A,N/A,1098,1111,N/A,6,5
19,N/A,N/A,N/A,1079,1098,N/A,12,5
4,N/A,N/A,N/A,1075,1079,N/A,15,2
2,N/A,N/A,N/A,1073,1075,N/A,20,1
10,N/A,N/A,N/A,1063,1073,N/A,24,5
3,N/A,N/A,N/A,1060,1063,N/A,27,2
11,N/A,N/A,N/A,1049,1060,N/A,30,5
3,N/A,N/A,N/A,1046,1049,N/A,34,3
4,N/A,N/A,N/A,1042,1046,N/A,40,3
3,N/A,N/A,N/A,1039,1042,N/A,45,2
18,N/A,N/A,N/A,1021,1039,N/A,49,6
10,N/A,N/A,N/A,1011,1021,N/A,53,4
4,N/A,N/A,N/A,1007,1011,N/A,58,3
2,N/A,N/A,N/A,1005,1007,N/A,62,1
17,N/A,N/A,N/A,988,1005,N/A,67,6
16,N/A,N/A,N/A,972,988,N/A,72,5
11,N/A,N/A,N/A,961,972,N/A,77,4
4,N/A,N/A,N/A,957,961,N/A,81,2
16,N/A,N/A,N/A,941,957,N/A,84,5
8,N/A,N/A,N/A,933,941,N/A,89,4
4,N/A,N/A,N/A,929,933,N/A,93,2
4,N/A,N/A,N/A,925,929,N/A,99,2
2,N/A,N/A,N/A,923,925,N/A,104,1
12,N/A,N/A,N/A,911,923,N/A,107,4
2,N/A,N/A,N/A,909,911,N/A,110,1
2,N/A,N/A,N/A,907,909,N/A,116,1
1,N/A,N/A,N/A,906,907,N/A,122,1
18,N/A,N/A,N/A,888,906,N/A,126,5
3,N/A,N/A,N/A,885,888,N/A,129,2
18,N/A,N/A,N/A,867,885,N/A,132,5
14,N/A,N/A,N/A,1227,1241,N/A,5,4
2,N/A,N/A,N/A,1225,1227,N/A,8,1
10,N/A,N/A,N/A,1215,1225,N/A,11,4
2,N/A,N/A,N/A,1213,1215,N/A,14,1
9,N/A,N/A,N/A,1204,1213,N/A,17,4
1,N/A,N/A,N/A,1203,1204,N/A,20,1
10,N/A,N/A,N/A,1193,1203,N/A,23,4
1,N/A,N/A,N/A,1192,1193,N/A,26,1
12,N/A,N/A,N/A,1180,1192,N/A,31,6
3,N/A,N/A,N/A,1177,1180,N/A,34,3
3,N/A,N/A,N/A,1174,1177,N/A,40,3
1,N/A,N/A,N/A,1173,1174,N/A,44,1
18,N/A,N/A,N/A,1155,1173,N/A,49,6
1,N/A,N/A,N/A,1154,1155,N/A,55,0
5,N/A,N/A,N/A,1149,1154,N/A,59,4
4,N/A,N/A,N/A,1145,1149,N/A,64,3
2,N/A,N/A,N/A,1143,1145,N/A,68,1
14,N/A,N/A,N/A,1129,1143,N/A,71,4
1,N/A,N/A,N/A,1128,1129,N/A,74,1
17,N/A,N/A,N/A,1111,1128,N/A,78,5
16,N/A,N/A,N/A,1095,1111,N/A,84,5
4,N/A,N/A,N/A,1091,1095,N/A,87,2
4,N/A,N/A,N/A,1087,1091,N/A,93,2
17,N/A,N/A,N/A,1070,1087,N/A,96,5
4,N/A,N/A,N/A,1066,1070,N/A,100,3
4,N/A,N/A,N/A,1062,1066,N/A,106,3
2,N/A,N/A,N/A,1060,1062,N/A,111,2
16,N/A,N/A,N/A,1044,1060,N/A,115,6
3,N/A,N/A,N/A,1041,1044,N/A,118,3
16,N/A,N/A,N/A,1025,1041,N/A,121,6
12,N/A,N/A,N/A,1155,1167,N/A,4,4
4,N/A,N/A,N/A,1151,1155,N/A,9,3
2,N/A,N/A,N/A,1149,1151,N/A,14,2
4,N/A,N/A,N/A,1145,1149,N/A,20,2
3,N/A,N/A,N/A,1142,1145,N/A,26,2
3,N/A,N/A,N/A,1139,1142,N/A,32,2
15,N/A,N/A,N/A,1124,1139,N/A,35,5
6,N/A,N/A,N/A,1118,1124,N/A,40,4
1,N/A,N/A,N/A,1117,1118,N/A,43,1
17,N/A,N/A,N/A,1100,1117,N/A,48,6
2,N/A,N/A,N/A,1098,1100,N/A,51,3
3,N/A,N/A,N/A,1095,1098,N/A,57,3
4,N/A,N/A,N/A,1091,1095,N/A,63,3
1,N/A,N/A,N/A,1090,1091,N/A,67,1
10,N/A,N/A,N/A,1080,1090,N/A,70,4
2,N/A,N/A,N/A,1078,1080,N/A,73,1
1,N/A,N/A,N/A,1077,1078,N/A,79,1
7,N/A,N/A,N/A,1070,1077,N/A,82,4
2,N/A,N/A,N/A,1068,1070,N/A,87,3
4,N/A,N/A,N/A,1064,1068,N/A,92,2
19,N/A,N/A,N/A,1045,1064,N/A,95,5
12,N/A,N/A,N/A,1033,1045,N/A,100,4
1,N/A,N/A,N/A,1032,1033,N/A,103,1
1,N/A,N/A,N/A,1031,1032,N/A,109,1
12,N/A,N/A,N/A,1019,1031,N/A,112,4
3,N/A,N/A,N/A,1016,1019,N/A,116,2
12,N/A,N/A,N/A,1004,1016,N/A,119,5
4,N/A,N/A,N/A,1000,1004,N/A,123,3
4,N/A,N/A,N/A,996,1000,N/A,129,3
3,N/A,N/A,N/A,993,996,N/A,135,3
2,N/A,N/A,N/A,898,900,N/A,6,2
18,N/A,N/A,N/A,880,898,N/A,9,5
4,N/A,N/A,N/A,876,880,N/A,12,2
1,N/A,N/A,N/A,875,876,N/A,17,1
16,N/A,N/A,N/A,859,875,N/A,21,5
14,N/A,N/A,N/A,845,859,N/A,26,4
3,N/A,N/A,N/A,842,845,N/A,31,3
2,N/A,N/A,N/A,840,842,N/A,37,3
1,N/A,N/A,N/A,839,840,N/A,41,1
11,N/A,N/A,N/A,828,839,N/A,44,4
13,N/A,N/A,N/A,815,828,N/A,50,4
3,N/A,N/A,N/A,812,815,N/A,54,2
2,N/A,N/A,N/A,810,812,N/A,60,2
2,N/A,N/A,N/A,808,810,N/A,66,2
13,N/A,N/A,N/A,795,808,N/A,69,5
9,N/A,N/A,N/A,786,795,N/A,74,4
3,N/A,N/A,N/A,783,786,N/A,78,2
14,N/A,N/A,N/A,769,783,N/A,82,6
6,N/A,N/A,N/A,763,769,N/A,86,4
13,N/A,N/A,N/A,750,763,N/A,92,4
3,N/A,N/A,N/A,747,750,N/A,97,3
2,N/A,N/A,N/A,745,747,N/A,101,1
13,N/A,N/A,N/A,732,745,N/A,105,5
4,N/A,N/A,N/A,728,732,N/A,109,3
16,N/A,N/A,N/A,712,728,N/A,112,6
13,N/A,N/A,N/A,699,712,N/A,116,4
11,N/A,N/A,N/A,688,699,N/A,122,4
3,N/A,N/A,N/A,685,688,N/A,126,2
2,N/A,N/A,N/A,683,685,N/A,131,1
12,N/A,N/A,N/A,671,683,N/A,136,6
16,N/A,N/A,N/A,533,549,N/A,3,5
4,N/A,N/A,N/A,529,533,N/A,7,3
2,N/A,N/A,N/A,527,529,N/A,11,1
19,N/A,N/A,N/A,508,527,N/A,15,5
11,N/A,N/A,N/A,497,508,N/A,21,5
3,N/A,N/A,N/A,494,497,N/A,25,3
13,N/A,N/A,N/A,481,494,N/A,28,6
4,N/A,N/A,N/A,477,481,N/A,31,3
1,N/A,N/A,N/A,476,477,N/A,35,1
6,N/A,N/A,N/A,470,476,N/A,38,4
3,N/A,N/A,N/A,467,470,N/A,42,2
13,N/A,N/A,N/A,454,467,N/A,46,6
2,N/A,N/A,N/A,452,454,N/A,52,0
13,N/A,N/A,N/A,439,452,N/A,57,5
11,N/A,N/A,N/A,428,439,N/A,63,5
5,N/A,N/A,N/A,423,428,N/A,68,4
10,N/A,N/A,N/A,413,423,N/A,74,4
1,N/A,N/A,N/A,412,413,N/A,77,1
15,N/A,N/A,N/A,397,412,N/A,82,6
12,N/A,N/A,N/A,385,397,N/A,87,5
3,N/A,N/A,N/A,382,385,N/A,90,2
20,N/A,N/A,N/A,362,382,N/A,94,6
1,N/A,N/A,N/A,361,362,N/A,100,0
3,N/A,N/A,N/A,358,361,N/A,103,3
19,N/A,N/A,N/A,339,358,N/A,106,6
17,N/A,N/A,N/A,322,339,N/A,111,5
4,N/A,N/A,N/A,318,322,N/A,115,3
18,N/A,N/A,N/A,300,318,N/A,118,6
10,N/A,N/A,N/A,290,300,N/A,123,5
2,N/A,N/A,N/A,288,290,N/A,127,3
17,N/A,N/A,N/A,686,703,N/A,5,5
3,N/A,N/A,N/A,683,686,N/A,8,2
14,N/A,N/A,N/A,669,683,N/A,11,5
3,N/A,N/A,N/A,666,669,N/A,14,2
19,N/A,N/A,N/A,647,666,N/A,18,6
2,N/A,N/A,N/A,645,647,N/A,21,3
2,N/A,N/A,N/A,643,645,N/A,27,3
2,N/A,N/A,N/A,641,643,N/A,31,1
2,N/A,N/A,N/A,639,641,N/A,37,1
8,N/A,N/A,N/A,631,639,N/A,40,4
4,N/A,N/A,N/A,627,631,N/A,44,2
16,N/A,N/A,N/A,611,627,N/A,47,5
3,N/A,N/A,N/A,608,611,N/A,50,2
17,N/A,N/A,N/A,591,608,N/A,54,6
2,N/A,N/A,N/A,589,591,N/A,60,0
2,N/A,N/A,N/A,587,589,N/A,63,3
2,N/A,N/A,N/A,585,587,N/A,69,3
1,N/A,N/A,N/A,584,585,N/A,73,1
16,N/A,N/A,N/A,568,584,N/A,78,6
4,N/A,N/A,N/A,564,568,N/A,81,3
2,N/A,N/A,N/A,562,564,N/A,85,1
13,N/A,N/A,N/A,549,562,N/A,90,6
6,N/A,N/A,N/A,543,549,N/A,94,4
9,N/A,N/A,N/A,534,543,N/A,100,4
1,N/A,N/A,N/A,533,534,N/A,103,1
16,N/A,N/A,N/A,517,533,N/A,107,5
4,N/A,N/A,N/A,513,517,N/A,110,2
3,N/A,N/A,N/A,510,513,N/A,116,2
2,N/A,N/A,N/A,508,510,N/A,121,1
2,N/A,N/A,N/A,506,508,N/A,127,1
2,N/A,N/A,N/A,1565,1567,N/A,4,2
1,N/A,N/A,N/A,1564,1565,N/A,9,1
14,N/A,N/A,N/A,1550,1564,N/A,12,4
4,N/A,N/A,N/A,1546,1550,N/A,17,3
2,N/A,N/A,N/A,1544,1546,N/A,23,3
15,N/A,N/A,N/A,1529,1544,N/A,26,6
2,N/A,N/A,N/A,1527,1529,N/A,29,3
4,N/A,N/A,N/A,1523,1527,N/A,34,2
14,N/A,N/A,N/A,1509,1523,N/A,38,6
11,N/A,N/A,N/A,1498,1509,N/A,42,4
3,N/A,N/A,N/A,1495,1498,N/A,47,3
3,N/A,N/A,N/A,1492,1495,N/A,53,3
19,N/A,N/A,N/A,1473,1492,N/A,56,6
11,N/A,N/A,N/A,1462,1473,N/A,61,5
2,N/A,N/A,N/A,1460,1462,N/A,65,3
1,N/A,N/A,N/A,1459,1460,N/A,69,1
16,N/A,N/A,N/A,1443,1459,N/A,73,5
2,N/A,N/A,N/A,1441,1443,N/A,77,3
18,N/A,N/A,N/A,1423,1441,N/A,80,6
5,N/A,N/A,N/A,1418,1423,N/A,84,4
1,N/A,N/A,N/A,1417,1418,N/A,87,1
11,N/A,N/A,N/A,1406,1417,N/A,91,5
10,N/A,N/A,N/A,1396,1406,N/A,96,4
2,N/A,N/A,N/A,1394,1396,N/A,100,2
16,N/A,N/A,N/A,1378,1394,N/A,104,6
2,N/A,N/A,N/A,1376,1378,N/A,110,0
17,N/A,N/A,N/A,1359,1376,N/A,115,5
12,N/A,N/A,N/A,1347,1359,N/A,120,4
3,N/A,N/A,N/A,1344,1347,N/A,124,2
12,N/A,N/A,N/A,1332,1344,N/A,128,6
14,N/A,N/A,N/A,1696,1710,N/A,5,4
4,N/A,N/A,N/A,1692,1696,N/A,10,3
1,N/A,N/A,N/A,1691,1692,N/A,14,1
13,N/A,N/A,N/A,1678,1691,N/A,17,4
4,N/A,N/A,N/A,1674,1678,N/A,22,3
4,N/A,N/A,N/A,1670,1674,N/A,27,2
16,N/A,N/A,N/A,1654,1670,N/A,31,6
2,N/A,N/A,N/A,1652,1654,N/A,34,3
3,N/A,N/A,N/A,1649,1652,N/A,40,3
2,N/A,N/A,N/A,1647,1649,N/A,45,2
3,N/A,N/A,N/A,1644,1647,N/A,51,2
13,N/A,N/A,N/A,1631,1644,N/A,55,6
11,N/A,N/A,N/A,1620,1631,N/A,59,4
1,N/A,N/A,N/A,1619,1620,N/A,62,1
13,N/A,N/A,N/A,1606,1619,N/A,65,4
9,N/A,N/A,N/A,1597,1606,N/A,71,4
4,N/A,N/A,N/A,1593,1597,N/A,76,3
18,N/A,N/A,N/A,1575,1593,N/A,79,6
17,N/A,N/A,N/A,1558,1575,N/A,84,5
13,N/A,N/A,N/A,1545,1558,N/A,89,4
4,N/A,N/A,N/A,1541,1545,N/A,93,2
19,N/A,N/A,N/A,1522,1541,N/A,97,6
19,N/A,N/A,N/A,1503,1522,N/A,102,5
3,N/A,N/A,N/A,1500,1503,N/A,106,3
3,N/A,N/A,N/A,1497,1500,N/A,111,2
2,N/A,N/A,N/A,1495,1497,N/A,117,2
4,N/A,N/A,N/A,1491,1495,N/A,123,2
1,N/A,N/A,N/A,1490,1491,N/A,128,1
16,N/A,N/A,N/A,1474,1490,N/A,133,6
19,N/A,N/A,N/A,1455,1474,N/A,138,5
18,N/A,N/A,N/A,359,377,N/A,6,6
13,N/A,N/A,N/A,346,359,N/A,11,5
16,N/A,N/A,N/A,330,346,N/A,17,5
3,N/A,N/A,N/A,327,330,N/A,20,2
3,N/A,N/A,N/A,324,327,N/A,26,2
1,N/A,N/A,N/A,323,324,N/A,31,1
2,N/A,N/A,N/A,321,323,N/A,37,1
5,N/A,N/A,N/A,316,321,N/A,40,4
14,N/A,N/A,N/A,302,316,N/A,46,4
3,N/A,N/A,N/A,299,302,N/A,50,2
2,N/A,N/A,N/A,297,299,N/A,55,1
2,N/A,N/A,N/A,295,297,N/A,61,1
5,N/A,N/A,N/A,290,295,N/A,64,4
13,N/A,N/A,N/A,277,290,N/A,70,4
8,N/A,N/A,N/A,269,277,N/A,76,4
2,N/A,N/A,N/A,267,269,N/A,81,3
19,N/A,N/A,N/A,248,267,N/A,84,6
9,N/A,N/A,N/A,239,248,N/A,88,4
3,N/A,N/A,N/A,236,239,N/A,92,2
14,N/A,N/A,N/A,222,236,N/A,95,5
13,N/A,N/A,N/A,209,222,N/A,100,4
11,N/A,N/A,N/A,198,209,N/A,106,4
1,N/A,N/A,N/A,197,198,N/A,109,1
15,N/A,N/A,N/A,182,197,N/A,114,6
11,N/A,N/A,N/A,171,182,N/A,118,4
8,N/A,N/A,N/A,163,171,N/A,124,4
4,N/A,N/A,N/A,159,163,N/A,129,3
2,N/A,N/A,N/A,157,159,N/A,133,1
12,N/A,N/A,N/A,145,157,N/A,138,6
3,N/A,N/A,N/A,142,145,N/A,141,3
11,N/A,N/A,N/A,302,313,N/A,6,4
2,N/A,N/A,N/A,300,302,N/A,9,1
14,N/A,N/A,N/A,286,300,N/A,13,5
5,N/A,N/A,N/A,281,286,N/A,18,4
2,N/A,N/A,N/A,279,281,N/A,21,1
17,N/A,N/A,N/A,262,279,N/A,25,5
5,N/A,N/A,N/A,257,262,N/A,30,4
4,N/A,N/A,N/A,253,257,N/A,34,2
18,N/A,N/A,N/A,235,253,N/A,37,5
17,N/A,N/A,N/A,218,235,N/A,43,5
10,N/A,N/A,N/A,208,218,N/A,48,4
1,N/A,N/A,N/A,207,208,N/A,51,1
1,N/A,N/A,N/A,206,207,N/A,57,1
16,N/A,N/A,N/A,190,206,N/A,61,5
6,N/A,N/A,N/A,184,190,N/A,66,4
4,N/A,N/A,N/A,180,184,N/A,71,3
16,N/A,N/A,N/A,164,180,N/A,74,6
4,N/A,N/A,N/A,160,164,N/A,77,3
2,N/A,N/A,N/A,158,160,N/A,82,2
4,N/A,N/A,N/A,154,158,N/A,88,2
1,N/A,N/A,N/A,153,154,N/A,93,1
11,N/A,N/A,N/A,142,153,N/A,97,5
11,N/A,N/A,N/A,131,142,N/A,102,4
2,N/A,N/A,N/A,129,131,N/A,107,3
17,N/A,N/A,N/A,112,129,N/A,110,6
11,N/A,N/A,N/A,101,112,N/A,114,4
3,N/A,N/A,N/A,98,101,N/A,119,3
2,N/A,N/A,N/A,96,98,N/A,123,1
13,N/A,N/A,N/A,83,96,N/A,128,6
8,N/A,N/A,N/A,75,83,N/A,132,4
2,N/A,N/A,N/A,1022,1024,N/A,3,3
13,N/A,N/A,N/A,1009,1022,N/A,6,6
12,N/A,N/A,N/A,997,1009,N/A,11,5
4,N/A,N/A,N/A,993,997,N/A,15,3
2,N/A,N/A,N/A,991,993,N/A,20,2
17,N/A,N/A,N/A,974,991,N/A,24,6
2,N/A,N/A,N/A,972,974,N/A,27,3
18,N/A,N/A,N/A,954,972,N/A,30,6
2,N/A,N/A,N/A,952,954,N/A,36,0
11,N/A,N/A,N/A,941,952,N/A,40,4
6,N/A,N/A,N/A,935,941,N/A,46,4
2,N/A,N/A,N/A,933,935,N/A,49,1
11,N/A,N/A,N/A,922,933,N/A,54,6
1,N/A,N/A,N/A,921,922,N/A,60,0
14,N/A,N/A,N/A,907,921,N/A,65,5
8,N/A,N/A,N/A,899,907,N/A,70,4
3,N/A,N/A,N/A,896,899,N/A,74,2
2,N/A,N/A,N/A,894,896,N/A,79,1
1,N/A,N/A,N/A,893,894,N/A,85,1
2,N/A,N/A,N/A,891,893,N/A,91,1
13,N/A,N/A,N/A,878,891,N/A,94,4
2,N/A,N/A,N/A,876,878,N/A,98,2
1,N/A,N/A,N/A,875,876,N/A,103,1
1,N/A,N/A,N/A,874,875,N/A,109,1
16,N/A,N/A,N/A,858,874,N/A,114,6
10,N/A,N/A,N/A,848,858,N/A,118,4
2,N/A,N/A,N/A,846,848,N/A,122,2
14,N/A,N/A,N/A,832,846,N/A,126,6
2,N/A,N/A,N/A,830,832,N/A,129,3
3,N/A,N/A,N/A,827,830,N/A,135,3
4,N/A,N/A,N/A,1448,1452,N/A,4,3
2,N/A,N/A,N/A,1446,1448,N/A,8,1
14,N/A,N/A,N/A,1432,1446,N/A,12,5
4,N/A,N/A,N/A,1428,1432,N/A,15,2
16,N/A,N/A,N/A,1412,1428,N/A,18,5
14,N/A,N/A,N/A,1398,1412,N/A,24,5
2,N/A,N/A,N/A,1396,1398,N/A,27,2
2,N/A,N/A,N/A,1394,1396,N/A,33,2
13,N/A,N/A,N/A,1381,1394,N/A,36,5
13,N/A,N/A,N/A,1368,1381,N/A,42,5
2,N/A,N/A,N/A,1366,1368,N/A,46,3
4,N/A,N/A,N/A,1362,1366,N/A,51,2
2,N/A,N/A,N/A,1360,1362,N/A,57,2
18,N/A,N/A,N/A,1342,1360,N/A,60,5
19,N/A,N/A,N/A,1323,1342,N/A,66,5
19,N/A,N/A,N/A,1304,1323,N/A,72,5
12,N/A,N/A,N/A,1292,1304,N/A,78,5
4,N/A,N/A,N/A,1288,1292,N/A,81,2
3,N/A,N/A,N/A,1285,1288,N/A,87,2
19,N/A,N/A,N/A,1266,1285,N/A,90,5
17,N/A,N/A,N/A,1249,1266,N/A,96,5
3,N/A,N/A,N/A,1246,1249,N/A,100,3
3,N/A,N/A,N/A,1243,1246,N/A,105,2
2,N/A,N/A,N/A,1241,1243,N/A,111,2
14,N/A,N/A,N/A,1227,1241,N/A,114,5
14,N/A,N/A,N/A,1213,1227,N/A,119,4
3,N/A,N/A,N/A,1210,1213,N/A,123,2
19,N/A,N/A,N/A,1191,1210,N/A,127,6
1,N/A,N/A,N/A,1190,1191,N/A,133,0
17,N/A,N/A,N/A,1173,1190,N/A,138,5
11,N/A,N/A,N/A,1131,1142,N/A,6,5
3,N/A,N/A,N/A,1128,1131,N/A,10,3
20,N/A,N/A,N/A,1108,1128,N/A,13,6
15,N/A,N/A,N/A,1093,1108,N/A,18,5
4,N/A,N/A,N/A,1089,1093,N/A,22,3
2,N/A,N/A,N/A,1087,1089,N/A,27,2
10,N/A,N/A,N/A,1077,1087,N/A,30,5
4,N/A,N/A,N/A,1073,1077,N/A,33,2
12,N/A,N/A,N/A,1061,1073,N/A,37,6
2,N/A,N/A,N/A,1059,1061,N/A,40,3
2,N/A,N/A,N/A,1057,1059,N/A,45,2
1,N/A,N/A,N/A,1056,1057,N/A,50,1
2,N/A,N/A,N/A,1054,1056,N/A,56,1
20,N/A,N/A,N/A,1034,1054,N/A,61,6
14,N/A,N/A,N/A,1020,1034,N/A,65,4
2,N/A,N/A,N/A,1018,1020,N/A,68,1
2,N/A,N/A,N/A,1016,1018,N/A,74,1
14,N/A,N/A,N/A,1002,1016,N/A,77,4
4,N/A,N/A,N/A,998,1002,N/A,81,2
13,N/A,N/A,N/A,985,998,N/A,84,5
19,N/A,N/A,N/A,966,985,N/A,90,5
3,N/A,N/A,N/A,963,966,N/A,94,3
17,N/A,N/A,N/A,946,963,N/A,97,6
2,N/A,N/A,N/A,944,946,N/A,100,3
1,N/A,N/A,N/A,943,944,N/A,104,1
12,N/A,N/A,N/A,931,943,N/A,109,6
1,N/A,N/A,N/A,930,931,N/A,115,0
17,N/A,N/A,N/A,913,930,N/A,121,6
13,N/A,N/A,N/A,900,913,N/A,125,4
4,N/A,N/A,N/A,896,900,N/A,129,2
14,N/A,N/A,N/A,1824,1838,N/A,4,4
3,N/A,N/A,N/A,1821,1824,N/A,8,2
1,N/A,N/A,N/A,1820,1821,N/A,13,1
10,N/A,N/A,N/A,1810,1820,N/A,17,5
4,N/A,N/A,N/A,1806,1810,N/A,20,2
2,N/A,N/A,N/A,1804,1806,N/A,26,2
13,N/A,N/A,N/A,1791,1804,N/A,30,6
18,N/A,N/A,N/A,1773,1791,N/A,35,5
12,N/A,N/A,N/A,1761,1773,N/A,41,5
5,N/A,N/A,N/A,1756,1761,N/A,46,4
2,N/A,N/A,N/A,1754,1756,N/A,50,2
4,N/A,N/A,N/A,1750,1754,N/A,56,2
12,N/A,N/A,N/A,1738,1750,N/A,59,5
4,N/A,N/A,N/A,1734,1738,N/A,62,2
3,N/A,N/A,N/A,1731,1734,N/A,68,2
15,N/A,N/A,N/A,1716,1731,N/A,71,5
8,N/A,N/A,N/A,1708,1716,N/A,76,4
2,N/A,N/A,N/A,1706,1708,N/A,79,1
16,N/A,N/A,N/A,1690,1706,N/A,83,5
10,N/A,N/A,N/A,1680,1690,N/A,88,4
2,N/A,N/A,N/A,1678,1680,N/A,91,1
5,N/A,N/A,N/A,1673,1678,N/A,94,4
2,N/A,N/A,N/A,1671,1673,N/A,98,2
4,N/A,N/A,N/A,1667,1671,N/A,104,2
4,N/A,N/A,N/A,1663,1667,N/A,110,2
13,N/A,N/A,N/A,1650,1663,N/A,114,6
2,N/A,N/A,N/A,1648,1650,N/A,120,0
9,N/A,N/A,N/A,1639,1648,N/A,124,4
5,N/A,N/A,N/A,1634,1639,N/A,130,4
11,N/A,N/A,N/A,1623,1634,N/A,136,4
12,N/A,N/A,N/A,878,890,N/A,4,4
1,N/A,N/A,N/A,877,878,N/A,7,1
17,N/A,N/A,N/A,860,877,N/A,12,6
1,N/A,N/A,N/A,859,860,N/A,18,0
16,N/A,N/A,N/A,843,859,N/A,24,6
8,N/A,N/A,N/A,835,843,N/A,28,4
4,N/A,N/A,N/A,831,835,N/A,32,2
12,N/A,N/A,N/A,819,831,N/A,36,6
7,N/A,N/A,N/A,812,819,N/A,40,4
4,N/A,N/A,N/A,808,812,N/A,44,2
2,N/A,N/A,N/A,806,808,N/A,49,1
19,N/A,N/A,N/A,787,806,N/A,54,6
16,N/A,N/A,N/A,771,787,N/A,59,5
16,N/A,N/A,N/A,755,771,N/A,65,5
11,N/A,N/A,N/A,744,755,N/A,71,5
2,N/A,N/A,N/A,742,744,N/A,75,3
2,N/A,N/A,N/A,740,742,N/A,80,2
2,N/A,N/A,N/A,738,740,N/A,85,1
13,N/A,N/A,N/A,725,738,N/A,90,6
12,N/A,N/A,N/A,713,725,N/A,94,4
4,N/A,N/A,N/A,709,713,N/A,99,3
1,N/A,N/A,N/A,708,709,N/A,103,1
1,N/A,N/A,N/A,707,708,N/A,109,1
13,N/A,N/A,N/A,694,707,N/A,114,6
2,N/A,N/A,N/A,692,694,N/A,117,3
2,N/A,N/A,N/A,690,692,N/A,123,3
12,N/A,N/A,N/A,678,690,N/A,126,6
3,N/A,N/A,N/A,675,678,N/A,129,3
4,N/A,N/A,N/A,671,675,N/A,134,2
2,N/A,N/A,N/A,669,671,N/A,139,1
4,N/A,N/A,N/A,1387,1391,N/A,6,3
2,N/A,N/A,N/A,1385,1387,N/A,10,1
2,N/A,N/A,N/A,1383,1385,N/A,16,1
2,N/A,N/A,N/A,1381,1383,N/A,22,1
1,N/A,N/A,N/A,1380,1381,N/A,28,1
17,N/A,N/A,N/A,1363,1380,N/A,33,6
2,N/A,N/A,N/A,1361,1363,N/A,39,0
6,N/A,N/A,N/A,1355,1361,N/A,43,4
2,N/A,N/A,N/A,1353,1355,N/A,47,2
15,N/A,N/A,N/A,1338,1353,N/A,51,6
3,N/A,N/A,N/A,1335,1338,N/A,54,3
1,N/A,N/A,N/A,1334,1335,N/A,58,1
13,N/A,N/A,N/A,1321,1334,N/A,61,4
4,N/A,N/A,N/A,1317,1321,N/A,65,2
18,N/A,N/A,N/A,1299,1317,N/A,68,5
15,N/A,N/A,N/A,1284,1299,N/A,74,5
10,N/A,N/A,N/A,1274,1284,N/A,80,5
14,N/A,N/A,N/A,1260,1274,N/A,85,4
2,N/A,N/A,N/A,1258,1260,N/A,90,3
13,N/A,N/A,N/A,1245,1258,N/A,93,6
10,N/A,N/A,N/A,1235,1245,N/A,98,5
3,N/A,N/A,N/A,1232,1235,N/A,102,3
11,N/A,N/A,N/A,1221,1232,N/A,105,6
4,N/A,N/A,N/A,1217,1221,N/A,108,3
1,N/A,N/A,N/A,1216,1217,N/A,112,1
14,N/A,N/A,N/A,1202,1216,N/A,115,4
2,N/A,N/A,N/A,1200,1202,N/A,120,3
2,N/A,N/A,N/A,1198,1200,N/A,124,1
17,N/A,N/A,N/A,1181,1198,N/A,128,5
4,N/A,N/A,N/A,1177,1181,N/A,131,2
14,N/A,N/A,N/A,1665,1679,N/A,5,5
3,N/A,N/A,N/A,1662,1665,N/A,9,3
2,N/A,N/A,N/A,1660,1662,N/A,14,2
16,N/A,N/A,N/A,1644,1660,N/A,17,5
13,N/A,N/A,N/A,1631,1644,N/A,23,5
16,N/A,N/A,N/A,1615,1631,N/A,29,5
3,N/A,N/A,N/A,1612,1615,N/A,32,2
17,N/A,N/A,N/A,1595,1612,N/A,35,5
14,N/A,N/A,N/A,1581,1595,N/A,41,5
3,N/A,N/A,N/A,1578,1581,N/A,45,3
20,N/A,N/A,N/A,1558,1578,N/A,48,6
2,N/A,N/A,N/A,1556,1558,N/A,54,0
4,N/A,N/A,N/A,1552,1556,N/A,57,3
4,N/A,N/A,N/A,1548,1552,N/A,62,2
15,N/A,N/A,N/A,1533,1548,N/A,66,6
8,N/A,N/A,N/A,1525,1533,N/A,70,4
3,N/A,N/A,N/A,1522,1525,N/A,74,2
13,N/A,N/A,N/A,1509,1522,N/A,78,6
11,N/A,N/A,N/A,1498,1509,N/A,83,5
14,N/A,N/A,N/A,1484,1498,N/A,89,5
4,N/A,N/A,N/A,1480,1484,N/A,93,3
12,N/A,N/A,N/A,1468,1480,N/A,96,6
2,N/A,N/A,N/A,1466,1468,N/A,99,3
3,N/A,N/A,N/A,1463,1466,N/A,105,3
16,N/A,N/A,N/A,1447,1463,N/A,108,6
2,N/A,N/A,N/A,1445,1447,N/A,111,3
2,N/A,N/A,N/A,1443,1445,N/A,116,2
19,N/A,N/A,N/A,1424,1443,N/A,120,6
2,N/A,N/A,N/A,1422,1424,N/A,123,3
1,N/A,N/A,N/A,1421,1422,N/A,127,1
17,N/A,N/A,N/A,1073,1090,N/A,6,5
7,N/A,N/A,N/A,1066,1073,N/A,11,4
2,N/A,N/A,N/A,1064,1066,N/A,16,3
16,N/A,N/A,N/A,1048,1064,N/A,19,6
4,N/A,N/A,N/A,1044,1048,N/A,22,3
1,N/A,N/A,N/A,1043,1044,N/A,26,1
14,N/A,N/A,N/A,1029,1043,N/A,30,5
6,N/A,N/A,N/A,1023,1029,N/A,35,4
2,N/A,N/A,N/A,1021,1023,N/A,40,3
3,N/A,N/A,N/A,1018,1021,N/A,45,2
2,N/A,N/A,N/A,1016,1018,N/A,51,2
14,N/A,N/A,N/A,1002,1016,N/A,55,6
8,N/A,N/A,N/A,994,1002,N/A,59,4
1,N/A,N/A,N/A,993,994,N/A,62,1
1,N/A,N/A,N/A,992,993,N/A,68,1
14,N/A,N/A,N/A,978,992,N/A,72,5
12,N/A,N/A,N/A,966,978,N/A,77,4
3,N/A,N/A,N/A,963,966,N/A,81,2
1,N/A,N/A,N/A,962,963,N/A,86,1
2,N/A,N/A,N/A,960,962,N/A,92,1
13,N/A,N/A,N/A,947,960,N/A,95,4
4,N/A,N/A,N/A,943,947,N/A,99,2
18,N/A,N/A,N/A,925,943,N/A,102,5
2,N/A,N/A,N/A,923,925,N/A,105,2
10,N/A,N/A,N/A,913,923,N/A,108,5
4,N/A,N/A,N/A,909,913,N/A,112,3
11,N/A,N/A,N/A,898,909,N/A,115,6
2,N/A,N/A,N/A,896,898,N/A,121,0
6,N/A,N/A,N/A,890,896,N/A,125,4
8,N/A,N/A,N/A,882,890,N/A,131,4
2,N/A,N/A,N/A,483,485,N/A,4,1
18,N/A,N/A,N/A,465,483,N/A,8,5
5,N/A,N/A,N/A,460,465,N/A,13,4
2,N/A,N/A,N/A,458,460,N/A,17,2
2,N/A,N/A,N/A,456,458,N/A,22,1
2,N/A,N/A,N/A,454,456,N/A,28,1
19,N/A,N/A,N/A,435,454,N/A,33,6
11,N/A,N/A,N/A,424,435,N/A,38,5
4,N/A,N/A,N/A,420,424,N/A,41,2
2,N/A,N/A,N/A,418,420,N/A,47,2
17,N/A,N/A,N/A,401,418,N/A,51,6
6,N/A,N/A,N/A,395,401,N/A,55,4
4,N/A,N/A,N/A,391,395,N/A,59,2
15,N/A,N/A,N/A,376,391,N/A,63,6
1,N/A,N/A,N/A,375,376,N/A,69,0
14,N/A,N/A,N/A,361,375,N/A,75,6
18,N/A,N/A,N/A,343,361,N/A,80,5
4,N/A,N/A,N/A,339,343,N/A,84,3
4,N/A,N/A,N/A,335,339,N/A,90,3
14,N/A,N/A,N/A,321,335,N/A,93,6
17,N/A,N/A,N/A,304,321,N/A,98,5
12,N/A,N/A,N/A,292,304,N/A,104,5
11,N/A,N/A,N/A,281,292,N/A,109,4
8,N/A,N/A,N/A,273,281,N/A,115,4
2,N/A,N/A,N/A,271,273,N/A,120,3
2,N/A,N/A,N/A,269,271,N/A,124,1
14,N/A,N/A,N/A,255,269,N/A,127,4
3,N/A,N/A,N/A,252,255,N/A,131,2
2,N/A,N/A,N/A,250,252,N/A,136,1
2,N/A,N/A,N/A,248,250,N/A,142,1
18,N/A,N/A,N/A,893,911,N/A,3,5
2,N/A,N/A,N/A,891,893,N/A,6,2
18,N/A,N/A,N/A,873,891,N/A,9,5
6,N/A,N/A,N/A,867,873,N/A,14,4
3,N/A,N/A,N/A,864,867,N/A,18,2
17,N/A,N/A,N/A,847,864,N/A,22,6
2,N/A,N/A,N/A,845,847,N/A,28,0
11,N/A,N/A,N/A,834,845,N/A,34,6
8,N/A,N/A,N/A,826,834,N/A,38,4
4,N/A,N/A,N/A,822,826,N/A,42,2
2,N/A,N/A,N/A,820,822,N/A,47,1
9,N/A,N/A,N/A,811,820,N/A,50,4
14,N/A,N/A,N/A,797,811,N/A,56,4
9,N/A,N/A,N/A,788,797,N/A,62,4
2,N/A,N/A,N/A,786,788,N/A,65,1
13,N/A,N/A,N/A,773,786,N/A,70,6
12,N/A,N/A,N/A,761,773,N/A,74,4
4,N/A,N/A,N/A,757,761,N/A,79,3
1,N/A,N/A,N/A,756,757,N/A,83,1
6,N/A,N/A,N/A,750,756,N/A,86,4
9,N/A,N/A,N/A,741,750,N/A,92,4
2,N/A,N/A,N/A,739,741,N/A,96,2
2,N/A,N/A,N/A,737,739,N/A,101,1
1,N/A,N/A,N/A,736,737,N/A,107,1
7,N/A,N/A,N/A,729,736,N/A,110,4
2,N/A,N/A,N/A,727,729,N/A,113,1
14,N/A,N/A,N/A,713,727,N/A,117,5
2,N/A,N/A,N/A,711,713,N/A,121,3
17,N/A,N/A,N/A,694,711,N/A,124,6
1,N/A,N/A,N/A,693,694,N/A,130,0
2,N/A,N/A,N/A,863,865,N/A,4,1
15,N/A,N/A,N/A,848,863,N/A,8,5
4,N/A,N/A,N/A,844,848,N/A,12,3
4,N/A,N/A,N/A,840,844,N/A,18,3
2,N/A,N/A,N/A,838,840,N/A,22,1
8,N/A,N/A,N/A,830,838,N/A,25,4
3,N/A,N/A,N/A,827,830,N/A,30,3
2,N/A,N/A,N/A,825,827,N/A,35,2
17,N/A,N/A,N/A,808,825,N/A,39,6
5,N/A,N/A,N/A,803,808,N/A,43,4
4,N/A,N/A,N/A,799,803,N/A,47,2
17,N/A,N/A,N/A,782,799,N/A,50,5
2,N/A,N/A,N/A,780,782,N/A,54,3
3,N/A,N/A,N/A,777,780,N/A,60,3
2,N/A,N/A,N/A,775,777,N/A,65,2
19,N/A,N/A,N/A,756,775,N/A,69,6
2,N/A,N/A,N/A,754,756,N/A,75,0
19,N/A,N/A,N/A,735,754,N/A,80,5
2,N/A,N/A,N/A,733,735,N/A,83,2
13,N/A,N/A,N/A,720,733,N/A,87,6
3,N/A,N/A,N/A,717,720,N/A,90,3
4,N/A,N/A,N/A,713,717,N/A,95,2
1,N/A,N/A,N/A,712,713,N/A,100,1
6,N/A,N/A,N/A,706,712,N/A,103,4
1,N/A,N/A,N/A,705,706,N/A,106,1
1,N/A,N/A,N/A,704,705,N/A,112,1
8,N/A,N/A,N/A,696,704,N/A,115,4
12,N/A,N/A,N/A,684,696,N/A,121,4
4,N/A,N/A,N/A,680,684,N/A,125,2
4,N/A,N/A,N/A,676,680,N/A,131,2
13,N/A,N/A,N/A,716,729,N/A,6,4
4,N/A,N/A,N/A,712,716,N/A,11,3
2,N/A,N/A,N/A,710,712,N/A,17,3
3,N/A,N/A,N/A,707,710,N/A,23,3
11,N/A,N/A,N/A,696,707,N/A,26,6
1,N/A,N/A,N/A,695,696,N/A,32,0
19,N/A,N/A,N/A,676,695,N/A,37,5
19,N/A,N/A,N/A,657,676,N/A,43,5
4,N/A,N/A,N/A,653,657,N/A,47,3
12,N/A,N/A,N/A,641,653,N/A,50,6
4,N/A,N/A,N/A,637,641,N/A,53,3
4,N/A,N/A,N/A,633,637,N/A,58,2
4,N/A,N/A,N/A,629,633,N/A,64,2
14,N/A,N/A,N/A,615,629,N/A,68,6
2,N/A,N/A,N/A,613,615,N/A,74,0
19,N/A,N/A,N/A,594,613,N/A,79,5
4,N/A,N/A,N/A,590,594,N/A,83,3
16,N/A,N/A,N/A,574,590,N/A,86,6
3,N/A,N/A,N/A,571,574,N/A,89,3
4,N/A,N/A,N/A,567,571,N/A,94,2
1,N/A,N/A,N/A,566,567,N/A,99,1
13,N/A,N/A,N/A,553,566,N/A,104,6
3,N/A,N/A,N/A,550,553,N/A,107,3
3,N/A,N/A,N/A,547,550,N/A,113,3
18,N/A,N/A,N/A,529,547,N/A,116,6
3,N/A,N/A,N/A,526,529,N/A,119,3
2,N/A,N/A,N/A,524,526,N/A,123,1
15,N/A,N/A,N/A,509,524,N/A,127,5
4,N/A,N/A,N/A,505,509,N/A,130,2
2,N/A,N/A,N/A,503,505,N/A,135,1
3,N/A,N/A,N/A,375,378,N/A,6,3
2,N/A,N/A,N/A,373,375,N/A,10,1
11,N/A,N/A,N/A,362,373,N/A,15,6
12,N/A,N/A,N/A,350,362,N/A,19,4
13,N/A,N/A,N/A,337,350,N/A,25,4
1,N/A,N/A,N/A,336,337,N/A,28,1
17,N/A,N/A,N/A,319,336,N/A,32,5
4,N/A,N/A,N/A,315,319,N/A,36,3
1,N/A,N/A,N/A,314,315,N/A,40,1
1,N/A,N/A,N/A,313,314,N/A,46,1
10,N/A,N/A,N/A,303,313,N/A,50,5
4,N/A,N/A,N/A,299,303,N/A,53,2
15,N/A,N/A,N/A,284,299,N/A,56,5
4,N/A,N/A,N/A,280,284,N/A,60,3
1,N/A,N/A,N/A,279,280,N/A,64,1
1,N/A,N/A,N/A,278,279,N/A,70,1
2,N/A,N/A,N/A,276,278,N/A,76,1
20,N/A,N/A,N/A,256,276,N/A,81,6
4,N/A,N/A,N/A,252,256,N/A,84,3
2,N/A,N/A,N/A,250,252,N/A,88,1
13,N/A,N/A,N/A,237,250,N/A,93,6
4,N/A,N/A,N/A,233,237,N/A,96,3
3,N/A,N/A,N/A,230,233,N/A,101,2
1,N/A,N/A,N/A,229,230,N/A,106,1
14,N/A,N/A,N/A,215,229,N/A,111,6
9,N/A,N/A,N/A,206,215,N/A,115,4
2,N/A,N/A,N/A,204,206,N/A,118,1
2,N/A,N/A,N/A,202,204,N/A,124,1
14,N/A,N/A,N/A,188,202,N/A,129,6
7,N/A,N/A,N/A,181,188,N/A,133,4
2,N/A,N/A,N/A,1931,1933,N/A,6,3
2,N/A,N/A,N/A,1929,1931,N/A,10,1
8,N/A,N/A,N/A,1921,1929,N/A,13,4
4,N/A,N/A,N/A,1917,1921,N/A,17,2
18,N/A,N/A,N/A,1899,1917,N/A,21,6
2,N/A,N/A,N/A,1897,1899,N/A,24,3
13,N/A,N/A,N/A,1884,1897,N/A,27,6
2,N/A,N/A,N/A,1882,1884,N/A,33,0
19,N/A,N/A,N/A,1863,1882,N/A,39,6
4,N/A,N/A,N/A,1859,1863,N/A,42,3
2,N/A,N/A,N/A,1857,1859,N/A,48,3
14,N/A,N/A,N/A,1843,1857,N/A,51,6
1,N/A,N/A,N/A,1842,1843,N/A,57,0
4,N/A,N/A,N/A,1838,1842,N/A,60,3
16,N/A,N/A,N/A,1822,1838,N/A,63,6
1,N/A,N/A,N/A,1821,1822,N/A,69,0
11,N/A,N/A,N/A,1810,1821,N/A,73,4
2,N/A,N/A,N/A,1808,1810,N/A,76,1
1,N/A,N/A,N/A,1807,1808,N/A,82,1
12,N/A,N/A,N/A,1795,1807,N/A,87,6
1,N/A,N/A,N/A,1794,1795,N/A,93,0
19,N/A,N/A,N/A,1775,1794,N/A,99,6
2,N/A,N/A,N/A,1773,1775,N/A,105,0
11,N/A,N/A,N/A,1762,1773,N/A,110,5
17,N/A,N/A,N/A,1745,1762,N/A,116,5
10,N/A,N/A,N/A,1735,1745,N/A,121,4
1,N/A,N/A,N/A,1734,1735,N/A,124,1
11,N/A,N/A,N/A,1723,1734,N/A,129,6
12,N/A,N/A,N/A,1711,1723,N/A,133,4
7,N/A,N/A,N/A,1704,1711,N/A,139,4
11,N/A,N/A,N/A,1441,1452,N/A,3,6
2,N/A,N/A,N/A,1439,1441,N/A,6,3
4,N/A,N/A,N/A,1435,1439,N/A,12,3
3,N/A,N/A,N/A,1432,1435,N/A,18,3
19,N/A,N/A,N/A,1413,1432,N/A,21,6
12,N/A,N/A,N/A,1401,1413,N/A,26,5
6,N/A,N/A,N/A,1395,1401,N/A,31,4
3,N/A,N/A,N/A,1392,1395,N/A,35,2
10,N/A,N/A,N/A,1382,1392,N/A,38,5
11,N/A,N/A,N/A,1371,1382,N/A,44,5
17,N/A,N/A,N/A,1354,1371,N/A,50,5
19,N/A,N/A,N/A,1335,1354,N/A,56,5
13,N/A,N/A,N/A,1322,1335,N/A,61,4
3,N/A,N/A,N/A,1319,1322,N/A,66,3
2,N/A,N/A,N/A,1317,1319,N/A,70,1
10,N/A,N/A,N/A,1307,1317,N/A,74,5
3,N/A,N/A,N/A,1304,1307,N/A,78,3
3,N/A,N/A,N/A,1301,1304,N/A,84,3
12,N/A,N/A,N/A,1289,1301,N/A,87,6
1,N/A,N/A,N/A,1288,1289,N/A,93,0
13,N/A,N/A,N/A,1275,1288,N/A,99,6
2,N/A,N/A,N/A,1273,1275,N/A,102,3
2,N/A,N/A,N/A,1271,1273,N/A,108,3
4,N/A,N/A,N/A,1267,1271,N/A,113,2
1,N/A,N/A,N/A,1266,1267,N/A,118,1
8,N/A,N/A,N/A,1258,1266,N/A,121,4
1,N/A,N/A,N/A,1257,1258,N/A,124,1
19,N/A,N/A,N/A,1238,1257,N/A,129,6
13,N/A,N/A,N/A,1225,1238,N/A,133,4
1,N/A,N/A,N/A,1224,1225,N/A,136,1
20,N/A,N/A,N/A,1345,1365,N/A,5,6
1,N/A,N/A,N/A,1344,1345,N/A,11,0
14,N/A,N/A,N/A,1330,1344,N/A,15,4
2,N/A,N/A,N/A,1328,1330,N/A,20,3
4,N/A,N/A,N/A,1324,1328,N/A,26,3
2,N/A,N/A,N/A,1322,1324,N/A,30,1
2,N/A,N/A,N/A,1320,1322,N/A,36,1
13,N/A,N/A,N/A,1307,1320,N/A,40,5
10,N/A,N/A,N/A,1297,1307,N/A,46,5
4,N/A,N/A,N/A,1293,1297,N/A,50,3
4,N/A,N/A,N/A,1289,1293,N/A,55,2
2,N/A,N/A,N/A,1287,1289,N/A,61,2
2,N/A,N/A,N/A,1285,1287,N/A,67,2
4,N/A,N/A,N/A,1281,1285,N/A,73,2
2,N/A,N/A,N/A,1279,1281,N/A,79,2
18,N/A,N/A,N/A,1261,1279,N/A,82,5
2,N/A,N/A,N/A,1259,1261,N/A,86,3
2,N/A,N/A,N/A,1257,1259,N/A,90,1
9,N/A,N/A,N/A,1248,1257,N/A,93,4
12,N/A,N/A,N/A,1236,1248,N/A,99,4
2,N/A,N/A,N/A,1234,1236,N/A,104,3
2,N/A,N/A,N/A,1232,1234,N/A,110,3
19,N/A,N/A,N/A,1213,1232,N/A,113,6
16,N/A,N/A,N/A,1197,1213,N/A,118,5
3,N/A,N/A,N/A,1194,1197,N/A,121,2
2,N/A,N/A,N/A,1192,1194,N/A,127,2
19,N/A,N/A,N/A,1173,1192,N/A,130,5
4,N/A,N/A,N/A,1169,1173,N/A,133,2
1,N/A,N/A,N/A,1168,1169,N/A,138,1
20,N/A,N/A,N/A,1148,1168,N/A,143,6
3,N/A,N/A,N/A,1319,1322,N/A,4,2
14,N/A,N/A,N/A,1305,1319,N/A,7,5
7,N/A,N/A,N/A,1298,1305,N/A,12,4
2,N/A,N/A,N/A,1296,1298,N/A,16,2
14,N/A,N/A,N/A,1282,1296,N/A,20,6
16,N/A,N/A,N/A,1266,1282,N/A,25,5
2,N/A,N/A,N/A,1264,1266,N/A,28,2
16,N/A,N/A,N/A,1248,1264,N/A,32,6
16,N/A,N/A,N/A,1232,1248,N/A,37,5
2,N/A,N/A,N/A,1230,1232,N/A,40,2
1,N/A,N/A,N/A,1229,1230,N/A,45,1
16,N/A,N/A,N/A,1213,1229,N/A,50,6
12,N/A,N/A,N/A,1201,1213,N/A,55,5
4,N/A,N/A,N/A,1197,1201,N/A,58,2
17,N/A,N/A,N/A,1180,1197,N/A,61,5
10,N/A,N/A,N/A,1170,1180,N/A,67,5
3,N/A,N/A,N/A,1167,1170,N/A,70,2
17,N/A,N/A,N/A,1150,1167,N/A,73,5
2,N/A,N/A,N/A,1148,1150,N/A,76,2
11,N/A,N/A,N/A,1137,1148,N/A,79,5
18,N/A,N/A,N/A,1119,1137,N/A,85,5
9,N/A,N/A,N/A,1110,1119,N/A,90,4
3,N/A,N/A,N/A,1107,1110,N/A,94,2
1,N/A,N/A,N/A,1106,1107,N/A,99,1
13,N/A,N/A,N/A,1093,1106,N/A,102,4
1,N/A,N/A,N/A,1092,1093,N/A,105,1
12,N/A,N/A,N/A,1080,1092,N/A,109,5
4,N/A,N/A,N/A,1076,1080,N/A,113,3
14,N/A,N/A,N/A,1062,1076,N/A,116,6
2,N/A,N/A,N/A,1060,1062,N/A,119,3
3,N/A,N/A,N/A,1875,1878,N/A,4,3
13,N/A,N/A,N/A,1862,1875,N/A,7,6
4,N/A,N/A,N/A,1858,1862,N/A,10,3
1,N/A,N/A,N/A,1857,1858,N/A,14,1
19,N/A,N/A,N/A,1838,1857,N/A,18,5
12,N/A,N/A,N/A,1826,1838,N/A,24,5
12,N/A,N/A,N/A,1814,1826,N/A,29,4
3,N/A,N/A,N/A,1811,1814,N/A,34,3
2,N/A,N/A,N/A,1809,1811,N/A,40,3
17,N/A,N/A,N/A,1792,1809,N/A,43,6
10,N/A,N/A,N/A,1782,1792,N/A,47,4
3,N/A,N/A,N/A,1779,1782,N/A,52,3
4,N/A,N/A,N/A,1775,1779,N/A,58,3
11,N/A,N/A,N/A,1764,1775,N/A,61,6
10,N/A,N/A,N/A,1754,1764,N/A,65,4
2,N/A,N/A,N/A,1752,1754,N/A,70,3
2,N/A,N/A,N/A,1750,1752,N/A,74,1
1,N/A,N/A,N/A,1749,1750,N/A,80,1
1,N/A,N/A,N/A,1748,1749,N/A,86,1
17,N/A,N/A,N/A,1731,1748,N/A,91,6
17,N/A,N/A,N/A,1714,1731,N/A,96,5
4,N/A,N/A,N/A,1710,1714,N/A,100,3
1,N/A,N/A,N/A,1709,1710,N/A,104,1
16,N/A,N/A,N/A,1693,1709,N/A,109,6
3,N/A,N/A,N/A,1690,1693,N/A,112,3
4,N/A,N/A,N/A,1686,1690,N/A,118,3
13,N/A,N/A,N/A,1673,1686,N/A,121,6
13,N/A,N/A,N/A,1660,1673,N/A,125,4
3,N/A,N/A,N/A,1657,1660,N/A,129,2
4,N/A,N/A,N/A,1653,1657,N/A,135,2
19,N/A,N/A,N/A,636,655,N/A,4,6
2,N/A,N/A,N/A,634,636,N/A,7,3
2,N/A,N/A,N/A,632,634,N/A,11,1
11,N/A,N/A,N/A,621,632,N/A,15,5
2,N/A,N/A,N/A,619,621,N/A,18,2
2,N/A,N/A,N/A,617,619,N/A,24,2
2,N/A,N/A,N/A,615,617,N/A,29,1
17,N/A,N/A,N/A,598,615,N/A,34,6
1,N/A,N/A,N/A,597,598,N/A,40,0
7,N/A,N/A,N/A,590,597,N/A,44,4
6,N/A,N/A,N/A,584,590,N/A,50,4
2,N/A,N/A,N/A,582,584,N/A,55,3
1,N/A,N/A,N/A,581,582,N/A,59,1
11,N/A,N/A,N/A,570,581,N/A,63,5
2,N/A,N/A,N/A,568,570,N/A,66,2
13,N/A,N/A,N/A,555,568,N/A,69,5
4,N/A,N/A,N/A,551,555,N/A,73,3
2,N/A,N/A,N/A,549,551,N/A,77,1
11,N/A,N/A,N/A,538,549,N/A,81,5
8,N/A,N/A,N/A,530,538,N/A,86,4
2,N/A,N/A,N/A,528,530,N/A,91,3
18,N/A,N/A,N/A,510,528,N/A,94,6
15,N/A,N/A,N/A,495,510,N/A,99,5
2,N/A,N/A,N/A,493,495,N/A,102,2
2,N/A,N/A,N/A,491,493,N/A,108,2
2,N/A,N/A,N/A,489,491,N/A,113,1
18,N/A,N/A,N/A,471,489,N/A,118,6
4,N/A,N/A,N/A,467,471,N/A,121,3
1,N/A,N/A,N/A,466,467,N/A,125,1
2,N/A,N/A,N/A,464,466,N/A,131,1
10,N/A,N/A,N/A,362,372,N/A,5,4
9,N/A,N/A,N/A,353,362,N/A,11,4
12,N/A,N/A,N/A,341,353,N/A,17,4
4,N/A,N/A,N/A,337,341,N/A,21,2
1,N/A,N/A,N/A,336,337,N/A,26,1
16,N/A,N/A,N/A,320,336,N/A,31,6
4,N/A,N/A,N/A,316,320,N/A,34,3
3,N/A,N/A,N/A,313,316,N/A,39,2
1,N/A,N/A,N/A,312,313,N/A,44,1
10,N/A,N/A,N/A,302,312,N/A,47,4
1,N/A,N/A,N/A,301,302,N/A,50,1
6,N/A,N/A,N/A,295,301,N/A,53,4
11,N/A,N/A,N/A,284,295,N/A,59,4
12,N/A,N/A,N/A,272,284,N/A,65,4
9,N/A,N/A,N/A,263,272,N/A,71,4
6,N/A,N/A,N/A,257,263,N/A,77,4
1,N/A,N/A,N/A,256,257,N/A,80,1
16,N/A,N/A,N/A,240,256,N/A,85,6
2,N/A,N/A,N/A,238,240,N/A,91,0
14,N/A,N/A,N/A,224,238,N/A,97,6
2,N/A,N/A,N/A,222,224,N/A,103,0
10,N/A,N/A,N/A,212,222,N/A,107,4
3,N/A,N/A,N/A,209,212,N/A,112,3
13,N/A,N/A,N/A,196,209,N/A,115,6
13,N/A,N/A,N/A,183,196,N/A,119,4
4,N/A,N/A,N/A,179,183,N/A,123,2
2,N/A,N/A,N/A,177,179,N/A,129,2
12,N/A,N/A,N/A,165,177,N/A,133,6
12,N/A,N/A,N/A,153,165,N/A,137,4
2,N/A,N/A,N/A,151,153,N/A,140,1
5,N/A,N/A,N/A,1387,1392,N/A,3,4
2,N/A,N/A,N/A,1385,1387,N/A,6,1
1,N/A,N/A,N/A,1384,1385,N/A,12,1
1,N/A,N/A,N/A,1383,1384,N/A,18,1
12,N/A,N/A,N/A,1371,1383,N/A,22,5
3,N/A,N/A,N/A,1368,1371,N/A,26,3
2,N/A,N/A,N/A,1366,1368,N/A,32,3
4,N/A,N/A,N/A,1362,1366,N/A,37,2
16,N/A,N/A,N/A,1346,1362,N/A,40,5
4,N/A,N/A,N/A,1342,1346,N/A,44,3
19,N/A,N/A,N/A,1323,1342,N/A,47,6
18,N/A,N/A,N/A,1305,1323,N/A,52,5
10,N/A,N/A,N/A,1295,1305,N/A,57,4
4,N/A,N/A,N/A,1291,1295,N/A,62,3
13,N/A,N/A,N/A,1278,1291,N/A,65,6
1,N/A,N/A,N/A,1277,1278,N/A,71,0
2,N/A,N/A,N/A,1275,1277,N/A,74,3
2,N/A,N/A,N/A,1273,1275,N/A,79,2
3,N/A,N/A,N/A,1270,1273,N/A,85,2
10,N/A,N/A,N/A,1260,1270,N/A,88,5
4,N/A,N/A,N/A,1256,1260,N/A,92,3
2,N/A,N/A,N/A,1254,1256,N/A,97,2
2,N/A,N/A,N/A,1252,1254,N/A,102,1
11,N/A,N/A,N/A,1241,1252,N/A,106,5
10,N/A,N/A,N/A,1231,1241,N/A,112,5
17,N/A,N/A,N/A,1214,1231,N/A,118,5
11,N/A,N/A,N/A,1203,1214,N/A,124,5
3,N/A,N/A,N/A,1200,1203,N/A,127,2
4,N/A,N/A,N/A,1196,1200,N/A,133,2
2,N/A,N/A,N/A,1194,1196,N/A,138,1
4,N/A,N/A,N/A,1289,1293,N/A,6,2
2,N/A,N/A,N/A,1287,1289,N/A,11,1
2,N/A,N/A,N/A,1285,1287,N/A,17,1
11,N/A,N/A,N/A,1274,1285,N/A,22,6
1,N/A,N/A,N/A,1273,1274,N/A,28,0
12,N/A,N/A,N/A,1261,1273,N/A,32,4
5,N/A,N/A,N/A,1256,1261,N/A,38,4
3,N/A,N/A,N/A,1253,1256,N/A,43,3
4,N/A,N/A,N/A,1249,1253,N/A,49,3
1,N/A,N/A,N/A,1248,1249,N/A,53,1
1,N/A,N/A,N/A,1247,1248,N/A,59,1
19,N/A,N/A,N/A,1228,1247,N/A,64,6
13,N/A,N/A,N/A,1215,1228,N/A,68,4
4,N/A,N/A,N/A,1211,1215,N/A,72,2
3,N/A,N/A,N/A,1208,1211,N/A,78,2
1,N/A,N/A,N/A,1207,1208,N/A,83,1
14,N/A,N/A,N/A,1193,1207,N/A,88,6
1,N/A,N/A,N/A,1192,1193,N/A,94,0
11,N/A,N/A,N/A,1181,1192,N/A,98,4
8,N/A,N/A,N/A,1173,1181,N/A,104,4
3,N/A,N/A,N/A,1170,1173,N/A,109,3
14,N/A,N/A,N/A,1156,1170,N/A,112,6
14,N/A,N/A,N/A,1142,1156,N/A,117,5
3,N/A,N/A,N/A,1139,1142,N/A,120,2
13,N/A,N/A,N/A,1126,1139,N/A,123,5
7,N/A,N/A,N/A,1119,1126,N/A,128,4
4,N/A,N/A,N/A,1115,1119,N/A,133,3
14,N/A,N/A,N/A,1101,1115,N/A,136,6
15,N/A,N/A,N/A,1086,1101,N/A,141,5
4,N/A,N/A,N/A,1082,1086,N/A,145,3
11,N/A,N/A,N/A,535,546,N/A,5,6
2,N/A,N/A,N/A,533,535,N/A,8,3
2,N/A,N/A,N/A,531,533,N/A,13,2
2,N/A,N/A,N/A,529,531,N/A,19,2
17,N/A,N/A,N/A,512,529,N/A,22,5
15,N/A,N/A,N/A,497,512,N/A,28,5
11,N/A,N/A,N/A,486,497,N/A,34,5
11,N/A,N/A,N/A,475,486,N/A,40,5
3,N/A,N/A,N/A,472,475,N/A,43,2
2,N/A,N/A,N/A,470,472,N/A,48,1
1,N/A,N/A,N/A,469,470,N/A,54,1
17,N/A,N/A,N/A,452,469,N/A,59,6
9,N/A,N/A,N/A,443,452,N/A,63,4
2,N/A,N/A,N/A,441,443,N/A,68,3
2,N/A,N/A,N/A,439,441,N/A,74,3
2,N/A,N/A,N/A,437,439,N/A,78,1
1,N/A,N/A,N/A,436,437,N/A,84,1
18,N/A,N/A,N/A,418,436,N/A,89,6
13,N/A,N/A,N/A,405,418,N/A,93,4
3,N/A,N/A,N/A,402,405,N/A,97,2
12,N/A,N/A,N/A,390,402,N/A,101,6
2,N/A,N/A,N/A,388,390,N/A,107,0
19,N/A,N/A,N/A,369,388,N/A,113,6
7,N/A,N/A,N/A,362,369,N/A,117,4
3,N/A,N/A,N/A,359,362,N/A,121,2
4,N/A,N/A,N/A,355,359,N/A,127,2
2,N/A,N/A,N/A,353,355,N/A,133,2
4,N/A,N/A,N/A,349,353,N/A,139,2
4,N/A,N/A,N/A,345,349,N/A,145,2
13,N/A,N/A,N/A,332,345,N/A,149,6
6,N/A,N/A,N/A,1004,1010,N/A,5,4
3,N/A,N/A,N/A,1001,1004,N/A,9,2
11,N/A,N/A,N/A,990,1001,N/A,12,5
17,N/A,N/A,N/A,973,990,N/A,18,5
4,N/A,N/A,N/A,969,973,N/A,22,3
1,N/A,N/A,N/A,968,969,N/A,26,1
14,N/A,N/A,N/A,954,968,N/A,30,5
13,N/A,N/A,N/A,941,954,N/A,35,4
2,N/A,N/A,N/A,939,941,N/A,40,3
4,N/A,N/A,N/A,935,939,N/A,46,3
1,N/A,N/A,N/A,934,935,N/A,50,1
18,N/A,N/A,N/A,916,934,N/A,55,6
2,N/A,N/A,N/A,914,916,N/A,61,0
17,N/A,N/A,N/A,897,914,N/A,66,5
2,N/A,N/A,N/A,895,897,N/A,70,3
3,N/A,N/A,N/A,892,895,N/A,75,2
2,N/A,N/A,N/A,890,892,N/A,81,2
12,N/A,N/A,N/A,878,890,N/A,84,5
19,N/A,N/A,N/A,859,878,N/A,90,5
2,N/A,N/A,N/A,857,859,N/A,94,3
1,N/A,N/A,N/A,856,857,N/A,98,1
2,N/A,N/A,N/A,854,856,N/A,104,1
20,N/A,N/A,N/A,834,854,N/A,109,6
12,N/A,N/A,N/A,822,834,N/A,113,4
1,N/A,N/A,N/A,821,822,N/A,116,1
2,N/A,N/A,N/A,819,821,N/A,122,1
15,N/A,N/A,N/A,804,819,N/A,127,6
1,N/A,N/A,N/A,803,804,N/A,133,0
18,N/A,N/A,N/A,785,803,N/A,139,6
2,N/A,N/A,N/A,783,785,N/A,145,0
16,N/A,N/A,N/A,557,573,N/A,5,5
17,N/A,N/A,N/A,540,557,N/A,11,5
2,N/A,N/A,N/A,538,540,N/A,14,2
19,N/A,N/A,N/A,519,538,N/A,17,5
3,N/A,N/A,N/A,516,519,N/A,21,3
3,N/A,N/A,N/A,513,516,N/A,26,2
1,N/A,N/A,N/A,512,513,N/A,31,1
17,N/A,N/A,N/A,495,512,N/A,36,6
2,N/A,N/A,N/A,493,495,N/A,42,0
2,N/A,N/A,N/A,491,493,N/A,45,3
11,N/A,N/A,N/A,480,491,N/A,48,6
16,N/A,N/A,N/A,464,480,N/A,53,5
6,N/A,N/A,N/A,458,464,N/A,58,4
4,N/A,N/A,N/A,454,458,N/A,63,3
3,N/A,N/A,N/A,451,454,N/A,69,3
4,N/A,N/A,N/A,447,451,N/A,74,2
1,N/A,N/A,N/A,446,447,N/A,79,1
15,N/A,N/A,N/A,431,446,N/A,84,6
17,N/A,N/A,N/A,414,431,N/A,89,5
10,N/A,N/A,N/A,404,414,N/A,95,5
15,N/A,N/A,N/A,389,404,N/A,101,5
4,N/A,N/A,N/A,385,389,N/A,104,2
2,N/A,N/A,N/A,383,385,N/A,110,2
2,N/A,N/A,N/A,381,383,N/A,115,1
19,N/A,N/A,N/A,362,381,N/A,120,6
3,N/A,N/A,N/A,359,362,N/A,123,3
4,N/A,N/A,N/A,355,359,N/A,129,3
4,N/A,N/A,N/A,351,355,N/A,134,2
3,N/A,N/A,N/A,348,351,N/A,140,2
2,N/A,N/A,N/A,346,348,N/A,146,2
14,N/A,N/A,N/A,1355,1369,N/A,4,4
4,N/A,N/A,N/A,1351,1355,N/A,8,2
1,N/A,N/A,N/A,1350,1351,N/A,13,1
11,N/A,N/A,N/A,1339,1350,N/A,17,5
4,N/A,N/A,N/A,1335,1339,N/A,21,3
2,N/A,N/A,N/A,1333,1335,N/A,25,1
18,N/A,N/A,N/A,1315,1333,N/A,29,5
12,N/A,N/A,N/A,1303,1315,N/A,34,4
2,N/A,N/A,N/A,1301,1303,N/A,38,2
3,N/A,N/A,N/A,1298,1301,N/A,44,2
17,N/A,N/A,N/A,1281,1298,N/A,48,6
2,N/A,N/A,N/A,1279,1281,N/A,54,0
14,N/A,N/A,N/A,1265,1279,N/A,59,5
3,N/A,N/A,N/A,1262,1265,N/A,62,2
15,N/A,N/A,N/A,1247,1262,N/A,65,5
3,N/A,N/A,N/A,1244,1247,N/A,69,3
2,N/A,N/A,N/A,1242,1244,N/A,75,3
2,N/A,N/A,N/A,1240,1242,N/A,81,3
15,N/A,N/A,N/A,1225,1240,N/A,84,6
18,N/A,N/A,N/A,1207,1225,N/A,89,5
3,N/A,N/A,N/A,1204,1207,N/A,92,2
19,N/A,N/A,N/A,1185,1204,N/A,95,5
2,N/A,N/A,N/A,1183,1185,N/A,99,3
1,N/A,N/A,N/A,1182,1183,N/A,103,1
10,N/A,N/A,N/A,1172,1182,N/A,107,5
4,N/A,N/A,N/A,1168,1172,N/A,111,3
4,N/A,N/A,N/A,1164,1168,N/A,117,3
3,N/A,N/A,N/A,1161,1164,N/A,122,2
1,N/A,N/A,N/A,1160,1161,N/A,127,1
14,N/A,N/A,N/A,1146,1160,N/A,131,5
3,N/A,N/A,N/A,1827,1830,N/A,5,3
1,N/A,N/A,N/A,1826,1827,N/A,9,1
13,N/A,N/A,N/A,1813,1826,N/A,14,6
3,N/A,N/A,N/A,1810,1813,N/A,17,3
3,N/A,N/A,N/A,1807,1810,N/A,23,3
16,N/A,N/A,N/A,1791,1807,N/A,26,6
6,N/A,N/A,N/A,1785,1791,N/A,30,4
4,N/A,N/A,N/A,1781,1785,N/A,35,3
2,N/A,N/A,N/A,1779,1781,N/A,41,3
17,N/A,N/A,N/A,1762,1779,N/A,44,6
2,N/A,N/A,N/A,1760,1762,N/A,50,0
18,N/A,N/A,N/A,1742,1760,N/A,55,5
9,N/A,N/A,N/A,1733,1742,N/A,60,4
13,N/A,N/A,N/A,1720,1733,N/A,66,4
2,N/A,N/A,N/A,1718,1720,N/A,71,3
2,N/A,N/A,N/A,1716,1718,N/A,76,2
2,N/A,N/A,N/A,1714,1716,N/A,81,1
11,N/A,N/A,N/A,1703,1714,N/A,84,4
7,N/A,N/A,N/A,1696,1703,N/A,90,4
4,N/A,N/A,N/A,1692,1696,N/A,95,3
3,N/A,N/A,N/A,1689,1692,N/A,101,3
1,N/A,N/A,N/A,1688,1689,N/A,105,1
2,N/A,N/A,N/A,1686,1688,N/A,111,1
2,N/A,N/A,N/A,1684,1686,N/A,117,1
2,N/A,N/A,N/A,1682,1684,N/A,123,1
2,N/A,N/A,N/A,1680,1682,N/A,129,1
6,N/A,N/A,N/A,1674,1680,N/A,132,4
2,N/A,N/A,N/A,1672,1674,N/A,137,3
1,N/A,N/A,N/A,1671,1672,N/A,141,1
16,N/A,N/A,N/A,1655,1671,N/A,145,5
11,N/A,N/A,N/A,1344,1355,N/A,5,4
1,N/A,N/A,N/A,1343,1344,N/A,8,1
8,N/A,N/A,N/A,1335,1343,N/A,11,4
1,N/A,N/A,N/A,1334,1335,N/A,14,1
11,N/A,N/A,N/A,1323,1334,N/A,19,6
1,N/A,N/A,N/A,1322,1323,N/A,25,0
14,N/A,N/A,N/A,1308,1322,N/A,29,4
2,N/A,N/A,N/A,1306,1308,N/A,33,2
1,N/A,N/A,N/A,1305,1306,N/A,38,1
15,N/A,N/A,N/A,1290,1305,N/A,42,5
2,N/A,N/A,N/A,1288,1290,N/A,46,3
2,N/A,N/A,N/A,1286,1288,N/A,51,2
17,N/A,N/A,N/A,1269,1286,N/A,54,5
11,N/A,N/A,N/A,1258,1269,N/A,60,5
4,N/A,N/A,N/A,1254,1258,N/A,64,3
3,N/A,N/A,N/A,1251,1254,N/A,70,3
2,N/A,N/A,N/A,1249,1251,N/A,74,1
1,N/A,N/A,N/A,1248,1249,N/A,80,1
2,N/A,N/A,N/A,1246,1248,N/A,86,1
13,N/A,N/A,N/A,1233,1246,N/A,91,6
15,N/A,N/A,N/A,1218,1233,N/A,96,5
3,N/A,N/A,N/A,1215,1218,N/A,100,3
14,N/A,N/A,N/A,1201,1215,N/A,103,6
2,N/A,N/A,N/A,1199,1201,N/A,106,3
3,N/A,N/A,N/A,1196,1199,N/A,112,3
2,N/A,N/A,N/A,1194,1196,N/A,118,3
4,N/A,N/A,N/A,1190,1194,N/A,123,2
3,N/A,N/A,N/A,1187,1190,N/A,129,2
2,N/A,N/A,N/A,1185,1187,N/A,134,1
14,N/A,N/A,N/A,1171,1185,N/A,137,4
11,N/A,N/A,N/A,303,314,N/A,4,4
2,N/A,N/A,N/A,301,303,N/A,7,1
18,N/A,N/A,N/A,283,301,N/A,12,6
8,N/A,N/A,N/A,275,283,N/A,16,4
12,N/A,N/A,N/A,263,275,N/A,22,4
2,N/A,N/A,N/A,261,263,N/A,25,1
19,N/A,N/A,N/A,242,261,N/A,29,5
4,N/A,N/A,N/A,238,242,N/A,33,3
2,N/A,N/A,N/A,236,238,N/A,38,2
13,N/A,N/A,N/A,223,236,N/A,41,5
4,N/A,N/A,N/A,219,223,N/A,44,2
19,N/A,N/A,N/A,200,219,N/A,48,6
1,N/A,N/A,N/A,199,200,N/A,54,0
13,N/A,N/A,N/A,186,199,N/A,59,5
3,N/A,N/A,N/A,183,186,N/A,62,2
3,N/A,N/A,N/A,180,183,N/A,68,2
15,N/A,N/A,N/A,165,180,N/A,72,6
17,N/A,N/A,N/A,148,165,N/A,77,5
16,N/A,N/A,N/A,132,148,N/A,83,5
9,N/A,N/A,N/A,123,132,N/A,88,4
3,N/A,N/A,N/A,120,123,N/A,93,3
3,N/A,N/A,N/A,117,120,N/A,99,3
13,N/A,N/A,N/A,104,117,N/A,102,6
4,N/A,N/A,N/A,100,104,N/A,105,3
2,N/A,N/A,N/A,98,100,N/A,110,2
12,N/A,N/A,N/A,86,98,N/A,113,5
2,N/A,N/A,N/A,84,86,N/A,116,2
14,N/A,N/A,N/A,70,84,N/A,120,6
4,N/A,N/A,N/A,66,70,N/A,123,3
4,N/A,N/A,N/A,62,66,N/A,129,3
1,N/A,N/A,N/A,1360,1361,N/A,3,1
9,N/A,N/A,N/A,1351,1360,N/A,6,4
1,N/A,N/A,N/A,1350,1351,N/A,9,1
11,N/A,N/A,N/A,1339,1350,N/A,14,6
10,N/A,N/A,N/A,1329,1339,N/A,19,5
14,N/A,N/A,N/A,1315,1329,N/A,25,5
2,N/A,N/A,N/A,1313,1315,N/A,28,2
2,N/A,N/A,N/A,1311,1313,N/A,33,1
1,N/A,N/A,N/A,1310,1311,N/A,39,1
15,N/A,N/A,N/A,1295,1310,N/A,44,6
2,N/A,N/A,N/A,1293,1295,N/A,47,3
2,N/A,N/A,N/A,1291,1293,N/A,52,2
2,N/A,N/A,N/A,1289,1291,N/A,57,1
10,N/A,N/A,N/A,1279,1289,N/A,61,5
2,N/A,N/A,N/A,1277,1279,N/A,64,2
20,N/A,N/A,N/A,1257,1277,N/A,68,6
3,N/A,N/A,N/A,1254,1257,N/A,71,3
2,N/A,N/A,N/A,1252,1254,N/A,76,2
2,N/A,N/A,N/A,1250,1252,N/A,81,1
1,N/A,N/A,N/A,1249,1250,N/A,87,1
13,N/A,N/A,N/A,1236,1249,N/A,90,4
4,N/A,N/A,N/A,1232,1236,N/A,95,3
2,N/A,N/A,N/A,1230,1232,N/A,99,1
17,N/A,N/A,N/A,1213,1230,N/A,103,5
19,N/A,N/A,N/A,1194,1213,N/A,109,5
12,N/A,N/A,N/A,1182,1194,N/A,115,5
3,N/A,N/A,N/A,1179,1182,N/A,118,2
4,N/A,N/A,N/A,1175,1179,N/A,124,2
2,N/A,N/A,N/A,1173,1175,N/A,130,2
4,N/A,N/A,N/A,1169,1173,N/A,136,2
2,N/A,N/A,N/A,903,905,N/A,3,3
2,N/A,N/A,N/A,901,903,N/A,8,2
2,N/A,N/A,N/A,899,901,N/A,13,1
1,N/A,N/A,N/A,898,899,N/A,19,1
12,N/A,N/A,N/A,886,898,N/A,24,6
10,N/A,N/A,N/A,876,886,N/A,29,5
10,N/A,N/A,N/A,866,876,N/A,35,5
6,N/A,N/A,N/A,860,866,N/A,40,4
4,N/A,N/A,N/A,856,860,N/A,44,2
15,N/A,N/A,N/A,841,856,N/A,48,6
13,N/A,N/A,N/A,828,841,N/A,53,5
2,N/A,N/A,N/A,826,828,N/A,56,2
3,N/A,N/A,N/A,823,826,N/A,62,2
2,N/A,N/A,N/A,821,823,N/A,67,1
13,N/A,N/A,N/A,808,821,N/A,71,5
14,N/A,N/A,N/A,794,808,N/A,77,5
2,N/A,N/A,N/A,792,794,N/A,81,3
2,N/A,N/A,N/A,790,792,N/A,86,2
2,N/A,N/A,N/A,788,790,N/A,91,1
8,N/A,N/A,N/A,780,788,N/A,94,4
1,N/A,N/A,N/A,779,780,N/A,97,1
11,N/A,N/A,N/A,768,779,N/A,102,6
13,N/A,N/A,N/A,755,768,N/A,106,4
9,N/A,N/A,N/A,746,755,N/A,112,4
4,N/A,N/A,N/A,742,746,N/A,117,3
13,N/A,N/A,N/A,729,742,N/A,120,6
2,N/A,N/A,N/A,727,729,N/A,126,0
7,N/A,N/A,N/A,720,727,N/A,130,4
1,N/A,N/A,N/A,719,720,N/A,133,1
14,N/A,N/A,N/A,705,719,N/A,137,5
19,N/A,N/A,N/A,1131,1150,N/A,3,5
9,N/A,N/A,N/A,1122,1131,N/A,8,4
3,N/A,N/A,N/A,1119,1122,N/A,13,3
15,N/A,N/A,N/A,1104,1119,N/A,16,6
2,N/A,N/A,N/A,1102,1104,N/A,19,3
16,N/A,N/A,N/A,1086,1102,N/A,22,6
3,N/A,N/A,N/A,1083,1086,N/A,25,3
13,N/A,N/A,N/A,1070,1083,N/A,28,6
11,N/A,N/A,N/A,1059,1070,N/A,32,4
2,N/A,N/A,N/A,1057,1059,N/A,36,2
13,N/A,N/A,N/A,1044,1057,N/A,39,5
12,N/A,N/A,N/A,1032,1044,N/A,44,4
8,N/A,N/A,N/A,1024,1032,N/A,50,4
4,N/A,N/A,N/A,1020,1024,N/A,55,3
2,N/A,N/A,N/A,1018,1020,N/A,60,2
15,N/A,N/A,N/A,1003,1018,N/A,63,5
3,N/A,N/A,N/A,1000,1003,N/A,67,3
2,N/A,N/A,N/A,998,1000,N/A,73,3
20,N/A,N/A,N/A,978,998,N/A,76,6
4,N/A,N/A,N/A,974,978,N/A,79,3
2,N/A,N/A,N/A,972,974,N/A,84,2
17,N/A,N/A,N/A,955,972,N/A,88,6
4,N/A,N/A,N/A,951,955,N/A,91,3
12,N/A,N/A,N/A,939,951,N/A,94,6
3,N/A,N/A,N/A,936,939,N/A,97,3
15,N/A,N/A,N/A,921,936,N/A,100,6
3,N/A,N/A,N/A,918,921,N/A,103,3
4,N/A,N/A,N/A,914,918,N/A,109,3
12,N/A,N/A,N/A,902,914,N/A,112,6
4,N/A,N/A,N/A,898,902,N/A,115,3
1,N/A,N/A,N/A,425,426,N/A,5,1
16,N/A,N/A,N/A,409,425,N/A,9,5
3,N/A,N/A,N/A,406,409,N/A,13,3
15,N/A,N/A,N/A,391,406,N/A,16,6
18,N/A,N/A,N/A,373,391,N/A,21,5
8,N/A,N/A,N/A,365,373,N/A,26,4
3,N/A,N/A,N/A,362,365,N/A,30,2
17,N/A,N/A,N/A,345,362,N/A,34,6
3,N/A,N/A,N/A,342,345,N/A,37,3
3,N/A,N/A,N/A,339,342,N/A,43,3
2,N/A,N/A,N/A,337,339,N/A,48,2
4,N/A,N/A,N/A,333,337,N/A,54,2
3,N/A,N/A,N/A,330,333,N/A,60,2
15,N/A,N/A,N/A,315,330,N/A,64,6
2,N/A,N/A,N/A,313,315,N/A,70,0
5,N/A,N/A,N/A,308,313,N/A,74,4
7,N/A,N/A,N/A,301,308,N/A,80,4
2,N/A,N/A,N/A,299,301,N/A,84,2
4,N/A,N/A,N/A,295,299,N/A,90,2
1,N/A,N/A,N/A,294,295,N/A,95,1
18,N/A,N/A,N/A,276,294,N/A,99,5
3,N/A,N/A,N/A,273,276,N/A,103,3
2,N/A,N/A,N/A,271,273,N/A,107,1
20,N/A,N/A,N/A,251,271,N/A,112,6
2,N/A,N/A,N/A,249,251,N/A,115,3
2,N/A,N/A,N/A,247,249,N/A,119,1
2,N/A,N/A,N/A,245,247,N/A,125,1
2,N/A,N/A,N/A,243,245,N/A,131,1
12,N/A,N/A,N/A,231,243,N/A,135,5
4,N/A,N/A,N/A,227,231,N/A,138,2
18,N/A,N/A,N/A,772,790,N/A,6,6
14,N/A,N/A,N/A,758,772,N/A,10,4
3,N/A,N/A,N/A,755,758,N/A,14,2
19,N/A,N/A,N/A,736,755,N/A,17,5
9,N/A,N/A,N/A,727,736,N/A,22,4
8,N/A,N/A,N/A,719,727,N/A,28,4
3,N/A,N/A,N/A,716,719,N/A,33,3
18,N/A,N/A,N/A,698,716,N/A,36,6
1,N/A,N/A,N/A,697,698,N/A,42,0
2,N/A,N/A,N/A,695,697,N/A,45,3
2,N/A,N/A,N/A,693,695,N/A,51,3
20,N/A,N/A,N/A,673,693,N/A,54,6
5,N/A,N/A,N/A,668,673,N/A,58,4
3,N/A,N/A,N/A,665,668,N/A,63,3
2,N/A,N/A,N/A,663,665,N/A,67,1
8,N/A,N/A,N/A,655,663,N/A,70,4
2,N/A,N/A,N/A,653,655,N/A,74,2
11,N/A,N/A,N/A,642,653,N/A,77,5
2,N/A,N/A,N/A,640,642,N/A,81,3
2,N/A,N/A,N/A,638,640,N/A,85,1
1,N/A,N/A,N/A,637,638,N/A,91,1
6,N/A,N/A,N/A,631,637,N/A,94,4
4,N/A,N/A,N/A,627,631,N/A,99,3
15,N/A,N/A,N/A,612,627,N/A,102,6
15,N/A,N/A,N/A,597,612,N/A,107,5
8,N/A,N/A,N/A,589,597,N/A,112,4
4,N/A,N/A,N/A,585,589,N/A,117,3
2,N/A,N/A,N/A,583,585,N/A,122,2
16,N/A,N/A,N/A,567,583,N/A,125,5
11,N/A,N/A,N/A,556,567,N/A,131,5
1,N/A,N/A,N/A,1616,1617,N/A,3,1
2,N/A,N/A,N/A,1614,1616,N/A,9,1
7,N/A,N/A,N/A,1607,1614,N/A,12,4
3,N/A,N/A,N/A,1604,1607,N/A,17,3
4,N/A,N/A,N/A,1600,1604,N/A,22,2
11,N/A,N/A,N/A,1589,1600,N/A,26,6
15,N/A,N/A,N/A,1574,1589,N/A,31,5
13,N/A,N/A,N/A,1561,1574,N/A,37,5
4,N/A,N/A,N/A,1557,1561,N/A,40,2
14,N/A,N/A,N/A,1543,1557,N/A,44,6
7,N/A,N/A,N/A,1536,1543,N/A,48,4
1,N/A,N/A,N/A,1535,1536,N/A,51,1
13,N/A,N/A,N/A,1522,1535,N/A,55,5
8,N/A,N/A,N/A,1514,1522,N/A,60,4
2,N/A,N/A,N/A,1512,1514,N/A,64,2
17,N/A,N/A,N/A,1495,1512,N/A,67,5
2,N/A,N/A,N/A,1493,1495,N/A,70,2
2,N/A,N/A,N/A,1491,1493,N/A,75,1
11,N/A,N/A,N/A,1480,1491,N/A,79,5
2,N/A,N/A,N/A,1478,1480,N/A,82,2
12,N/A,N/A,N/A,1466,1478,N/A,85,5
2,N/A,N/A,N/A,1464,1466,N/A,88,2
1,N/A,N/A,N/A,1463,1464,N/A,93,1
11,N/A,N/A,N/A,1452,1463,N/A,98,6
9,N/A,N/A,N/A,1443,1452,N/A,102,4
2,N/A,N/A,N/A,1441,1443,N/A,105,1
10,N/A,N/A,N/A,1431,1441,N/A,109,5
14,N/A,N/A,N/A,1417,1431,N/A,115,5
11,N/A,N/A,N/A,1406,1417,N/A,120,4
7,N/A,N/A,N/A,1399,1406,N/A,126,4
16,N/A,N/A,N/A,1569,1585,N/A,5,6
3,N/A,N/A,N/A,1566,1569,N/A,8,3
2,N/A,N/A,N/A,1564,1566,N/A,14,3
4,N/A,N/A,N/A,1560,1564,N/A,19,2
2,N/A,N/A,N/A,1558,1560,N/A,24,1
16,N/A,N/A,N/A,1542,1558,N/A,29,6
1,N/A,N/A,N/A,1541,1542,N/A,35,0
19,N/A,N/A,N/A,1522,1541,N/A,40,5
2,N/A,N/A,N/A,1520,1522,N/A,44,3
2,N/A,N/A,N/A,1518,1520,N/A,50,3
1,N/A,N/A,N/A,1517,1518,N/A,54,1
20,N/A,N/A,N/A,1497,1517,N/A,59,6
17,N/A,N/A,N/A,1480,1497,N/A,64,5
13,N/A,N/A,N/A,1467,1480,N/A,70,5
5,N/A,N/A,N/A,1462,1467,N/A,75,4
2,N/A,N/A,N/A,1460,1462,N/A,80,3
2,N/A,N/A,N/A,1458,1460,N/A,86,3
17,N/A,N/A,N/A,1441,1458,N/A,89,6
3,N/A,N/A,N/A,1438,1441,N/A,92,3
2,N/A,N/A,N/A,1436,1438,N/A,96,1
12,N/A,N/A,N/A,1424,1436,N/A,100,5
15,N/A,N/A,N/A,1409,1424,N/A,106,5
11,N/A,N/A,N/A,1398,1409,N/A,112,5
13,N/A,N/A,N/A,1385,1398,N/A,117,4
14,N/A,N/A,N/A,1371,1385,N/A,123,4
8,N/A,N/A,N/A,1363,1371,N/A,129,4
3,N/A,N/A,N/A,1360,1363,N/A,133,2
13,N/A,N/A,N/A,1347,1360,N/A,136,5
5,N/A,N/A,N/A,1342,1347,N/A,141,4
9,N/A,N/A,N/A,1333,1342,N/A,147,4
2,N/A,N/A,N/A,1351,1353,N/A,5,3
2,N/A,N/A,N/A,1349,1351,N/A,10,2
1,N/A,N/A,N/A,1348,1349,N/A,15,1
15,N/A,N/A,N/A,1333,1348,N/A,20,6
2,N/A,N/A,N/A,1331,1333,N/A,26,0
16,N/A,N/A,N/A,1315,1331,N/A,32,6
2,N/A,N/A,N/A,1313,1315,N/A,38,0
19,N/A,N/A,N/A,1294,1313,N/A,44,6
14,N/A,N/A,N/A,1280,1294,N/A,48,4
3,N/A,N/A,N/A,1277,1280,N/A,52,2
14,N/A,N/A,N/A,1263,1277,N/A,55,5
11,N/A,N/A,N/A,1252,1263,N/A,60,4
1,N/A,N/A,N/A,1251,1252,N/A,63,1
12,N/A,N/A,N/A,1239,1251,N/A,68,6
13,N/A,N/A,N/A,1226,1239,N/A,73,5
3,N/A,N/A,N/A,1223,1226,N/A,76,2
14,N/A,N/A,N/A,1209,1223,N/A,80,6
1,N/A,N/A,N/A,1208,1209,N/A,86,0
15,N/A,N/A,N/A,1193,1208,N/A,92,6
7,N/A,N/A,N/A,1186,1193,N/A,96,4
1,N/A,N/A,N/A,1185,1186,N/A,99,1
2,N/A,N/A,N/A,1183,1185,N/A,105,1
2,N/A,N/A,N/A,1181,1183,N/A,111,1
11,N/A,N/A,N/A,1170,1181,N/A,114,4
3,N/A,N/A,N/A,1167,1170,N/A,118,2
19,N/A,N/A,N/A,1148,1167,N/A,121,5
13,N/A,N/A,N/A,1135,1148,N/A,126,4
4,N/A,N/A,N/A,1131,1135,N/A,130,2
10,N/A,N/A,N/A,1121,1131,N/A,133,5
13,N/A,N/A,N/A,1108,1121,N/A,138,4
3,N/A,N/A,N/A,905,908,N/A,5,3
2,N/A,N/A,N/A,903,905,N/A,11,3
2,N/A,N/A,N/A,901,903,N/A,16,2
14,N/A,N/A,N/A,887,901,N/A,19,5
3,N/A,N/A,N/A,884,887,N/A,22,2
13,N/A,N/A,N/A,871,884,N/A,26,6
3,N/A,N/A,N/A,868,871,N/A,29,3
3,N/A,N/A,N/A,865,868,N/A,35,3
2,N/A,N/A,N/A,863,865,N/A,41,3
3,N/A,N/A,N/A,860,863,N/A,47,3
4,N/A,N/A,N/A,856,860,N/A,52,2
4,N/A,N/A,N/A,852,856,N/A,58,2
20,N/A,N/A,N/A,832,852,N/A,62,6
4,N/A,N/A,N/A,828,832,N/A,65,3
3,N/A,N/A,N/A,825,828,N/A,70,2
12,N/A,N/A,N/A,813,825,N/A,74,6
2,N/A,N/A,N/A,811,813,N/A,80,0
4,N/A,N/A,N/A,807,811,N/A,83,3
2,N/A,N/A,N/A,805,807,N/A,87,1
17,N/A,N/A,N/A,788,805,N/A,92,6
13,N/A,N/A,N/A,775,788,N/A,96,4
3,N/A,N/A,N/A,772,775,N/A,101,3
2,N/A,N/A,N/A,770,772,N/A,105,1
10,N/A,N/A,N/A,760,770,N/A,108,4
1,N/A,N/A,N/A,759,760,N/A,111,1
11,N/A,N/A,N/A,748,759,N/A,114,4
11,N/A,N/A,N/A,737,748,N/A,120,4
1,N/A,N/A,N/A,736,737,N/A,123,1
14,N/A,N/A,N/A,722,736,N/A,126,4
2,N/A,N/A,N/A,720,722,N/A,130,2
5,N/A,N/A,N/A,1804,1809,N/A,4,4
4,N/A,N/A,N/A,1800,1804,N/A,8,2
3,N/A,N/A,N/A,1797,1800,N/A,14,2
19,N/A,N/A,N/A,1778,1797,N/A,17,5
3,N/A,N/A,N/A,1775,1778,N/A,21,3
16,N/A,N/A,N/A,1759,1775,N/A,24,6
19,N/A,N/A,N/A,1740,1759,N/A,29,5
14,N/A,N/A,N/A,1726,1740,N/A,35,5
10,N/A,N/A,N/A,1716,1726,N/A,40,4
4,N/A,N/A,N/A,1712,1716,N/A,44,2
2,N/A,N/A,N/A,1710,1712,N/A,49,1
1,N/A,N/A,N/A,1709,1710,N/A,55,1
5,N/A,N/A,N/A,1704,1709,N/A,58,4
3,N/A,N/A,N/A,1701,1704,N/A,63,3
2,N/A,N/A,N/A,1699,1701,N/A,67,1
11,N/A,N/A,N/A,1688,1699,N/A,71,5
4,N/A,N/A,N/A,1684,1688,N/A,74,2
12,N/A,N/A,N/A,1672,1684,N/A,77,5
16,N/A,N/A,N/A,1656,1672,N/A,83,5
5,N/A,N/A,N/A,1651,1656,N/A,88,4
3,N/A,N/A,N/A,1648,1651,N/A,92,2
14,N/A,N/A,N/A,1634,1648,N/A,96,6
4,N/A,N/A,N/A,1630,1634,N/A,99,3
4,N/A,N/A,N/A,1626,1630,N/A,104,2
4,N/A,N/A,N/A,1622,1626,N/A,110,2
1,N/A,N/A,N/A,1621,1622,N/A,115,1
6,N/A,N/A,N/A,1615,1621,N/A,118,4
6,N/A,N/A,N/A,1609,1615,N/A,124,4
2,N/A,N/A,N/A,1607,1609,N/A,127,1
2,N/A,N/A,N/A,1605,1607,N/A,133,1
2,N/A,N/A,N/A,1924,1926,N/A,6,1
11,N/A,N/A,N/A,1913,1924,N/A,9,4
1,N/A,N/A,N/A,1912,1913,N/A,12,1
2,N/A,N/A,N/A,1910,1912,N/A,18,1
13,N/A,N/A,N/A,1897,1910,N/A,23,6
17,N/A,N/A,N/A,1880,1897,N/A,28,5
11,N/A,N/A,N/A,1869,1880,N/A,33,4
11,N/A,N/A,N/A,1858,1869,N/A,39,4
9,N/A,N/A,N/A,1849,1858,N/A,45,4
2,N/A,N/A,N/A,1847,1849,N/A,49,2
4,N/A,N/A,N/A,1843,1847,N/A,55,2
16,N/A,N/A,N/A,1827,1843,N/A,59,6
3,N/A,N/A,N/A,1824,1827,N/A,62,3
1,N/A,N/A,N/A,1823,1824,N/A,66,1
1,N/A,N/A,N/A,1822,1823,N/A,72,1
1,N/A,N/A,N/A,1821,1822,N/A,78,1
11,N/A,N/A,N/A,1810,1821,N/A,82,5
3,N/A,N/A,N/A,1807,1810,N/A,85,2
1,N/A,N/A,N/A,1806,1807,N/A,90,1
12,N/A,N/A,N/A,1794,1806,N/A,94,5
2,N/A,N/A,N/A,1792,1794,N/A,97,2
12,N/A,N/A,N/A,1780,1792,N/A,100,5
2,N/A,N/A,N/A,1778,1780,N/A,103,2
4,N/A,N/A,N/A,1774,1778,N/A,109,2
11,N/A,N/A,N/A,1763,1774,N/A,113,6
11,N/A,N/A,N/A,1752,1763,N/A,118,5
4,N/A,N/A,N/A,1748,1752,N/A,121,2
20,N/A,N/A,N/A,1728,1748,N/A,125,6
4,N/A,N/A,N/A,1724,1728,N/A,128,3
2,N/A,N/A,N/A,1722,1724,N/A,134,3
10,N/A,N/A,N/A,630,640,N/A,4,4
2,N/A,N/A,N/A,628,630,N/A,8,2
14,N/A,N/A,N/A,614,628,N/A,12,6
9,N/A,N/A,N/A,605,614,N/A,16,4
2,N/A,N/A,N/A,603,605,N/A,21,3
4,N/A,N/A,N/A,599,603,N/A,27,3
2,N/A,N/A,N/A,597,599,N/A,31,1
2,N/A,N/A,N/A,595,597,N/A,37,1
20,N/A,N/A,N/A,575,595,N/A,42,6
2,N/A,N/A,N/A,573,575,N/A,48,0
19,N/A,N/A,N/A,554,573,N/A,53,5
12,N/A,N/A,N/A,542,554,N/A,59,5
13,N/A,N/A,N/A,529,542,N/A,64,4
1,N/A,N/A,N/A,528,529,N/A,67,1
1,N/A,N/A,N/A,527,528,N/A,73,1
15,N/A,N/A,N/A,512,527,N/A,77,5
13,N/A,N/A,N/A,499,512,N/A,82,4
1,N/A,N/A,N/A,498,499,N/A,85,1
19,N/A,N/A,N/A,479,498,N/A,89,5
2,N/A,N/A,N/A,477,479,N/A,93,3
14,N/A,N/A,N/A,463,477,N/A,96,6
11,N/A,N/A,N/A,452,463,N/A,100,4
4,N/A,N/A,N/A,448,452,N/A,105,3
4,N/A,N/A,N/A,444,448,N/A,111,3
4,N/A,N/A,N/A,440,444,N/A,116,2
2,N/A,N/A,N/A,438,440,N/A,122,2
2,N/A,N/A,N/A,436,438,N/A,128,2
2,N/A,N/A,N/A,434,436,N/A,133,1
2,N/A,N/A,N/A,432,434,N/A,139,1
19,N/A,N/A,N/A,413,432,N/A,144,6
17,N/A,N/A,N/A,434,451,N/A,4,6
10,N/A,N/A,N/A,424,434,N/A,8,4
5,N/A,N/A,N/A,419,424,N/A,14,4
2,N/A,N/A,N/A,417,419,N/A,18,2
14,N/A,N/A,N/A,403,417,N/A,22,6
1,N/A,N/A,N/A,402,403,N/A,28,0
15,N/A,N/A,N/A,387,402,N/A,34,6
8,N/A,N/A,N/A,379,387,N/A,38,4
3,N/A,N/A,N/A,376,379,N/A,43,3
1,N/A,N/A,N/A,375,376,N/A,47,1
12,N/A,N/A,N/A,363,375,N/A,50,4
4,N/A,N/A,N/A,359,363,N/A,55,3
1,N/A,N/A,N/A,358,359,N/A,59,1
15,N/A,N/A,N/A,343,358,N/A,63,5
16,N/A,N/A,N/A,327,343,N/A,69,5
3,N/A,N/A,N/A,324,327,N/A,73,3
4,N/A,N/A,N/A,320,324,N/A,78,2
18,N/A,N/A,N/A,302,320,N/A,82,6
2,N/A,N/A,N/A,300,302,N/A,85,3
17,N/A,N/A,N/A,283,300,N/A,88,6
1,N/A,N/A,N/A,282,283,N/A,94,0
15,N/A,N/A,N/A,267,282,N/A,100,6
17,N/A,N/A,N/A,250,267,N/A,105,5
2,N/A,N/A,N/A,248,250,N/A,109,3
4,N/A,N/A,N/A,244,248,N/A,115,3
2,N/A,N/A,N/A,242,244,N/A,120,2
18,N/A,N/A,N/A,224,242,N/A,124,6
2,N/A,N/A,N/A,222,224,N/A,130,0
8,N/A,N/A,N/A,214,222,N/A,134,4
4,N/A,N/A,N/A,210,214,N/A,138,2
12,N/A,N/A,N/A,317,329,N/A,5,4
9,N/A,N/A,N/A,308,317,N/A,11,4
14,N/A,N/A,N/A,294,308,N/A,17,4
4,N/A,N/A,N/A,290,294,N/A,22,3
1,N/A,N/A,N/A,289,290,N/A,26,1
19,N/A,N/A,N/A,270,289,N/A,30,5
3,N/A,N/A,N/A,267,270,N/A,34,3
3,N/A,N/A,N/A,264,267,N/A,39,2
14,N/A,N/A,N/A,250,264,N/A,42,5
8,N/A,N/A,N/A,242,250,N/A,47,4
2,N/A,N/A,N/A,240,242,N/A,50,1
13,N/A,N/A,N/A,227,240,N/A,53,4
2,N/A,N/A,N/A,225,227,N/A,56,1
16,N/A,N/A,N/A,209,225,N/A,61,6
4,N/A,N/A,N/A,205,209,N/A,64,3
4,N/A,N/A,N/A,201,205,N/A,70,3
4,N/A,N/A,N/A,197,201,N/A,76,3
2,N/A,N/A,N/A,195,197,N/A,81,2
2,N/A,N/A,N/A,193,195,N/A,87,2
1,N/A,N/A,N/A,192,193,N/A,92,1
15,N/A,N/A,N/A,177,192,N/A,96,5
7,N/A,N/A,N/A,170,177,N/A,101,4
2,N/A,N/A,N/A,168,170,N/A,104,1
12,N/A,N/A,N/A,156,168,N/A,109,6
2,N/A,N/A,N/A,154,156,N/A,115,0
15,N/A,N/A,N/A,139,154,N/A,121,6
1,N/A,N/A,N/A,138,139,N/A,127,0
19,N/A,N/A,N/A,119,138,N/A,132,5
2,N/A,N/A,N/A,117,119,N/A,136,3
4,N/A,N/A,N/A,113,117,N/A,141,2
1,N/A,N/A,N/A,1552,1553,N/A,6,1
1,N/A,N/A,N/A,1551,1552,N/A,12,1
15,N/A,N/A,N/A,1536,1551,N/A,16,5
12,N/A,N/A,N/A,1524,1536,N/A,22,5
7,N/A,N/A,N/A,1517,1524,N/A,27,4
3,N/A,N/A,N/A,1514,1517,N/A,32,3
2,N/A,N/A,N/A,1512,1514,N/A,36,1
14,N/A,N/A,N/A,1498,1512,N/A,41,6
2,N/A,N/A,N/A,1496,1498,N/A,47,0
13,N/A,N/A,N/A,1483,1496,N/A,53,6
3,N/A,N/A,N/A,1480,1483,N/A,56,3
13,N/A,N/A,N/A,1467,1480,N/A,59,6
3,N/A,N/A,N/A,1464,1467,N/A,62,3
2,N/A,N/A,N/A,1462,1464,N/A,66,1
17,N/A,N/A,N/A,1445,1462,N/A,71,6
13,N/A,N/A,N/A,1432,1445,N/A,76,5
16,N/A,N/A,N/A,1416,1432,N/A,82,5
3,N/A,N/A,N/A,1413,1416,N/A,85,2
17,N/A,N/A,N/A,1396,1413,N/A,89,6
13,N/A,N/A,N/A,1383,1396,N/A,94,5
3,N/A,N/A,N/A,1380,1383,N/A,98,3
4,N/A,N/A,N/A,1376,1380,N/A,103,2
2,N/A,N/A,N/A,1374,1376,N/A,108,1
12,N/A,N/A,N/A,1362,1374,N/A,111,4
3,N/A,N/A,N/A,1359,1362,N/A,115,2
15,N/A,N/A,N/A,1344,1359,N/A,119,6
8,N/A,N/A,N/A,1336,1344,N/A,123,4
4,N/A,N/A,N/A,1332,1336,N/A,128,3
17,N/A,N/A,N/A,1315,1332,N/A,131,6
14,N/A,N/A,N/A,1301,1315,N/A,135,4
18,N/A,N/A,N/A,499,517,N/A,3,5
10,N/A,N/A,N/A,489,499,N/A,8,4
12,N/A,N/A,N/A,477,489,N/A,14,4
6,N/A,N/A,N/A,471,477,N/A,20,4
1,N/A,N/A,N/A,470,471,N/A,23,1
14,N/A,N/A,N/A,456,470,N/A,28,6
6,N/A,N/A,N/A,450,456,N/A,32,4
6,N/A,N/A,N/A,444,450,N/A,38,4
7,N/A,N/A,N/A,437,444,N/A,44,4
2,N/A,N/A,N/A,435,437,N/A,49,3
19,N/A,N/A,N/A,416,435,N/A,52,6
1,N/A,N/A,N/A,415,416,N/A,58,0
7,N/A,N/A,N/A,408,415,N/A,62,4
2,N/A,N/A,N/A,406,408,N/A,65,1
14,N/A,N/A,N/A,392,406,N/A,69,5
19,N/A,N/A,N/A,373,392,N/A,75,5
6,N/A,N/A,N/A,367,373,N/A,80,4
4,N/A,N/A,N/A,363,367,N/A,84,2
15,N/A,N/A,N/A,348,363,N/A,88,6
19,N/A,N/A,N/A,329,348,N/A,93,5
2,N/A,N/A,N/A,327,329,N/A,96,2
18,N/A,N/A,N/A,309,327,N/A,99,5
10,N/A,N/A,N/A,299,309,N/A,105,5
8,N/A,N/A,N/A,291,299,N/A,110,4
1,N/A,N/A,N/A,290,291,N/A,113,1
16,N/A,N/A,N/A,274,290,N/A,118,6
17,N/A,N/A,N/A,257,274,N/A,123,5
19,N/A,N/A,N/A,238,257,N/A,129,5
5,N/A,N/A,N/A,233,238,N/A,134,4
3,N/A,N/A,N/A,230,233,N/A,138,2
2,N/A,N/A,N/A,1364,1366,N/A,4,2
11,N/A,N/A,N/A,1353,1364,N/A,7,5
4,N/A,N/A,N/A,1349,1353,N/A,10,2
11,N/A,N/A,N/A,1338,1349,N/A,14,6
2,N/A,N/A,N/A,1336,1338,N/A,20,0
12,N/A,N/A,N/A,1324,1336,N/A,25,5
4,N/A,N/A,N/A,1320,1324,N/A,28,2
12,N/A,N/A,N/A,1308,1320,N/A,32,6
1,N/A,N/A,N/A,1307,1308,N/A,38,0
13,N/A,N/A,N/A,1294,1307,N/A,42,4
1,N/A,N/A,N/A,1293,1294,N/A,45,1
9,N/A,N/A,N/A,1284,1293,N/A,48,4
4,N/A,N/A,N/A,1280,1284,N/A,52,2
3,N/A,N/A,N/A,1277,1280,N/A,58,2
1,N/A,N/A,N/A,1276,1277,N/A,63,1
11,N/A,N/A,N/A,1265,1276,N/A,68,6
2,N/A,N/A,N/A,1263,1265,N/A,74,0
4,N/A,N/A,N/A,1259,1263,N/A,77,3
2,N/A,N/A,N/A,1257,1259,N/A,83,3
14,N/A,N/A,N/A,1243,1257,N/A,86,6
4,N/A,N/A,N/A,1239,1243,N/A,89,3
1,N/A,N/A,N/A,1238,1239,N/A,93,1
19,N/A,N/A,N/A,1219,1238,N/A,97,5
17,N/A,N/A,N/A,1202,1219,N/A,103,5
3,N/A,N/A,N/A,1199,1202,N/A,106,2
2,N/A,N/A,N/A,1197,1199,N/A,111,1
5,N/A,N/A,N/A,1192,1197,N/A,114,4
4,N/A,N/A,N/A,1188,1192,N/A,118,2
12,N/A,N/A,N/A,1176,1188,N/A,122,6
4,N/A,N/A,N/A,1172,1176,N/A,125,3
14,N/A,N/A,N/A,1172,1186,N/A,5,4
1,N/A,N/A,N/A,1171,1172,N/A,8,1
13,N/A,N/A,N/A,1158,1171,N/A,13,6
19,N/A,N/A,N/A,1139,1158,N/A,18,5
2,N/A,N/A,N/A,1137,1139,N/A,21,2
1,N/A,N/A,N/A,1136,1137,N/A,26,1
11,N/A,N/A,N/A,1125,1136,N/A,29,4
3,N/A,N/A,N/A,1122,1125,N/A,33,2
12,N/A,N/A,N/A,1110,1122,N/A,36,5
3,N/A,N/A,N/A,1107,1110,N/A,40,3
4,N/A,N/A,N/A,1103,1107,N/A,46,3
1,N/A,N/A,N/A,1102,1103,N/A,50,1
10,N/A,N/A,N/A,1092,1102,N/A,53,4
2,N/A,N/A,N/A,1090,1092,N/A,58,3
2,N/A,N/A,N/A,1088,1090,N/A,63,2
15,N/A,N/A,N/A,1073,1088,N/A,67,6
2,N/A,N/A,N/A,1071,1073,N/A,70,3
1,N/A,N/A,N/A,1070,1071,N/A,74,1
19,N/A,N/A,N/A,1051,1070,N/A,79,6
11,N/A,N/A,N/A,1040,1051,N/A,84,5
18,N/A,N/A,N/A,1022,1040,N/A,90,5
11,N/A,N/A,N/A,1011,1022,N/A,95,4
6,N/A,N/A,N/A,1005,1011,N/A,101,4
2,N/A,N/A,N/A,1003,1005,N/A,106,3
3,N/A,N/A,N/A,1000,1003,N/A,112,3
13,N/A,N/A,N/A,987,1000,N/A,115,6
15,N/A,N/A,N/A,972,987,N/A,120,5
4,N/A,N/A,N/A,968,972,N/A,123,2
4,N/A,N/A,N/A,964,968,N/A,129,2
2,N/A,N/A,N/A,962,964,N/A,135,2
2,N/A,N/A,N/A,1088,1090,N/A,5,1
12,N/A,N/A,N/A,1076,1088,N/A,10,6
11,N/A,N/A,N/A,1065,1076,N/A,14,4
1,N/A,N/A,N/A,1064,1065,N/A,17,1
1,N/A,N/A,N/A,1063,1064,N/A,23,1
16,N/A,N/A,N/A,1047,1063,N/A,28,6
15,N/A,N/A,N/A,1032,1047,N/A,33,5
19,N/A,N/A,N/A,1013,1032,N/A,39,5
19,N/A,N/A,N/A,994,1013,N/A,45,5
4,N/A,N/A,N/A,990,994,N/A,49,3
16,N/A,N/A,N/A,974,990,N/A,52,6
1,N/A,N/A,N/A,973,974,N/A,58,0
13,N/A,N/A,N/A,960,973,N/A,62,4
1,N/A,N/A,N/A,959,960,N/A,65,1
11,N/A,N/A,N/A,948,959,N/A,68,4
4,N/A,N/A,N/A,944,948,N/A,73,3
16,N/A,N/A,N/A,928,944,N/A,76,6
16,N/A,N/A,N/A,912,928,N/A,81,5
11,N/A,N/A,N/A,901,912,N/A,86,4
2,N/A,N/A,N/A,899,901,N/A,89,1
7,N/A,N/A,N/A,892,899,N/A,92,4
14,N/A,N/A,N/A,878,892,N/A,98,4
2,N/A,N/A,N/A,876,878,N/A,101,1
13,N/A,N/A,N/A,863,876,N/A,105,5
3,N/A,N/A,N/A,860,863,N/A,108,2
3,N/A,N/A,N/A,857,860,N/A,114,2
17,N/A,N/A,N/A,840,857,N/A,117,5
2,N/A,N/A,N/A,838,840,N/A,120,2
15,N/A,N/A,N/A,823,838,N/A,124,6
10,N/A,N/A,N/A,813,823,N/A,128,4
4,N/A,N/A,N/A,1066,1070,N/A,6,3
16,N/A,N/A,N/A,1050,1066,N/A,9,6
8,N/A,N/A,N/A,1042,1050,N/A,13,4
1,N/A,N/A,N/A,1041,1042,N/A,16,1
16,N/A,N/A,N/A,1025,1041,N/A,20,5
2,N/A,N/A,N/A,1023,1025,N/A,24,3
4,N/A,N/A,N/A,1019,1023,N/A,30,3
3,N/A,N/A,N/A,1016,1019,N/A,36,3
14,N/A,N/A,N/A,1002,1016,N/A,39,6
12,N/A,N/A,N/A,990,1002,N/A,44,5
19,N/A,N/A,N/A,971,990,N/A,50,5
12,N/A,N/A,N/A,959,971,N/A,56,5
13,N/A,N/A,N/A,946,959,N/A,61,4
1,N/A,N/A,N/A,945,946,N/A,64,1
16,N/A,N/A,N/A,929,945,N/A,69,6
14,N/A,N/A,N/A,915,929,N/A,74,5
11,N/A,N/A,N/A,904,915,N/A,79,4
3,N/A,N/A,N/A,901,904,N/A,83,2
19,N/A,N/A,N/A,882,901,N/A,86,5
13,N/A,N/A,N/A,869,882,N/A,92,5
3,N/A,N/A,N/A,866,869,N/A,95,2
2,N/A,N/A,N/A,864,866,N/A,101,2
2,N/A,N/A,N/A,862,864,N/A,107,2
3,N/A,N/A,N/A,859,862,N/A,113,2
11,N/A,N/A,N/A,848,859,N/A,117,6
12,N/A,N/A,N/A,836,848,N/A,121,4
2,N/A,N/A,N/A,834,836,N/A,126,3
1,N/A,N/A,N/A,833,834,N/A,130,1
6,N/A,N/A,N/A,827,833,N/A,133,4
2,N/A,N/A,N/A,825,827,N/A,136,1
12,N/A,N/A,N/A,1338,1350,N/A,4,6
10,N/A,N/A,N/A,1328,1338,N/A,8,4
12,N/A,N/A,N/A,1316,1328,N/A,14,4
2,N/A,N/A,N/A,1314,1316,N/A,18,2
2,N/A,N/A,N/A,1312,1314,N/A,24,2
19,N/A,N/A,N/A,1293,1312,N/A,28,6
2,N/A,N/A,N/A,1291,1293,N/A,31,3
1,N/A,N/A,N/A,1290,1291,N/A,35,1
20,N/A,N/A,N/A,1270,1290,N/A,40,6
13,N/A,N/A,N/A,1257,1270,N/A,45,5
11,N/A,N/A,N/A,1246,1257,N/A,50,4
1,N/A,N/A,N/A,1245,1246,N/A,53,1
8,N/A,N/A,N/A,1237,1245,N/A,56,4
4,N/A,N/A,N/A,1233,1237,N/A,61,3
1,N/A,N/A,N/A,1232,1233,N/A,65,1
11,N/A,N/A,N/A,1221,1232,N/A,70,6
2,N/A,N/A,N/A,1219,1221,N/A,76,0
3,N/A,N/A,N/A,1216,1219,N/A,79,3
2,N/A,N/A,N/A,1214,1216,N/A,85,3
1,N/A,N/A,N/A,1213,1214,N/A,89,1
5,N/A,N/A,N/A,1208,1213,N/A,92,4
8,N/A,N/A,N/A,1200,1208,N/A,98,4
6,N/A,N/A,N/A,1194,1200,N/A,104,4
3,N/A,N/A,N/A,1191,1194,N/A,108,2
4,N/A,N/A,N/A,1187,1191,N/A,114,2
2,N/A,N/A,N/A,1185,1187,N/A,119,1
20,N/A,N/A,N/A,1165,1185,N/A,124,6
14,N/A,N/A,N/A,1151,1165,N/A,128,4
2,N/A,N/A,N/A,1149,1151,N/A,131,1
11,N/A,N/A,N/A,1138,1149,N/A,136,6
13,N/A,N/A,N/A,1725,1738,N/A,4,6
1,N/A,N/A,N/A,1724,1725,N/A,10,0
3,N/A,N/A,N/A,1721,1724,N/A,13,3
2,N/A,N/A,N/A,1719,1721,N/A,17,1
11,N/A,N/A,N/A,1708,1719,N/A,22,6
2,N/A,N/A,N/A,1706,1708,N/A,28,0
17,N/A,N/A,N/A,1689,1706,N/A,34,6
13,N/A,N/A,N/A,1676,1689,N/A,39,5
4,N/A,N/A,N/A,1672,1676,N/A,42,2
2,N/A,N/A,N/A,1670,1672,N/A,47,1
18,N/A,N/A,N/A,1652,1670,N/A,52,6
4,N/A,N/A,N/A,1648,1652,N/A,55,3
4,N/A,N/A,N/A,1644,1648,N/A,60,2
14,N/A,N/A,N/A,1630,1644,N/A,63,5
3,N/A,N/A,N/A,1627,1630,N/A,67,3
17,N/A,N/A,N/A,1610,1627,N/A,70,6
1,N/A,N/A,N/A,1609,1610,N/A,76,0
3,N/A,N/A,N/A,1606,1609,N/A,79,3
2,N/A,N/A,N/A,1604,1606,N/A,84,2
3,N/A,N/A,N/A,1601,1604,N/A,90,2
1,N/A,N/A,N/A,1600,1601,N/A,95,1
14,N/A,N/A,N/A,1586,1600,N/A,98,4
2,N/A,N/A,N/A,1584,1586,N/A,101,1
2,N/A,N/A,N/A,1582,1584,N/A,107,1
10,N/A,N/A,N/A,1572,1582,N/A,111,5
18,N/A,N/A,N/A,1554,1572,N/A,117,5
12,N/A,N/A,N/A,1542,1554,N/A,123,5
19,N/A,N/A,N/A,1523,1542,N/A,129,5
4,N/A,N/A,N/A,1519,1523,N/A,132,2
4,N/A,N/A,N/A,1515,1519,N/A,138,2
3,N/A,N/A,N/A,1091,1094,N/A,4,2
2,N/A,N/A,N/A,1089,1091,N/A,9,1
17,N/A,N/A,N/A,1072,1089,N/A,14,6
2,N/A,N/A,N/A,1070,1072,N/A,20,0
17,N/A,N/A,N/A,1053,1070,N/A,26,6
14,N/A,N/A,N/A,1039,1053,N/A,30,4
10,N/A,N/A,N/A,1029,1039,N/A,36,4
2,N/A,N/A,N/A,1027,1029,N/A,41,3
1,N/A,N/A,N/A,1026,1027,N/A,45,1
1,N/A,N/A,N/A,1025,1026,N/A,51,1
13,N/A,N/A,N/A,1012,1025,N/A,54,4
1,N/A,N/A,N/A,1011,1012,N/A,57,1
14,N/A,N/A,N/A,997,1011,N/A,61,5
11,N/A,N/A,N/A,986,997,N/A,66,4
10,N/A,N/A,N/A,976,986,N/A,72,4
12,N/A,N/A,N/A,964,976,N/A,78,4
6,N/A,N/A,N/A,958,964,N/A,84,4
4,N/A,N/A,N/A,954,958,N/A,89,3
18,N/A,N/A,N/A,936,954,N/A,92,6
7,N/A,N/A,N/A,929,936,N/A,96,4
4,N/A,N/A,N/A,925,929,N/A,100,2
14,N/A,N/A,N/A,911,925,N/A,104,6
3,N/A,N/A,N/A,908,911,N/A,107,3
2,N/A,N/A,N/A,906,908,N/A,111,1
16,N/A,N/A,N/A,890,906,N/A,116,6
9,N/A,N/A,N/A,881,890,N/A,120,4
1,N/A,N/A,N/A,880,881,N/A,123,1
11,N/A,N/A,N/A,869,880,N/A,128,6
2,N/A,N/A,N/A,867,869,N/A,134,0
9,N/A,N/A,N/A,858,867,N/A,138,4
10,N/A,N/A,N/A,352,362,N/A,5,4
3,N/A,N/A,N/A,349,352,N/A,9,2
14,N/A,N/A,N/A,335,349,N/A,13,6
3,N/A,N/A,N/A,332,335,N/A,16,3
2,N/A,N/A,N/A,330,332,N/A,20,1
2,N/A,N/A,N/A,328,330,N/A,26,1
8,N/A,N/A,N/A,320,328,N/A,29,4
2,N/A,N/A,N/A,318,320,N/A,33,2
1,N/A,N/A,N/A,317,318,N/A,38,1
15,N/A,N/A,N/A,302,317,N/A,43,6
1,N/A,N/A,N/A,301,302,N/A,49,0
16,N/A,N/A,N/A,285,301,N/A,55,6
16,N/A,N/A,N/A,269,285,N/A,60,5
3,N/A,N/A,N/A,266,269,N/A,63,2
13,N/A,N/A,N/A,253,266,N/A,66,5
12,N/A,N/A,N/A,241,253,N/A,72,5
13,N/A,N/A,N/A,228,241,N/A,78,5
11,N/A,N/A,N/A,217,228,N/A,83,4
4,N/A,N/A,N/A,213,217,N/A,87,2
2,N/A,N/A,N/A,211,213,N/A,92,1
1,N/A,N/A,N/A,210,211,N/A,98,1
16,N/A,N/A,N/A,194,210,N/A,102,5
18,N/A,N/A,N/A,176,194,N/A,108,5
4,N/A,N/A,N/A,172,176,N/A,112,3
19,N/A,N/A,N/A,153,172,N/A,115,6
14,N/A,N/A,N/A,139,153,N/A,119,4
4,N/A,N/A,N/A,135,139,N/A,124,3
4,N/A,N/A,N/A,131,135,N/A,129,2
1,N/A,N/A,N/A,130,131,N/A,134,1
11,N/A,N/A,N/A,119,130,N/A,137,4
17,N/A,N/A,N/A,644,661,N/A,6,6
13,N/A,N/A,N/A,631,644,N/A,11,5
9,N/A,N/A,N/A,622,631,N/A,16,4
3,N/A,N/A,N/A,619,622,N/A,20,2
2,N/A,N/A,N/A,617,619,N/A,25,1
2,N/A,N/A,N/A,615,617,N/A,31,1
10,N/A,N/A,N/A,605,615,N/A,34,4
1,N/A,N/A,N/A,604,605,N/A,37,1
19,N/A,N/A,N/A,585,604,N/A,42,6
19,N/A,N/A,N/A,566,585,N/A,47,5
11,N/A,N/A,N/A,555,566,N/A,52,4
2,N/A,N/A,N/A,553,555,N/A,57,3
2,N/A,N/A,N/A,551,553,N/A,62,2
1,N/A,N/A,N/A,550,551,N/A,67,1
17,N/A,N/A,N/A,533,550,N/A,71,5
7,N/A,N/A,N/A,526,533,N/A,76,4
4,N/A,N/A,N/A,522,526,N/A,81,3
4,N/A,N/A,N/A,518,522,N/A,87,3
1,N/A,N/A,N/A,517,518,N/A,91,1
2,N/A,N/A,N/A,515,517,N/A,97,1
18,N/A,N/A,N/A,497,515,N/A,102,6
12,N/A,N/A,N/A,485,497,N/A,107,5
14,N/A,N/A,N/A,471,485,N/A,113,5
2,N/A,N/A,N/A,469,471,N/A,116,2
15,N/A,N/A,N/A,454,469,N/A,119,5
4,N/A,N/A,N/A,450,454,N/A,122,2
3,N/A,N/A,N/A,447,450,N/A,128,2
14,N/A,N/A,N/A,433,447,N/A,131,5
4,N/A,N/A,N/A,429,433,N/A,134,2
11,N/A,N/A,N/A,418,429,N/A,137,5
8,N/A,N/A,N/A,631,639,N/A,3,4
9,N/A,N/A,N/A,622,631,N/A,9,4
2,N/A,N/A,N/A,620,622,N/A,14,3
4,N/A,N/A,N/A,616,620,N/A,19,2
2,N/A,N/A,N/A,614,616,N/A,25,2
12,N/A,N/A,N/A,602,614,N/A,28,5
11,N/A,N/A,N/A,591,602,N/A,34,5
3,N/A,N/A,N/A,588,591,N/A,37,2
17,N/A,N/A,N/A,571,588,N/A,40,5
18,N/A,N/A,N/A,553,571,N/A,46,5
18,N/A,N/A,N/A,535,553,N/A,52,5
6,N/A,N/A,N/A,529,535,N/A,57,4
4,N/A,N/A,N/A,525,529,N/A,61,2
4,N/A,N/A,N/A,521,525,N/A,67,2
2,N/A,N/A,N/A,519,521,N/A,72,1
19,N/A,N/A,N/A,500,519,N/A,76,5
11,N/A,N/A,N/A,489,500,N/A,81,4
4,N/A,N/A,N/A,485,489,N/A,85,2
14,N/A,N/A,N/A,471,485,N/A,89,6
14,N/A,N/A,N/A,457,471,N/A,94,5
13,N/A,N/A,N/A,444,457,N/A,99,4
2,N/A,N/A,N/A,442,444,N/A,102,1
14,N/A,N/A,N/A,428,442,N/A,105,4
1,N/A,N/A,N/A,427,428,N/A,108,1
12,N/A,N/A,N/A,415,427,N/A,113,6
2,N/A,N/A,N/A,413,415,N/A,119,0
13,N/A,N/A,N/A,400,413,N/A,123,4
3,N/A,N/A,N/A,397,400,N/A,128,3
4,N/A,N/A,N/A,393,397,N/A,134,3
2,N/A,N/A,N/A,391,393,N/A,139,2
15,N/A,N/A,N/A,1589,1604,N/A,3,5
17,N/A,N/A,N/A,1572,1589,N/A,9,5
3,N/A,N/A,N/A,1569,1572,N/A,12,2
2,N/A,N/A,N/A,1567,1569,N/A,17,1
1,N/A,N/A,N/A,1566,1567,N/A,23,1
16,N/A,N/A,N/A,1550,1566,N/A,27,5
3,N/A,N/A,N/A,1547,1550,N/A,30,2
4,N/A,N/A,N/A,1543,1547,N/A,36,2
15,N/A,N/A,N/A,1528,1543,N/A,40,6
4,N/A,N/A,N/A,1524,1528,N/A,43,3
3,N/A,N/A,N/A,1521,1524,N/A,49,3
2,N/A,N/A,N/A,1519,1521,N/A,54,2
1,N/A,N/A,N/A,1518,1519,N/A,59,1
19,N/A,N/A,N/A,1499,1518,N/A,63,5
16,N/A,N/A,N/A,1483,1499,N/A,69,5
14,N/A,N/A,N/A,1469,1483,N/A,74,4
4,N/A,N/A,N/A,1465,1469,N/A,78,2
3,N/A,N/A,N/A,1462,1465,N/A,84,2
2,N/A,N/A,N/A,1460,1462,N/A,90,2
15,N/A,N/A,N/A,1445,1460,N/A,93,5
2,N/A,N/A,N/A,1443,1445,N/A,97,3
4,N/A,N/A,N/A,1439,1443,N/A,103,3
1,N/A,N/A,N/A,1438,1439,N/A,107,1
2,N/A,N/A,N/A,1436,1438,N/A,113,1
17,N/A,N/A,N/A,1419,1436,N/A,117,5
7,N/A,N/A,N/A,1412,1419,N/A,122,4
1,N/A,N/A,N/A,1411,1412,N/A,125,1
7,N/A,N/A,N/A,1404,1411,N/A,128,4
3,N/A,N/A,N/A,1401,1404,N/A,132,2
17,N/A,N/A,N/A,1384,1401,N/A,135,5
13,N/A,N/A,N/A,966,979,N/A,5,5
4,N/A,N/A,N/A,962,966,N/A,8,2
3,N/A,N/A,N/A,959,962,N/A,14,2
1,N/A,N/A,N/A,958,959,N/A,19,1
15,N/A,N/A,N/A,943,958,N/A,24,6
17,N/A,N/A,N/A,926,943,N/A,29,5
12,N/A,N/A,N/A,914,926,N/A,35,5
4,N/A,N/A,N/A,910,914,N/A,38,2
3,N/A,N/A,N/A,907,910,N/A,44,2
1,N/A,N/A,N/A,906,907,N/A,49,1
14,N/A,N/A,N/A,892,906,N/A,52,4
2,N/A,N/A,N/A,890,892,N/A,56,2
1,N/A,N/A,N/A,889,890,N/A,61,1
13,N/A,N/A,N/A,876,889,N/A,64,4
4,N/A,N/A,N/A,872,876,N/A,69,3
3,N/A,N/A,N/A,869,872,N/A,75,3
3,N/A,N/A,N/A,866,869,N/A,80,2
3,N/A,N/A,N/A,863,866,N/A,86,2
19,N/A,N/A,N/A,844,863,N/A,90,6
2,N/A,N/A,N/A,842,844,N/A,93,3
2,N/A,N/A,N/A,840,842,N/A,98,2
13,N/A,N/A,N/A,827,840,N/A,101,5
5,N/A,N/A,N/A,822,827,N/A,106,4
8,N/A,N/A,N/A,814,822,N/A,112,4
10,N/A,N/A,N/A,804,814,N/A,118,4
8,N/A,N/A,N/A,796,804,N/A,124,4
2,N/A,N/A,N/A,794,796,N/A,127,1
12,N/A,N/A,N/A,782,794,N/A,130,4
13,N/A,N/A,N/A,769,782,N/A,136,4
13,N/A,N/A,N/A,756,769,N/A,142,4
11,N/A,N/A,N/A,1537,1548,N/A,3,5
3,N/A,N/A,N/A,1534,1537,N/A,6,2
2,N/A,N/A,N/A,1532,1534,N/A,11,1
13,N/A,N/A,N/A,1519,1532,N/A,14,4
1,N/A,N/A,N/A,1518,1519,N/A,17,1
14,N/A,N/A,N/A,1504,1518,N/A,21,5
4,N/A,N/A,N/A,1500,1504,N/A,25,3
2,N/A,N/A,N/A,1498,1500,N/A,31,3
19,N/A,N/A,N/A,1479,1498,N/A,34,6
18,N/A,N/A,N/A,1461,1479,N/A,39,5
2,N/A,N/A,N/A,1459,1461,N/A,43,3
1,N/A,N/A,N/A,1458,1459,N/A,47,1
18,N/A,N/A,N/A,1440,1458,N/A,52,6
17,N/A,N/A,N/A,1423,1440,N/A,57,5
3,N/A,N/A,N/A,1420,1423,N/A,60,2
2,N/A,N/A,N/A,1418,1420,N/A,65,1
1,N/A,N/A,N/A,1417,1418,N/A,71,1
17,N/A,N/A,N/A,1400,1417,N/A,76,6
1,N/A,N/A,N/A,1399,1400,N/A,82,0
2,N/A,N/A,N/A,1397,1399,N/A,85,3
14,N/A,N/A,N/A,1383,1397,N/A,88,6
12,N/A,N/A,N/A,1371,1383,N/A,93,5
15,N/A,N/A,N/A,1356,1371,N/A,99,5
4,N/A,N/A,N/A,1352,1356,N/A,102,2
17,N/A,N/A,N/A,1335,1352,N/A,106,6
2,N/A,N/A,N/A,1333,1335,N/A,112,0
14,N/A,N/A,N/A,1319,1333,N/A,116,4
4,N/A,N/A,N/A,1315,1319,N/A,121,3
2,N/A,N/A,N/A,1313,1315,N/A,125,1
2,N/A,N/A,N/A,1311,1313,N/A,131,1
4,N/A,N/A,N/A,1292,1296,N/A,6,2
20,N/A,N/A,N/A,1272,1292,N/A,10,6
1,N/A,N/A,N/A,1271,1272,N/A,16,0
11,N/A,N/A,N/A,1260,1271,N/A,20,4
2,N/A,N/A,N/A,1258,1260,N/A,24,2
2,N/A,N/A,N/A,1256,1258,N/A,29,1
7,N/A,N/A,N/A,1249,1256,N/A,32,4
1,N/A,N/A,N/A,1248,1249,N/A,35,1
6,N/A,N/A,N/A,1242,1248,N/A,38,4
3,N/A,N/A,N/A,1239,1242,N/A,43,3
1,N/A,N/A,N/A,1238,1239,N/A,47,1
13,N/A,N/A,N/A,1225,1238,N/A,51,5
3,N/A,N/A,N/A,1222,1225,N/A,54,2
2,N/A,N/A,N/A,1220,1222,N/A,60,2
2,N/A,N/A,N/A,1218,1220,N/A,65,1
2,N/A,N/A,N/A,1216,1218,N/A,71,1
2,N/A,N/A,N/A,1214,1216,N/A,77,1
14,N/A,N/A,N/A,1200,1214,N/A,82,6
1,N/A,N/A,N/A,1199,1200,N/A,88,0
10,N/A,N/A,N/A,1189,1199,N/A,93,5
3,N/A,N/A,N/A,1186,1189,N/A,97,3
3,N/A,N/A,N/A,1183,1186,N/A,103,3
4,N/A,N/A,N/A,1179,1183,N/A,109,3
3,N/A,N/A,N/A,1176,1179,N/A,115,3
1,N/A,N/A,N/A,1175,1176,N/A,119,1
17,N/A,N/A,N/A,1158,1175,N/A,123,5
4,N/A,N/A,N/A,1154,1158,N/A,127,3
2,N/A,N/A,N/A,1152,1154,N/A,131,1
16,N/A,N/A,N/A,1136,1152,N/A,136,6
2,N/A,N/A,N/A,1134,1136,N/A,142,0
19,N/A,N/A,N/A,1158,1177,N/A,3,6
2,N/A,N/A,N/A,1156,1158,N/A,9,0
12,N/A,N/A,N/A,1144,1156,N/A,13,4
4,N/A,N/A,N/A,1140,1144,N/A,17,2
11,N/A,N/A,N/A,1129,1140,N/A,21,6
14,N/A,N/A,N/A,1115,1129,N/A,25,4
4,N/A,N/A,N/A,1111,1115,N/A,30,3
12,N/A,N/A,N/A,1099,1111,N/A,33,6
12,N/A,N/A,N/A,1087,1099,N/A,38,5
14,N/A,N/A,N/A,1073,1087,N/A,43,4
2,N/A,N/A,N/A,1071,1073,N/A,46,1
2,N/A,N/A,N/A,1069,1071,N/A,52,1
15,N/A,N/A,N/A,1054,1069,N/A,57,6
2,N/A,N/A,N/A,1052,1054,N/A,60,3
2,N/A,N/A,N/A,1050,1052,N/A,65,2
3,N/A,N/A,N/A,1047,1050,N/A,71,2
12,N/A,N/A,N/A,1035,1047,N/A,75,6
2,N/A,N/A,N/A,1033,1035,N/A,81,0
18,N/A,N/A,N/A,1015,1033,N/A,87,6
1,N/A,N/A,N/A,1014,1015,N/A,93,0
13,N/A,N/A,N/A,1001,1014,N/A,97,4
2,N/A,N/A,N/A,999,1001,N/A,100,1
19,N/A,N/A,N/A,980,999,N/A,105,6
1,N/A,N/A,N/A,979,980,N/A,111,0
10,N/A,N/A,N/A,969,979,N/A,115,4
3,N/A,N/A,N/A,966,969,N/A,120,3
3,N/A,N/A,N/A,963,966,N/A,126,3
16,N/A,N/A,N/A,947,963,N/A,129,6
4,N/A,N/A,N/A,943,947,N/A,132,3
14,N/A,N/A,N/A,929,943,N/A,135,6
13,N/A,N/A,N/A,1437,1450,N/A,5,4
1,N/A,N/A,N/A,1436,1437,N/A,8,1
1,N/A,N/A,N/A,1435,1436,N/A,14,1
1,N/A,N/A,N/A,1434,1435,N/A,20,1
12,N/A,N/A,N/A,1422,1434,N/A,24,5
12,N/A,N/A,N/A,1410,1422,N/A,30,5
2,N/A,N/A,N/A,1408,1410,N/A,34,3
14,N/A,N/A,N/A,1394,1408,N/A,37,6
19,N/A,N/A,N/A,1375,1394,N/A,42,5
17,N/A,N/A,N/A,1358,1375,N/A,48,5
2,N/A,N/A,N/A,1356,1358,N/A,52,3
2,N/A,N/A,N/A,1354,1356,N/A,57,2
2,N/A,N/A,N/A,1352,1354,N/A,63,2
20,N/A,N/A,N/A,1332,1352,N/A,67,6
3,N/A,N/A,N/A,1329,1332,N/A,70,3
2,N/A,N/A,N/A,1327,1329,N/A,75,2
2,N/A,N/A,N/A,1325,1327,N/A,80,1
10,N/A,N/A,N/A,1315,1325,N/A,83,4
1,N/A,N/A,N/A,1314,1315,N/A,86,1
11,N/A,N/A,N/A,1303,1314,N/A,89,4
1,N/A,N/A,N/A,1302,1303,N/A,92,1
11,N/A,N/A,N/A,1291,1302,N/A,96,5
19,N/A,N/A,N/A,1272,1291,N/A,102,5
2,N/A,N/A,N/A,1270,1272,N/A,105,2
2,N/A,N/A,N/A,1268,1270,N/A,111,2
12,N/A,N/A,N/A,1256,1268,N/A,115,6
2,N/A,N/A,N/A,1254,1256,N/A,121,0
11,N/A,N/A,N/A,1243,1254,N/A,126,5
12,N/A,N/A,N/A,1231,1243,N/A,131,4
9,N/A,N/A,N/A,1222,1231,N/A,137,4
2,N/A,N/A,N/A,1635,1637,N/A,6,2
19,N/A,N/A,N/A,1616,1635,N/A,9,5
4,N/A,N/A,N/A,1612,1616,N/A,12,2
3,N/A,N/A,N/A,1609,1612,N/A,18,2
14,N/A,N/A,N/A,1595,1609,N/A,21,5
6,N/A,N/A,N/A,1589,1595,N/A,26,4
3,N/A,N/A,N/A,1586,1589,N/A,30,2
2,N/A,N/A,N/A,1584,1586,N/A,35,1
7,N/A,N/A,N/A,1577,1584,N/A,38,4
2,N/A,N/A,N/A,1575,1577,N/A,41,1
1,N/A,N/A,N/A,1574,1575,N/A,47,1
8,N/A,N/A,N/A,1566,1574,N/A,50,4
5,N/A,N/A,N/A,1561,1566,N/A,56,4
4,N/A,N/A,N/A,1557,1561,N/A,60,2
14,N/A,N/A,N/A,1543,1557,N/A,63,5
12,N/A,N/A,N/A,1531,1543,N/A,69,5
4,N/A,N/A,N/A,1527,1531,N/A,73,3
3,N/A,N/A,N/A,1524,1527,N/A,78,2
11,N/A,N/A,N/A,1513,1524,N/A,81,5
2,N/A,N/A,N/A,1511,1513,N/A,84,2
3,N/A,N/A,N/A,1508,1511,N/A,90,2
2,N/A,N/A,N/A,1506,1508,N/A,96,2
19,N/A,N/A,N/A,1487,1506,N/A,100,6
14,N/A,N/A,N/A,1473,1487,N/A,104,4
1,N/A,N/A,N/A,1472,1473,N/A,107,1
2,N/A,N/A,N/A,1470,1472,N/A,113,1
15,N/A,N/A,N/A,1455,1470,N/A,117,5
2,N/A,N/A,N/A,1453,1455,N/A,120,2
1,N/A,N/A,N/A,1452,1453,N/A,125,1
11,N/A,N/A,N/A,1441,1452,N/A,128,4
12,N/A,N/A,N/A,779,791,N/A,6,5
4,N/A,N/A,N/A,775,779,N/A,10,3
4,N/A,N/A,N/A,771,775,N/A,16,3
4,N/A,N/A,N/A,767,771,N/A,22,3
20,N/A,N/A,N/A,747,767,N/A,25,6
1,N/A,N/A,N/A,746,747,N/A,31,0
17,N/A,N/A,N/A,729,746,N/A,37,6
4,N/A,N/A,N/A,725,729,N/A,40,3
15,N/A,N/A,N/A,710,725,N/A,43,6
12,N/A,N/A,N/A,698,710,N/A,47,4
3,N/A,N/A,N/A,695,698,N/A,51,2
2,N/A,N/A,N/A,693,695,N/A,56,1
2,N/A,N/A,N/A,691,693,N/A,62,1
2,N/A,N/A,N/A,689,691,N/A,68,1
6,N/A,N/A,N/A,683,689,N/A,71,4
13,N/A,N/A,N/A,670,683,N/A,77,4
2,N/A,N/A,N/A,668,670,N/A,81,2
2,N/A,N/A,N/A,666,668,N/A,87,2
4,N/A,N/A,N/A,662,666,N/A,93,2
14,N/A,N/A,N/A,648,662,N/A,96,5
4,N/A,N/A,N/A,644,648,N/A,99,2
19,N/A,N/A,N/A,625,644,N/A,103,6
12,N/A,N/A,N/A,613,625,N/A,107,4
8,N/A,N/A,N/A,605,613,N/A,113,4
4,N/A,N/A,N/A,601,605,N/A,118,3
3,N/A,N/A,N/A,598,601,N/A,124,3
3,N/A,N/A,N/A,595,598,N/A,129,2
2,N/A,N/A,N/A,593,595,N/A,134,1
2,N/A,N/A,N/A,591,593,N/A,140,1
5,N/A,N/A,N/A,586,591,N/A,143,4
14,N/A,N/A,N/A,1772,1786,N/A,5,5
2,N/A,N/A,N/A,1770,1772,N/A,8,2
11,N/A,N/A,N/A,1759,1770,N/A,11,5
2,N/A,N/A,N/A,1757,1759,N/A,15,3
2,N/A,N/A,N/A,1755,1757,N/A,20,2
2,N/A,N/A,N/A,1753,1755,N/A,26,2
11,N/A,N/A,N/A,1742,1753,N/A,30,6
2,N/A,N/A,N/A,1740,1742,N/A,36,0
3,N/A,N/A,N/A,1737,1740,N/A,39,3
4,N/A,N/A,N/A,1733,1737,N/A,45,3
4,N/A,N/A,N/A,1729,1733,N/A,50,2
4,N/A,N/A,N/A,1725,1729,N/A,56,2
12,N/A,N/A,N/A,1713,1725,N/A,60,6
8,N/A,N/A,N/A,1705,1713,N/A,64,4
2,N/A,N/A,N/A,1703,1705,N/A,68,2
4,N/A,N/A,N/A,1699,1703,N/A,74,2
16,N/A,N/A,N/A,1683,1699,N/A,78,6
1,N/A,N/A,N/A,1682,1683,N/A,84,0
15,N/A,N/A,N/A,1667,1682,N/A,90,6
11,N/A,N/A,N/A,1656,1667,N/A,95,5
3,N/A,N/A,N/A,1653,1656,N/A,99,3
4,N/A,N/A,N/A,1649,1653,N/A,105,3
2,N/A,N/A,N/A,1647,1649,N/A,111,3
2,N/A,N/A,N/A,1645,1647,N/A,116,2
3,N/A,N/A,N/A,1642,1645,N/A,122,2
12,N/A,N/A,N/A,1630,1642,N/A,126,6
12,N/A,N/A,N/A,1618,1630,N/A,131,5
2,N/A,N/A,N/A,1616,1618,N/A,134,2
3,N/A,N/A,N/A,1613,1616,N/A,140,2
1,N/A,N/A,N/A,1612,1613,N/A,145,1
1,N/A,N/A,N/A,299,300,N/A,4,1
14,N/A,N/A,N/A,285,299,N/A,7,4
7,N/A,N/A,N/A,278,285,N/A,13,4
3,N/A,N/A,N/A,275,278,N/A,17,2
3,N/A,N/A,N/A,272,275,N/A,23,2
3,N/A,N/A,N/A,269,272,N/A,29,2
16,N/A,N/A,N/A,253,269,N/A,32,5
10,N/A,N/A,N/A,243,253,N/A,38,5
16,N/A,N/A,N/A,227,243,N/A,44,5
4,N/A,N/A,N/A,223,227,N/A,48,3
4,N/A,N/A,N/A,219,223,N/A,54,3
1,N/A,N/A,N/A,218,219,N/A,58,1
13,N/A,N/A,N/A,205,218,N/A,61,4
2,N/A,N/A,N/A,203,205,N/A,65,2
15,N/A,N/A,N/A,188,203,N/A,69,6
5,N/A,N/A,N/A,183,188,N/A,73,4
4,N/A,N/A,N/A,179,183,N/A,77,2
4,N/A,N/A,N/A,175,179,N/A,83,2
11,N/A,N/A,N/A,164,175,N/A,86,5
11,N/A,N/A,N/A,153,164,N/A,91,4
2,N/A,N/A,N/A,151,153,N/A,96,3
3,N/A,N/A,N/A,148,151,N/A,102,3
2,N/A,N/A,N/A,146,148,N/A,106,1
19,N/A,N/A,N/A,127,146,N/A,110,5
10,N/A,N/A,N/A,117,127,N/A,116,5
14,N/A,N/A,N/A,103,117,N/A,121,4
1,N/A,N/A,N/A,102,103,N/A,124,1
10,N/A,N/A,N/A,92,102,N/A,128,5
3,N/A,N/A,N/A,89,92,N/A,131,2
2,N/A,N/A,N/A,87,89,N/A,136,1
3,N/A,N/A,N/A,1581,1584,N/A,4,2
11,N/A,N/A,N/A,1570,1581,N/A,8,6
8,N/A,N/A,N/A,1562,1570,N/A,12,4
2,N/A,N/A,N/A,1560,1562,N/A,16,2
4,N/A,N/A,N/A,1556,1560,N/A,22,2
16,N/A,N/A,N/A,1540,1556,N/A,26,6
11,N/A,N/A,N/A,1529,1540,N/A,31,5
2,N/A,N/A,N/A,1527,1529,N/A,35,3
12,N/A,N/A,N/A,1515,1527,N/A,38,6
3,N/A,N/A,N/A,1512,1515,N/A,41,3
12,N/A,N/A,N/A,1500,1512,N/A,44,6
4,N/A,N/A,N/A,1496,1500,N/A,47,3
1,N/A,N/A,N/A,1495,1496,N/A,51,1
11,N/A,N/A,N/A,1484,1495,N/A,55,5
3,N/A,N/A,N/A,1481,1484,N/A,58,2
13,N/A,N/A,N/A,1468,1481,N/A,61,5
4,N/A,N/A,N/A,1464,1468,N/A,64,2
15,N/A,N/A,N/A,1449,1464,N/A,68,6
4,N/A,N/A,N/A,1445,1449,N/A,71,3
18,N/A,N/A,N/A,1427,1445,N/A,74,6
15,N/A,N/A,N/A,1412,1427,N/A,79,5
2,N/A,N/A,N/A,1410,1412,N/A,82,2
2,N/A,N/A,N/A,1408,1410,N/A,87,1
2,N/A,N/A,N/A,1406,1408,N/A,93,1
12,N/A,N/A,N/A,1394,1406,N/A,97,5
2,N/A,N/A,N/A,1392,1394,N/A,100,2
2,N/A,N/A,N/A,1390,1392,N/A,105,1
11,N/A,N/A,N/A,1379,1390,N/A,110,6
4,N/A,N/A,N/A,1375,1379,N/A,113,3
2,N/A,N/A,N/A,1373,1375,N/A,119,3
19,N/A,N/A,N/A,1795,1814,N/A,6,6
4,N/A,N/A,N/A,1791,1795,N/A,9,3
2,N/A,N/A,N/A,1789,1791,N/A,15,3
2,N/A,N/A,N/A,1787,1789,N/A,20,2
18,N/A,N/A,N/A,1769,1787,N/A,23,5
4,N/A,N/A,N/A,1765,1769,N/A,27,3
4,N/A,N/A,N/A,1761,1765,N/A,32,2
15,N/A,N/A,N/A,1746,1761,N/A,36,6
18,N/A,N/A,N/A,1728,1746,N/A,41,5
3,N/A,N/A,N/A,1725,1728,N/A,44,2
2,N/A,N/A,N/A,1723,1725,N/A,49,1
13,N/A,N/A,N/A,1710,1723,N/A,53,5
6,N/A,N/A,N/A,1704,1710,N/A,58,4
2,N/A,N/A,N/A,1702,1704,N/A,63,3
1,N/A,N/A,N/A,1701,1702,N/A,67,1
18,N/A,N/A,N/A,1683,1701,N/A,72,6
4,N/A,N/A,N/A,1679,1683,N/A,75,3
2,N/A,N/A,N/A,1677,1679,N/A,79,1
1,N/A,N/A,N/A,1676,1677,N/A,85,1
1,N/A,N/A,N/A,1675,1676,N/A,91,1
1,N/A,N/A,N/A,1674,1675,N/A,97,1
1,N/A,N/A,N/A,1673,1674,N/A,103,1
10,N/A,N/A,N/A,1663,1673,N/A,107,5
12,N/A,N/A,N/A,1651,1663,N/A,112,4
4,N/A,N/A,N/A,1647,1651,N/A,117,3
4,N/A,N/A,N/A,1643,1647,N/A,122,2
4,N/A,N/A,N/A,1639,1643,N/A,128,2
3,N/A,N/A,N/A,1636,1639,N/A,134,2
14,N/A,N/A,N/A,1622,1636,N/A,138,6
12,N/A,N/A,N/A,1610,1622,N/A,142,4
2,N/A,N/A,N/A,1327,1329,N/A,4,2
18,N/A,N/A,N/A,1309,1327,N/A,7,5
4,N/A,N/A,N/A,1305,1309,N/A,11,3
2,N/A,N/A,N/A,1303,1305,N/A,15,1
17,N/A,N/A,N/A,1286,1303,N/A,20,6
2,N/A,N/A,N/A,1284,1286,N/A,26,0
2,N/A,N/A,N/A,1282,1284,N/A,29,3
3,N/A,N/A,N/A,1279,1282,N/A,35,3
15,N/A,N/A,N/A,1264,1279,N/A,38,6
3,N/A,N/A,N/A,1261,1264,N/A,41,3
3,N/A,N/A,N/A,1258,1261,N/A,47,3
2,N/A,N/A,N/A,1256,1258,N/A,51,1
20,N/A,N/A,N/A,1236,1256,N/A,56,6
12,N/A,N/A,N/A,1224,1236,N/A,60,4
3,N/A,N/A,N/A,1221,1224,N/A,65,3
1,N/A,N/A,N/A,1220,1221,N/A,69,1
1,N/A,N/A,N/A,1219,1220,N/A,75,1
14,N/A,N/A,N/A,1205,1219,N/A,80,6
14,N/A,N/A,N/A,1191,1205,N/A,84,4
4,N/A,N/A,N/A,1187,1191,N/A,88,2
13,N/A,N/A,N/A,1174,1187,N/A,91,5
8,N/A,N/A,N/A,1166,1174,N/A,96,4
13,N/A,N/A,N/A,1153,1166,N/A,102,4
2,N/A,N/A,N/A,1151,1153,N/A,107,3
4,N/A,N/A,N/A,1147,1151,N/A,112,2
13,N/A,N/A,N/A,1134,1147,N/A,116,6
4,N/A,N/A,N/A,1130,1134,N/A,119,3
4,N/A,N/A,N/A,1126,1130,N/A,125,3
17,N/A,N/A,N/A,1109,1126,N/A,128,6
19,N/A,N/A,N/A,1090,1109,N/A,133,5
3,N/A,N/A,N/A,671,674,N/A,4,2
15,N/A,N/A,N/A,656,671,N/A,7,5
13,N/A,N/A,N/A,643,656,N/A,13,5
2,N/A,N/A,N/A,641,643,N/A,17,3
4,N/A,N/A,N/A,637,641,N/A,22,2
19,N/A,N/A,N/A,618,637,N/A,26,6
8,N/A,N/A,N/A,610,618,N/A,30,4
11,N/A,N/A,N/A,599,610,N/A,36,4
1,N/A,N/A,N/A,598,599,N/A,39,1
1,N/A,N/A,N/A,597,598,N/A,45,1
12,N/A,N/A,N/A,585,597,N/A,49,5
5,N/A,N/A,N/A,580,585,N/A,54,4
2,N/A,N/A,N/A,578,580,N/A,57,1
11,N/A,N/A,N/A,567,578,N/A,62,6
12,N/A,N/A,N/A,555,567,N/A,67,5
11,N/A,N/A,N/A,544,555,N/A,72,4
2,N/A,N/A,N/A,542,544,N/A,75,1
11,N/A,N/A,N/A,531,542,N/A,80,6
11,N/A,N/A,N/A,520,531,N/A,85,5
2,N/A,N/A,N/A,518,520,N/A,88,2
4,N/A,N/A,N/A,514,518,N/A,94,2
2,N/A,N/A,N/A,512,514,N/A,99,1
2,N/A,N/A,N/A,510,512,N/A,105,1
18,N/A,N/A,N/A,492,510,N/A,110,6
19,N/A,N/A,N/A,473,492,N/A,115,5
17,N/A,N/A,N/A,456,473,N/A,121,5
4,N/A,N/A,N/A,452,456,N/A,124,2
16,N/A,N/A,N/A,436,452,N/A,128,6
3,N/A,N/A,N/A,433,436,N/A,131,3
2,N/A,N/A,N/A,431,433,N/A,136,2
11,N/A,N/A,N/A,677,688,N/A,3,5
11,N/A,N/A,N/A,666,677,N/A,8,4
1,N/A,N/A,N/A,665,666,N/A,11,1
18,N/A,N/A,N/A,647,665,N/A,16,6
3,N/A,N/A,N/A,644,647,N/A,19,3
20,N/A,N/A,N/A,624,644,N/A,22,6
2,N/A,N/A,N/A,622,624,N/A,28,0
4,N/A,N/A,N/A,618,622,N/A,31,3
3,N/A,N/A,N/A,615,618,N/A,36,2
20,N/A,N/A,N/A,595,615,N/A,40,6
2,N/A,N/A,N/A,593,595,N/A,43,3
4,N/A,N/A,N/A,589,593,N/A,48,2
15,N/A,N/A,N/A,574,589,N/A,52,6
4,N/A,N/A,N/A,570,574,N/A,55,3
2,N/A,N/A,N/A,568,570,N/A,60,2
2,N/A,N/A,N/A,566,568,N/A,66,2
3,N/A,N/A,N/A,563,566,N/A,72,2
10,N/A,N/A,N/A,553,563,N/A,75,5
8,N/A,N/A,N/A,545,553,N/A,80,4
7,N/A,N/A,N/A,538,545,N/A,86,4
2,N/A,N/A,N/A,536,538,N/A,90,2
19,N/A,N/A,N/A,517,536,N/A,93,5
2,N/A,N/A,N/A,515,517,N/A,97,3
17,N/A,N/A,N/A,498,515,N/A,100,6
6,N/A,N/A,N/A,492,498,N/A,104,4
2,N/A,N/A,N/A,490,492,N/A,109,3
1,N/A,N/A,N/A,489,490,N/A,113,1
2,N/A,N/A,N/A,487,489,N/A,119,1
18,N/A,N/A,N/A,469,487,N/A,123,5
3,N/A,N/A,N/A,466,469,N/A,127,3
10,N/A,N/A,N/A,1222,1232,N/A,5,4
4,N/A,N/A,N/A,1218,1222,N/A,9,2
12,N/A,N/A,N/A,1206,1218,N/A,13,6
1,N/A,N/A,N/A,1205,1206,N/A,19,0
3,N/A,N/A,N/A,1202,1205,N/A,22,3
11,N/A,N/A,N/A,1191,1202,N/A,25,6
8,N/A,N/A,N/A,1183,1191,N/A,29,4
3,N/A,N/A,N/A,1180,1183,N/A,34,3
11,N/A,N/A,N/A,1169,1180,N/A,37,6
1,N/A,N/A,N/A,1168,1169,N/A,43,0
5,N/A,N/A,N/A,1163,1168,N/A,47,4
3,N/A,N/A,N/A,1160,1163,N/A,51,2
4,N/A,N/A,N/A,1156,1160,N/A,57,2
4,N/A,N/A,N/A,1152,1156,N/A,63,2
4,N/A,N/A,N/A,1148,1152,N/A,69,2
20,N/A,N/A,N/A,1128,1148,N/A,73,6
4,N/A,N/A,N/A,1124,1128,N/A,76,3
4,N/A,N/A,N/A,1120,1124,N/A,81,2
18,N/A,N/A,N/A,1102,1120,N/A,84,5
4,N/A,N/A,N/A,1098,1102,N/A,88,3
19,N/A,N/A,N/A,1079,1098,N/A,91,6
11,N/A,N/A,N/A,1068,1079,N/A,95,4
4,N/A,N/A,N/A,1064,1068,N/A,99,2
4,N/A,N/A,N/A,1060,1064,N/A,105,2
19,N/A,N/A,N/A,1041,1060,N/A,109,6
2,N/A,N/A,N/A,1039,1041,N/A,115,0
2,N/A,N/A,N/A,1037,1039,N/A,118,3
2,N/A,N/A,N/A,1035,1037,N/A,124,3
16,N/A,N/A,N/A,1019,1035,N/A,127,6
16,N/A,N/A,N/A,1003,1019,N/A,132,5
2,N/A,N/A,N/A,1581,1583,N/A,3,1
20,N/A,N/A,N/A,1561,1581,N/A,8,6
2,N/A,N/A,N/A,1559,1561,N/A,14,0
12,N/A,N/A,N/A,1547,1559,N/A,18,4
2,N/A,N/A,N/A,1545,1547,N/A,21,1
1,N/A,N/A,N/A,1544,1545,N/A,27,1
7,N/A,N/A,N/A,1537,1544,N/A,30,4
1,N/A,N/A,N/A,1536,1537,N/A,33,1
12,N/A,N/A,N/A,1524,1536,N/A,37,5
17,N/A,N/A,N/A,1507,1524,N/A,43,5
4,N/A,N/A,N/A,1503,1507,N/A,47,3
4,N/A,N/A,N/A,1499,1503,N/A,52,2
2,N/A,N/A,N/A,1497,1499,N/A,57,1
9,N/A,N/A,N/A,1488,1497,N/A,60,4
1,N/A,N/A,N/A,1487,1488,N/A,63,1
10,N/A,N/A,N/A,1477,1487,N/A,66,4
4,N/A,N/A,N/A,1473,1477,N/A,71,3
2,N/A,N/A,N/A,1471,1473,N/A,77,3
2,N/A,N/A,N/A,1469,1471,N/A,82,2
1,N/A,N/A,N/A,1468,1469,N/A,87,1
2,N/A,N/A,N/A,1466,1468,N/A,93,1
7,N/A,N/A,N/A,1459,1466,N/A,96,4
2,N/A,N/A,N/A,1457,1459,N/A,99,1
2,N/A,N/A,N/A,1455,1457,N/A,105,1
11,N/A,N/A,N/A,1444,1455,N/A,109,5
18,N/A,N/A,N/A,1426,1444,N/A,115,5
3,N/A,N/A,N/A,1423,1426,N/A,118,2
1,N/A,N/A,N/A,1422,1423,N/A,123,1
10,N/A,N/A,N/A,1412,1422,N/A,127,5
3,N/A,N/A,N/A,1409,1412,N/A,131,3
3,N/A,N/A,N/A,679,682,N/A,4,2
4,N/A,N/A,N/A,675,679,N/A,10,2
12,N/A,N/A,N/A,663,675,N/A,14,6
4,N/A,N/A,N/A,659,663,N/A,17,3
3,N/A,N/A,N/A,656,659,N/A,23,3
14,N/A,N/A,N/A,642,656,N/A,26,6
4,N/A,N/A,N/A,638,642,N/A,29,3
4,N/A,N/A,N/A,634,638,N/A,35,3
4,N/A,N/A,N/A,630,634,N/A,41,3
1,N/A,N/A,N/A,629,630,N/A,45,1
14,N/A,N/A,N/A,615,629,N/A,48,4
3,N/A,N/A,N/A,612,615,N/A,53,3
2,N/A,N/A,N/A,610,612,N/A,59,3
20,N/A,N/A,N/A,590,610,N/A,62,6
1,N/A,N/A,N/A,589,590,N/A,68,0
11,N/A,N/A,N/A,578,589,N/A,73,5
15,N/A,N/A,N/A,563,578,N/A,79,5
4,N/A,N/A,N/A,559,563,N/A,82,2
19,N/A,N/A,N/A,540,559,N/A,85,5
5,N/A,N/A,N/A,535,540,N/A,90,4
2,N/A,N/A,N/A,533,535,N/A,95,3
16,N/A,N/A,N/A,517,533,N/A,98,6
3,N/A,N/A,N/A,514,517,N/A,101,3
4,N/A,N/A,N/A,510,514,N/A,107,3
15,N/A,N/A,N/A,495,510,N/A,110,6
2,N/A,N/A,N/A,493,495,N/A,116,0
9,N/A,N/A,N/A,484,493,N/A,120,4
12,N/A,N/A,N/A,472,484,N/A,126,4
3,N/A,N/A,N/A,469,472,N/A,131,3
2,N/A,N/A,N/A,467,469,N/A,136,2
11,N/A,N/A,N/A,1969,1980,N/A,3,4
2,N/A,N/A,N/A,1967,1969,N/A,6,1
2,N/A,N/A,N/A,1965,1967,N/A,12,1
19,N/A,N/A,N/A,1946,1965,N/A,16,5
4,N/A,N/A,N/A,1942,1946,N/A,19,2
16,N/A,N/A,N/A,1926,1942,N/A,22,5
2,N/A,N/A,N/A,1924,1926,N/A,26,3
12,N/A,N/A,N/A,1912,1924,N/A,29,6
13,N/A,N/A,N/A,1899,1912,N/A,34,5
10,N/A,N/A,N/A,1889,1899,N/A,40,5
2,N/A,N/A,N/A,1887,1889,N/A,44,3
1,N/A,N/A,N/A,1886,1887,N/A,48,1
1,N/A,N/A,N/A,1885,1886,N/A,54,1
7,N/A,N/A,N/A,1878,1885,N/A,57,4
2,N/A,N/A,N/A,1876,1878,N/A,61,2
17,N/A,N/A,N/A,1859,1876,N/A,64,5
19,N/A,N/A,N/A,1840,1859,N/A,70,5
2,N/A,N/A,N/A,1838,1840,N/A,74,3
2,N/A,N/A,N/A,1836,1838,N/A,79,2
11,N/A,N/A,N/A,1825,1836,N/A,83,6
11,N/A,N/A,N/A,1814,1825,N/A,88,5
16,N/A,N/A,N/A,1798,1814,N/A,94,5
4,N/A,N/A,N/A,1794,1798,N/A,98,3
2,N/A,N/A,N/A,1792,1794,N/A,104,3
2,N/A,N/A,N/A,1790,1792,N/A,108,1
2,N/A,N/A,N/A,1788,1790,N/A,114,1
15,N/A,N/A,N/A,1773,1788,N/A,119,6
4,N/A,N/A,N/A,1769,1773,N/A,122,3
4,N/A,N/A,N/A,1765,1769,N/A,128,3
4,N/A,N/A,N/A,1761,1765,N/A,133,2
12,N/A,N/A,N/A,368,380,N/A,6,6
1,N/A,N/A,N/A,367,368,N/A,12,0
2,N/A,N/A,N/A,365,367,N/A,15,3
3,N/A,N/A,N/A,362,365,N/A,21,3
2,N/A,N/A,N/A,360,362,N/A,26,2
15,N/A,N/A,N/A,345,360,N/A,30,6
2,N/A,N/A,N/A,343,345,N/A,36,0
18,N/A,N/A,N/A,325,343,N/A,41,5
3,N/A,N/A,N/A,322,325,N/A,45,3
1,N/A,N/A,N/A,321,322,N/A,49,1
2,N/A,N/A,N/A,319,321,N/A,55,1
13,N/A,N/A,N/A,306,319,N/A,59,5
8,N/A,N/A,N/A,298,306,N/A,64,4
2,N/A,N/A,N/A,296,298,N/A,67,1
6,N/A,N/A,N/A,290,296,N/A,70,4
3,N/A,N/A,N/A,287,290,N/A,75,3
16,N/A,N/A,N/A,271,287,N/A,78,6
2,N/A,N/A,N/A,269,271,N/A,81,3
17,N/A,N/A,N/A,252,269,N/A,84,6
11,N/A,N/A,N/A,241,252,N/A,89,5
9,N/A,N/A,N/A,232,241,N/A,94,4
3,N/A,N/A,N/A,229,232,N/A,98,2
2,N/A,N/A,N/A,227,229,N/A,104,2
1,N/A,N/A,N/A,226,227,N/A,109,1
11,N/A,N/A,N/A,215,226,N/A,114,6
3,N/A,N/A,N/A,212,215,N/A,117,3
2,N/A,N/A,N/A,210,212,N/A,121,1
10,N/A,N/A,N/A,200,210,N/A,125,5
16,N/A,N/A,N/A,184,200,N/A,131,5
2,N/A,N/A,N/A,182,184,N/A,135,3
12,N/A,N/A,N/A,1872,1884,N/A,3,6
2,N/A,N/A,N/A,1870,1872,N/A,9,0
10,N/A,N/A,N/A,1860,1870,N/A,14,5
14,N/A,N/A,N/A,1846,1860,N/A,19,4
1,N/A,N/A,N/A,1845,1846,N/A,22,1
1,N/A,N/A,N/A,1844,1845,N/A,28,1
8,N/A,N/A,N/A,1836,1844,N/A,31,4
8,N/A,N/A,N/A,1828,1836,N/A,37,4
7,N/A,N/A,N/A,1821,1828,N/A,43,4
3,N/A,N/A,N/A,1818,1821,N/A,48,3
1,N/A,N/A,N/A,1817,1818,N/A,52,1
6,N/A,N/A,N/A,1811,1817,N/A,55,4
13,N/A,N/A,N/A,1798,1811,N/A,61,4
5,N/A,N/A,N/A,1793,1798,N/A,67,4
2,N/A,N/A,N/A,1791,1793,N/A,71,2
13,N/A,N/A,N/A,1778,1791,N/A,75,6
3,N/A,N/A,N/A,1775,1778,N/A,78,3
2,N/A,N/A,N/A,1773,1775,N/A,84,3
1,N/A,N/A,N/A,1772,1773,N/A,88,1
15,N/A,N/A,N/A,1757,1772,N/A,93,6
16,N/A,N/A,N/A,1741,1757,N/A,98,5
3,N/A,N/A,N/A,1738,1741,N/A,101,2
17,N/A,N/A,N/A,1721,1738,N/A,104,5
8,N/A,N/A,N/A,1713,1721,N/A,109,4
3,N/A,N/A,N/A,1710,1713,N/A,114,3
2,N/A,N/A,N/A,1708,1710,N/A,120,3
4,N/A,N/A,N/A,1704,1708,N/A,126,3
4,N/A,N/A,N/A,1700,1704,N/A,131,2
19,N/A,N/A,N/A,1681,1700,N/A,135,6
2,N/A,N/A,N/A,1679,1681,N/A,138,3
13,N/A,N/A,N/A,593,606,N/A,5,6
10,N/A,N/A,N/A,583,593,N/A,9,4
7,N/A,N/A,N/A,576,583,N/A,15,4
4,N/A,N/A,N/A,572,576,N/A,20,3
20,N/A,N/A,N/A,552,572,N/A,23,6
1,N/A,N/A,N/A,551,552,N/A,29,0
16,N/A,N/A,N/A,535,551,N/A,35,6
7,N/A,N/A,N/A,528,535,N/A,39,4
2,N/A,N/A,N/A,526,528,N/A,42,1
8,N/A,N/A,N/A,518,526,N/A,45,4
3,N/A,N/A,N/A,515,518,N/A,50,3
19,N/A,N/A,N/A,496,515,N/A,53,6
3,N/A,N/A,N/A,493,496,N/A,56,3
3,N/A,N/A,N/A,490,493,N/A,61,2
2,N/A,N/A,N/A,488,490,N/A,66,1
7,N/A,N/A,N/A,481,488,N/A,69,4
8,N/A,N/A,N/A,473,481,N/A,75,4
2,N/A,N/A,N/A,471,473,N/A,78,1
20,N/A,N/A,N/A,451,471,N/A,83,6
2,N/A,N/A,N/A,449,451,N/A,86,3
2,N/A,N/A,N/A,447,449,N/A,91,2
12,N/A,N/A,N/A,435,447,N/A,94,5
4,N/A,N/A,N/A,431,435,N/A,98,3
4,N/A,N/A,N/A,427,431,N/A,104,3
11,N/A,N/A,N/A,416,427,N/A,107,6
2,N/A,N/A,N/A,414,416,N/A,110,3
2,N/A,N/A,N/A,412,414,N/A,114,1
1,N/A,N/A,N/A,411,412,N/A,120,1
1,N/A,N/A,N/A,410,411,N/A,126,1
12,N/A,N/A,N/A,398,410,N/A,130,5
2,N/A,N/A,N/A,1326,1328,N/A,6,1
13,N/A,N/A,N/A,1313,1326,N/A,11,6
14,N/A,N/A,N/A,1299,1313,N/A,15,4
7,N/A,N/A,N/A,1292,1299,N/A,21,4
3,N/A,N/A,N/A,1289,1292,N/A,25,2
17,N/A,N/A,N/A,1272,1289,N/A,28,5
3,N/A,N/A,N/A,1269,1272,N/A,31,2
17,N/A,N/A,N/A,1252,1269,N/A,35,6
14,N/A,N/A,N/A,1238,1252,N/A,40,5
11,N/A,N/A,N/A,1227,1238,N/A,46,5
2,N/A,N/A,N/A,1225,1227,N/A,49,2
14,N/A,N/A,N/A,1211,1225,N/A,53,6
13,N/A,N/A,N/A,1198,1211,N/A,58,5
18,N/A,N/A,N/A,1180,1198,N/A,64,5
2,N/A,N/A,N/A,1178,1180,N/A,68,3
3,N/A,N/A,N/A,1175,1178,N/A,74,3
2,N/A,N/A,N/A,1173,1175,N/A,78,1
16,N/A,N/A,N/A,1157,1173,N/A,83,6
1,N/A,N/A,N/A,1156,1157,N/A,89,0
3,N/A,N/A,N/A,1153,1156,N/A,92,3
20,N/A,N/A,N/A,1133,1153,N/A,95,6
1,N/A,N/A,N/A,1132,1133,N/A,101,0
3,N/A,N/A,N/A,1129,1132,N/A,104,3
2,N/A,N/A,N/A,1127,1129,N/A,108,1
15,N/A,N/A,N/A,1112,1127,N/A,112,5
6,N/A,N/A,N/A,1106,1112,N/A,117,4
2,N/A,N/A,N/A,1104,1106,N/A,122,3
4,N/A,N/A,N/A,1100,1104,N/A,127,2
3,N/A,N/A,N/A,1097,1100,N/A,133,2
3,N/A,N/A,N/A,1094,1097,N/A,139,2
1,N/A,N/A,N/A,393,394,N/A,6,1
13,N/A,N/A,N/A,380,393,N/A,11,6
2,N/A,N/A,N/A,378,380,N/A,17,0
4,N/A,N/A,N/A,374,378,N/A,20,3
3,N/A,N/A,N/A,371,374,N/A,26,3
1,N/A,N/A,N/A,370,371,N/A,30,1
13,N/A,N/A,N/A,357,370,N/A,33,4
3,N/A,N/A,N/A,354,357,N/A,37,2
15,N/A,N/A,N/A,339,354,N/A,40,5
15,N/A,N/A,N/A,324,339,N/A,46,5
4,N/A,N/A,N/A,320,324,N/A,49,2
4,N/A,N/A,N/A,316,320,N/A,55,2
13,N/A,N/A,N/A,303,316,N/A,59,6
13,N/A,N/A,N/A,290,303,N/A,63,4
3,N/A,N/A,N/A,287,290,N/A,68,3
1,N/A,N/A,N/A,286,287,N/A,72,1
2,N/A,N/A,N/A,284,286,N/A,78,1
15,N/A,N/A,N/A,269,284,N/A,83,6
4,N/A,N/A,N/A,265,269,N/A,86,3
2,N/A,N/A,N/A,263,265,N/A,90,1
1,N/A,N/A,N/A,262,263,N/A,96,1
12,N/A,N/A,N/A,250,262,N/A,101,6
2,N/A,N/A,N/A,248,250,N/A,104,3
3,N/A,N/A,N/A,245,248,N/A,109,2
17,N/A,N/A,N/A,228,245,N/A,112,5
5,N/A,N/A,N/A,223,228,N/A,117,4
3,N/A,N/A,N/A,220,223,N/A,121,2
15,N/A,N/A,N/A,205,220,N/A,125,6
1,N/A,N/A,N/A,204,205,N/A,131,0
13,N/A,N/A,N/A,191,204,N/A,136,5
3,N/A,N/A,N/A,415,418,N/A,6,3
14,N/A,N/A,N/A,401,415,N/A,9,6
18,N/A,N/A,N/A,383,401,N/A,14,5
3,N/A,N/A,N/A,380,383,N/A,17,2
15,N/A,N/A,N/A,365,380,N/A,20,5
3,N/A,N/A,N/A,362,365,N/A,23,2
4,N/A,N/A,N/A,358,362,N/A,29,2
1,N/A,N/A,N/A,357,358,N/A,34,1
10,N/A,N/A,N/A,347,357,N/A,37,4
2,N/A,N/A,N/A,345,347,N/A,42,3
1,N/A,N/A,N/A,344,345,N/A,46,1
19,N/A,N/A,N/A,325,344,N/A,50,5
19,N/A,N/A,N/A,306,325,N/A,56,5
2,N/A,N/A,N/A,304,306,N/A,59,2
1,N/A,N/A,N/A,303,304,N/A,64,1
17,N/A,N/A,N/A,286,303,N/A,69,6
2,N/A,N/A,N/A,284,286,N/A,75,0
15,N/A,N/A,N/A,269,284,N/A,81,6
3,N/A,N/A,N/A,266,269,N/A,84,3
3,N/A,N/A,N/A,263,266,N/A,90,3
17,N/A,N/A,N/A,246,263,N/A,93,6
15,N/A,N/A,N/A,231,246,N/A,98,5
14,N/A,N/A,N/A,217,231,N/A,104,5
5,N/A,N/A,N/A,212,217,N/A,109,4
4,N/A,N/A,N/A,208,212,N/A,114,3
2,N/A,N/A,N/A,206,208,N/A,118,1
14,N/A,N/A,N/A,192,206,N/A,121,4
12,N/A,N/A,N/A,180,192,N/A,127,4
7,N/A,N/A,N/A,173,180,N/A,133,4
4,N/A,N/A,N/A,169,173,N/A,137,2
16,N/A,N/A,N/A,604,620,N/A,4,6
16,N/A,N/A,N/A,588,604,N/A,9,5
4,N/A,N/A,N/A,584,588,N/A,13,3
4,N/A,N/A,N/A,580,584,N/A,18,2
15,N/A,N/A,N/A,565,580,N/A,22,6
3,N/A,N/A,N/A,562,565,N/A,25,3
3,N/A,N/A,N/A,559,562,N/A,31,3
4,N/A,N/A,N/A,555,559,N/A,36,2
2,N/A,N/A,N/A,553,555,N/A,42,2
1,N/A,N/A,N/A,552,553,N/A,47,1
9,N/A,N/A,N/A,543,552,N/A,50,4
3,N/A,N/A,N/A,540,543,N/A,54,2
2,N/A,N/A,N/A,538,540,N/A,59,1
1,N/A,N/A,N/A,537,538,N/A,65,1
13,N/A,N/A,N/A,524,537,N/A,68,4
2,N/A,N/A,N/A,522,524,N/A,72,2
4,N/A,N/A,N/A,518,522,N/A,78,2
2,N/A,N/A,N/A,516,518,N/A,83,1
10,N/A,N/A,N/A,506,516,N/A,87,5
4,N/A,N/A,N/A,502,506,N/A,90,2
18,N/A,N/A,N/A,484,502,N/A,94,6
12,N/A,N/A,N/A,472,484,N/A,98,4
7,N/A,N/A,N/A,465,472,N/A,104,4
7,N/A,N/A,N/A,458,465,N/A,110,4
2,N/A,N/A,N/A,456,458,N/A,113,1
10,N/A,N/A,N/A,446,456,N/A,116,4
6,N/A,N/A,N/A,440,446,N/A,122,4
1,N/A,N/A,N/A,439,440,N/A,125,1
11,N/A,N/A,N/A,428,439,N/A,128,4
3,N/A,N/A,N/A,425,428,N/A,133,3
1,N/A,N/A,N/A,1946,1947,N/A,3,1
14,N/A,N/A,N/A,1932,1946,N/A,6,4
7,N/A,N/A,N/A,1925,1932,N/A,12,4
4,N/A,N/A,N/A,1921,1925,N/A,17,3
2,N/A,N/A,N/A,1919,1921,N/A,21,1
13,N/A,N/A,N/A,1906,1919,N/A,24,4
2,N/A,N/A,N/A,1904,1906,N/A,28,2
18,N/A,N/A,N/A,1886,1904,N/A,31,5
4,N/A,N/A,N/A,1882,1886,N/A,34,2
1,N/A,N/A,N/A,1881,1882,N/A,39,1
16,N/A,N/A,N/A,1865,1881,N/A,43,5
4,N/A,N/A,N/A,1861,1865,N/A,46,2
14,N/A,N/A,N/A,1847,1861,N/A,50,6
14,N/A,N/A,N/A,1833,1847,N/A,54,4
8,N/A,N/A,N/A,1825,1833,N/A,60,4
2,N/A,N/A,N/A,1823,1825,N/A,63,1
7,N/A,N/A,N/A,1816,1823,N/A,66,4
13,N/A,N/A,N/A,1803,1816,N/A,72,4
2,N/A,N/A,N/A,1801,1803,N/A,75,1
15,N/A,N/A,N/A,1786,1801,N/A,80,6
14,N/A,N/A,N/A,1772,1786,N/A,84,4
11,N/A,N/A,N/A,1761,1772,N/A,90,4
4,N/A,N/A,N/A,1757,1761,N/A,94,2
15,N/A,N/A,N/A,1742,1757,N/A,97,5
13,N/A,N/A,N/A,1729,1742,N/A,103,5
3,N/A,N/A,N/A,1726,1729,N/A,106,2
2,N/A,N/A,N/A,1724,1726,N/A,111,1
13,N/A,N/A,N/A,1711,1724,N/A,115,5
16,N/A,N/A,N/A,1695,1711,N/A,121,5
18,N/A,N/A,N/A,1677,1695,N/A,127,5
9,N/A,N/A,N/A,1170,1179,N/A,4,4
3,N/A,N/A,N/A,1167,1170,N/A,9,3
2,N/A,N/A,N/A,1165,1167,N/A,13,1
19,N/A,N/A,N/A,1146,1165,N/A,17,5
13,N/A,N/A,N/A,1133,1146,N/A,23,5
4,N/A,N/A,N/A,1129,1133,N/A,27,3
12,N/A,N/A,N/A,1117,1129,N/A,30,6
8,N/A,N/A,N/A,1109,1117,N/A,34,4
2,N/A,N/A,N/A,1107,1109,N/A,37,1
2,N/A,N/A,N/A,1105,1107,N/A,43,1
16,N/A,N/A,N/A,1089,1105,N/A,48,6
6,N/A,N/A,N/A,1083,1089,N/A,52,4
6,N/A,N/A,N/A,1077,1083,N/A,58,4
12,N/A,N/A,N/A,1065,1077,N/A,64,4
4,N/A,N/A,N/A,1061,1065,N/A,69,3
2,N/A,N/A,N/A,1059,1061,N/A,73,1
14,N/A,N/A,N/A,1045,1059,N/A,77,5
3,N/A,N/A,N/A,1042,1045,N/A,81,3
4,N/A,N/A,N/A,1038,1042,N/A,87,3
2,N/A,N/A,N/A,1036,1038,N/A,91,1
15,N/A,N/A,N/A,1021,1036,N/A,96,6
9,N/A,N/A,N/A,1012,1021,N/A,100,4
4,N/A,N/A,N/A,1008,1012,N/A,104,2
13,N/A,N/A,N/A,995,1008,N/A,108,6
7,N/A,N/A,N/A,988,995,N/A,112,4
4,N/A,N/A,N/A,984,988,N/A,116,2
15,N/A,N/A,N/A,969,984,N/A,119,5
11,N/A,N/A,N/A,958,969,N/A,125,5
10,N/A,N/A,N/A,948,958,N/A,131,5
3,N/A,N/A,N/A,945,948,N/A,134,2
14,N/A,N/A,N/A,946,960,N/A,6,6
3,N/A,N/A,N/A,943,946,N/A,9,3
3,N/A,N/A,N/A,940,943,N/A,14,2
12,N/A,N/A,N/A,928,940,N/A,18,6
1,N/A,N/A,N/A,927,928,N/A,24,0
12,N/A,N/A,N/A,915,927,N/A,28,4
4,N/A,N/A,N/A,911,915,N/A,33,3
13,N/A,N/A,N/A,898,911,N/A,36,6
18,N/A,N/A,N/A,880,898,N/A,41,5
16,N/A,N/A,N/A,864,880,N/A,47,5
9,N/A,N/A,N/A,855,864,N/A,52,4
4,N/A,N/A,N/A,851,855,N/A,57,3
11,N/A,N/A,N/A,840,851,N/A,60,6
2,N/A,N/A,N/A,838,840,N/A,66,0
11,N/A,N/A,N/A,827,838,N/A,71,5
3,N/A,N/A,N/A,824,827,N/A,75,3
4,N/A,N/A,N/A,820,824,N/A,80,2
4,N/A,N/A,N/A,816,820,N/A,86,2
3,N/A,N/A,N/A,813,816,N/A,92,2
3,N/A,N/A,N/A,810,813,N/A,98,2
2,N/A,N/A,N/A,808,810,N/A,104,2
2,N/A,N/A,N/A,806,808,N/A,109,1
2,N/A,N/A,N/A,804,806,N/A,115,1
13,N/A,N/A,N/A,791,804,N/A,119,5
13,N/A,N/A,N/A,778,791,N/A,125,5
10,N/A,N/A,N/A,768,778,N/A,130,4
3,N/A,N/A,N/A,765,768,N/A,135,3
20,N/A,N/A,N/A,745,765,N/A,138,6
7,N/A,N/A,N/A,738,745,N/A,142,4
2,N/A,N/A,N/A,736,738,N/A,145,1
4,N/A,N/A,N/A,725,729,N/A,3,2
2,N/A,N/A,N/A,723,725,N/A,8,1
12,N/A,N/A,N/A,711,723,N/A,12,5
2,N/A,N/A,N/A,709,711,N/A,16,3
14,N/A,N/A,N/A,695,709,N/A,19,6
1,N/A,N/A,N/A,694,695,N/A,25,0
20,N/A,N/A,N/A,674,694,N/A,31,6
2,N/A,N/A,N/A,672,674,N/A,34,3
15,N/A,N/A,N/A,657,672,N/A,37,6
9,N/A,N/A,N/A,648,657,N/A,41,4
4,N/A,N/A,N/A,644,648,N/A,46,3
13,N/A,N/A,N/A,631,644,N/A,49,6
7,N/A,N/A,N/A,624,631,N/A,53,4
12,N/A,N/A,N/A,612,624,N/A,59,4
7,N/A,N/A,N/A,605,612,N/A,65,4
4,N/A,N/A,N/A,601,605,N/A,69,2
2,N/A,N/A,N/A,599,601,N/A,75,2
18,N/A,N/A,N/A,581,599,N/A,78,5
3,N/A,N/A,N/A,578,581,N/A,82,3
2,N/A,N/A,N/A,576,578,N/A,87,2
12,N/A,N/A,N/A,564,576,N/A,90,5
2,N/A,N/A,N/A,562,564,N/A,94,3
15,N/A,N/A,N/A,547,562,N/A,97,6
4,N/A,N/A,N/A,543,547,N/A,100,3
13,N/A,N/A,N/A,530,543,N/A,103,6
3,N/A,N/A,N/A,527,530,N/A,106,3
2,N/A,N/A,N/A,525,527,N/A,111,2
2,N/A,N/A,N/A,523,525,N/A,116,1
1,N/A,N/A,N/A,522,523,N/A,122,1
19,N/A,N/A,N/A,503,522,N/A,126,5
4,N/A,N/A,N/A,554,558,N/A,3,3
4,N/A,N/A,N/A,550,554,N/A,9,3
2,N/A,N/A,N/A,548,550,N/A,15,3
2,N/A,N/A,N/A,546,548,N/A,19,1
14,N/A,N/A,N/A,532,546,N/A,24,6
6,N/A,N/A,N/A,526,532,N/A,28,4
10,N/A,N/A,N/A,516,526,N/A,34,4
2,N/A,N/A,N/A,514,516,N/A,38,2
13,N/A,N/A,N/A,501,514,N/A,41,5
15,N/A,N/A,N/A,486,501,N/A,47,5
16,N/A,N/A,N/A,470,486,N/A,53,5
18,N/A,N/A,N/A,452,470,N/A,59,5
5,N/A,N/A,N/A,447,452,N/A,64,4
1,N/A,N/A,N/A,446,447,N/A,67,1
20,N/A,N/A,N/A,426,446,N/A,72,6
10,N/A,N/A,N/A,416,426,N/A,77,5
4,N/A,N/A,N/A,412,416,N/A,80,2
10,N/A,N/A,N/A,402,412,N/A,83,5
13,N/A,N/A,N/A,389,402,N/A,89,5
4,N/A,N/A,N/A,385,389,N/A,93,3
1,N/A,N/A,N/A,384,385,N/A,97,1
11,N/A,N/A,N/A,373,384,N/A,102,6
2,N/A,N/A,N/A,371,373,N/A,108,0
13,N/A,N/A,N/A,358,371,N/A,113,5
6,N/A,N/A,N/A,352,358,N/A,118,4
3,N/A,N/A,N/A,349,352,N/A,123,3
1,N/A,N/A,N/A,348,349,N/A,127,1
10,N/A,N/A,N/A,338,348,N/A,131,5
9,N/A,N/A,N/A,329,338,N/A,136,4
2,N/A,N/A,N/A,327,329,N/A,140,2
15,N/A,N/A,N/A,1833,1848,N/A,6,6
11,N/A,N/A,N/A,1822,1833,N/A,10,4
9,N/A,N/A,N/A,1813,1822,N/A,16,4
8,N/A,N/A,N/A,1805,1813,N/A,22,4
2,N/A,N/A,N/A,1803,1805,N/A,25,1
20,N/A,N/A,N/A,1783,1803,N/A,30,6
10,N/A,N/A,N/A,1773,1783,N/A,34,4
4,N/A,N/A,N/A,1769,1773,N/A,38,2
1,N/A,N/A,N/A,1768,1769,N/A,43,1
2,N/A,N/A,N/A,1766,1768,N/A,49,1
6,N/A,N/A,N/A,1760,1766,N/A,52,4
4,N/A,N/A,N/A,1756,1760,N/A,56,2
1,N/A,N/A,N/A,1755,1756,N/A,61,1
6,N/A,N/A,N/A,1749,1755,N/A,64,4
12,N/A,N/A,N/A,1737,1749,N/A,70,4
14,N/A,N/A,N/A,1723,1737,N/A,76,4
2,N/A,N/A,N/A,1721,1723,N/A,79,1
16,N/A,N/A,N/A,1705,1721,N/A,83,5
2,N/A,N/A,N/A,1703,1705,N/A,87,3
3,N/A,N/A,N/A,1700,1703,N/A,93,3
4,N/A,N/A,N/A,1696,1700,N/A,98,2
1,N/A,N/A,N/A,1695,1696,N/A,103,1
12,N/A,N/A,N/A,1683,1695,N/A,107,5
3,N/A,N/A,N/A,1680,1683,N/A,110,2
12,N/A,N/A,N/A,1668,1680,N/A,114,6
1,N/A,N/A,N/A,1667,1668,N/A,120,0
2,N/A,N/A,N/A,1665,1667,N/A,123,3
2,N/A,N/A,N/A,1663,1665,N/A,129,3
2,N/A,N/A,N/A,1661,1663,N/A,133,1
11,N/A,N/A,N/A,1650,1661,N/A,136,4
11,N/A,N/A,N/A,1967,1978,N/A,5,5
4,N/A,N/A,N/A,1963,1967,N/A,9,3
4,N/A,N/A,N/A,1959,1963,N/A,14,2
11,N/A,N/A,N/A,1948,1959,N/A,17,5
18,N/A,N/A,N/A,1930,1948,N/A,23,5
19,N/A,N/A,N/A,1911,1930,N/A,29,5
4,N/A,N/A,N/A,1907,1911,N/A,32,2
3,N/A,N/A,N/A,1904,1907,N/A,38,2
1,N/A,N/A,N/A,1903,1904,N/A,43,1
10,N/A,N/A,N/A,1893,1903,N/A,47,5
2,N/A,N/A,N/A,1891,1893,N/A,51,3
2,N/A,N/A,N/A,1889,1891,N/A,55,1
1,N/A,N/A,N/A,1888,1889,N/A,61,1
2,N/A,N/A,N/A,1886,1888,N/A,67,1
10,N/A,N/A,N/A,1876,1886,N/A,71,5
4,N/A,N/A,N/A,1872,1876,N/A,74,2
15,N/A,N/A,N/A,1857,1872,N/A,77,5
4,N/A,N/A,N/A,1853,1857,N/A,80,2
15,N/A,N/A,N/A,1838,1853,N/A,83,5
5,N/A,N/A,N/A,1833,1838,N/A,88,4
10,N/A,N/A,N/A,1823,1833,N/A,94,4
4,N/A,N/A,N/A,1819,1823,N/A,98,2
4,N/A,N/A,N/A,1815,1819,N/A,104,2
12,N/A,N/A,N/A,1803,1815,N/A,107,5
3,N/A,N/A,N/A,1800,1803,N/A,111,3
12,N/A,N/A,N/A,1788,1800,N/A,114,6
4,N/A,N/A,N/A,1784,1788,N/A,117,3
4,N/A,N/A,N/A,1780,1784,N/A,122,2
3,N/A,N/A,N/A,1777,1780,N/A,128,2
2,N/A,N/A,N/A,1775,1777,N/A,134,2
3,N/A,N/A,N/A,1236,1239,N/A,5,3
16,N/A,N/A,N/A,1220,1236,N/A,8,6
14,N/A,N/A,N/A,1206,1220,N/A,13,5
13,N/A,N/A,N/A,1193,1206,N/A,19,5
3,N/A,N/A,N/A,1190,1193,N/A,22,2
20,N/A,N/A,N/A,1170,1190,N/A,26,6
1,N/A,N/A,N/A,1169,1170,N/A,32,0
11,N/A,N/A,N/A,1158,1169,N/A,37,5
15,N/A,N/A,N/A,1143,1158,N/A,43,5
13,N/A,N/A,N/A,1130,1143,N/A,49,5
4,N/A,N/A,N/A,1126,1130,N/A,53,3
2,N/A,N/A,N/A,1124,1126,N/A,57,1
1,N/A,N/A,N/A,1123,1124,N/A,63,1
6,N/A,N/A,N/A,1117,1123,N/A,66,4
11,N/A,N/A,N/A,1106,1117,N/A,72,4
2,N/A,N/A,N/A,1104,1106,N/A,75,1
2,N/A,N/A,N/A,1102,1104,N/A,81,1
12,N/A,N/A,N/A,1090,1102,N/A,85,5
12,N/A,N/A,N/A,1078,1090,N/A,91,5
2,N/A,N/A,N/A,1076,1078,N/A,94,2
13,N/A,N/A,N/A,1063,1076,N/A,97,5
2,N/A,N/A,N/A,1061,1063,N/A,101,3
11,N/A,N/A,N/A,1050,1061,N/A,104,6
12,N/A,N/A,N/A,1038,1050,N/A,108,4
11,N/A,N/A,N/A,1027,1038,N/A,114,4
2,N/A,N/A,N/A,1025,1027,N/A,117,1
11,N/A,N/A,N/A,1014,1025,N/A,122,6
2,N/A,N/A,N/A,1012,1014,N/A,128,0
16,N/A,N/A,N/A,996,1012,N/A,133,5
4,N/A,N/A,N/A,992,996,N/A,136,2
19,N/A,N/A,N/A,746,765,N/A,4,6
12,N/A,N/A,N/A,734,746,N/A,8,4
1,N/A,N/A,N/A,733,734,N/A,11,1
20,N/A,N/A,N/A,713,733,N/A,16,6
2,N/A,N/A,N/A,711,713,N/A,22,0
14,N/A,N/A,N/A,697,711,N/A,27,5
18,N/A,N/A,N/A,679,697,N/A,33,5
2,N/A,N/A,N/A,677,679,N/A,36,2
17,N/A,N/A,N/A,660,677,N/A,40,6
7,N/A,N/A,N/A,653,660,N/A,44,4
8,N/A,N/A,N/A,645,653,N/A,50,4
4,N/A,N/A,N/A,641,645,N/A,55,3
16,N/A,N/A,N/A,625,641,N/A,58,6
1,N/A,N/A,N/A,624,625,N/A,64,0
3,N/A,N/A,N/A,621,624,N/A,67,3
2,N/A,N/A,N/A,619,621,N/A,72,2
1,N/A,N/A,N/A,618,619,N/A,77,1
7,N/A,N/A,N/A,611,618,N/A,80,4
10,N/A,N/A,N/A,601,611,N/A,86,4
11,N/A,N/A,N/A,590,601,N/A,92,4
4,N/A,N/A,N/A,586,590,N/A,97,3
2,N/A,N/A,N/A,584,586,N/A,101,1
11,N/A,N/A,N/A,573,584,N/A,106,6
1,N/A,N/A,N/A,572,573,N/A,112,0
13,N/A,N/A,N/A,559,572,N/A,118,6
3,N/A,N/A,N/A,556,559,N/A,121,3
2,N/A,N/A,N/A,554,556,N/A,125,1
12,N/A,N/A,N/A,542,554,N/A,130,6
5,N/A,N/A,N/A,537,542,N/A,134,4
14,N/A,N/A,N/A,523,537,N/A,140,4
3,N/A,N/A,N/A,805,808,N/A,3,3
2,N/A,N/A,N/A,803,805,N/A,8,2
4,N/A,N/A,N/A,799,803,N/A,14,2
1,N/A,N/A,N/A,798,799,N/A,19,1
12,N/A,N/A,N/A,786,798,N/A,23,5
13,N/A,N/A,N/A,773,786,N/A,29,5
5,N/A,N/A,N/A,768,773,N/A,34,4
10,N/A,N/A,N/A,758,768,N/A,40,4
6,N/A,N/A,N/A,752,758,N/A,46,4
3,N/A,N/A,N/A,749,752,N/A,51,3
4,N/A,N/A,N/A,745,749,N/A,57,3
2,N/A,N/A,N/A,743,745,N/A,62,2
14,N/A,N/A,N/A,729,743,N/A,65,5
4,N/A,N/A,N/A,725,729,N/A,69,3
3,N/A,N/A,N/A,722,725,N/A,75,3
13,N/A,N/A,N/A,709,722,N/A,78,6
1,N/A,N/A,N/A,708,709,N/A,84,0
10,N/A,N/A,N/A,698,708,N/A,88,4
14,N/A,N/A,N/A,684,698,N/A,94,4
1,N/A,N/A,N/A,683,684,N/A,97,1
6,N/A,N/A,N/A,677,683,N/A,100,4
12,N/A,N/A,N/A,665,677,N/A,106,4
14,N/A,N/A,N/A,651,665,N/A,112,4
4,N/A,N/A,N/A,647,651,N/A,116,2
20,N/A,N/A,N/A,627,647,N/A,120,6
16,N/A,N/A,N/A,611,627,N/A,125,5
12,N/A,N/A,N/A,599,611,N/A,131,5
2,N/A,N/A,N/A,597,599,N/A,135,3
4,N/A,N/A,N/A,593,597,N/A,141,3
19,N/A,N/A,N/A,574,593,N/A,144,6
1,N/A,N/A,N/A,1676,1677,N/A,6,1
12,N/A,N/A,N/A,1664,1676,N/A,11,6
2,N/A,N/A,N/A,1662,1664,N/A,14,3
2,N/A,N/A,N/A,1660,1662,N/A,20,3
3,N/A,N/A,N/A,1657,1660,N/A,26,3
15,N/A,N/A,N/A,1642,1657,N/A,29,6
16,N/A,N/A,N/A,1626,1642,N/A,34,5
6,N/A,N/A,N/A,1620,1626,N/A,39,4
4,N/A,N/A,N/A,1616,1620,N/A,44,3
18,N/A,N/A,N/A,1598,1616,N/A,47,6
2,N/A,N/A,N/A,1596,1598,N/A,53,0
13,N/A,N/A,N/A,1583,1596,N/A,58,5
2,N/A,N/A,N/A,1581,1583,N/A,62,3
1,N/A,N/A,N/A,1580,1581,N/A,66,1
13,N/A,N/A,N/A,1567,1580,N/A,69,4
6,N/A,N/A,N/A,1561,1567,N/A,75,4
2,N/A,N/A,N/A,1559,1561,N/A,78,1
12,N/A,N/A,N/A,1547,1559,N/A,83,6
3,N/A,N/A,N/A,1544,1547,N/A,86,3
3,N/A,N/A,N/A,1541,1544,N/A,91,2
19,N/A,N/A,N/A,1522,1541,N/A,94,5
10,N/A,N/A,N/A,1512,1522,N/A,100,5
2,N/A,N/A,N/A,1510,1512,N/A,104,3
2,N/A,N/A,N/A,1508,1510,N/A,110,3
2,N/A,N/A,N/A,1506,1508,N/A,114,1
15,N/A,N/A,N/A,1491,1506,N/A,119,6
1,N/A,N/A,N/A,1490,1491,N/A,125,0
16,N/A,N/A,N/A,1474,1490,N/A,131,6
18,N/A,N/A,N/A,1456,1474,N/A,136,5
12,N/A,N/A,N/A,1444,1456,N/A,142,5
4,N/A,N/A,N/A,602,606,N/A,5,2
12,N/A,N/A,N/A,590,602,N/A,9,6
3,N/A,N/A,N/A,587,590,N/A,12,3
18,N/A,N/A,N/A,569,587,N/A,15,6
2,N/A,N/A,N/A,567,569,N/A,21,0
18,N/A,N/A,N/A,549,567,N/A,26,5
3,N/A,N/A,N/A,546,549,N/A,29,2
14,N/A,N/A,N/A,532,546,N/A,33,6
10,N/A,N/A,N/A,522,532,N/A,37,4
2,N/A,N/A,N/A,520,522,N/A,40,1
5,N/A,N/A,N/A,515,520,N/A,43,4
2,N/A,N/A,N/A,513,515,N/A,46,1
2,N/A,N/A,N/A,511,513,N/A,52,1
19,N/A,N/A,N/A,492,511,N/A,56,5
18,N/A,N/A,N/A,474,492,N/A,62,5
18,N/A,N/A,N/A,456,474,N/A,68,5
10,N/A,N/A,N/A,446,456,N/A,74,5
2,N/A,N/A,N/A,444,446,N/A,78,3
13,N/A,N/A,N/A,431,444,N/A,81,6
1,N/A,N/A,N/A,430,431,N/A,87,0
7,N/A,N/A,N/A,423,430,N/A,91,4
1,N/A,N/A,N/A,422,423,N/A,94,1
19,N/A,N/A,N/A,403,422,N/A,98,5
2,N/A,N/A,N/A,401,403,N/A,102,3
2,N/A,N/A,N/A,399,401,N/A,106,1
1,N/A,N/A,N/A,398,399,N/A,112,1
14,N/A,N/A,N/A,384,398,N/A,116,5
12,N/A,N/A,N/A,372,384,N/A,122,5
2,N/A,N/A,N/A,370,372,N/A,125,2
13,N/A,N/A,N/A,357,370,N/A,128,5
5,N/A,N/A,N/A,1218,1223,N/A,6,4
4,N/A,N/A,N/A,1214,1218,N/A,10,2
3,N/A,N/A,N/A,1211,1214,N/A,16,2
18,N/A,N/A,N/A,1193,1211,N/A,19,5
3,N/A,N/A,N/A,1190,1193,N/A,23,3
3,N/A,N/A,N/A,1187,1190,N/A,28,2
12,N/A,N/A,N/A,1175,1187,N/A,31,5
16,N/A,N/A,N/A,1159,1175,N/A,37,5
4,N/A,N/A,N/A,1155,1159,N/A,41,3
2,N/A,N/A,N/A,1153,1155,N/A,46,2
12,N/A,N/A,N/A,1141,1153,N/A,49,5
4,N/A,N/A,N/A,1137,1141,N/A,53,3
2,N/A,N/A,N/A,1135,1137,N/A,59,3
20,N/A,N/A,N/A,1115,1135,N/A,62,6
4,N/A,N/A,N/A,1111,1115,N/A,65,3
3,N/A,N/A,N/A,1108,1111,N/A,71,3
4,N/A,N/A,N/A,1104,1108,N/A,76,2
12,N/A,N/A,N/A,1092,1104,N/A,79,5
13,N/A,N/A,N/A,1079,1092,N/A,85,5
17,N/A,N/A,N/A,1062,1079,N/A,91,5
2,N/A,N/A,N/A,1060,1062,N/A,94,2
2,N/A,N/A,N/A,1058,1060,N/A,100,2
16,N/A,N/A,N/A,1042,1058,N/A,103,5
4,N/A,N/A,N/A,1038,1042,N/A,106,2
10,N/A,N/A,N/A,1028,1038,N/A,109,5
17,N/A,N/A,N/A,1011,1028,N/A,115,5
3,N/A,N/A,N/A,1008,1011,N/A,118,2
12,N/A,N/A,N/A,996,1008,N/A,122,6
12,N/A,N/A,N/A,984,996,N/A,127,5
10,N/A,N/A,N/A,974,984,N/A,132,4
1,N/A,N/A,N/A,804,805,N/A,3,1
11,N/A,N/A,N/A,793,804,N/A,7,5
17,N/A,N/A,N/A,776,793,N/A,13,5
2,N/A,N/A,N/A,774,776,N/A,16,2
4,N/A,N/A,N/A,770,774,N/A,22,2
17,N/A,N/A,N/A,753,770,N/A,25,5
11,N/A,N/A,N/A,742,753,N/A,31,5
6,N/A,N/A,N/A,736,742,N/A,36,4
7,N/A,N/A,N/A,729,736,N/A,42,4
2,N/A,N/A,N/A,727,729,N/A,45,1
2,N/A,N/A,N/A,725,727,N/A,51,1
17,N/A,N/A,N/A,708,725,N/A,56,6
10,N/A,N/A,N/A,698,708,N/A,61,5
4,N/A,N/A,N/A,694,698,N/A,64,2
20,N/A,N/A,N/A,674,694,N/A,68,6
14,N/A,N/A,N/A,660,674,N/A,72,4
9,N/A,N/A,N/A,651,660,N/A,78,4
2,N/A,N/A,N/A,649,651,N/A,83,3
4,N/A,N/A,N/A,645,649,N/A,88,2
2,N/A,N/A,N/A,643,645,N/A,93,1
1,N/A,N/A,N/A,642,643,N/A,99,1
13,N/A,N/A,N/A,629,642,N/A,103,5
11,N/A,N/A,N/A,618,629,N/A,109,5
3,N/A,N/A,N/A,615,618,N/A,113,3
4,N/A,N/A,N/A,611,615,N/A,118,2
19,N/A,N/A,N/A,592,611,N/A,121,5
4,N/A,N/A,N/A,588,592,N/A,124,2
2,N/A,N/A,N/A,586,588,N/A,129,1
14,N/A,N/A,N/A,572,586,N/A,133,5
6,N/A,N/A,N/A,566,572,N/A,138,4
4,N/A,N/A,N/A,1979,1983,N/A,5,2
1,N/A,N/A,N/A,1978,1979,N/A,10,1
2,N/A,N/A,N/A,1976,1978,N/A,16,1
17,N/A,N/A,N/A,1959,1976,N/A,21,6
2,N/A,N/A,N/A,1957,1959,N/A,27,0
14,N/A,N/A,N/A,1943,1957,N/A,32,5
2,N/A,N/A,N/A,1941,1943,N/A,35,2
18,N/A,N/A,N/A,1923,1941,N/A,39,6
10,N/A,N/A,N/A,1913,1923,N/A,44,5
12,N/A,N/A,N/A,1901,1913,N/A,49,4
1,N/A,N/A,N/A,1900,1901,N/A,52,1
2,N/A,N/A,N/A,1898,1900,N/A,58,1
14,N/A,N/A,N/A,1884,1898,N/A,62,5
5,N/A,N/A,N/A,1879,1884,N/A,67,4
8,N/A,N/A,N/A,1871,1879,N/A,73,4
3,N/A,N/A,N/A,1868,1871,N/A,78,3
20,N/A,N/A,N/A,1848,1868,N/A,81,6
19,N/A,N/A,N/A,1829,1848,N/A,86,5
2,N/A,N/A,N/A,1827,1829,N/A,89,2
2,N/A,N/A,N/A,1825,1827,N/A,94,1
14,N/A,N/A,N/A,1811,1825,N/A,99,6
4,N/A,N/A,N/A,1807,1811,N/A,102,3
2,N/A,N/A,N/A,1805,1807,N/A,106,1
2,N/A,N/A,N/A,1803,1805,N/A,112,1
1,N/A,N/A,N/A,1802,1803,N/A,118,1
12,N/A,N/A,N/A,1790,1802,N/A,123,6
13,N/A,N/A,N/A,1777,1790,N/A,127,4
4,N/A,N/A,N/A,1773,1777,N/A,131,2
19,N/A,N/A,N/A,1754,1773,N/A,135,6
11,N/A,N/A,N/A,1743,1754,N/A,140,5
3,N/A,N/A,N/A,1732,1735,N/A,6,3
3,N/A,N/A,N/A,1729,1732,N/A,11,2
12,N/A,N/A,N/A,1717,1729,N/A,15,6
3,N/A,N/A,N/A,1714,1717,N/A,18,3
15,N/A,N/A,N/A,1699,1714,N/A,21,6
5,N/A,N/A,N/A,1694,1699,N/A,25,4
2,N/A,N/A,N/A,1692,1694,N/A,30,3
3,N/A,N/A,N/A,1689,1692,N/A,35,2
18,N/A,N/A,N/A,1671,1689,N/A,38,5
13,N/A,N/A,N/A,1658,1671,N/A,43,4
6,N/A,N/A,N/A,1652,1658,N/A,49,4
4,N/A,N/A,N/A,1648,1652,N/A,53,2
1,N/A,N/A,N/A,1647,1648,N/A,58,1
12,N/A,N/A,N/A,1635,1647,N/A,63,6
2,N/A,N/A,N/A,1633,1635,N/A,69,0
18,N/A,N/A,N/A,1615,1633,N/A,75,6
4,N/A,N/A,N/A,1611,1615,N/A,78,3
4,N/A,N/A,N/A,1607,1611,N/A,84,3
1,N/A,N/A,N/A,1606,1607,N/A,88,1
1,N/A,N/A,N/A,1605,1606,N/A,94,1
1,N/A,N/A,N/A,1604,1605,N/A,100,1
11,N/A,N/A,N/A,1593,1604,N/A,103,4
6,N/A,N/A,N/A,1587,1593,N/A,109,4
3,N/A,N/A,N/A,1584,1587,N/A,113,2
4,N/A,N/A,N/A,1580,1584,N/A,119,2
4,N/A,N/A,N/A,1576,1580,N/A,125,2
2,N/A,N/A,N/A,1574,1576,N/A,130,1
2,N/A,N/A,N/A,1572,1574,N/A,136,1
11,N/A,N/A,N/A,1561,1572,N/A,139,4
4,N/A,N/A,N/A,1557,1561,N/A,144,3
11,N/A,N/A,N/A,776,787,N/A,3,4
2,N/A,N/A,N/A,774,776,N/A,7,2
14,N/A,N/A,N/A,760,774,N/A,11,6
2,N/A,N/A,N/A,758,760,N/A,17,0
12,N/A,N/A,N/A,746,758,N/A,23,6
2,N/A,N/A,N/A,744,746,N/A,29,0
13,N/A,N/A,N/A,731,744,N/A,34,5
3,N/A,N/A,N/A,728,731,N/A,38,3
4,N/A,N/A,N/A,724,728,N/A,44,3
4,N/A,N/A,N/A,720,724,N/A,49,2
17,N/A,N/A,N/A,703,720,N/A,52,5
2,N/A,N/A,N/A,701,703,N/A,55,2
18,N/A,N/A,N/A,683,701,N/A,59,6
6,N/A,N/A,N/A,677,683,N/A,63,4
3,N/A,N/A,N/A,674,677,N/A,68,3
4,N/A,N/A,N/A,670,674,N/A,74,3
2,N/A,N/A,N/A,668,670,N/A,78,1
8,N/A,N/A,N/A,660,668,N/A,81,4
3,N/A,N/A,N/A,657,660,N/A,86,3
13,N/A,N/A,N/A,644,657,N/A,89,6
10,N/A,N/A,N/A,634,644,N/A,93,4
1,N/A,N/A,N/A,633,634,N/A,96,1
18,N/A,N/A,N/A,615,633,N/A,100,5
4,N/A,N/A,N/A,611,615,N/A,104,3
3,N/A,N/A,N/A,608,611,N/A,110,3
3,N/A,N/A,N/A,605,608,N/A,115,2
1,N/A,N/A,N/A,604,605,N/A,120,1
14,N/A,N/A,N/A,590,604,N/A,124,5
11,N/A,N/A,N/A,579,590,N/A,129,4
1,N/A,N/A,N/A,578,579,N/A,132,1
1,N/A,N/A,N/A,448,449,N/A,5,1
11,N/A,N/A,N/A,437,448,N/A,8,4
2,N/A,N/A,N/A,435,437,N/A,11,1
19,N/A,N/A,N/A,416,435,N/A,15,5
4,N/A,N/A,N/A,412,416,N/A,18,2
1,N/A,N/A,N/A,411,412,N/A,23,1
7,N/A,N/A,N/A,404,411,N/A,26,4
3,N/A,N/A,N/A,401,404,N/A,31,3
15,N/A,N/A,N/A,386,401,N/A,34,6
3,N/A,N/A,N/A,383,386,N/A,37,3
1,N/A,N/A,N/A,382,383,N/A,41,1
17,N/A,N/A,N/A,365,382,N/A,46,6
2,N/A,N/A,N/A,363,365,N/A,49,3
2,N/A,N/A,N/A,361,363,N/A,55,3
2,N/A,N/A,N/A,359,361,N/A,59,1
19,N/A,N/A,N/A,340,359,N/A,64,6
12,N/A,N/A,N/A,328,340,N/A,69,5
2,N/A,N/A,N/A,326,328,N/A,72,2
3,N/A,N/A,N/A,323,326,N/A,78,2
14,N/A,N/A,N/A,309,323,N/A,81,5
10,N/A,N/A,N/A,299,309,N/A,86,4
4,N/A,N/A,N/A,295,299,N/A,90,2
11,N/A,N/A,N/A,284,295,N/A,93,5
5,N/A,N/A,N/A,279,284,N/A,98,4
4,N/A,N/A,N/A,275,279,N/A,102,2
2,N/A,N/A,N/A,273,275,N/A,107,1
18,N/A,N/A,N/A,255,273,N/A,112,6
18,N/A,N/A,N/A,237,255,N/A,117,5
10,N/A,N/A,N/A,227,237,N/A,123,5
16,N/A,N/A,N/A,211,227,N/A,129,5
16,N/A,N/A,N/A,1968,1984,N/A,5,5
4,N/A,N/A,N/A,1964,1968,N/A,9,3
3,N/A,N/A,N/A,1961,1964,N/A,14,2
2,N/A,N/A,N/A,1959,1961,N/A,20,2
13,N/A,N/A,N/A,1946,1959,N/A,24,6
4,N/A,N/A,N/A,1942,1946,N/A,27,3
2,N/A,N/A,N/A,1940,1942,N/A,32,2
15,N/A,N/A,N/A,1925,1940,N/A,36,6
14,N/A,N/A,N/A,1911,1925,N/A,40,4
9,N/A,N/A,N/A,1902,1911,N/A,46,4
4,N/A,N/A,N/A,1898,1902,N/A,51,3
2,N/A,N/A,N/A,1896,1898,N/A,56,2
18,N/A,N/A,N/A,1878,1896,N/A,59,5
4,N/A,N/A,N/A,1874,1878,N/A,62,2
19,N/A,N/A,N/A,1855,1874,N/A,66,6
4,N/A,N/A,N/A,1851,1855,N/A,69,3
4,N/A,N/A,N/A,1847,1851,N/A,75,3
3,N/A,N/A,N/A,1844,1847,N/A,81,3
3,N/A,N/A,N/A,1841,1844,N/A,87,3
2,N/A,N/A,N/A,1839,1841,N/A,91,1
18,N/A,N/A,N/A,1821,1839,N/A,95,5
17,N/A,N/A,N/A,1804,1821,N/A,101,5
6,N/A,N/A,N/A,1798,1804,N/A,106,4
4,N/A,N/A,N/A,1794,1798,N/A,110,2
11,N/A,N/A,N/A,1783,1794,N/A,113,5
3,N/A,N/A,N/A,1780,1783,N/A,116,2
4,N/A,N/A,N/A,1776,1780,N/A,122,2
3,N/A,N/A,N/A,1773,1776,N/A,128,2
15,N/A,N/A,N/A,1758,1773,N/A,132,6
5,N/A,N/A,N/A,1753,1758,N/A,136,4
7,N/A,N/A,N/A,1155,1162,N/A,5,4
4,N/A,N/A,N/A,1151,1155,N/A,10,3
2,N/A,N/A,N/A,1149,1151,N/A,14,1
10,N/A,N/A,N/A,1139,1149,N/A,17,4
1,N/A,N/A,N/A,1138,1139,N/A,20,1
15,N/A,N/A,N/A,1123,1138,N/A,25,6
7,N/A,N/A,N/A,1116,1123,N/A,29,4
2,N/A,N/A,N/A,1114,1116,N/A,32,1
2,N/A,N/A,N/A,1112,1114,N/A,38,1
14,N/A,N/A,N/A,1098,1112,N/A,43,6
1,N/A,N/A,N/A,1097,1098,N/A,49,0
10,N/A,N/A,N/A,1087,1097,N/A,54,5
11,N/A,N/A,N/A,1076,1087,N/A,59,4
2,N/A,N/A,N/A,1074,1076,N/A,62,1
10,N/A,N/A,N/A,1064,1074,N/A,65,4
4,N/A,N/A,N/A,1060,1064,N/A,69,2
17,N/A,N/A,N/A,1043,1060,N/A,72,5
14,N/A,N/A,N/A,1029,1043,N/A,77,4
3,N/A,N/A,N/A,1026,1029,N/A,82,3
3,N/A,N/A,N/A,1023,1026,N/A,87,2
4,N/A,N/A,N/A,1019,1023,N/A,93,2
11,N/A,N/A,N/A,1008,1019,N/A,96,5
14,N/A,N/A,N/A,994,1008,N/A,101,4
1,N/A,N/A,N/A,993,994,N/A,104,1
12,N/A,N/A,N/A,981,993,N/A,109,6
13,N/A,N/A,N/A,968,981,N/A,113,4
10,N/A,N/A,N/A,958,968,N/A,119,4
2,N/A,N/A,N/A,956,958,N/A,122,1
5,N/A,N/A,N/A,951,956,N/A,125,4
4,N/A,N/A,N/A,947,951,N/A,129,2
12,N/A,N/A,N/A,429,441,N/A,3,5
3,N/A,N/A,N/A,426,429,N/A,7,3
13,N/A,N/A,N/A,413,426,N/A,10,6
2,N/A,N/A,N/A,411,413,N/A,16,0
19,N/A,N/A,N/A,392,411,N/A,22,6
13,N/A,N/A,N/A,379,392,N/A,27,5
4,N/A,N/A,N/A,375,379,N/A,31,3
2,N/A,N/A,N/A,373,375,N/A,36,2
2,N/A,N/A,N/A,371,373,N/A,41,1
14,N/A,N/A,N/A,357,371,N/A,45,5
19,N/A,N/A,N/A,338,357,N/A,51,5
4,N/A,N/A,N/A,334,338,N/A,54,2
12,N/A,N/A,N/A,322,334,N/A,58,6
1,N/A,N/A,N/A,321,322,N/A,64,0
16,N/A,N/A,N/A,305,321,N/A,70,6
17,N/A,N/A,N/A,288,305,N/A,75,5
16,N/A,N/A,N/A,272,288,N/A,81,5
15,N/A,N/A,N/A,257,272,N/A,87,5
2,N/A,N/A,N/A,255,257,N/A,90,2
19,N/A,N/A,N/A,236,255,N/A,93,5
3,N/A,N/A,N/A,233,236,N/A,96,2
17,N/A,N/A,N/A,216,233,N/A,100,6
17,N/A,N/A,N/A,199,216,N/A,105,5
3,N/A,N/A,N/A,196,199,N/A,109,3
3,N/A,N/A,N/A,193,196,N/A,114,2
11,N/A,N/A,N/A,182,193,N/A,117,5
4,N/A,N/A,N/A,178,182,N/A,121,3
2,N/A,N/A,N/A,176,178,N/A,127,3
15,N/A,N/A,N/A,161,176,N/A,130,6
2,N/A,N/A,N/A,159,161,N/A,136,0
15,N/A,N/A,N/A,1817,1832,N/A,4,5
3,N/A,N/A,N/A,1814,1817,N/A,7,2
20,N/A,N/A,N/A,1794,1814,N/A,11,6
4,N/A,N/A,N/A,1790,1794,N/A,14,3
1,N/A,N/A,N/A,1789,1790,N/A,18,1
17,N/A,N/A,N/A,1772,1789,N/A,23,6
17,N/A,N/A,N/A,1755,1772,N/A,28,5
3,N/A,N/A,N/A,1752,1755,N/A,31,2
2,N/A,N/A,N/A,1750,1752,N/A,36,1
11,N/A,N/A,N/A,1739,1750,N/A,39,4
1,N/A,N/A,N/A,1738,1739,N/A,42,1
7,N/A,N/A,N/A,1731,1738,N/A,45,4
4,N/A,N/A,N/A,1727,1731,N/A,49,2
4,N/A,N/A,N/A,1723,1727,N/A,55,2
1,N/A,N/A,N/A,1722,1723,N/A,60,1
14,N/A,N/A,N/A,1708,1722,N/A,64,5
4,N/A,N/A,N/A,1704,1708,N/A,67,2
1,N/A,N/A,N/A,1703,1704,N/A,72,1
16,N/A,N/A,N/A,1687,1703,N/A,76,5
10,N/A,N/A,N/A,1677,1687,N/A,81,4
3,N/A,N/A,N/A,1674,1677,N/A,86,3
4,N/A,N/A,N/A,1670,1674,N/A,92,3
3,N/A,N/A,N/A,1667,1670,N/A,97,2
12,N/A,N/A,N/A,1655,1667,N/A,100,5
4,N/A,N/A,N/A,1651,1655,N/A,104,3
3,N/A,N/A,N/A,1648,1651,N/A,110,3
3,N/A,N/A,N/A,1645,1648,N/A,116,3
1,N/A,N/A,N/A,1644,1645,N/A,120,1
17,N/A,N/A,N/A,1627,1644,N/A,125,6
2,N/A,N/A,N/A,1625,1627,N/A,131,0
14,N/A,N/A,N/A,399,413,N/A,5,4
2,N/A,N/A,N/A,397,399,N/A,10,3
2,N/A,N/A,N/A,395,397,N/A,16,3
13,N/A,N/A,N/A,382,395,N/A,19,6
1,N/A,N/A,N/A,381,382,N/A,25,0
5,N/A,N/A,N/A,376,381,N/A,29,4
2,N/A,N/A,N/A,374,376,N/A,32,1
14,N/A,N/A,N/A,360,374,N/A,35,4
3,N/A,N/A,N/A,357,360,N/A,39,2
13,N/A,N/A,N/A,344,357,N/A,43,6
19,N/A,N/A,N/A,325,344,N/A,48,5
4,N/A,N/A,N/A,321,325,N/A,52,3
11,N/A,N/A,N/A,310,321,N/A,55,6
5,N/A,N/A,N/A,305,310,N/A,59,4
4,N/A,N/A,N/A,301,305,N/A,63,2
11,N/A,N/A,N/A,290,301,N/A,66,5
4,N/A,N/A,N/A,286,290,N/A,69,2
4,N/A,N/A,N/A,282,286,N/A,75,2
3,N/A,N/A,N/A,279,282,N/A,81,2
2,N/A,N/A,N/A,277,279,N/A,87,2
19,N/A,N/A,N/A,258,277,N/A,90,5
17,N/A,N/A,N/A,241,258,N/A,96,5
4,N/A,N/A,N/A,237,241,N/A,99,2
4,N/A,N/A,N/A,233,237,N/A,105,2
10,N/A,N/A,N/A,223,233,N/A,108,5
19,N/A,N/A,N/A,204,223,N/A,114,5
2,N/A,N/A,N/A,202,204,N/A,118,3
1,N/A,N/A,N/A,201,202,N/A,122,1
8,N/A,N/A,N/A,193,201,N/A,125,4
5,N/A,N/A,N/A,188,193,N/A,131,4
11,N/A,N/A,N/A,1569,1580,N/A,3,4
2,N/A,N/A,N/A,1567,1569,N/A,7,2
4,N/A,N/A,N/A,1563,1567,N/A,13,2
3,N/A,N/A,N/A,1560,1563,N/A,19,2
12,N/A,N/A,N/A,1548,1560,N/A,23,6
18,N/A,N/A,N/A,1530,1548,N/A,28,5
4,N/A,N/A,N/A,1526,1530,N/A,31,2
13,N/A,N/A,N/A,1513,1526,N/A,35,6
2,N/A,N/A,N/A,1511,1513,N/A,38,3
17,N/A,N/A,N/A,1494,1511,N/A,41,6
13,N/A,N/A,N/A,1481,1494,N/A,46,5
4,N/A,N/A,N/A,1477,1481,N/A,49,2
20,N/A,N/A,N/A,1457,1477,N/A,53,6
9,N/A,N/A,N/A,1448,1457,N/A,57,4
9,N/A,N/A,N/A,1439,1448,N/A,63,4
8,N/A,N/A,N/A,1431,1439,N/A,69,4
1,N/A,N/A,N/A,1430,1431,N/A,72,1
18,N/A,N/A,N/A,1412,1430,N/A,76,5
4,N/A,N/A,N/A,1408,1412,N/A,80,3
2,N/A,N/A,N/A,1406,1408,N/A,85,2
2,N/A,N/A,N/A,1404,1406,N/A,90,1
17,N/A,N/A,N/A,1387,1404,N/A,95,6
14,N/A,N/A,N/A,1373,1387,N/A,100,5
3,N/A,N/A,N/A,1370,1373,N/A,104,3
4,N/A,N/A,N/A,1366,1370,N/A,110,3
3,N/A,N/A,N/A,1363,1366,N/A,116,3
3,N/A,N/A,N/A,1360,1363,N/A,122,3
4,N/A,N/A,N/A,1356,1360,N/A,127,2
12,N/A,N/A,N/A,1344,1356,N/A,131,6
2,N/A,N/A,N/A,1342,1344,N/A,134,3
11,N/A,N/A,N/A,588,599,N/A,4,6
17,N/A,N/A,N/A,571,588,N/A,9,5
11,N/A,N/A,N/A,560,571,N/A,15,5
2,N/A,N/A,N/A,558,560,N/A,19,3
15,N/A,N/A,N/A,543,558,N/A,22,6
10,N/A,N/A,N/A,533,543,N/A,26,4
14,N/A,N/A,N/A,519,533,N/A,32,4
1,N/A,N/A,N/A,518,519,N/A,35,1
17,N/A,N/A,N/A,501,518,N/A,39,5
11,N/A,N/A,N/A,490,501,N/A,45,5
5,N/A,N/A,N/A,485,490,N/A,50,4
13,N/A,N/A,N/A,472,485,N/A,56,4
2,N/A,N/A,N/A,470,472,N/A,59,1
12,N/A,N/A,N/A,458,470,N/A,62,4
2,N/A,N/A,N/A,456,458,N/A,67,3
12,N/A,N/A,N/A,444,456,N/A,70,6
1,N/A,N/A,N/A,443,444,N/A,76,0
15,N/A,N/A,N/A,428,443,N/A,81,5
3,N/A,N/A,N/A,425,428,N/A,85,3
2,N/A,N/A,N/A,423,425,N/A,89,1
1,N/A,N/A,N/A,422,423,N/A,95,1
15,N/A,N/A,N/A,407,422,N/A,99,5
14,N/A,N/A,N/A,393,407,N/A,105,5
5,N/A,N/A,N/A,388,393,N/A,110,4
2,N/A,N/A,N/A,386,388,N/A,113,1
14,N/A,N/A,N/A,372,386,N/A,118,6
16,N/A,N/A,N/A,356,372,N/A,123,5
3,N/A,N/A,N/A,353,356,N/A,126,2
18,N/A,N/A,N/A,335,353,N/A,129,5
2,N/A,N/A,N/A,333,335,N/A,133,3
10,N/A,N/A,N/A,399,409,N/A,6,4
4,N/A,N/A,N/A,395,399,N/A,10,2
3,N/A,N/A,N/A,392,395,N/A,16,2
2,N/A,N/A,N/A,390,392,N/A,22,2
18,N/A,N/A,N/A,372,390,N/A,25,5
4,N/A,N/A,N/A,368,372,N/A,28,2
13,N/A,N/A,N/A,355,368,N/A,31,5
14,N/A,N/A,N/A,341,355,N/A,37,5
11,N/A,N/A,N/A,330,341,N/A,42,4
3,N/A,N/A,N/A,327,330,N/A,47,3
2,N/A,N/A,N/A,325,327,N/A,53,3
3,N/A,N/A,N/A,322,325,N/A,58,2
4,N/A,N/A,N/A,318,322,N/A,64,2
11,N/A,N/A,N/A,307,318,N/A,68,6
2,N/A,N/A,N/A,305,307,N/A,71,3
4,N/A,N/A,N/A,301,305,N/A,77,3
15,N/A,N/A,N/A,286,301,N/A,80,6
16,N/A,N/A,N/A,270,286,N/A,85,5
3,N/A,N/A,N/A,267,270,N/A,88,2
12,N/A,N/A,N/A,255,267,N/A,91,5
7,N/A,N/A,N/A,248,255,N/A,96,4
2,N/A,N/A,N/A,246,248,N/A,100,2
15,N/A,N/A,N/A,231,246,N/A,104,6
7,N/A,N/A,N/A,224,231,N/A,108,4
10,N/A,N/A,N/A,214,224,N/A,114,4
3,N/A,N/A,N/A,211,214,N/A,118,2
20,N/A,N/A,N/A,191,211,N/A,122,6
1,N/A,N/A,N/A,190,191,N/A,128,0
4,N/A,N/A,N/A,186,190,N/A,131,3
19,N/A,N/A,N/A,167,186,N/A,134,6
11,N/A,N/A,N/A,512,523,N/A,3,5
3,N/A,N/A,N/A,509,512,N/A,6,2
13,N/A,N/A,N/A,496,509,N/A,10,6
2,N/A,N/A,N/A,494,496,N/A,13,3
16,N/A,N/A,N/A,478,494,N/A,16,6
12,N/A,N/A,N/A,466,478,N/A,20,4
2,N/A,N/A,N/A,464,466,N/A,24,2
4,N/A,N/A,N/A,460,464,N/A,30,2
12,N/A,N/A,N/A,448,460,N/A,34,6
15,N/A,N/A,N/A,433,448,N/A,39,5
3,N/A,N/A,N/A,430,433,N/A,43,3
14,N/A,N/A,N/A,416,430,N/A,46,6
18,N/A,N/A,N/A,398,416,N/A,51,5
14,N/A,N/A,N/A,384,398,N/A,57,5
3,N/A,N/A,N/A,381,384,N/A,60,2
10,N/A,N/A,N/A,371,381,N/A,63,5
11,N/A,N/A,N/A,360,371,N/A,68,4
2,N/A,N/A,N/A,358,360,N/A,72,2
1,N/A,N/A,N/A,357,358,N/A,77,1
1,N/A,N/A,N/A,356,357,N/A,83,1
1,N/A,N/A,N/A,355,356,N/A,89,1
8,N/A,N/A,N/A,347,355,N/A,92,4
7,N/A,N/A,N/A,340,347,N/A,98,4
2,N/A,N/A,N/A,338,340,N/A,101,1
17,N/A,N/A,N/A,321,338,N/A,106,6
2,N/A,N/A,N/A,319,321,N/A,109,3
13,N/A,N/A,N/A,306,319,N/A,112,6
2,N/A,N/A,N/A,304,306,N/A,118,0
2,N/A,N/A,N/A,302,304,N/A,121,3
4,N/A,N/A,N/A,298,302,N/A,126,2
18,N/A,N/A,N/A,1331,1349,N/A,6,5
13,N/A,N/A,N/A,1318,1331,N/A,12,5
13,N/A,N/A,N/A,1305,1318,N/A,17,4
5,N/A,N/A,N/A,1300,1305,N/A,23,4
2,N/A,N/A,N/A,1298,1300,N/A,26,1
11,N/A,N/A,N/A,1287,1298,N/A,29,4
4,N/A,N/A,N/A,1283,1287,N/A,33,2
17,N/A,N/A,N/A,1266,1283,N/A,36,5
10,N/A,N/A,N/A,1256,1266,N/A,41,4
3,N/A,N/A,N/A,1253,1256,N/A,45,2
19,N/A,N/A,N/A,1234,1253,N/A,49,6
2,N/A,N/A,N/A,1232,1234,N/A,52,3
2,N/A,N/A,N/A,1230,1232,N/A,58,3
3,N/A,N/A,N/A,1227,1230,N/A,63,2
17,N/A,N/A,N/A,1210,1227,N/A,67,6
10,N/A,N/A,N/A,1200,1210,N/A,71,4
3,N/A,N/A,N/A,1197,1200,N/A,75,2
14,N/A,N/A,N/A,1183,1197,N/A,78,5
16,N/A,N/A,N/A,1167,1183,N/A,84,5
3,N/A,N/A,N/A,1164,1167,N/A,87,2
2,N/A,N/A,N/A,1162,1164,N/A,92,1
2,N/A,N/A,N/A,1160,1162,N/A,98,1
11,N/A,N/A,N/A,1149,1160,N/A,103,6
3,N/A,N/A,N/A,1146,1149,N/A,106,3
4,N/A,N/A,N/A,1142,1146,N/A,111,2
2,N/A,N/A,N/A,1140,1142,N/A,116,1
2,N/A,N/A,N/A,1138,1140,N/A,122,1
19,N/A,N/A,N/A,1119,1138,N/A,127,6
2,N/A,N/A,N/A,1117,1119,N/A,133,0
4,N/A,N/A,N/A,1113,1117,N/A,136,3
19,N/A,N/A,N/A,1343,1362,N/A,4,6
1,N/A,N/A,N/A,1342,1343,N/A,10,0
18,N/A,N/A,N/A,1324,1342,N/A,16,6
2,N/A,N/A,N/A,1322,1324,N/A,22,0
2,N/A,N/A,N/A,1320,1322,N/A,25,3
3,N/A,N/A,N/A,1317,1320,N/A,31,3
2,N/A,N/A,N/A,1315,1317,N/A,36,2
2,N/A,N/A,N/A,1313,1315,N/A,42,2
2,N/A,N/A,N/A,1311,1313,N/A,47,1
2,N/A,N/A,N/A,1309,1311,N/A,53,1
19,N/A,N/A,N/A,1290,1309,N/A,58,6
12,N/A,N/A,N/A,1278,1290,N/A,63,5
11,N/A,N/A,N/A,1267,1278,N/A,68,4
4,N/A,N/A,N/A,1263,1267,N/A,72,2
16,N/A,N/A,N/A,1247,1263,N/A,75,5
6,N/A,N/A,N/A,1241,1247,N/A,80,4
2,N/A,N/A,N/A,1239,1241,N/A,83,1
13,N/A,N/A,N/A,1226,1239,N/A,87,5
4,N/A,N/A,N/A,1222,1226,N/A,90,2
20,N/A,N/A,N/A,1202,1222,N/A,94,6
17,N/A,N/A,N/A,1185,1202,N/A,99,5
15,N/A,N/A,N/A,1170,1185,N/A,105,5
3,N/A,N/A,N/A,1167,1170,N/A,109,3
3,N/A,N/A,N/A,1164,1167,N/A,115,3
11,N/A,N/A,N/A,1153,1164,N/A,118,6
4,N/A,N/A,N/A,1149,1153,N/A,121,3
1,N/A,N/A,N/A,1148,1149,N/A,125,1
18,N/A,N/A,N/A,1130,1148,N/A,129,5
3,N/A,N/A,N/A,1127,1130,N/A,133,3
2,N/A,N/A,N/A,1125,1127,N/A,139,3
14,N/A,N/A,N/A,1545,1559,N/A,3,6
2,N/A,N/A,N/A,1543,1545,N/A,9,0
10,N/A,N/A,N/A,1533,1543,N/A,13,4
4,N/A,N/A,N/A,1529,1533,N/A,18,3
2,N/A,N/A,N/A,1527,1529,N/A,23,2
4,N/A,N/A,N/A,1523,1527,N/A,29,2
17,N/A,N/A,N/A,1506,1523,N/A,33,6
2,N/A,N/A,N/A,1504,1506,N/A,39,0
10,N/A,N/A,N/A,1494,1504,N/A,44,5
4,N/A,N/A,N/A,1490,1494,N/A,48,3
2,N/A,N/A,N/A,1488,1490,N/A,53,2
12,N/A,N/A,N/A,1476,1488,N/A,57,6
13,N/A,N/A,N/A,1463,1476,N/A,61,4
8,N/A,N/A,N/A,1455,1463,N/A,67,4
2,N/A,N/A,N/A,1453,1455,N/A,72,3
1,N/A,N/A,N/A,1452,1453,N/A,76,1
1,N/A,N/A,N/A,1451,1452,N/A,82,1
8,N/A,N/A,N/A,1443,1451,N/A,85,4
1,N/A,N/A,N/A,1442,1443,N/A,88,1
6,N/A,N/A,N/A,1436,1442,N/A,91,4
3,N/A,N/A,N/A,1433,1436,N/A,96,3
2,N/A,N/A,N/A,1431,1433,N/A,100,1
12,N/A,N/A,N/A,1419,1431,N/A,105,6
4,N/A,N/A,N/A,1415,1419,N/A,108,3
2,N/A,N/A,N/A,1413,1415,N/A,112,1
2,N/A,N/A,N/A,1411,1413,N/A,118,1
9,N/A,N/A,N/A,1402,1411,N/A,121,4
11,N/A,N/A,N/A,1391,1402,N/A,127,4
11,N/A,N/A,N/A,1380,1391,N/A,133,4
2,N/A,N/A,N/A,1378,1380,N/A,136,1
4,N/A,N/A,N/A,1458,1462,N/A,3,2
2,N/A,N/A,N/A,1456,1458,N/A,8,1
5,N/A,N/A,N/A,1451,1456,N/A,11,4
2,N/A,N/A,N/A,1449,1451,N/A,16,3
15,N/A,N/A,N/A,1434,1449,N/A,19,6
2,N/A,N/A,N/A,1432,1434,N/A,25,0
3,N/A,N/A,N/A,1429,1432,N/A,28,3
2,N/A,N/A,N/A,1427,1429,N/A,34,3
3,N/A,N/A,N/A,1424,1427,N/A,40,3
20,N/A,N/A,N/A,1404,1424,N/A,43,6
4,N/A,N/A,N/A,1400,1404,N/A,46,3
4,N/A,N/A,N/A,1396,1400,N/A,52,3
2,N/A,N/A,N/A,1394,1396,N/A,57,2
15,N/A,N/A,N/A,1379,1394,N/A,61,6
4,N/A,N/A,N/A,1375,1379,N/A,64,3
2,N/A,N/A,N/A,1373,1375,N/A,68,1
18,N/A,N/A,N/A,1355,1373,N/A,72,5
2,N/A,N/A,N/A,1353,1355,N/A,75,2
4,N/A,N/A,N/A,1349,1353,N/A,81,2
12,N/A,N/A,N/A,1337,1349,N/A,84,5
3,N/A,N/A,N/A,1334,1337,N/A,88,3
4,N/A,N/A,N/A,1330,1334,N/A,94,3
17,N/A,N/A,N/A,1313,1330,N/A,97,6
2,N/A,N/A,N/A,1311,1313,N/A,103,0
6,N/A,N/A,N/A,1305,1311,N/A,107,4
4,N/A,N/A,N/A,1301,1305,N/A,111,2
3,N/A,N/A,N/A,1298,1301,N/A,117,2
2,N/A,N/A,N/A,1296,1298,N/A,122,1
9,N/A,N/A,N/A,1287,1296,N/A,125,4
3,N/A,N/A,N/A,1284,1287,N/A,130,3
2,N/A,N/A,N/A,1626,1628,N/A,6,3
3,N/A,N/A,N/A,1623,1626,N/A,11,2
3,N/A,N/A,N/A,1620,1623,N/A,17,2
1,N/A,N/A,N/A,1619,1620,N/A,22,1
5,N/A,N/A,N/A,1614,1619,N/A,25,4
13,N/A,N/A,N/A,1601,1614,N/A,31,4
2,N/A,N/A,N/A,1599,1601,N/A,34,1
12,N/A,N/A,N/A,1587,1599,N/A,39,6
18,N/A,N/A,N/A,1569,1587,N/A,44,5
4,N/A,N/A,N/A,1565,1569,N/A,48,3
1,N/A,N/A,N/A,1564,1565,N/A,52,1
11,N/A,N/A,N/A,1553,1564,N/A,56,5
2,N/A,N/A,N/A,1551,1553,N/A,59,2
17,N/A,N/A,N/A,1534,1551,N/A,63,6
2,N/A,N/A,N/A,1532,1534,N/A,69,0
14,N/A,N/A,N/A,1518,1532,N/A,75,6
19,N/A,N/A,N/A,1499,1518,N/A,80,5
2,N/A,N/A,N/A,1497,1499,N/A,83,2
19,N/A,N/A,N/A,1478,1497,N/A,86,5
7,N/A,N/A,N/A,1471,1478,N/A,91,4
9,N/A,N/A,N/A,1462,1471,N/A,97,4
2,N/A,N/A,N/A,1460,1462,N/A,101,2
13,N/A,N/A,N/A,1447,1460,N/A,105,6
7,N/A,N/A,N/A,1440,1447,N/A,109,4
2,N/A,N/A,N/A,1438,1440,N/A,112,1
19,N/A,N/A,N/A,1419,1438,N/A,116,5
4,N/A,N/A,N/A,1415,1419,N/A,119,2
2,N/A,N/A,N/A,1413,1415,N/A,125,2
2,N/A,N/A,N/A,1411,1413,N/A,130,1
19,N/A,N/A,N/A,1392,1411,N/A,135,6
4,N/A,N/A,N/A,389,393,N/A,5,2
1,N/A,N/A,N/A,388,389,N/A,10,1
1,N/A,N/A,N/A,387,388,N/A,16,1
10,N/A,N/A,N/A,377,387,N/A,19,4
3,N/A,N/A,N/A,374,377,N/A,23,2
2,N/A,N/A,N/A,372,374,N/A,29,2
18,N/A,N/A,N/A,354,372,N/A,32,5
6,N/A,N/A,N/A,348,354,N/A,37,4
3,N/A,N/A,N/A,345,348,N/A,41,2
17,N/A,N/A,N/A,328,345,N/A,44,5
2,N/A,N/A,N/A,326,328,N/A,48,3
1,N/A,N/A,N/A,325,326,N/A,52,1
12,N/A,N/A,N/A,313,325,N/A,56,5
13,N/A,N/A,N/A,300,313,N/A,62,5
3,N/A,N/A,N/A,297,300,N/A,66,3
4,N/A,N/A,N/A,293,297,N/A,71,2
2,N/A,N/A,N/A,291,293,N/A,76,1
11,N/A,N/A,N/A,280,291,N/A,81,6
13,N/A,N/A,N/A,267,280,N/A,86,5
2,N/A,N/A,N/A,265,267,N/A,90,3
4,N/A,N/A,N/A,261,265,N/A,96,3
4,N/A,N/A,N/A,257,261,N/A,101,2
3,N/A,N/A,N/A,254,257,N/A,107,2
2,N/A,N/A,N/A,252,254,N/A,113,2
18,N/A,N/A,N/A,234,252,N/A,117,6
12,N/A,N/A,N/A,222,234,N/A,121,4
1,N/A,N/A,N/A,221,222,N/A,124,1
1,N/A,N/A,N/A,220,221,N/A,130,1
20,N/A,N/A,N/A,200,220,N/A,135,6
14,N/A,N/A,N/A,186,200,N/A,140,5
16,N/A,N/A,N/A,970,986,N/A,5,5
15,N/A,N/A,N/A,955,970,N/A,11,5
4,N/A,N/A,N/A,951,955,N/A,14,2
17,N/A,N/A,N/A,934,951,N/A,18,6
2,N/A,N/A,N/A,932,934,N/A,24,0
3,N/A,N/A,N/A,929,932,N/A,27,3
2,N/A,N/A,N/A,927,929,N/A,31,1
9,N/A,N/A,N/A,918,927,N/A,34,4
1,N/A,N/A,N/A,917,918,N/A,37,1
19,N/A,N/A,N/A,898,917,N/A,41,5
17,N/A,N/A,N/A,881,898,N/A,47,5
11,N/A,N/A,N/A,870,881,N/A,52,4
4,N/A,N/A,N/A,866,870,N/A,57,3
4,N/A,N/A,N/A,862,866,N/A,62,2
12,N/A,N/A,N/A,850,862,N/A,66,6
1,N/A,N/A,N/A,849,850,N/A,72,0
2,N/A,N/A,N/A,847,849,N/A,75,3
3,N/A,N/A,N/A,844,847,N/A,80,2
10,N/A,N/A,N/A,834,844,N/A,83,5
4,N/A,N/A,N/A,830,834,N/A,86,2
4,N/A,N/A,N/A,826,830,N/A,92,2
2,N/A,N/A,N/A,824,826,N/A,98,2
16,N/A,N/A,N/A,808,824,N/A,101,5
2,N/A,N/A,N/A,806,808,N/A,104,2
3,N/A,N/A,N/A,803,806,N/A,110,2
4,N/A,N/A,N/A,799,803,N/A,116,2
2,N/A,N/A,N/A,797,799,N/A,121,1
2,N/A,N/A,N/A,795,797,N/A,127,1
11,N/A,N/A,N/A,784,795,N/A,131,5
2,N/A,N/A,N/A,782,784,N/A,134,2
1,N/A,N/A,N/A,1447,1448,N/A,5,1
19,N/A,N/A,N/A,1428,1447,N/A,10,6
4,N/A,N/A,N/A,1424,1428,N/A,13,3
12,N/A,N/A,N/A,1412,1424,N/A,16,6
2,N/A,N/A,N/A,1410,1412,N/A,22,0
14,N/A,N/A,N/A,1396,1410,N/A,28,6
12,N/A,N/A,N/A,1384,1396,N/A,32,4
3,N/A,N/A,N/A,1381,1384,N/A,36,2
18,N/A,N/A,N/A,1363,1381,N/A,39,5
4,N/A,N/A,N/A,1359,1363,N/A,42,2
3,N/A,N/A,N/A,1356,1359,N/A,48,2
1,N/A,N/A,N/A,1355,1356,N/A,53,1
15,N/A,N/A,N/A,1340,1355,N/A,58,6
1,N/A,N/A,N/A,1339,1340,N/A,64,0
15,N/A,N/A,N/A,1324,1339,N/A,69,5
4,N/A,N/A,N/A,1320,1324,N/A,72,2
14,N/A,N/A,N/A,1306,1320,N/A,75,5
17,N/A,N/A,N/A,1289,1306,N/A,81,5
2,N/A,N/A,N/A,1287,1289,N/A,85,3
4,N/A,N/A,N/A,1283,1287,N/A,91,3
1,N/A,N/A,N/A,1282,1283,N/A,95,1
6,N/A,N/A,N/A,1276,1282,N/A,98,4
3,N/A,N/A,N/A,1273,1276,N/A,102,2
4,N/A,N/A,N/A,1269,1273,N/A,108,2
3,N/A,N/A,N/A,1266,1269,N/A,114,2
16,N/A,N/A,N/A,1250,1266,N/A,118,6
1,N/A,N/A,N/A,1249,1250,N/A,124,0
5,N/A,N/A,N/A,1244,1249,N/A,128,4
3,N/A,N/A,N/A,1241,1244,N/A,132,2
1,N/A,N/A,N/A,1240,1241,N/A,137,1
12,N/A,N/A,N/A,592,604,N/A,4,4
3,N/A,N/A,N/A,589,592,N/A,9,3
1,N/A,N/A,N/A,588,589,N/A,13,1
14,N/A,N/A,N/A,574,588,N/A,18,6
16,N/A,N/A,N/A,558,574,N/A,23,5
13,N/A,N/A,N/A,545,558,N/A,29,5
16,N/A,N/A,N/A,529,545,N/A,35,5
11,N/A,N/A,N/A,518,529,N/A,41,5
2,N/A,N/A,N/A,516,518,N/A,45,3
20,N/A,N/A,N/A,496,516,N/A,48,6
3,N/A,N/A,N/A,493,496,N/A,51,3
14,N/A,N/A,N/A,479,493,N/A,54,6
10,N/A,N/A,N/A,469,479,N/A,58,4
2,N/A,N/A,N/A,467,469,N/A,61,1
18,N/A,N/A,N/A,449,467,N/A,65,5
11,N/A,N/A,N/A,438,449,N/A,71,5
2,N/A,N/A,N/A,436,438,N/A,75,3
2,N/A,N/A,N/A,434,436,N/A,79,1
18,N/A,N/A,N/A,416,434,N/A,84,6
3,N/A,N/A,N/A,413,416,N/A,87,3
4,N/A,N/A,N/A,409,413,N/A,93,3
4,N/A,N/A,N/A,405,409,N/A,98,2
10,N/A,N/A,N/A,395,405,N/A,101,5
5,N/A,N/A,N/A,390,395,N/A,106,4
3,N/A,N/A,N/A,387,390,N/A,111,3
19,N/A,N/A,N/A,368,387,N/A,114,6
1,N/A,N/A,N/A,367,368,N/A,120,0
12,N/A,N/A,N/A,355,367,N/A,126,6
3,N/A,N/A,N/A,352,355,N/A,129,3
2,N/A,N/A,N/A,350,352,N/A,134,2
1,N/A,N/A,N/A,1060,1061,N/A,6,1
15,N/A,N/A,N/A,1045,1060,N/A,11,6
2,N/A,N/A,N/A,1043,1045,N/A,14,3
3,N/A,N/A,N/A,1040,1043,N/A,20,3
2,N/A,N/A,N/A,1038,1040,N/A,25,2
2,N/A,N/A,N/A,1036,1038,N/A,31,2
2,N/A,N/A,N/A,1034,1036,N/A,37,2
1,N/A,N/A,N/A,1033,1034,N/A,42,1
18,N/A,N/A,N/A,1015,1033,N/A,46,5
8,N/A,N/A,N/A,1007,1015,N/A,51,4
3,N/A,N/A,N/A,1004,1007,N/A,56,3
2,N/A,N/A,N/A,1002,1004,N/A,62,3
4,N/A,N/A,N/A,998,1002,N/A,67,2
1,N/A,N/A,N/A,997,998,N/A,72,1
11,N/A,N/A,N/A,986,997,N/A,77,6
4,N/A,N/A,N/A,982,986,N/A,80,3
2,N/A,N/A,N/A,980,982,N/A,85,2
1,N/A,N/A,N/A,979,980,N/A,90,1
11,N/A,N/A,N/A,968,979,N/A,95,6
5,N/A,N/A,N/A,963,968,N/A,99,4
3,N/A,N/A,N/A,960,963,N/A,104,3
20,N/A,N/A,N/A,940,960,N/A,107,6
1,N/A,N/A,N/A,939,940,N/A,113,0
20,N/A,N/A,N/A,919,939,N/A,119,6
2,N/A,N/A,N/A,917,919,N/A,125,0
17,N/A,N/A,N/A,900,917,N/A,131,6
12,N/A,N/A,N/A,888,900,N/A,136,5
15,N/A,N/A,N/A,873,888,N/A,142,5
7,N/A,N/A,N/A,866,873,N/A,147,4
3,N/A,N/A,N/A,863,866,N/A,152,3
9,N/A,N/A,N/A,1898,1907,N/A,6,4
3,N/A,N/A,N/A,1895,1898,N/A,11,3
4,N/A,N/A,N/A,1891,1895,N/A,17,3
4,N/A,N/A,N/A,1887,1891,N/A,23,3
2,N/A,N/A,N/A,1885,1887,N/A,29,3
12,N/A,N/A,N/A,1873,1885,N/A,32,6
2,N/A,N/A,N/A,1871,1873,N/A,38,0
2,N/A,N/A,N/A,1869,1871,N/A,41,3
19,N/A,N/A,N/A,1850,1869,N/A,44,6
2,N/A,N/A,N/A,1848,1850,N/A,47,3
4,N/A,N/A,N/A,1844,1848,N/A,52,2
2,N/A,N/A,N/A,1842,1844,N/A,58,2
2,N/A,N/A,N/A,1840,1842,N/A,63,1
2,N/A,N/A,N/A,1838,1840,N/A,69,1
2,N/A,N/A,N/A,1836,1838,N/A,75,1
14,N/A,N/A,N/A,1822,1836,N/A,80,6
11,N/A,N/A,N/A,1811,1822,N/A,85,5
2,N/A,N/A,N/A,1809,1811,N/A,88,2
12,N/A,N/A,N/A,1797,1809,N/A,92,6
1,N/A,N/A,N/A,1796,1797,N/A,98,0
19,N/A,N/A,N/A,1777,1796,N/A,104,6
4,N/A,N/A,N/A,1773,1777,N/A,107,3
13,N/A,N/A,N/A,1760,1773,N/A,110,6
2,N/A,N/A,N/A,1758,1760,N/A,113,3
3,N/A,N/A,N/A,1755,1758,N/A,119,3
2,N/A,N/A,N/A,1753,1755,N/A,124,2
15,N/A,N/A,N/A,1738,1753,N/A,128,6
16,N/A,N/A,N/A,1722,1738,N/A,133,5
4,N/A,N/A,N/A,1718,1722,N/A,137,3
2,N/A,N/A,N/A,1716,1718,N/A,141,1
11,N/A,N/A,N/A,1905,1916,N/A,3,4
14,N/A,N/A,N/A,1891,1905,N/A,9,4
4,N/A,N/A,N/A,1887,1891,N/A,14,3
4,N/A,N/A,N/A,1883,1887,N/A,20,3
2,N/A,N/A,N/A,1881,1883,N/A,25,2
12,N/A,N/A,N/A,1869,1881,N/A,29,6
6,N/A,N/A,N/A,1863,1869,N/A,33,4
2,N/A,N/A,N/A,1861,1863,N/A,38,3
1,N/A,N/A,N/A,1860,1861,N/A,42,1
19,N/A,N/A,N/A,1841,1860,N/A,47,6
1,N/A,N/A,N/A,1840,1841,N/A,53,0
14,N/A,N/A,N/A,1826,1840,N/A,59,6
4,N/A,N/A,N/A,1822,1826,N/A,62,3
18,N/A,N/A,N/A,1804,1822,N/A,65,6
1,N/A,N/A,N/A,1803,1804,N/A,71,0
4,N/A,N/A,N/A,1799,1803,N/A,74,3
16,N/A,N/A,N/A,1783,1799,N/A,77,6
11,N/A,N/A,N/A,1772,1783,N/A,81,4
2,N/A,N/A,N/A,1770,1772,N/A,84,1
13,N/A,N/A,N/A,1757,1770,N/A,88,5
3,N/A,N/A,N/A,1754,1757,N/A,91,2
17,N/A,N/A,N/A,1737,1754,N/A,95,6
2,N/A,N/A,N/A,1735,1737,N/A,98,3
2,N/A,N/A,N/A,1733,1735,N/A,103,2
16,N/A,N/A,N/A,1717,1733,N/A,106,5
4,N/A,N/A,N/A,1713,1717,N/A,109,2
16,N/A,N/A,N/A,1697,1713,N/A,113,6
10,N/A,N/A,N/A,1687,1697,N/A,118,5
17,N/A,N/A,N/A,1670,1687,N/A,124,5
10,N/A,N/A,N/A,1660,1670,N/A,129,4
4,N/A,N/A,N/A,1739,1743,N/A,4,2
2,N/A,N/A,N/A,1737,1739,N/A,10,2
17,N/A,N/A,N/A,1720,1737,N/A,13,5
10,N/A,N/A,N/A,1710,1720,N/A,19,5
2,N/A,N/A,N/A,1708,1710,N/A,23,3
17,N/A,N/A,N/A,1691,1708,N/A,26,6
2,N/A,N/A,N/A,1689,1691,N/A,29,3
2,N/A,N/A,N/A,1687,1689,N/A,35,3
20,N/A,N/A,N/A,1667,1687,N/A,38,6
17,N/A,N/A,N/A,1650,1667,N/A,43,5
18,N/A,N/A,N/A,1632,1650,N/A,49,5
10,N/A,N/A,N/A,1622,1632,N/A,55,5
19,N/A,N/A,N/A,1603,1622,N/A,61,5
4,N/A,N/A,N/A,1599,1603,N/A,64,2
1,N/A,N/A,N/A,1598,1599,N/A,69,1
2,N/A,N/A,N/A,1596,1598,N/A,75,1
17,N/A,N/A,N/A,1579,1596,N/A,79,5
13,N/A,N/A,N/A,1566,1579,N/A,85,5
11,N/A,N/A,N/A,1555,1566,N/A,91,5
2,N/A,N/A,N/A,1553,1555,N/A,95,3
11,N/A,N/A,N/A,1542,1553,N/A,98,6
3,N/A,N/A,N/A,1539,1542,N/A,101,3
2,N/A,N/A,N/A,1537,1539,N/A,105,1
1,N/A,N/A,N/A,1536,1537,N/A,111,1
14,N/A,N/A,N/A,1522,1536,N/A,114,4
1,N/A,N/A,N/A,1521,1522,N/A,117,1
2,N/A,N/A,N/A,1519,1521,N/A,123,1
10,N/A,N/A,N/A,1509,1519,N/A,126,4
3,N/A,N/A,N/A,1506,1509,N/A,130,2
1,N/A,N/A,N/A,1505,1506,N/A,135,1
4,N/A,N/A,N/A,1073,1077,N/A,4,3
2,N/A,N/A,N/A,1071,1073,N/A,9,2
2,N/A,N/A,N/A,1069,1071,N/A,14,1
18,N/A,N/A,N/A,1051,1069,N/A,18,5
3,N/A,N/A,N/A,1048,1051,N/A,21,2
15,N/A,N/A,N/A,1033,1048,N/A,25,6
4,N/A,N/A,N/A,1029,1033,N/A,28,3
11,N/A,N/A,N/A,1018,1029,N/A,31,6
10,N/A,N/A,N/A,1008,1018,N/A,35,4
1,N/A,N/A,N/A,1007,1008,N/A,38,1
12,N/A,N/A,N/A,995,1007,N/A,42,5
13,N/A,N/A,N/A,982,995,N/A,47,4
7,N/A,N/A,N/A,975,982,N/A,53,4
11,N/A,N/A,N/A,964,975,N/A,59,4
2,N/A,N/A,N/A,962,964,N/A,64,3
3,N/A,N/A,N/A,959,962,N/A,69,2
15,N/A,N/A,N/A,944,959,N/A,73,6
4,N/A,N/A,N/A,940,944,N/A,76,3
17,N/A,N/A,N/A,923,940,N/A,79,6
4,N/A,N/A,N/A,919,923,N/A,82,3
4,N/A,N/A,N/A,915,919,N/A,87,2
15,N/A,N/A,N/A,900,915,N/A,90,5
8,N/A,N/A,N/A,892,900,N/A,95,4
2,N/A,N/A,N/A,890,892,N/A,99,2
15,N/A,N/A,N/A,875,890,N/A,103,6
2,N/A,N/A,N/A,873,875,N/A,106,3
2,N/A,N/A,N/A,871,873,N/A,110,1
18,N/A,N/A,N/A,853,871,N/A,114,5
13,N/A,N/A,N/A,840,853,N/A,120,5
4,N/A,N/A,N/A,836,840,N/A,123,2
16,N/A,N/A,N/A,1831,1847,N/A,5,6
4,N/A,N/A,N/A,1827,1831,N/A,8,3
1,N/A,N/A,N/A,1826,1827,N/A,12,1
10,N/A,N/A,N/A,1816,1826,N/A,15,4
2,N/A,N/A,N/A,1814,1816,N/A,19,2
11,N/A,N/A,N/A,1803,1814,N/A,23,6
12,N/A,N/A,N/A,1791,1803,N/A,27,4
1,N/A,N/A,N/A,1790,1791,N/A,30,1
2,N/A,N/A,N/A,1788,1790,N/A,36,1
15,N/A,N/A,N/A,1773,1788,N/A,40,5
3,N/A,N/A,N/A,1770,1773,N/A,44,3
20,N/A,N/A,N/A,1750,1770,N/A,47,6
18,N/A,N/A,N/A,1732,1750,N/A,52,5
2,N/A,N/A,N/A,1730,1732,N/A,56,3
1,N/A,N/A,N/A,1729,1730,N/A,60,1
17,N/A,N/A,N/A,1712,1729,N/A,64,5
4,N/A,N/A,N/A,1708,1712,N/A,68,3
14,N/A,N/A,N/A,1694,1708,N/A,71,6
15,N/A,N/A,N/A,1679,1694,N/A,76,5
3,N/A,N/A,N/A,1676,1679,N/A,80,3
1,N/A,N/A,N/A,1675,1676,N/A,84,1
10,N/A,N/A,N/A,1665,1675,N/A,88,5
2,N/A,N/A,N/A,1663,1665,N/A,91,2
16,N/A,N/A,N/A,1647,1663,N/A,94,5
8,N/A,N/A,N/A,1639,1647,N/A,99,4
4,N/A,N/A,N/A,1635,1639,N/A,104,3
4,N/A,N/A,N/A,1631,1635,N/A,110,3
2,N/A,N/A,N/A,1629,1631,N/A,114,1
19,N/A,N/A,N/A,1610,1629,N/A,119,6
1,N/A,N/A,N/A,1609,1610,N/A,125,0
4,N/A,N/A,N/A,1288,1292,N/A,5,2
18,N/A,N/A,N/A,1270,1288,N/A,8,5
17,N/A,N/A,N/A,1253,1270,N/A,14,5
2,N/A,N/A,N/A,1251,1253,N/A,17,2
1,N/A,N/A,N/A,1250,1251,N/A,22,1
12,N/A,N/A,N/A,1238,1250,N/A,26,5
2,N/A,N/A,N/A,1236,1238,N/A,29,2
20,N/A,N/A,N/A,1216,1236,N/A,33,6
17,N/A,N/A,N/A,1199,1216,N/A,38,5
2,N/A,N/A,N/A,1197,1199,N/A,42,3
4,N/A,N/A,N/A,1193,1197,N/A,48,3
4,N/A,N/A,N/A,1189,1193,N/A,53,2
1,N/A,N/A,N/A,1188,1189,N/A,58,1
2,N/A,N/A,N/A,1186,1188,N/A,64,1
13,N/A,N/A,N/A,1173,1186,N/A,67,4
10,N/A,N/A,N/A,1163,1173,N/A,73,4
8,N/A,N/A,N/A,1155,1163,N/A,79,4
5,N/A,N/A,N/A,1150,1155,N/A,85,4
2,N/A,N/A,N/A,1148,1150,N/A,88,1
20,N/A,N/A,N/A,1128,1148,N/A,93,6
2,N/A,N/A,N/A,1126,1128,N/A,99,0
17,N/A,N/A,N/A,1109,1126,N/A,104,5
2,N/A,N/A,N/A,1107,1109,N/A,107,2
18,N/A,N/A,N/A,1089,1107,N/A,111,6
2,N/A,N/A,N/A,1087,1089,N/A,117,0
20,N/A,N/A,N/A,1067,1087,N/A,123,6
4,N/A,N/A,N/A,1063,1067,N/A,126,3
11,N/A,N/A,N/A,1052,1063,N/A,129,6
7,N/A,N/A,N/A,1045,1052,N/A,133,4
4,N/A,N/A,N/A,1041,1045,N/A,138,3
2,N/A,N/A,N/A,696,698,N/A,3,1
13,N/A,N/A,N/A,683,696,N/A,8,6
19,N/A,N/A,N/A,664,683,N/A,13,5
3,N/A,N/A,N/A,661,664,N/A,16,2
3,N/A,N/A,N/A,658,661,N/A,22,2
12,N/A,N/A,N/A,646,658,N/A,26,6
1,N/A,N/A,N/A,645,646,N/A,32,0
2,N/A,N/A,N/A,643,645,N/A,35,3
17,N/A,N/A,N/A,626,643,N/A,38,6
18,N/A,N/A,N/A,608,626,N/A,43,5
11,N/A,N/A,N/A,597,608,N/A,48,4
2,N/A,N/A,N/A,595,597,N/A,52,2
1,N/A,N/A,N/A,594,595,N/A,57,1
17,N/A,N/A,N/A,577,594,N/A,61,5
18,N/A,N/A,N/A,559,577,N/A,67,5
7,N/A,N/A,N/A,552,559,N/A,72,4
3,N/A,N/A,N/A,549,552,N/A,76,2
4,N/A,N/A,N/A,545,549,N/A,82,2
20,N/A,N/A,N/A,525,545,N/A,86,6
12,N/A,N/A,N/A,513,525,N/A,91,5
12,N/A,N/A,N/A,501,513,N/A,97,5
4,N/A,N/A,N/A,497,501,N/A,100,2
15,N/A,N/A,N/A,482,497,N/A,103,5
4,N/A,N/A,N/A,478,482,N/A,106,2
14,N/A,N/A,N/A,464,478,N/A,109,5
14,N/A,N/A,N/A,450,464,N/A,114,4
4,N/A,N/A,N/A,446,450,N/A,119,3
2,N/A,N/A,N/A,444,446,N/A,125,3
3,N/A,N/A,N/A,441,444,N/A,130,2
17,N/A,N/A,N/A,424,441,N/A,134,6
16,N/A,N/A,N/A,1421,1437,N/A,4,5
2,N/A,N/A,N/A,1419,1421,N/A,7,2
17,N/A,N/A,N/A,1402,1419,N/A,10,5
6,N/A,N/A,N/A,1396,1402,N/A,15,4
13,N/A,N/A,N/A,1383,1396,N/A,21,4
5,N/A,N/A,N/A,1378,1383,N/A,27,4
4,N/A,N/A,N/A,1374,1378,N/A,32,3
3,N/A,N/A,N/A,1371,1374,N/A,38,3
1,N/A,N/A,N/A,1370,1371,N/A,42,1
14,N/A,N/A,N/A,1356,1370,N/A,45,4
2,N/A,N/A,N/A,1354,1356,N/A,50,3
19,N/A,N/A,N/A,1335,1354,N/A,53,6
1,N/A,N/A,N/A,1334,1335,N/A,59,0
3,N/A,N/A,N/A,1331,1334,N/A,62,3
2,N/A,N/A,N/A,1329,1331,N/A,66,1
20,N/A,N/A,N/A,1309,1329,N/A,71,6
1,N/A,N/A,N/A,1308,1309,N/A,77,0
17,N/A,N/A,N/A,1291,1308,N/A,83,6
4,N/A,N/A,N/A,1287,1291,N/A,86,3
2,N/A,N/A,N/A,1285,1287,N/A,90,1
15,N/A,N/A,N/A,1270,1285,N/A,95,6
12,N/A,N/A,N/A,1258,1270,N/A,100,5
14,N/A,N/A,N/A,1244,1258,N/A,105,4
13,N/A,N/A,N/A,1231,1244,N/A,111,4
2,N/A,N/A,N/A,1229,1231,N/A,115,2
2,N/A,N/A,N/A,1227,1229,N/A,121,2
17,N/A,N/A,N/A,1210,1227,N/A,124,5
4,N/A,N/A,N/A,1206,1210,N/A,127,2
1,N/A,N/A,N/A,1205,1206,N/A,132,1
14,N/A,N/A,N/A,1191,1205,N/A,135,4
11,N/A,N/A,N/A,978,989,N/A,6,6
4,N/A,N/A,N/A,974,978,N/A,9,3
3,N/A,N/A,N/A,971,974,N/A,14,2
16,N/A,N/A,N/A,955,971,N/A,17,5
15,N/A,N/A,N/A,940,955,N/A,23,5
2,N/A,N/A,N/A,938,940,N/A,27,3
14,N/A,N/A,N/A,924,938,N/A,30,6
8,N/A,N/A,N/A,916,924,N/A,34,4
2,N/A,N/A,N/A,914,916,N/A,37,1
14,N/A,N/A,N/A,900,914,N/A,41,5
4,N/A,N/A,N/A,896,900,N/A,45,3
1,N/A,N/A,N/A,895,896,N/A,49,1
17,N/A,N/A,N/A,878,895,N/A,54,6
2,N/A,N/A,N/A,876,878,N/A,60,0
3,N/A,N/A,N/A,873,876,N/A,63,3
17,N/A,N/A,N/A,856,873,N/A,66,6
13,N/A,N/A,N/A,843,856,N/A,71,5
3,N/A,N/A,N/A,840,843,N/A,74,2
1,N/A,N/A,N/A,839,840,N/A,79,1
2,N/A,N/A,N/A,837,839,N/A,85,1
12,N/A,N/A,N/A,825,837,N/A,88,4
4,N/A,N/A,N/A,821,825,N/A,92,2
1,N/A,N/A,N/A,820,821,N/A,97,1
19,N/A,N/A,N/A,801,820,N/A,102,6
7,N/A,N/A,N/A,794,801,N/A,106,4
3,N/A,N/A,N/A,791,794,N/A,110,2
3,N/A,N/A,N/A,788,791,N/A,116,2
19,N/A,N/A,N/A,769,788,N/A,119,5
5,N/A,N/A,N/A,764,769,N/A,124,4
3,N/A,N/A,N/A,761,764,N/A,128,2
14,N/A,N/A,N/A,1461,1475,N/A,4,6
4,N/A,N/A,N/A,1457,1461,N/A,7,3
4,N/A,N/A,N/A,1453,1457,N/A,12,2
4,N/A,N/A,N/A,1449,1453,N/A,18,2
4,N/A,N/A,N/A,1445,1449,N/A,24,2
11,N/A,N/A,N/A,1434,1445,N/A,27,5
17,N/A,N/A,N/A,1417,1434,N/A,33,5
8,N/A,N/A,N/A,1409,1417,N/A,38,4
4,N/A,N/A,N/A,1405,1409,N/A,42,2
1,N/A,N/A,N/A,1404,1405,N/A,47,1
14,N/A,N/A,N/A,1390,1404,N/A,52,6
3,N/A,N/A,N/A,1387,1390,N/A,55,3
2,N/A,N/A,N/A,1385,1387,N/A,59,1
12,N/A,N/A,N/A,1373,1385,N/A,63,5
19,N/A,N/A,N/A,1354,1373,N/A,69,5
4,N/A,N/A,N/A,1350,1354,N/A,72,2
19,N/A,N/A,N/A,1331,1350,N/A,75,5
16,N/A,N/A,N/A,1315,1331,N/A,81,5
12,N/A,N/A,N/A,1303,1315,N/A,87,5
3,N/A,N/A,N/A,1300,1303,N/A,91,3
2,N/A,N/A,N/A,1298,1300,N/A,96,2
17,N/A,N/A,N/A,1281,1298,N/A,99,5
16,N/A,N/A,N/A,1265,1281,N/A,105,5
3,N/A,N/A,N/A,1262,1265,N/A,108,2
17,N/A,N/A,N/A,1245,1262,N/A,112,6
10,N/A,N/A,N/A,1235,1245,N/A,117,5
18,N/A,N/A,N/A,1217,1235,N/A,123,5
2,N/A,N/A,N/A,1215,1217,N/A,126,2
2,N/A,N/A,N/A,1213,1215,N/A,132,2
14,N/A,N/A,N/A,1199,1213,N/A,135,5
2,N/A,N/A,N/A,364,366,N/A,4,2
17,N/A,N/A,N/A,347,364,N/A,7,5
12,N/A,N/A,N/A,335,347,N/A,13,5
11,N/A,N/A,N/A,324,335,N/A,19,5
11,N/A,N/A,N/A,313,324,N/A,25,5
10,N/A,N/A,N/A,303,313,N/A,31,5
2,N/A,N/A,N/A,301,303,N/A,35,3
2,N/A,N/A,N/A,299,301,N/A,39,1
18,N/A,N/A,N/A,281,299,N/A,43,5
2,N/A,N/A,N/A,279,281,N/A,47,3
1,N/A,N/A,N/A,278,279,N/A,51,1
15,N/A,N/A,N/A,263,278,N/A,56,6
6,N/A,N/A,N/A,257,263,N/A,60,4
2,N/A,N/A,N/A,255,257,N/A,63,1
12,N/A,N/A,N/A,243,255,N/A,66,4
14,N/A,N/A,N/A,229,243,N/A,72,4
2,N/A,N/A,N/A,227,229,N/A,75,1
10,N/A,N/A,N/A,217,227,N/A,79,5
14,N/A,N/A,N/A,203,217,N/A,84,4
2,N/A,N/A,N/A,201,203,N/A,87,1
9,N/A,N/A,N/A,192,201,N/A,90,4
1,N/A,N/A,N/A,191,192,N/A,93,1
7,N/A,N/A,N/A,184,191,N/A,96,4
2,N/A,N/A,N/A,182,184,N/A,100,2
2,N/A,N/A,N/A,180,182,N/A,106,2
14,N/A,N/A,N/A,166,180,N/A,109,5
3,N/A,N/A,N/A,163,166,N/A,113,3
1,N/A,N/A,N/A,162,163,N/A,117,1
15,N/A,N/A,N/A,147,162,N/A,121,5
3,N/A,N/A,N/A,144,147,N/A,124,2
20,N/A,N/A,N/A,1226,1246,N/A,6,6
16,N/A,N/A,N/A,1210,1226,N/A,11,5
13,N/A,N/A,N/A,1197,1210,N/A,17,5
2,N/A,N/A,N/A,1195,1197,N/A,21,3
1,N/A,N/A,N/A,1194,1195,N/A,25,1
13,N/A,N/A,N/A,1181,1194,N/A,28,4
4,N/A,N/A,N/A,1177,1181,N/A,32,2
3,N/A,N/A,N/A,1174,1177,N/A,38,2
2,N/A,N/A,N/A,1172,1174,N/A,44,2
2,N/A,N/A,N/A,1170,1172,N/A,50,2
2,N/A,N/A,N/A,1168,1170,N/A,55,1
13,N/A,N/A,N/A,1155,1168,N/A,60,6
19,N/A,N/A,N/A,1136,1155,N/A,65,5
6,N/A,N/A,N/A,1130,1136,N/A,70,4
2,N/A,N/A,N/A,1128,1130,N/A,73,1
2,N/A,N/A,N/A,1126,1128,N/A,79,1
1,N/A,N/A,N/A,1125,1126,N/A,85,1
19,N/A,N/A,N/A,1106,1125,N/A,89,5
2,N/A,N/A,N/A,1104,1106,N/A,92,2
1,N/A,N/A,N/A,1103,1104,N/A,97,1
1,N/A,N/A,N/A,1102,1103,N/A,103,1
2,N/A,N/A,N/A,1100,1102,N/A,109,1
9,N/A,N/A,N/A,1091,1100,N/A,112,4
2,N/A,N/A,N/A,1089,1091,N/A,115,1
2,N/A,N/A,N/A,1087,1089,N/A,121,1
1,N/A,N/A,N/A,1086,1087,N/A,127,1
13,N/A,N/A,N/A,1073,1086,N/A,131,5
17,N/A,N/A,N/A,1056,1073,N/A,137,5
3,N/A,N/A,N/A,1053,1056,N/A,140,2
1,N/A,N/A,N/A,1052,1053,N/A,145,1
19,N/A,N/A,N/A,1731,1750,N/A,3,5
4,N/A,N/A,N/A,1727,1731,N/A,6,2
3,N/A,N/A,N/A,1724,1727,N/A,12,2
2,N/A,N/A,N/A,1722,1724,N/A,17,1
2,N/A,N/A,N/A,1720,1722,N/A,23,1
1,N/A,N/A,N/A,1719,1720,N/A,29,1
13,N/A,N/A,N/A,1706,1719,N/A,33,5
4,N/A,N/A,N/A,1702,1706,N/A,36,2
2,N/A,N/A,N/A,1700,1702,N/A,41,1
15,N/A,N/A,N/A,1685,1700,N/A,45,5
3,N/A,N/A,N/A,1682,1685,N/A,49,3
1,N/A,N/A,N/A,1681,1682,N/A,53,1
16,N/A,N/A,N/A,1665,1681,N/A,57,5
7,N/A,N/A,N/A,1658,1665,N/A,62,4
8,N/A,N/A,N/A,1650,1658,N/A,68,4
2,N/A,N/A,N/A,1648,1650,N/A,72,2
11,N/A,N/A,N/A,1637,1648,N/A,75,5
3,N/A,N/A,N/A,1634,1637,N/A,79,3
3,N/A,N/A,N/A,1631,1634,N/A,85,3
2,N/A,N/A,N/A,1629,1631,N/A,91,3
3,N/A,N/A,N/A,1626,1629,N/A,97,3
16,N/A,N/A,N/A,1610,1626,N/A,100,6
13,N/A,N/A,N/A,1597,1610,N/A,104,4
11,N/A,N/A,N/A,1586,1597,N/A,110,4
3,N/A,N/A,N/A,1583,1586,N/A,114,2
3,N/A,N/A,N/A,1580,1583,N/A,120,2
1,N/A,N/A,N/A,1579,1580,N/A,125,1
13,N/A,N/A,N/A,1566,1579,N/A,128,4
2,N/A,N/A,N/A,1564,1566,N/A,132,2
18,N/A,N/A,N/A,1546,1564,N/A,136,6
17,N/A,N/A,N/A,1015,1032,N/A,5,5
2,N/A,N/A,N/A,1013,1015,N/A,9,3
18,N/A,N/A,N/A,995,1013,N/A,12,6
2,N/A,N/A,N/A,993,995,N/A,15,3
3,N/A,N/A,N/A,990,993,N/A,21,3
3,N/A,N/A,N/A,987,990,N/A,27,3
2,N/A,N/A,N/A,985,987,N/A,32,2
18,N/A,N/A,N/A,967,985,N/A,35,5
2,N/A,N/A,N/A,965,967,N/A,38,2
4,N/A,N/A,N/A,961,965,N/A,44,2
12,N/A,N/A,N/A,949,961,N/A,48,6
13,N/A,N/A,N/A,936,949,N/A,52,4
1,N/A,N/A,N/A,935,936,N/A,55,1
19,N/A,N/A,N/A,916,935,N/A,60,6
13,N/A,N/A,N/A,903,916,N/A,64,4
4,N/A,N/A,N/A,899,903,N/A,68,2
1,N/A,N/A,N/A,898,899,N/A,73,1
18,N/A,N/A,N/A,880,898,N/A,78,6
2,N/A,N/A,N/A,878,880,N/A,84,0
20,N/A,N/A,N/A,858,878,N/A,90,6
2,N/A,N/A,N/A,856,858,N/A,96,0
4,N/A,N/A,N/A,852,856,N/A,99,3
2,N/A,N/A,N/A,850,852,N/A,104,2
16,N/A,N/A,N/A,834,850,N/A,107,5
17,N/A,N/A,N/A,817,834,N/A,113,5
15,N/A,N/A,N/A,802,817,N/A,119,5
3,N/A,N/A,N/A,799,802,N/A,123,3
3,N/A,N/A,N/A,796,799,N/A,129,3
12,N/A,N/A,N/A,784,796,N/A,132,6
14,N/A,N/A,N/A,770,784,N/A,136,4
3,N/A,N/A,N/A,1043,1046,N/A,4,3
3,N/A,N/A,N/A,1040,1043,N/A,10,3
4,N/A,N/A,N/A,1036,1040,N/A,15,2
2,N/A,N/A,N/A,1034,1036,N/A,20,1
12,N/A,N/A,N/A,1022,1034,N/A,24,5
15,N/A,N/A,N/A,1007,1022,N/A,30,5
12,N/A,N/A,N/A,995,1007,N/A,36,5
13,N/A,N/A,N/A,982,995,N/A,41,4
3,N/A,N/A,N/A,979,982,N/A,45,2
18,N/A,N/A,N/A,961,979,N/A,48,5
7,N/A,N/A,N/A,954,961,N/A,53,4
2,N/A,N/A,N/A,952,954,N/A,56,1
8,N/A,N/A,N/A,944,952,N/A,59,4
1,N/A,N/A,N/A,943,944,N/A,62,1
9,N/A,N/A,N/A,934,943,N/A,65,4
3,N/A,N/A,N/A,931,934,N/A,70,3
1,N/A,N/A,N/A,930,931,N/A,74,1
12,N/A,N/A,N/A,918,930,N/A,77,4
4,N/A,N/A,N/A,914,918,N/A,82,3
2,N/A,N/A,N/A,912,914,N/A,86,1
12,N/A,N/A,N/A,900,912,N/A,91,6
1,N/A,N/A,N/A,899,900,N/A,97,0
3,N/A,N/A,N/A,896,899,N/A,100,3
2,N/A,N/A,N/A,894,896,N/A,104,1
20,N/A,N/A,N/A,874,894,N/A,109,6
9,N/A,N/A,N/A,865,874,N/A,113,4
2,N/A,N/A,N/A,863,865,N/A,118,3
3,N/A,N/A,N/A,860,863,N/A,123,2
17,N/A,N/A,N/A,843,860,N/A,126,5
4,N/A,N/A,N/A,839,843,N/A,129,2
2,N/A,N/A,N/A,992,994,N/A,4,2
17,N/A,N/A,N/A,975,992,N/A,7,5
2,N/A,N/A,N/A,973,975,N/A,11,3
4,N/A,N/A,N/A,969,973,N/A,17,3
1,N/A,N/A,N/A,968,969,N/A,21,1
6,N/A,N/A,N/A,962,968,N/A,24,4
2,N/A,N/A,N/A,960,962,N/A,28,2
15,N/A,N/A,N/A,945,960,N/A,32,6
6,N/A,N/A,N/A,939,945,N/A,36,4
3,N/A,N/A,N/A,936,939,N/A,41,3
2,N/A,N/A,N/A,934,936,N/A,46,2
3,N/A,N/A,N/A,931,934,N/A,52,2
16,N/A,N/A,N/A,915,931,N/A,56,6
1,N/A,N/A,N/A,914,915,N/A,62,0
11,N/A,N/A,N/A,903,914,N/A,66,4
2,N/A,N/A,N/A,901,903,N/A,70,2
12,N/A,N/A,N/A,889,901,N/A,74,6
3,N/A,N/A,N/A,886,889,N/A,77,3
3,N/A,N/A,N/A,883,886,N/A,83,3
12,N/A,N/A,N/A,871,883,N/A,86,6
2,N/A,N/A,N/A,869,871,N/A,92,0
3,N/A,N/A,N/A,866,869,N/A,95,3
2,N/A,N/A,N/A,864,866,N/A,100,2
19,N/A,N/A,N/A,845,864,N/A,103,5
17,N/A,N/A,N/A,828,845,N/A,109,5
3,N/A,N/A,N/A,825,828,N/A,112,2
2,N/A,N/A,N/A,823,825,N/A,118,2
1,N/A,N/A,N/A,822,823,N/A,123,1
13,N/A,N/A,N/A,809,822,N/A,127,5
3,N/A,N/A,N/A,806,809,N/A,131,3
7,N/A,N/A,N/A,1060,1067,N/A,5,4
8,N/A,N/A,N/A,1052,1060,N/A,11,4
2,N/A,N/A,N/A,1050,1052,N/A,15,2
1,N/A,N/A,N/A,1049,1050,N/A,20,1
13,N/A,N/A,N/A,1036,1049,N/A,25,6
1,N/A,N/A,N/A,1035,1036,N/A,31,0
5,N/A,N/A,N/A,1030,1035,N/A,35,4
2,N/A,N/A,N/A,1028,1030,N/A,39,2
2,N/A,N/A,N/A,1026,1028,N/A,44,1
1,N/A,N/A,N/A,1025,1026,N/A,50,1
1,N/A,N/A,N/A,1024,1025,N/A,56,1
12,N/A,N/A,N/A,1012,1024,N/A,60,5
2,N/A,N/A,N/A,1010,1012,N/A,64,3
4,N/A,N/A,N/A,1006,1010,N/A,69,2
12,N/A,N/A,N/A,994,1006,N/A,73,6
13,N/A,N/A,N/A,981,994,N/A,78,5
4,N/A,N/A,N/A,977,981,N/A,82,3
4,N/A,N/A,N/A,973,977,N/A,88,3
13,N/A,N/A,N/A,960,973,N/A,91,6
2,N/A,N/A,N/A,958,960,N/A,97,0
8,N/A,N/A,N/A,950,958,N/A,101,4
2,N/A,N/A,N/A,948,950,N/A,105,2
4,N/A,N/A,N/A,944,948,N/A,111,2
18,N/A,N/A,N/A,926,944,N/A,114,5
4,N/A,N/A,N/A,922,926,N/A,117,2
1,N/A,N/A,N/A,921,922,N/A,122,1
16,N/A,N/A,N/A,905,921,N/A,127,6
15,N/A,N/A,N/A,890,905,N/A,132,5
2,N/A,N/A,N/A,888,890,N/A,136,3
1,N/A,N/A,N/A,887,888,N/A,140,1
15,N/A,N/A,N/A,374,389,N/A,6,6
2,N/A,N/A,N/A,372,374,N/A,9,3
4,N/A,N/A,N/A,368,372,N/A,14,2
19,N/A,N/A,N/A,349,368,N/A,17,5
14,N/A,N/A,N/A,335,349,N/A,23,5
2,N/A,N/A,N/A,333,335,N/A,27,3
16,N/A,N/A,N/A,317,333,N/A,30,6
1,N/A,N/A,N/A,316,317,N/A,36,0
5,N/A,N/A,N/A,311,316,N/A,40,4
5,N/A,N/A,N/A,306,311,N/A,46,4
12,N/A,N/A,N/A,294,306,N/A,52,4
3,N/A,N/A,N/A,291,294,N/A,57,3
2,N/A,N/A,N/A,289,291,N/A,63,3
1,N/A,N/A,N/A,288,289,N/A,67,1
1,N/A,N/A,N/A,287,288,N/A,73,1
14,N/A,N/A,N/A,273,287,N/A,77,5
8,N/A,N/A,N/A,265,273,N/A,82,4
4,N/A,N/A,N/A,261,265,N/A,86,2
3,N/A,N/A,N/A,258,261,N/A,92,2
1,N/A,N/A,N/A,257,258,N/A,97,1
11,N/A,N/A,N/A,246,257,N/A,101,5
12,N/A,N/A,N/A,234,246,N/A,107,5
4,N/A,N/A,N/A,230,234,N/A,110,2
3,N/A,N/A,N/A,227,230,N/A,116,2
2,N/A,N/A,N/A,225,227,N/A,121,1
10,N/A,N/A,N/A,215,225,N/A,124,4
2,N/A,N/A,N/A,213,215,N/A,129,3
4,N/A,N/A,N/A,209,213,N/A,134,2
11,N/A,N/A,N/A,198,209,N/A,138,6
2,N/A,N/A,N/A,196,198,N/A,144,0
8,N/A,N/A,N/A,975,983,N/A,3,4
4,N/A,N/A,N/A,971,975,N/A,7,2
15,N/A,N/A,N/A,956,971,N/A,10,5
4,N/A,N/A,N/A,952,956,N/A,13,2
17,N/A,N/A,N/A,935,952,N/A,17,6
14,N/A,N/A,N/A,921,935,N/A,22,5
8,N/A,N/A,N/A,913,921,N/A,27,4
2,N/A,N/A,N/A,911,913,N/A,32,3
18,N/A,N/A,N/A,893,911,N/A,35,6
11,N/A,N/A,N/A,882,893,N/A,40,5
3,N/A,N/A,N/A,879,882,N/A,43,2
2,N/A,N/A,N/A,877,879,N/A,49,2
11,N/A,N/A,N/A,866,877,N/A,53,6
2,N/A,N/A,N/A,864,866,N/A,59,0
9,N/A,N/A,N/A,855,864,N/A,63,4
3,N/A,N/A,N/A,852,855,N/A,68,3
4,N/A,N/A,N/A,848,852,N/A,73,2
3,N/A,N/A,N/A,845,848,N/A,79,2
12,N/A,N/A,N/A,833,845,N/A,82,5
4,N/A,N/A,N/A,829,833,N/A,86,3
3,N/A,N/A,N/A,826,829,N/A,91,2
17,N/A,N/A,N/A,809,826,N/A,94,5
4,N/A,N/A,N/A,805,809,N/A,98,3
4,N/A,N/A,N/A,801,805,N/A,104,3
3,N/A,N/A,N/A,798,801,N/A,109,2
18,N/A,N/A,N/A,780,798,N/A,112,5
3,N/A,N/A,N/A,777,780,N/A,115,2
4,N/A,N/A,N/A,773,777,N/A,121,2
4,N/A,N/A,N/A,769,773,N/A,127,2
3,N/A,N/A,N/A,766,769,N/A,133,2
3,N/A,N/A,N/A,580,583,N/A,4,2
19,N/A,N/A,N/A,561,580,N/A,7,5
2,N/A,N/A,N/A,559,561,N/A,11,3
1,N/A,N/A,N/A,558,559,N/A,15,1
6,N/A,N/A,N/A,552,558,N/A,18,4
2,N/A,N/A,N/A,550,552,N/A,21,1
1,N/A,N/A,N/A,549,550,N/A,27,1
13,N/A,N/A,N/A,536,549,N/A,30,4
3,N/A,N/A,N/A,533,536,N/A,35,3
20,N/A,N/A,N/A,513,533,N/A,38,6
19,N/A,N/A,N/A,494,513,N/A,43,5
7,N/A,N/A,N/A,487,494,N/A,48,4
3,N/A,N/A,N/A,484,487,N/A,52,2
3,N/A,N/A,N/A,481,484,N/A,58,2
3,N/A,N/A,N/A,478,481,N/A,64,2
2,N/A,N/A,N/A,476,478,N/A,69,1
1,N/A,N/A,N/A,475,476,N/A,75,1
10,N/A,N/A,N/A,465,475,N/A,79,5
14,N/A,N/A,N/A,451,465,N/A,85,5
11,N/A,N/A,N/A,440,451,N/A,90,4
10,N/A,N/A,N/A,430,440,N/A,96,4
3,N/A,N/A,N/A,427,430,N/A,101,3
2,N/A,N/A,N/A,425,427,N/A,106,2
15,N/A,N/A,N/A,410,425,N/A,109,5
11,N/A,N/A,N/A,399,410,N/A,115,5
18,N/A,N/A,N/A,381,399,N/A,121,5
8,N/A,N/A,N/A,373,381,N/A,126,4
4,N/A,N/A,N/A,369,373,N/A,130,2
1,N/A,N/A,N/A,368,369,N/A,135,1
13,N/A,N/A,N/A,355,368,N/A,138,4
2,N/A,N/A,N/A,444,446,N/A,6,1
2,N/A,N/A,N/A,442,444,N/A,12,1
15,N/A,N/A,N/A,427,442,N/A,16,5
4,N/A,N/A,N/A,423,427,N/A,20,3
2,N/A,N/A,N/A,421,423,N/A,26,3
3,N/A,N/A,N/A,418,421,N/A,31,2
11,N/A,N/A,N/A,407,418,N/A,35,6
10,N/A,N/A,N/A,397,407,N/A,40,5
14,N/A,N/A,N/A,383,397,N/A,45,4
7,N/A,N/A,N/A,376,383,N/A,51,4
13,N/A,N/A,N/A,363,376,N/A,57,4
8,N/A,N/A,N/A,355,363,N/A,63,4
4,N/A,N/A,N/A,351,355,N/A,67,2
1,N/A,N/A,N/A,350,351,N/A,72,1
12,N/A,N/A,N/A,338,350,N/A,76,5
18,N/A,N/A,N/A,320,338,N/A,82,5
4,N/A,N/A,N/A,316,320,N/A,85,2
3,N/A,N/A,N/A,313,316,N/A,91,2
16,N/A,N/A,N/A,297,313,N/A,94,5
6,N/A,N/A,N/A,291,297,N/A,99,4
8,N/A,N/A,N/A,283,291,N/A,105,4
2,N/A,N/A,N/A,281,283,N/A,109,2
19,N/A,N/A,N/A,262,281,N/A,112,5
4,N/A,N/A,N/A,258,262,N/A,115,2
11,N/A,N/A,N/A,247,258,N/A,119,6
12,N/A,N/A,N/A,235,247,N/A,124,5
5,N/A,N/A,N/A,230,235,N/A,129,4
10,N/A,N/A,N/A,220,230,N/A,135,4
1,N/A,N/A,N/A,219,220,N/A,138,1
10,N/A,N/A,N/A,209,219,N/A,141,4
2,N/A,N/A,N/A,1277,1279,N/A,4,1
5,N/A,N/A,N/A,1272,1277,N/A,7,4
4,N/A,N/A,N/A,1268,1272,N/A,12,3
4,N/A,N/A,N/A,1264,1268,N/A,17,2
14,N/A,N/A,N/A,1250,1264,N/A,21,6
3,N/A,N/A,N/A,1247,1250,N/A,24,3
19,N/A,N/A,N/A,1228,1247,N/A,27,6
12,N/A,N/A,N/A,1216,1228,N/A,31,4
1,N/A,N/A,N/A,1215,1216,N/A,34,1
11,N/A,N/A,N/A,1204,1215,N/A,38,5
2,N/A,N/A,N/A,1202,1204,N/A,41,2
2,N/A,N/A,N/A,1200,1202,N/A,46,1
15,N/A,N/A,N/A,1185,1200,N/A,50,5
6,N/A,N/A,N/A,1179,1185,N/A,55,4
6,N/A,N/A,N/A,1173,1179,N/A,61,4
9,N/A,N/A,N/A,1164,1173,N/A,67,4
4,N/A,N/A,N/A,1160,1164,N/A,71,2
1,N/A,N/A,N/A,1159,1160,N/A,76,1
11,N/A,N/A,N/A,1148,1159,N/A,79,4
3,N/A,N/A,N/A,1145,1148,N/A,84,3
4,N/A,N/A,N/A,1141,1145,N/A,89,2
18,N/A,N/A,N/A,1123,1141,N/A,93,6
2,N/A,N/A,N/A,1121,1123,N/A,99,0
7,N/A,N/A,N/A,1114,1121,N/A,103,4
9,N/A,N/A,N/A,1105,1114,N/A,109,4
12,N/A,N/A,N/A,1093,1105,N/A,115,4
11,N/A,N/A,N/A,1082,1093,N/A,121,4
4,N/A,N/A,N/A,1078,1082,N/A,125,2
11,N/A,N/A,N/A,1067,1078,N/A,128,5
4,N/A,N/A,N/A,1063,1067,N/A,131,2
3,N/A,N/A,N/A,440,443,N/A,6,3
2,N/A,N/A,N/A,438,440,N/A,10,1
2,N/A,N/A,N/A,436,438,N/A,16,1
19,N/A,N/A,N/A,417,436,N/A,21,6
7,N/A,N/A,N/A,410,417,N/A,25,4
2,N/A,N/A,N/A,408,410,N/A,29,2
1,N/A,N/A,N/A,407,408,N/A,34,1
11,N/A,N/A,N/A,396,407,N/A,37,4
8,N/A,N/A,N/A,388,396,N/A,43,4
13,N/A,N/A,N/A,375,388,N/A,49,4
5,N/A,N/A,N/A,370,375,N/A,55,4
1,N/A,N/A,N/A,369,370,N/A,58,1
19,N/A,N/A,N/A,350,369,N/A,62,5
2,N/A,N/A,N/A,348,350,N/A,66,3
4,N/A,N/A,N/A,344,348,N/A,72,3
2,N/A,N/A,N/A,342,344,N/A,76,1
13,N/A,N/A,N/A,329,342,N/A,81,6
5,N/A,N/A,N/A,324,329,N/A,85,4
2,N/A,N/A,N/A,322,324,N/A,90,3
15,N/A,N/A,N/A,307,322,N/A,93,6
4,N/A,N/A,N/A,303,307,N/A,96,3
19,N/A,N/A,N/A,284,303,N/A,99,6
4,N/A,N/A,N/A,280,284,N/A,102,3
2,N/A,N/A,N/A,278,280,N/A,108,3
4,N/A,N/A,N/A,274,278,N/A,113,2
2,N/A,N/A,N/A,272,274,N/A,119,2
1,N/A,N/A,N/A,271,272,N/A,124,1
14,N/A,N/A,N/A,257,271,N/A,128,5
9,N/A,N/A,N/A,248,257,N/A,133,4
4,N/A,N/A,N/A,244,248,N/A,138,3
2,N/A,N/A,N/A,1829,1831,N/A,6,3
3,N/A,N/A,N/A,1826,1829,N/A,12,3
4,N/A,N/A,N/A,1822,1826,N/A,17,2
10,N/A,N/A,N/A,1812,1822,N/A,20,5
10,N/A,N/A,N/A,1802,1812,N/A,25,4
2,N/A,N/A,N/A,1800,1802,N/A,29,2
16,N/A,N/A,N/A,1784,1800,N/A,32,5
9,N/A,N/A,N/A,1775,1784,N/A,37,4
13,N/A,N/A,N/A,1762,1775,N/A,43,4
2,N/A,N/A,N/A,1760,1762,N/A,46,1
12,N/A,N/A,N/A,1748,1760,N/A,50,5
7,N/A,N/A,N/A,1741,1748,N/A,55,4
4,N/A,N/A,N/A,1737,1741,N/A,59,2
2,N/A,N/A,N/A,1735,1737,N/A,65,2
19,N/A,N/A,N/A,1716,1735,N/A,69,6
4,N/A,N/A,N/A,1712,1716,N/A,72,3
2,N/A,N/A,N/A,1710,1712,N/A,76,1
7,N/A,N/A,N/A,1703,1710,N/A,79,4
12,N/A,N/A,N/A,1691,1703,N/A,85,4
2,N/A,N/A,N/A,1689,1691,N/A,89,2
12,N/A,N/A,N/A,1677,1689,N/A,92,5
15,N/A,N/A,N/A,1662,1677,N/A,98,5
3,N/A,N/A,N/A,1659,1662,N/A,102,3
4,N/A,N/A,N/A,1655,1659,N/A,108,3
17,N/A,N/A,N/A,1638,1655,N/A,111,6
12,N/A,N/A,N/A,1626,1638,N/A,115,4
3,N/A,N/A,N/A,1623,1626,N/A,119,2
17,N/A,N/A,N/A,1606,1623,N/A,122,5
3,N/A,N/A,N/A,1603,1606,N/A,126,3
11,N/A,N/A,N/A,1592,1603,N/A,129,6
5,N/A,N/A,N/A,877,882,N/A,6,4
3,N/A,N/A,N/A,874,877,N/A,11,3
17,N/A,N/A,N/A,857,874,N/A,14,6
12,N/A,N/A,N/A,845,857,N/A,18,4
6,N/A,N/A,N/A,839,845,N/A,24,4
2,N/A,N/A,N/A,837,839,N/A,27,1
2,N/A,N/A,N/A,835,837,N/A,33,1
10,N/A,N/A,N/A,825,835,N/A,37,5
16,N/A,N/A,N/A,809,825,N/A,43,5
3,N/A,N/A,N/A,806,809,N/A,47,3
3,N/A,N/A,N/A,803,806,N/A,53,3
2,N/A,N/A,N/A,801,803,N/A,58,2
15,N/A,N/A,N/A,786,801,N/A,62,6
10,N/A,N/A,N/A,776,786,N/A,67,5
7,N/A,N/A,N/A,769,776,N/A,72,4
2,N/A,N/A,N/A,767,769,N/A,75,1
2,N/A,N/A,N/A,765,767,N/A,81,1
10,N/A,N/A,N/A,755,765,N/A,85,5
4,N/A,N/A,N/A,751,755,N/A,88,2
1,N/A,N/A,N/A,750,751,N/A,93,1
15,N/A,N/A,N/A,735,750,N/A,97,5
7,N/A,N/A,N/A,728,735,N/A,102,4
1,N/A,N/A,N/A,727,728,N/A,105,1
14,N/A,N/A,N/A,713,727,N/A,108,4
4,N/A,N/A,N/A,709,713,N/A,113,3
11,N/A,N/A,N/A,698,709,N/A,116,6
3,N/A,N/A,N/A,695,698,N/A,119,3
3,N/A,N/A,N/A,692,695,N/A,125,3
1,N/A,N/A,N/A,691,692,N/A,129,1
13,N/A,N/A,N/A,678,691,N/A,134,6
9,N/A,N/A,N/A,831,840,N/A,4,4
1,N/A,N/A,N/A,830,831,N/A,7,1
14,N/A,N/A,N/A,816,830,N/A,11,5
9,N/A,N/A,N/A,807,816,N/A,16,4
1,N/A,N/A,N/A,806,807,N/A,19,1
2,N/A,N/A,N/A,804,806,N/A,25,1
13,N/A,N/A,N/A,791,804,N/A,30,6
4,N/A,N/A,N/A,787,791,N/A,33,3
19,N/A,N/A,N/A,768,787,N/A,36,6
2,N/A,N/A,N/A,766,768,N/A,39,3
2,N/A,N/A,N/A,764,766,N/A,43,1
8,N/A,N/A,N/A,756,764,N/A,46,4
2,N/A,N/A,N/A,754,756,N/A,49,1
5,N/A,N/A,N/A,749,754,N/A,52,4
6,N/A,N/A,N/A,743,749,N/A,58,4
2,N/A,N/A,N/A,741,743,N/A,61,1
9,N/A,N/A,N/A,732,741,N/A,64,4
4,N/A,N/A,N/A,728,732,N/A,69,3
1,N/A,N/A,N/A,727,728,N/A,73,1
9,N/A,N/A,N/A,718,727,N/A,76,4
8,N/A,N/A,N/A,710,718,N/A,82,4
14,N/A,N/A,N/A,696,710,N/A,88,4
14,N/A,N/A,N/A,682,696,N/A,94,4
3,N/A,N/A,N/A,679,682,N/A,99,3
1,N/A,N/A,N/A,678,679,N/A,103,1
10,N/A,N/A,N/A,668,678,N/A,106,4
3,N/A,N/A,N/A,665,668,N/A,111,3
3,N/A,N/A,N/A,662,665,N/A,117,3
14,N/A,N/A,N/A,648,662,N/A,120,6
2,N/A,N/A,N/A,646,648,N/A,123,3
4,N/A,N/A,N/A,686,690,N/A,6,2
10,N/A,N/A,N/A,676,686,N/A,9,5
4,N/A,N/A,N/A,672,676,N/A,13,3
17,N/A,N/A,N/A,655,672,N/A,16,6
6,N/A,N/A,N/A,649,655,N/A,20,4
4,N/A,N/A,N/A,645,649,N/A,25,3
2,N/A,N/A,N/A,643,645,N/A,30,2
4,N/A,N/A,N/A,639,643,N/A,36,2
2,N/A,N/A,N/A,637,639,N/A,41,1
14,N/A,N/A,N/A,623,637,N/A,46,6
4,N/A,N/A,N/A,619,623,N/A,49,3
17,N/A,N/A,N/A,602,619,N/A,52,6
3,N/A,N/A,N/A,599,602,N/A,55,3
13,N/A,N/A,N/A,586,599,N/A,58,6
11,N/A,N/A,N/A,575,586,N/A,63,5
3,N/A,N/A,N/A,572,575,N/A,67,3
2,N/A,N/A,N/A,570,572,N/A,72,2
1,N/A,N/A,N/A,569,570,N/A,77,1
17,N/A,N/A,N/A,552,569,N/A,82,6
6,N/A,N/A,N/A,546,552,N/A,86,4
2,N/A,N/A,N/A,544,546,N/A,89,1
13,N/A,N/A,N/A,531,544,N/A,92,4
9,N/A,N/A,N/A,522,531,N/A,98,4
2,N/A,N/A,N/A,520,522,N/A,101,1
2,N/A,N/A,N/A,518,520,N/A,107,1
15,N/A,N/A,N/A,503,518,N/A,112,6
7,N/A,N/A,N/A,496,503,N/A,116,4
4,N/A,N/A,N/A,492,496,N/A,120,2
2,N/A,N/A,N/A,490,492,N/A,125,1
6,N/A,N/A,N/A,484,490,N/A,128,4
15,N/A,N/A,N/A,1396,1411,N/A,4,6
11,N/A,N/A,N/A,1385,1396,N/A,8,4
14,N/A,N/A,N/A,1371,1385,N/A,14,4
2,N/A,N/A,N/A,1369,1371,N/A,18,2
1,N/A,N/A,N/A,1368,1369,N/A,23,1
19,N/A,N/A,N/A,1349,1368,N/A,27,5
5,N/A,N/A,N/A,1344,1349,N/A,32,4
9,N/A,N/A,N/A,1335,1344,N/A,38,4
12,N/A,N/A,N/A,1323,1335,N/A,44,4
1,N/A,N/A,N/A,1322,1323,N/A,47,1
14,N/A,N/A,N/A,1308,1322,N/A,52,6
2,N/A,N/A,N/A,1306,1308,N/A,58,0
19,N/A,N/A,N/A,1287,1306,N/A,63,5
3,N/A,N/A,N/A,1284,1287,N/A,66,2
15,N/A,N/A,N/A,1269,1284,N/A,69,5
19,N/A,N/A,N/A,1250,1269,N/A,75,5
3,N/A,N/A,N/A,1247,1250,N/A,79,3
4,N/A,N/A,N/A,1243,1247,N/A,85,3
3,N/A,N/A,N/A,1240,1243,N/A,90,2
3,N/A,N/A,N/A,1237,1240,N/A,96,2
2,N/A,N/A,N/A,1235,1237,N/A,102,2
3,N/A,N/A,N/A,1232,1235,N/A,108,2
2,N/A,N/A,N/A,1230,1232,N/A,113,1
9,N/A,N/A,N/A,1221,1230,N/A,116,4
1,N/A,N/A,N/A,1220,1221,N/A,119,1
11,N/A,N/A,N/A,1209,1220,N/A,122,4
12,N/A,N/A,N/A,1197,1209,N/A,128,4
1,N/A,N/A,N/A,1196,1197,N/A,131,1
12,N/A,N/A,N/A,1184,1196,N/A,136,6
16,N/A,N/A,N/A,1168,1184,N/A,141,5
4,N/A,N/A,N/A,1047,1051,N/A,6,2
13,N/A,N/A,N/A,1034,1047,N/A,10,6
11,N/A,N/A,N/A,1023,1034,N/A,15,5
3,N/A,N/A,N/A,1020,1023,N/A,19,3
1,N/A,N/A,N/A,1019,1020,N/A,23,1
15,N/A,N/A,N/A,1004,1019,N/A,27,5
3,N/A,N/A,N/A,1001,1004,N/A,30,2
3,N/A,N/A,N/A,998,1001,N/A,36,2
14,N/A,N/A,N/A,984,998,N/A,39,5
9,N/A,N/A,N/A,975,984,N/A,44,4
2,N/A,N/A,N/A,973,975,N/A,47,1
13,N/A,N/A,N/A,960,973,N/A,52,6
3,N/A,N/A,N/A,957,960,N/A,55,3
1,N/A,N/A,N/A,956,957,N/A,59,1
15,N/A,N/A,N/A,941,956,N/A,64,6
2,N/A,N/A,N/A,939,941,N/A,67,3
3,N/A,N/A,N/A,936,939,N/A,72,2
14,N/A,N/A,N/A,922,936,N/A,76,6
12,N/A,N/A,N/A,910,922,N/A,80,4
13,N/A,N/A,N/A,897,910,N/A,86,4
11,N/A,N/A,N/A,886,897,N/A,92,4
4,N/A,N/A,N/A,882,886,N/A,96,2
19,N/A,N/A,N/A,863,882,N/A,99,5
18,N/A,N/A,N/A,845,863,N/A,105,5
15,N/A,N/A,N/A,830,845,N/A,111,5
13,N/A,N/A,N/A,817,830,N/A,117,5
11,N/A,N/A,N/A,806,817,N/A,123,5
6,N/A,N/A,N/A,800,806,N/A,128,4
2,N/A,N/A,N/A,798,800,N/A,132,2
16,N/A,N/A,N/A,782,798,N/A,136,6
13,N/A,N/A,N/A,1686,1699,N/A,6,6
2,N/A,N/A,N/A,1684,1686,N/A,9,3
2,N/A,N/A,N/A,1682,1684,N/A,14,2
3,N/A,N/A,N/A,1679,1682,N/A,20,2
3,N/A,N/A,N/A,1676,1679,N/A,26,2
2,N/A,N/A,N/A,1674,1676,N/A,31,1
2,N/A,N/A,N/A,1672,1674,N/A,37,1
14,N/A,N/A,N/A,1658,1672,N/A,42,6
1,N/A,N/A,N/A,1657,1658,N/A,48,0
11,N/A,N/A,N/A,1646,1657,N/A,52,4
9,N/A,N/A,N/A,1637,1646,N/A,58,4
11,N/A,N/A,N/A,1626,1637,N/A,64,4
14,N/A,N/A,N/A,1612,1626,N/A,70,4
2,N/A,N/A,N/A,1610,1612,N/A,74,2
2,N/A,N/A,N/A,1608,1610,N/A,80,2
14,N/A,N/A,N/A,1594,1608,N/A,83,5
18,N/A,N/A,N/A,1576,1594,N/A,89,5
4,N/A,N/A,N/A,1572,1576,N/A,93,3
1,N/A,N/A,N/A,1571,1572,N/A,97,1
12,N/A,N/A,N/A,1559,1571,N/A,101,5
3,N/A,N/A,N/A,1556,1559,N/A,104,2
2,N/A,N/A,N/A,1554,1556,N/A,109,1
18,N/A,N/A,N/A,1536,1554,N/A,113,5
12,N/A,N/A,N/A,1524,1536,N/A,119,5
3,N/A,N/A,N/A,1521,1524,N/A,122,2
2,N/A,N/A,N/A,1519,1521,N/A,128,2
2,N/A,N/A,N/A,1517,1519,N/A,134,2
1,N/A,N/A,N/A,1516,1517,N/A,139,1
2,N/A,N/A,N/A,1514,1516,N/A,145,1
8,N/A,N/A,N/A,1506,1514,N/A,148,4
2,N/A,N/A,N/A,531,533,N/A,5,1
13,N/A,N/A,N/A,518,531,N/A,8,4
1,N/A,N/A,N/A,517,518,N/A,11,1
15,N/A,N/A,N/A,502,517,N/A,15,5
3,N/A,N/A,N/A,499,502,N/A,19,3
3,N/A,N/A,N/A,496,499,N/A,24,2
18,N/A,N/A,N/A,478,496,N/A,28,6
12,N/A,N/A,N/A,466,478,N/A,33,5
3,N/A,N/A,N/A,463,466,N/A,36,2
14,N/A,N/A,N/A,449,463,N/A,40,6
8,N/A,N/A,N/A,441,449,N/A,44,4
8,N/A,N/A,N/A,433,441,N/A,50,4
3,N/A,N/A,N/A,430,433,N/A,55,3
2,N/A,N/A,N/A,428,430,N/A,60,2
2,N/A,N/A,N/A,426,428,N/A,66,2
4,N/A,N/A,N/A,422,426,N/A,72,2
11,N/A,N/A,N/A,411,422,N/A,76,6
1,N/A,N/A,N/A,410,411,N/A,82,0
18,N/A,N/A,N/A,392,410,N/A,88,6
4,N/A,N/A,N/A,388,392,N/A,91,3
3,N/A,N/A,N/A,385,388,N/A,97,3
4,N/A,N/A,N/A,381,385,N/A,102,2
2,N/A,N/A,N/A,379,381,N/A,108,2
1,N/A,N/A,N/A,378,379,N/A,113,1
13,N/A,N/A,N/A,365,378,N/A,118,6
1,N/A,N/A,N/A,364,365,N/A,124,0
4,N/A,N/A,N/A,360,364,N/A,127,3
17,N/A,N/A,N/A,343,360,N/A,130,6
6,N/A,N/A,N/A,337,343,N/A,134,4
8,N/A,N/A,N/A,329,337,N/A,140,4
3,N/A,N/A,N/A,1065,1068,N/A,5,3
2,N/A,N/A,N/A,1063,1065,N/A,10,2
17,N/A,N/A,N/A,1046,1063,N/A,13,5
4,N/A,N/A,N/A,1042,1046,N/A,17,3
4,N/A,N/A,N/A,1038,1042,N/A,23,3
2,N/A,N/A,N/A,1036,1038,N/A,28,2
19,N/A,N/A,N/A,1017,1036,N/A,32,6
12,N/A,N/A,N/A,1005,1017,N/A,36,4
2,N/A,N/A,N/A,1003,1005,N/A,40,2
4,N/A,N/A,N/A,999,1003,N/A,46,2
20,N/A,N/A,N/A,979,999,N/A,50,6
7,N/A,N/A,N/A,972,979,N/A,54,4
3,N/A,N/A,N/A,969,972,N/A,58,2
13,N/A,N/A,N/A,956,969,N/A,61,5
15,N/A,N/A,N/A,941,956,N/A,67,5
2,N/A,N/A,N/A,939,941,N/A,70,2
16,N/A,N/A,N/A,923,939,N/A,74,6
1,N/A,N/A,N/A,922,923,N/A,80,0
14,N/A,N/A,N/A,908,922,N/A,84,4
4,N/A,N/A,N/A,904,908,N/A,88,2
16,N/A,N/A,N/A,888,904,N/A,91,5
12,N/A,N/A,N/A,876,888,N/A,97,5
4,N/A,N/A,N/A,872,876,N/A,100,2
3,N/A,N/A,N/A,869,872,N/A,106,2
4,N/A,N/A,N/A,865,869,N/A,112,2
19,N/A,N/A,N/A,846,865,N/A,116,6
5,N/A,N/A,N/A,841,846,N/A,120,4
5,N/A,N/A,N/A,836,841,N/A,126,4
3,N/A,N/A,N/A,833,836,N/A,130,2
2,N/A,N/A,N/A,831,833,N/A,135,1
4,N/A,N/A,N/A,1736,1740,N/A,6,2
18,N/A,N/A,N/A,1718,1736,N/A,10,6
3,N/A,N/A,N/A,1715,1718,N/A,13,3
4,N/A,N/A,N/A,1711,1715,N/A,18,2
4,N/A,N/A,N/A,1707,1711,N/A,24,2
16,N/A,N/A,N/A,1691,1707,N/A,27,5
16,N/A,N/A,N/A,1675,1691,N/A,33,5
3,N/A,N/A,N/A,1672,1675,N/A,37,3
1,N/A,N/A,N/A,1671,1672,N/A,41,1
13,N/A,N/A,N/A,1658,1671,N/A,46,6
15,N/A,N/A,N/A,1643,1658,N/A,51,5
3,N/A,N/A,N/A,1640,1643,N/A,54,2
15,N/A,N/A,N/A,1625,1640,N/A,58,6
12,N/A,N/A,N/A,1613,1625,N/A,62,4
14,N/A,N/A,N/A,1599,1613,N/A,68,4
1,N/A,N/A,N/A,1598,1599,N/A,71,1
9,N/A,N/A,N/A,1589,1598,N/A,74,4
7,N/A,N/A,N/A,1582,1589,N/A,80,4
2,N/A,N/A,N/A,1580,1582,N/A,85,3
3,N/A,N/A,N/A,1577,1580,N/A,91,3
2,N/A,N/A,N/A,1575,1577,N/A,96,2
18,N/A,N/A,N/A,1557,1575,N/A,100,6
1,N/A,N/A,N/A,1556,1557,N/A,106,0
14,N/A,N/A,N/A,1542,1556,N/A,111,5
3,N/A,N/A,N/A,1539,1542,N/A,114,2
19,N/A,N/A,N/A,1520,1539,N/A,117,5
4,N/A,N/A,N/A,1516,1520,N/A,121,3
4,N/A,N/A,N/A,1512,1516,N/A,127,3
14,N/A,N/A,N/A,1498,1512,N/A,130,6
14,N/A,N/A,N/A,1484,1498,N/A,134,4
16,N/A,N/A,N/A,1821,1837,N/A,3,6
3,N/A,N/A,N/A,1818,1821,N/A,6,3
19,N/A,N/A,N/A,1799,1818,N/A,9,6
14,N/A,N/A,N/A,1785,1799,N/A,14,5
12,N/A,N/A,N/A,1773,1785,N/A,20,5
15,N/A,N/A,N/A,1758,1773,N/A,26,5
3,N/A,N/A,N/A,1755,1758,N/A,29,2
1,N/A,N/A,N/A,1754,1755,N/A,34,1
2,N/A,N/A,N/A,1752,1754,N/A,40,1
12,N/A,N/A,N/A,1740,1752,N/A,44,5
12,N/A,N/A,N/A,1728,1740,N/A,50,5
4,N/A,N/A,N/A,1724,1728,N/A,53,2
18,N/A,N/A,N/A,1706,1724,N/A,57,6
11,N/A,N/A,N/A,1695,1706,N/A,61,4
2,N/A,N/A,N/A,1693,1695,N/A,65,2
15,N/A,N/A,N/A,1678,1693,N/A,68,5
3,N/A,N/A,N/A,1675,1678,N/A,71,2
1,N/A,N/A,N/A,1674,1675,N/A,76,1
12,N/A,N/A,N/A,1662,1674,N/A,81,6
2,N/A,N/A,N/A,1660,1662,N/A,87,0
17,N/A,N/A,N/A,1643,1660,N/A,93,6
11,N/A,N/A,N/A,1632,1643,N/A,97,4
3,N/A,N/A,N/A,1629,1632,N/A,102,3
3,N/A,N/A,N/A,1626,1629,N/A,107,2
1,N/A,N/A,N/A,1625,1626,N/A,112,1
18,N/A,N/A,N/A,1607,1625,N/A,117,6
7,N/A,N/A,N/A,1600,1607,N/A,121,4
9,N/A,N/A,N/A,1591,1600,N/A,127,4
3,N/A,N/A,N/A,1588,1591,N/A,131,2
15,N/A,N/A,N/A,1573,1588,N/A,134,5
12,N/A,N/A,N/A,1199,1211,N/A,5,5
12,N/A,N/A,N/A,1187,1199,N/A,11,5
2,N/A,N/A,N/A,1185,1187,N/A,14,2
16,N/A,N/A,N/A,1169,1185,N/A,18,6
17,N/A,N/A,N/A,1152,1169,N/A,23,5
4,N/A,N/A,N/A,1148,1152,N/A,27,3
3,N/A,N/A,N/A,1145,1148,N/A,33,3
2,N/A,N/A,N/A,1143,1145,N/A,37,1
15,N/A,N/A,N/A,1128,1143,N/A,41,5
2,N/A,N/A,N/A,1126,1128,N/A,45,3
4,N/A,N/A,N/A,1122,1126,N/A,51,3
15,N/A,N/A,N/A,1107,1122,N/A,54,6
3,N/A,N/A,N/A,1104,1107,N/A,57,3
4,N/A,N/A,N/A,1100,1104,N/A,62,2
16,N/A,N/A,N/A,1084,1100,N/A,65,5
19,N/A,N/A,N/A,1065,1084,N/A,71,5
14,N/A,N/A,N/A,1051,1065,N/A,77,5
18,N/A,N/A,N/A,1033,1051,N/A,83,5
3,N/A,N/A,N/A,1030,1033,N/A,86,2
1,N/A,N/A,N/A,1029,1030,N/A,91,1
2,N/A,N/A,N/A,1027,1029,N/A,97,1
2,N/A,N/A,N/A,1025,1027,N/A,103,1
13,N/A,N/A,N/A,1012,1025,N/A,107,5
2,N/A,N/A,N/A,1010,1012,N/A,110,2
15,N/A,N/A,N/A,995,1010,N/A,113,5
3,N/A,N/A,N/A,992,995,N/A,117,3
2,N/A,N/A,N/A,990,992,N/A,122,2
3,N/A,N/A,N/A,987,990,N/A,128,2
14,N/A,N/A,N/A,973,987,N/A,131,5
14,N/A,N/A,N/A,959,973,N/A,137,5
2,N/A,N/A,N/A,1833,1835,N/A,3,2
19,N/A,N/A,N/A,1814,1833,N/A,6,5
4,N/A,N/A,N/A,1810,1814,N/A,9,2
1,N/A,N/A,N/A,1809,1810,N/A,14,1
13,N/A,N/A,N/A,1796,1809,N/A,17,4
4,N/A,N/A,N/A,1792,1796,N/A,22,3
4,N/A,N/A,N/A,1788,1792,N/A,28,3
2,N/A,N/A,N/A,1786,1788,N/A,33,2
14,N/A,N/A,N/A,1772,1786,N/A,37,6
13,N/A,N/A,N/A,1759,1772,N/A,41,4
2,N/A,N/A,N/A,1757,1759,N/A,45,2
19,N/A,N/A,N/A,1738,1757,N/A,48,5
13,N/A,N/A,N/A,1725,1738,N/A,53,4
4,N/A,N/A,N/A,1721,1725,N/A,58,3
16,N/A,N/A,N/A,1705,1721,N/A,61,6
4,N/A,N/A,N/A,1701,1705,N/A,64,3
2,N/A,N/A,N/A,1699,1701,N/A,69,2
13,N/A,N/A,N/A,1686,1699,N/A,73,6
2,N/A,N/A,N/A,1684,1686,N/A,76,3
14,N/A,N/A,N/A,1670,1684,N/A,79,6
1,N/A,N/A,N/A,1669,1670,N/A,85,0
4,N/A,N/A,N/A,1665,1669,N/A,88,3
3,N/A,N/A,N/A,1662,1665,N/A,94,3
2,N/A,N/A,N/A,1660,1662,N/A,98,1
13,N/A,N/A,N/A,1647,1660,N/A,102,5
4,N/A,N/A,N/A,1643,1647,N/A,105,2
17,N/A,N/A,N/A,1626,1643,N/A,109,6
17,N/A,N/A,N/A,1609,1626,N/A,114,5
3,N/A,N/A,N/A,1606,1609,N/A,117,2
1,N/A,N/A,N/A,1605,1606,N/A,122,1
16,N/A,N/A,N/A,430,446,N/A,3,6
10,N/A,N/A,N/A,420,430,N/A,7,4
1,N/A,N/A,N/A,419,420,N/A,10,1
17,N/A,N/A,N/A,402,419,N/A,14,5
3,N/A,N/A,N/A,399,402,N/A,18,3
1,N/A,N/A,N/A,398,399,N/A,22,1
20,N/A,N/A,N/A,378,398,N/A,27,6
1,N/A,N/A,N/A,377,378,N/A,33,0
11,N/A,N/A,N/A,366,377,N/A,37,4
2,N/A,N/A,N/A,364,366,N/A,40,1
13,N/A,N/A,N/A,351,364,N/A,45,6
13,N/A,N/A,N/A,338,351,N/A,50,5
9,N/A,N/A,N/A,329,338,N/A,55,4
2,N/A,N/A,N/A,327,329,N/A,59,2
13,N/A,N/A,N/A,314,327,N/A,62,5
10,N/A,N/A,N/A,304,314,N/A,68,5
16,N/A,N/A,N/A,288,304,N/A,74,5
12,N/A,N/A,N/A,276,288,N/A,79,4
2,N/A,N/A,N/A,274,276,N/A,84,3
4,N/A,N/A,N/A,270,274,N/A,90,3
12,N/A,N/A,N/A,258,270,N/A,93,6
8,N/A,N/A,N/A,250,258,N/A,97,4
4,N/A,N/A,N/A,246,250,N/A,101,2
17,N/A,N/A,N/A,229,246,N/A,104,5
12,N/A,N/A,N/A,217,229,N/A,110,5
12,N/A,N/A,N/A,205,217,N/A,116,5
2,N/A,N/A,N/A,203,205,N/A,119,2
18,N/A,N/A,N/A,185,203,N/A,122,5
3,N/A,N/A,N/A,182,185,N/A,125,2
2,N/A,N/A,N/A,180,182,N/A,130,1
10,N/A,N/A,N/A,1111,1121,N/A,6,5
2,N/A,N/A,N/A,1109,1111,N/A,10,3
3,N/A,N/A,N/A,1106,1109,N/A,16,3
2,N/A,N/A,N/A,1104,1106,N/A,21,2
4,N/A,N/A,N/A,1100,1104,N/A,27,2
17,N/A,N/A,N/A,1083,1100,N/A,31,6
2,N/A,N/A,N/A,1081,1083,N/A,37,0
19,N/A,N/A,N/A,1062,1081,N/A,42,5
9,N/A,N/A,N/A,1053,1062,N/A,47,4
4,N/A,N/A,N/A,1049,1053,N/A,52,3
15,N/A,N/A,N/A,1034,1049,N/A,55,6
4,N/A,N/A,N/A,1030,1034,N/A,58,3
3,N/A,N/A,N/A,1027,1030,N/A,63,2
4,N/A,N/A,N/A,1023,1027,N/A,69,2
18,N/A,N/A,N/A,1005,1023,N/A,73,6
3,N/A,N/A,N/A,1002,1005,N/A,76,3
2,N/A,N/A,N/A,1000,1002,N/A,82,3
4,N/A,N/A,N/A,996,1000,N/A,87,2
16,N/A,N/A,N/A,980,996,N/A,90,5
3,N/A,N/A,N/A,977,980,N/A,94,3
2,N/A,N/A,N/A,975,977,N/A,100,3
4,N/A,N/A,N/A,971,975,N/A,105,2
2,N/A,N/A,N/A,969,971,N/A,110,1
15,N/A,N/A,N/A,954,969,N/A,114,5
3,N/A,N/A,N/A,951,954,N/A,117,2
10,N/A,N/A,N/A,941,951,N/A,120,5
10,N/A,N/A,N/A,931,941,N/A,126,5
4,N/A,N/A,N/A,927,931,N/A,129,2
18,N/A,N/A,N/A,909,927,N/A,133,6
1,N/A,N/A,N/A,908,909,N/A,139,0
1,N/A,N/A,N/A,1066,1067,N/A,4,1
12,N/A,N/A,N/A,1054,1066,N/A,8,5
12,N/A,N/A,N/A,1042,1054,N/A,13,4
2,N/A,N/A,N/A,1040,1042,N/A,16,1
6,N/A,N/A,N/A,1034,1040,N/A,19,4
1,N/A,N/A,N/A,1033,1034,N/A,22,1
2,N/A,N/A,N/A,1031,1033,N/A,28,1
19,N/A,N/A,N/A,1012,1031,N/A,33,6
12,N/A,N/A,N/A,1000,1012,N/A,38,5
19,N/A,N/A,N/A,981,1000,N/A,44,5
15,N/A,N/A,N/A,966,981,N/A,50,5
11,N/A,N/A,N/A,955,966,N/A,55,4
5,N/A,N/A,N/A,950,955,N/A,61,4
2,N/A,N/A,N/A,948,950,N/A,66,3
2,N/A,N/A,N/A,946,948,N/A,71,2
3,N/A,N/A,N/A,943,946,N/A,77,2
15,N/A,N/A,N/A,928,943,N/A,80,5
14,N/A,N/A,N/A,914,928,N/A,85,4
4,N/A,N/A,N/A,910,914,N/A,90,3
13,N/A,N/A,N/A,897,910,N/A,93,6
1,N/A,N/A,N/A,896,897,N/A,99,0
11,N/A,N/A,N/A,885,896,N/A,104,5
18,N/A,N/A,N/A,867,885,N/A,110,5
4,N/A,N/A,N/A,863,867,N/A,113,2
2,N/A,N/A,N/A,861,863,N/A,119,2
1,N/A,N/A,N/A,860,861,N/A,124,1
12,N/A,N/A,N/A,848,860,N/A,127,4
1,N/A,N/A,N/A,847,848,N/A,130,1
10,N/A,N/A,N/A,837,847,N/A,133,4
1,N/A,N/A,N/A,836,837,N/A,136,1
1,N/A,N/A,N/A,649,650,N/A,6,1
17,N/A,N/A,N/A,632,649,N/A,10,5
4,N/A,N/A,N/A,628,632,N/A,14,3
2,N/A,N/A,N/A,626,628,N/A,18,1
19,N/A,N/A,N/A,607,626,N/A,22,5
17,N/A,N/A,N/A,590,607,N/A,28,5
3,N/A,N/A,N/A,587,590,N/A,31,2
15,N/A,N/A,N/A,572,587,N/A,35,6
11,N/A,N/A,N/A,561,572,N/A,39,4
2,N/A,N/A,N/A,559,561,N/A,42,1
11,N/A,N/A,N/A,548,559,N/A,46,5
2,N/A,N/A,N/A,546,548,N/A,50,3
2,N/A,N/A,N/A,544,546,N/A,54,1
11,N/A,N/A,N/A,533,544,N/A,59,6
2,N/A,N/A,N/A,531,533,N/A,62,3
12,N/A,N/A,N/A,519,531,N/A,65,6
9,N/A,N/A,N/A,510,519,N/A,69,4
2,N/A,N/A,N/A,508,510,N/A,73,2
1,N/A,N/A,N/A,507,508,N/A,78,1
7,N/A,N/A,N/A,500,507,N/A,81,4
1,N/A,N/A,N/A,499,500,N/A,84,1
1,N/A,N/A,N/A,498,499,N/A,90,1
1,N/A,N/A,N/A,497,498,N/A,96,1
19,N/A,N/A,N/A,478,497,N/A,100,5
3,N/A,N/A,N/A,475,478,N/A,104,3
13,N/A,N/A,N/A,462,475,N/A,107,6
6,N/A,N/A,N/A,456,462,N/A,111,4
3,N/A,N/A,N/A,453,456,N/A,116,3
3,N/A,N/A,N/A,450,453,N/A,121,2
2,N/A,N/A,N/A,448,450,N/A,127,2
18,N/A,N/A,N/A,393,411,N/A,5,6
1,N/A,N/A,N/A,392,393,N/A,11,0
12,N/A,N/A,N/A,380,392,N/A,17,6
8,N/A,N/A,N/A,372,380,N/A,21,4
5,N/A,N/A,N/A,367,372,N/A,27,4
4,N/A,N/A,N/A,363,367,N/A,32,3
2,N/A,N/A,N/A,361,363,N/A,37,2
16,N/A,N/A,N/A,345,361,N/A,40,5
4,N/A,N/A,N/A,341,345,N/A,44,3
16,N/A,N/A,N/A,325,341,N/A,47,6
10,N/A,N/A,N/A,315,325,N/A,51,4
1,N/A,N/A,N/A,314,315,N/A,54,1
5,N/A,N/A,N/A,309,314,N/A,57,4
2,N/A,N/A,N/A,307,309,N/A,60,1
16,N/A,N/A,N/A,291,307,N/A,64,5
2,N/A,N/A,N/A,289,291,N/A,68,3
4,N/A,N/A,N/A,285,289,N/A,74,3
12,N/A,N/A,N/A,273,285,N/A,77,6
17,N/A,N/A,N/A,256,273,N/A,82,5
11,N/A,N/A,N/A,245,256,N/A,87,4
1,N/A,N/A,N/A,244,245,N/A,90,1
11,N/A,N/A,N/A,233,244,N/A,94,5
3,N/A,N/A,N/A,230,233,N/A,97,2
10,N/A,N/A,N/A,220,230,N/A,100,5
14,N/A,N/A,N/A,206,220,N/A,106,5
18,N/A,N/A,N/A,188,206,N/A,112,5
6,N/A,N/A,N/A,182,188,N/A,117,4
4,N/A,N/A,N/A,178,182,N/A,122,3
1,N/A,N/A,N/A,177,178,N/A,126,1
2,N/A,N/A,N/A,175,177,N/A,132,1
20,N/A,N/A,N/A,1936,1956,N/A,4,6
2,N/A,N/A,N/A,1934,1936,N/A,7,3
3,N/A,N/A,N/A,1931,1934,N/A,13,3
18,N/A,N/A,N/A,1913,1931,N/A,16,6
10,N/A,N/A,N/A,1903,1913,N/A,21,5
2,N/A,N/A,N/A,1901,1903,N/A,25,3
3,N/A,N/A,N/A,1898,1901,N/A,30,2
3,N/A,N/A,N/A,1895,1898,N/A,36,2
14,N/A,N/A,N/A,1881,1895,N/A,39,5
4,N/A,N/A,N/A,1877,1881,N/A,43,3
11,N/A,N/A,N/A,1866,1877,N/A,46,6
2,N/A,N/A,N/A,1864,1866,N/A,49,3
3,N/A,N/A,N/A,1861,1864,N/A,54,2
12,N/A,N/A,N/A,1849,1861,N/A,58,6
2,N/A,N/A,N/A,1847,1849,N/A,61,3
1,N/A,N/A,N/A,1846,1847,N/A,65,1
13,N/A,N/A,N/A,1833,1846,N/A,69,5
3,N/A,N/A,N/A,1830,1833,N/A,73,3
18,N/A,N/A,N/A,1812,1830,N/A,76,6
15,N/A,N/A,N/A,1797,1812,N/A,81,5
2,N/A,N/A,N/A,1795,1797,N/A,85,3
20,N/A,N/A,N/A,1775,1795,N/A,88,6
2,N/A,N/A,N/A,1773,1775,N/A,94,0
3,N/A,N/A,N/A,1770,1773,N/A,97,3
2,N/A,N/A,N/A,1768,1770,N/A,101,1
11,N/A,N/A,N/A,1757,1768,N/A,105,5
7,N/A,N/A,N/A,1750,1757,N/A,110,4
8,N/A,N/A,N/A,1742,1750,N/A,116,4
2,N/A,N/A,N/A,1740,1742,N/A,121,3
3,N/A,N/A,N/A,1737,1740,N/A,127,3
4,N/A,N/A,N/A,1124,1128,N/A,5,2
2,N/A,N/A,N/A,1122,1124,N/A,11,2
2,N/A,N/A,N/A,1120,1122,N/A,16,1
13,N/A,N/A,N/A,1107,1120,N/A,19,4
2,N/A,N/A,N/A,1105,1107,N/A,22,1
15,N/A,N/A,N/A,1090,1105,N/A,26,5
3,N/A,N/A,N/A,1087,1090,N/A,29,2
19,N/A,N/A,N/A,1068,1087,N/A,32,5
3,N/A,N/A,N/A,1065,1068,N/A,36,3
4,N/A,N/A,N/A,1061,1065,N/A,42,3
1,N/A,N/A,N/A,1060,1061,N/A,46,1
19,N/A,N/A,N/A,1041,1060,N/A,50,5
15,N/A,N/A,N/A,1026,1041,N/A,56,5
4,N/A,N/A,N/A,1022,1026,N/A,59,2
2,N/A,N/A,N/A,1020,1022,N/A,65,2
17,N/A,N/A,N/A,1003,1020,N/A,69,6
2,N/A,N/A,N/A,1001,1003,N/A,72,3
2,N/A,N/A,N/A,999,1001,N/A,77,2
1,N/A,N/A,N/A,998,999,N/A,82,1
9,N/A,N/A,N/A,989,998,N/A,85,4
1,N/A,N/A,N/A,988,989,N/A,88,1
12,N/A,N/A,N/A,976,988,N/A,91,4
1,N/A,N/A,N/A,975,976,N/A,94,1
1,N/A,N/A,N/A,974,975,N/A,100,1
15,N/A,N/A,N/A,959,974,N/A,105,6
18,N/A,N/A,N/A,941,959,N/A,110,5
13,N/A,N/A,N/A,928,941,N/A,116,5
3,N/A,N/A,N/A,925,928,N/A,119,2
11,N/A,N/A,N/A,914,925,N/A,122,5
14,N/A,N/A,N/A,900,914,N/A,127,4
3,N/A,N/A,N/A,371,374,N/A,4,2
2,N/A,N/A,N/A,369,371,N/A,9,1
2,N/A,N/A,N/A,367,369,N/A,15,1
13,N/A,N/A,N/A,354,367,N/A,20,6
2,N/A,N/A,N/A,352,354,N/A,26,0
4,N/A,N/A,N/A,348,352,N/A,29,3
17,N/A,N/A,N/A,331,348,N/A,32,6
2,N/A,N/A,N/A,329,331,N/A,38,0
4,N/A,N/A,N/A,325,329,N/A,41,3
4,N/A,N/A,N/A,321,325,N/A,47,3
1,N/A,N/A,N/A,320,321,N/A,51,1
13,N/A,N/A,N/A,307,320,N/A,56,6
15,N/A,N/A,N/A,292,307,N/A,61,5
12,N/A,N/A,N/A,280,292,N/A,66,4
4,N/A,N/A,N/A,276,280,N/A,70,2
3,N/A,N/A,N/A,273,276,N/A,76,2
15,N/A,N/A,N/A,258,273,N/A,79,5
11,N/A,N/A,N/A,247,258,N/A,84,4
2,N/A,N/A,N/A,245,247,N/A,88,2
17,N/A,N/A,N/A,228,245,N/A,92,6
2,N/A,N/A,N/A,226,228,N/A,95,3
3,N/A,N/A,N/A,223,226,N/A,100,2
16,N/A,N/A,N/A,207,223,N/A,104,6
1,N/A,N/A,N/A,206,207,N/A,110,0
3,N/A,N/A,N/A,203,206,N/A,113,3
2,N/A,N/A,N/A,201,203,N/A,119,3
4,N/A,N/A,N/A,197,201,N/A,125,3
2,N/A,N/A,N/A,195,197,N/A,130,2
15,N/A,N/A,N/A,180,195,N/A,133,5
2,N/A,N/A,N/A,178,180,N/A,136,2
10,N/A,N/A,N/A,1554,1564,N/A,3,4
2,N/A,N/A,N/A,1552,1554,N/A,8,3
18,N/A,N/A,N/A,1534,1552,N/A,11,6
4,N/A,N/A,N/A,1530,1534,N/A,14,3
2,N/A,N/A,N/A,1528,1530,N/A,19,2
2,N/A,N/A,N/A,1526,1528,N/A,24,1
12,N/A,N/A,N/A,1514,1526,N/A,28,5
4,N/A,N/A,N/A,1510,1514,N/A,31,2
2,N/A,N/A,N/A,1508,1510,N/A,37,2
19,N/A,N/A,N/A,1489,1508,N/A,41,6
1,N/A,N/A,N/A,1488,1489,N/A,47,0
16,N/A,N/A,N/A,1472,1488,N/A,53,6
14,N/A,N/A,N/A,1458,1472,N/A,58,5
8,N/A,N/A,N/A,1450,1458,N/A,63,4
1,N/A,N/A,N/A,1449,1450,N/A,66,1
8,N/A,N/A,N/A,1441,1449,N/A,69,4
2,N/A,N/A,N/A,1439,1441,N/A,72,1
15,N/A,N/A,N/A,1424,1439,N/A,77,6
8,N/A,N/A,N/A,1416,1424,N/A,81,4
2,N/A,N/A,N/A,1414,1416,N/A,84,1
16,N/A,N/A,N/A,1398,1414,N/A,89,6
3,N/A,N/A,N/A,1395,1398,N/A,92,3
2,N/A,N/A,N/A,1393,1395,N/A,96,1
1,N/A,N/A,N/A,1392,1393,N/A,102,1
1,N/A,N/A,N/A,1391,1392,N/A,108,1
7,N/A,N/A,N/A,1384,1391,N/A,111,4
2,N/A,N/A,N/A,1382,1384,N/A,116,3
2,N/A,N/A,N/A,1380,1382,N/A,122,3
2,N/A,N/A,N/A,1378,1380,N/A,127,2
4,N/A,N/A,N/A,1374,1378,N/A,133,2
4,N/A,N/A,N/A,1428,1432,N/A,5,3
4,N/A,N/A,N/A,1424,1428,N/A,10,2
11,N/A,N/A,N/A,1413,1424,N/A,14,6
17,N/A,N/A,N/A,1396,1413,N/A,19,5
3,N/A,N/A,N/A,1393,1396,N/A,23,3
1,N/A,N/A,N/A,1392,1393,N/A,27,1
20,N/A,N/A,N/A,1372,1392,N/A,32,6
2,N/A,N/A,N/A,1370,1372,N/A,38,0
2,N/A,N/A,N/A,1368,1370,N/A,41,3
4,N/A,N/A,N/A,1364,1368,N/A,46,2
15,N/A,N/A,N/A,1349,1364,N/A,49,5
14,N/A,N/A,N/A,1335,1349,N/A,54,4
6,N/A,N/A,N/A,1329,1335,N/A,60,4
3,N/A,N/A,N/A,1326,1329,N/A,64,2
1,N/A,N/A,N/A,1325,1326,N/A,69,1
18,N/A,N/A,N/A,1307,1325,N/A,74,6
2,N/A,N/A,N/A,1305,1307,N/A,77,3
3,N/A,N/A,N/A,1302,1305,N/A,82,2
2,N/A,N/A,N/A,1300,1302,N/A,87,1
13,N/A,N/A,N/A,1287,1300,N/A,92,6
13,N/A,N/A,N/A,1274,1287,N/A,97,5
4,N/A,N/A,N/A,1270,1274,N/A,101,3
2,N/A,N/A,N/A,1268,1270,N/A,106,2
13,N/A,N/A,N/A,1255,1268,N/A,109,5
2,N/A,N/A,N/A,1253,1255,N/A,113,3
2,N/A,N/A,N/A,1251,1253,N/A,117,1
12,N/A,N/A,N/A,1239,1251,N/A,122,6
10,N/A,N/A,N/A,1229,1239,N/A,126,4
2,N/A,N/A,N/A,1227,1229,N/A,130,2
15,N/A,N/A,N/A,1212,1227,N/A,133,5
2,N/A,N/A,N/A,1036,1038,N/A,6,1
18,N/A,N/A,N/A,1018,1036,N/A,11,6
18,N/A,N/A,N/A,1000,1018,N/A,16,5
9,N/A,N/A,N/A,991,1000,N/A,21,4
2,N/A,N/A,N/A,989,991,N/A,26,3
4,N/A,N/A,N/A,985,989,N/A,31,2
17,N/A,N/A,N/A,968,985,N/A,34,5
14,N/A,N/A,N/A,954,968,N/A,39,4
2,N/A,N/A,N/A,952,954,N/A,42,1
5,N/A,N/A,N/A,947,952,N/A,45,4
3,N/A,N/A,N/A,944,947,N/A,50,3
13,N/A,N/A,N/A,931,944,N/A,53,6
12,N/A,N/A,N/A,919,931,N/A,57,4
9,N/A,N/A,N/A,910,919,N/A,63,4
3,N/A,N/A,N/A,907,910,N/A,68,3
2,N/A,N/A,N/A,905,907,N/A,73,2
15,N/A,N/A,N/A,890,905,N/A,77,6
19,N/A,N/A,N/A,871,890,N/A,82,5
3,N/A,N/A,N/A,868,871,N/A,85,2
19,N/A,N/A,N/A,849,868,N/A,88,5
4,N/A,N/A,N/A,845,849,N/A,91,2
15,N/A,N/A,N/A,830,845,N/A,95,6
17,N/A,N/A,N/A,813,830,N/A,100,5
14,N/A,N/A,N/A,799,813,N/A,106,5
19,N/A,N/A,N/A,780,799,N/A,112,5
3,N/A,N/A,N/A,777,780,N/A,115,2
10,N/A,N/A,N/A,767,777,N/A,118,5
13,N/A,N/A,N/A,754,767,N/A,123,4
12,N/A,N/A,N/A,742,754,N/A,129,4
3,N/A,N/A,N/A,739,742,N/A,133,2
2,N/A,N/A,N/A,1644,1646,N/A,6,1
5,N/A,N/A,N/A,1639,1644,N/A,9,4
3,N/A,N/A,N/A,1636,1639,N/A,14,3
4,N/A,N/A,N/A,1632,1636,N/A,19,2
1,N/A,N/A,N/A,1631,1632,N/A,24,1
13,N/A,N/A,N/A,1618,1631,N/A,27,4
2,N/A,N/A,N/A,1616,1618,N/A,30,1
2,N/A,N/A,N/A,1614,1616,N/A,36,1
14,N/A,N/A,N/A,1600,1614,N/A,40,5
11,N/A,N/A,N/A,1589,1600,N/A,45,4
4,N/A,N/A,N/A,1585,1589,N/A,50,3
3,N/A,N/A,N/A,1582,1585,N/A,56,3
1,N/A,N/A,N/A,1581,1582,N/A,60,1
1,N/A,N/A,N/A,1580,1581,N/A,66,1
1,N/A,N/A,N/A,1579,1580,N/A,72,1
12,N/A,N/A,N/A,1567,1579,N/A,76,5
2,N/A,N/A,N/A,1565,1567,N/A,79,2
16,N/A,N/A,N/A,1549,1565,N/A,83,6
3,N/A,N/A,N/A,1546,1549,N/A,86,3
4,N/A,N/A,N/A,1542,1546,N/A,91,2
3,N/A,N/A,N/A,1539,1542,N/A,97,2
4,N/A,N/A,N/A,1535,1539,N/A,103,2
10,N/A,N/A,N/A,1525,1535,N/A,106,5
4,N/A,N/A,N/A,1521,1525,N/A,110,3
4,N/A,N/A,N/A,1517,1521,N/A,116,3
2,N/A,N/A,N/A,1515,1517,N/A,121,2
2,N/A,N/A,N/A,1513,1515,N/A,126,1
11,N/A,N/A,N/A,1502,1513,N/A,130,5
6,N/A,N/A,N/A,1496,1502,N/A,135,4
3,N/A,N/A,N/A,1493,1496,N/A,139,2
1,N/A,N/A,N/A,467,468,N/A,5,1
1,N/A,N/A,N/A,466,467,N/A,11,1
17,N/A,N/A,N/A,449,466,N/A,15,5
8,N/A,N/A,N/A,441,449,N/A,20,4
1,N/A,N/A,N/A,440,441,N/A,23,1
13,N/A,N/A,N/A,427,440,N/A,28,6
2,N/A,N/A,N/A,425,427,N/A,34,0
17,N/A,N/A,N/A,408,425,N/A,40,6
9,N/A,N/A,N/A,399,408,N/A,44,4
8,N/A,N/A,N/A,391,399,N/A,50,4
2,N/A,N/A,N/A,389,391,N/A,53,1
14,N/A,N/A,N/A,375,389,N/A,56,4
3,N/A,N/A,N/A,372,375,N/A,61,3
17,N/A,N/A,N/A,355,372,N/A,64,6
10,N/A,N/A,N/A,345,355,N/A,69,5
14,N/A,N/A,N/A,331,345,N/A,74,4
4,N/A,N/A,N/A,327,331,N/A,78,2
1,N/A,N/A,N/A,326,327,N/A,83,1
19,N/A,N/A,N/A,307,326,N/A,87,5
10,N/A,N/A,N/A,297,307,N/A,93,5
4,N/A,N/A,N/A,293,297,N/A,96,2
3,N/A,N/A,N/A,290,293,N/A,102,2
11,N/A,N/A,N/A,279,290,N/A,105,5
11,N/A,N/A,N/A,268,279,N/A,111,5
4,N/A,N/A,N/A,264,268,N/A,115,3
1,N/A,N/A,N/A,263,264,N/A,119,1
10,N/A,N/A,N/A,253,263,N/A,122,4
2,N/A,N/A,N/A,251,253,N/A,125,1
1,N/A,N/A,N/A,250,251,N/A,131,1
14,N/A,N/A,N/A,236,250,N/A,136,6
8,N/A,N/A,N/A,1326,1334,N/A,6,4
4,N/A,N/A,N/A,1322,1326,N/A,11,3
2,N/A,N/A,N/A,1320,1322,N/A,16,2
12,N/A,N/A,N/A,1308,1320,N/A,19,5
4,N/A,N/A,N/A,1304,1308,N/A,23,3
1,N/A,N/A,N/A,1303,1304,N/A,27,1
13,N/A,N/A,N/A,1290,1303,N/A,31,5
3,N/A,N/A,N/A,1287,1290,N/A,35,3
2,N/A,N/A,N/A,1285,1287,N/A,41,3
2,N/A,N/A,N/A,1283,1285,N/A,47,3
3,N/A,N/A,N/A,1280,1283,N/A,53,3
2,N/A,N/A,N/A,1278,1280,N/A,57,1
14,N/A,N/A,N/A,1264,1278,N/A,60,4
2,N/A,N/A,N/A,1262,1264,N/A,64,2
1,N/A,N/A,N/A,1261,1262,N/A,69,1
19,N/A,N/A,N/A,1242,1261,N/A,73,5
2,N/A,N/A,N/A,1240,1242,N/A,76,2
18,N/A,N/A,N/A,1222,1240,N/A,79,5
4,N/A,N/A,N/A,1218,1222,N/A,83,3
13,N/A,N/A,N/A,1205,1218,N/A,86,6
3,N/A,N/A,N/A,1202,1205,N/A,89,3
3,N/A,N/A,N/A,1199,1202,N/A,95,3
4,N/A,N/A,N/A,1195,1199,N/A,100,2
2,N/A,N/A,N/A,1193,1195,N/A,105,1
12,N/A,N/A,N/A,1181,1193,N/A,110,6
15,N/A,N/A,N/A,1166,1181,N/A,115,5
3,N/A,N/A,N/A,1163,1166,N/A,119,3
16,N/A,N/A,N/A,1147,1163,N/A,122,6
2,N/A,N/A,N/A,1145,1147,N/A,125,3
16,N/A,N/A,N/A,1129,1145,N/A,128,6
1,N/A,N/A,N/A,310,311,N/A,5,1
2,N/A,N/A,N/A,308,310,N/A,11,1
11,N/A,N/A,N/A,297,308,N/A,16,6
12,N/A,N/A,N/A,285,297,N/A,21,5
2,N/A,N/A,N/A,283,285,N/A,24,2
2,N/A,N/A,N/A,281,283,N/A,29,1
2,N/A,N/A,N/A,279,281,N/A,35,1
15,N/A,N/A,N/A,264,279,N/A,39,5
12,N/A,N/A,N/A,252,264,N/A,44,4
3,N/A,N/A,N/A,249,252,N/A,49,3
3,N/A,N/A,N/A,246,249,N/A,54,2
1,N/A,N/A,N/A,245,246,N/A,59,1
10,N/A,N/A,N/A,235,245,N/A,63,5
11,N/A,N/A,N/A,224,235,N/A,69,5
10,N/A,N/A,N/A,214,224,N/A,74,4
2,N/A,N/A,N/A,212,214,N/A,77,1
16,N/A,N/A,N/A,196,212,N/A,82,6
3,N/A,N/A,N/A,193,196,N/A,85,3
3,N/A,N/A,N/A,190,193,N/A,91,3
17,N/A,N/A,N/A,173,190,N/A,94,6
8,N/A,N/A,N/A,165,173,N/A,98,4
4,N/A,N/A,N/A,161,165,N/A,102,2
2,N/A,N/A,N/A,159,161,N/A,108,2
11,N/A,N/A,N/A,148,159,N/A,111,5
16,N/A,N/A,N/A,132,148,N/A,117,5
2,N/A,N/A,N/A,130,132,N/A,121,3
3,N/A,N/A,N/A,127,130,N/A,127,3
4,N/A,N/A,N/A,123,127,N/A,132,2
1,N/A,N/A,N/A,122,123,N/A,137,1
16,N/A,N/A,N/A,106,122,N/A,141,5
3,N/A,N/A,N/A,1275,1278,N/A,3,2
11,N/A,N/A,N/A,1264,1275,N/A,6,5
12,N/A,N/A,N/A,1252,1264,N/A,12,5
3,N/A,N/A,N/A,1249,1252,N/A,16,3
2,N/A,N/A,N/A,1247,1249,N/A,22,3
14,N/A,N/A,N/A,1233,1247,N/A,25,6
1,N/A,N/A,N/A,1232,1233,N/A,31,0
6,N/A,N/A,N/A,1226,1232,N/A,35,4
1,N/A,N/A,N/A,1225,1226,N/A,38,1
10,N/A,N/A,N/A,1215,1225,N/A,41,4
4,N/A,N/A,N/A,1211,1215,N/A,45,2
17,N/A,N/A,N/A,1194,1211,N/A,49,6
10,N/A,N/A,N/A,1184,1194,N/A,53,4
13,N/A,N/A,N/A,1171,1184,N/A,59,4
1,N/A,N/A,N/A,1170,1171,N/A,62,1
12,N/A,N/A,N/A,1158,1170,N/A,66,5
13,N/A,N/A,N/A,1145,1158,N/A,71,4
3,N/A,N/A,N/A,1142,1145,N/A,75,2
4,N/A,N/A,N/A,1138,1142,N/A,81,2
4,N/A,N/A,N/A,1134,1138,N/A,87,2
4,N/A,N/A,N/A,1130,1134,N/A,93,2
4,N/A,N/A,N/A,1126,1130,N/A,99,2
15,N/A,N/A,N/A,1111,1126,N/A,102,5
8,N/A,N/A,N/A,1103,1111,N/A,107,4
13,N/A,N/A,N/A,1090,1103,N/A,113,4
11,N/A,N/A,N/A,1079,1090,N/A,119,4
2,N/A,N/A,N/A,1077,1079,N/A,122,1
18,N/A,N/A,N/A,1059,1077,N/A,126,5
5,N/A,N/A,N/A,1054,1059,N/A,131,4
1,N/A,N/A,N/A,1053,1054,N/A,134,1
3,N/A,N/A,N/A,836,839,N/A,3,2
3,N/A,N/A,N/A,833,836,N/A,9,2
1,N/A,N/A,N/A,832,833,N/A,14,1
10,N/A,N/A,N/A,822,832,N/A,17,4
2,N/A,N/A,N/A,820,822,N/A,20,1
1,N/A,N/A,N/A,819,820,N/A,26,1
16,N/A,N/A,N/A,803,819,N/A,31,6
4,N/A,N/A,N/A,799,803,N/A,34,3
1,N/A,N/A,N/A,798,799,N/A,38,1
12,N/A,N/A,N/A,786,798,N/A,42,5
2,N/A,N/A,N/A,784,786,N/A,45,2
15,N/A,N/A,N/A,769,784,N/A,49,6
8,N/A,N/A,N/A,761,769,N/A,53,4
2,N/A,N/A,N/A,759,761,N/A,57,2
4,N/A,N/A,N/A,755,759,N/A,63,2
14,N/A,N/A,N/A,741,755,N/A,66,5
18,N/A,N/A,N/A,723,741,N/A,72,5
4,N/A,N/A,N/A,719,723,N/A,76,3
4,N/A,N/A,N/A,715,719,N/A,81,2
16,N/A,N/A,N/A,699,715,N/A,85,6
1,N/A,N/A,N/A,698,699,N/A,91,0
12,N/A,N/A,N/A,686,698,N/A,97,6
11,N/A,N/A,N/A,675,686,N/A,102,5
4,N/A,N/A,N/A,671,675,N/A,106,3
2,N/A,N/A,N/A,669,671,N/A,112,3
4,N/A,N/A,N/A,665,669,N/A,117,2
2,N/A,N/A,N/A,663,665,N/A,123,2
14,N/A,N/A,N/A,649,663,N/A,127,6
1,N/A,N/A,N/A,648,649,N/A,133,0
4,N/A,N/A,N/A,644,648,N/A,136,3
2,N/A,N/A,N/A,1173,1175,N/A,6,3
1,N/A,N/A,N/A,1172,1173,N/A,10,1
15,N/A,N/A,N/A,1157,1172,N/A,14,5
2,N/A,N/A,N/A,1155,1157,N/A,17,2
11,N/A,N/A,N/A,1144,1155,N/A,21,6
19,N/A,N/A,N/A,1125,1144,N/A,26,5
6,N/A,N/A,N/A,1119,1125,N/A,31,4
3,N/A,N/A,N/A,1116,1119,N/A,36,3
11,N/A,N/A,N/A,1105,1116,N/A,39,6
2,N/A,N/A,N/A,1103,1105,N/A,42,3
3,N/A,N/A,N/A,1100,1103,N/A,47,2
11,N/A,N/A,N/A,1089,1100,N/A,50,5
4,N/A,N/A,N/A,1085,1089,N/A,53,2
3,N/A,N/A,N/A,1082,1085,N/A,59,2
2,N/A,N/A,N/A,1080,1082,N/A,65,2
15,N/A,N/A,N/A,1065,1080,N/A,69,6
4,N/A,N/A,N/A,1061,1065,N/A,72,3
2,N/A,N/A,N/A,1059,1061,N/A,76,1
9,N/A,N/A,N/A,1050,1059,N/A,79,4
2,N/A,N/A,N/A,1048,1050,N/A,83,2
11,N/A,N/A,N/A,1037,1048,N/A,86,5
4,N/A,N/A,N/A,1033,1037,N/A,90,3
11,N/A,N/A,N/A,1022,1033,N/A,93,6
4,N/A,N/A,N/A,1018,1022,N/A,96,3
4,N/A,N/A,N/A,1014,1018,N/A,101,2
20,N/A,N/A,N/A,994,1014,N/A,105,6
12,N/A,N/A,N/A,982,994,N/A,109,4
3,N/A,N/A,N/A,979,982,N/A,114,3
15,N/A,N/A,N/A,964,979,N/A,117,6
3,N/A,N/A,N/A,961,964,N/A,120,3
19,N/A,N/A,N/A,381,400,N/A,6,6
2,N/A,N/A,N/A,379,381,N/A,9,3
2,N/A,N/A,N/A,377,379,N/A,14,2
11,N/A,N/A,N/A,366,377,N/A,18,6
1,N/A,N/A,N/A,365,366,N/A,24,0
13,N/A,N/A,N/A,352,365,N/A,28,4
3,N/A,N/A,N/A,349,352,N/A,32,2
18,N/A,N/A,N/A,331,349,N/A,36,6
3,N/A,N/A,N/A,328,331,N/A,39,3
3,N/A,N/A,N/A,325,328,N/A,44,2
3,N/A,N/A,N/A,322,325,N/A,50,2
2,N/A,N/A,N/A,320,322,N/A,56,2
19,N/A,N/A,N/A,301,320,N/A,60,6
2,N/A,N/A,N/A,299,301,N/A,63,3
4,N/A,N/A,N/A,295,299,N/A,68,2
2,N/A,N/A,N/A,293,295,N/A,73,1
14,N/A,N/A,N/A,279,293,N/A,77,5
19,N/A,N/A,N/A,260,279,N/A,83,5
11,N/A,N/A,N/A,249,260,N/A,88,4
2,N/A,N/A,N/A,247,249,N/A,91,1
1,N/A,N/A,N/A,246,247,N/A,97,1
8,N/A,N/A,N/A,238,246,N/A,100,4
4,N/A,N/A,N/A,234,238,N/A,104,2
13,N/A,N/A,N/A,221,234,N/A,107,5
12,N/A,N/A,N/A,209,221,N/A,113,5
3,N/A,N/A,N/A,206,209,N/A,116,2
10,N/A,N/A,N/A,196,206,N/A,119,5
9,N/A,N/A,N/A,187,196,N/A,124,4
1,N/A,N/A,N/A,186,187,N/A,127,1
13,N/A,N/A,N/A,173,186,N/A,132,6
10,N/A,N/A,N/A,987,997,N/A,4,5
7,N/A,N/A,N/A,980,987,N/A,9,4
3,N/A,N/A,N/A,977,980,N/A,14,3
3,N/A,N/A,N/A,974,977,N/A,20,3
3,N/A,N/A,N/A,971,974,N/A,26,3
2,N/A,N/A,N/A,969,971,N/A,30,1
2,N/A,N/A,N/A,967,969,N/A,36,1
18,N/A,N/A,N/A,949,967,N/A,40,5
2,N/A,N/A,N/A,947,949,N/A,43,2
2,N/A,N/A,N/A,945,947,N/A,49,2
17,N/A,N/A,N/A,928,945,N/A,52,5
19,N/A,N/A,N/A,909,928,N/A,58,5
4,N/A,N/A,N/A,905,909,N/A,61,2
4,N/A,N/A,N/A,901,905,N/A,67,2
1,N/A,N/A,N/A,900,901,N/A,72,1
13,N/A,N/A,N/A,887,900,N/A,76,5
10,N/A,N/A,N/A,877,887,N/A,82,5
3,N/A,N/A,N/A,874,877,N/A,85,2
2,N/A,N/A,N/A,872,874,N/A,90,1
1,N/A,N/A,N/A,871,872,N/A,96,1
15,N/A,N/A,N/A,856,871,N/A,101,6
16,N/A,N/A,N/A,840,856,N/A,106,5
3,N/A,N/A,N/A,837,840,N/A,109,2
19,N/A,N/A,N/A,818,837,N/A,113,6
3,N/A,N/A,N/A,815,818,N/A,116,3
11,N/A,N/A,N/A,804,815,N/A,119,6
10,N/A,N/A,N/A,794,804,N/A,124,5
12,N/A,N/A,N/A,782,794,N/A,129,4
3,N/A,N/A,N/A,779,782,N/A,133,2
1,N/A,N/A,N/A,778,779,N/A,138,1
16,N/A,N/A,N/A,1795,1811,N/A,5,5
2,N/A,N/A,N/A,1793,1795,N/A,9,3
4,N/A,N/A,N/A,1789,1793,N/A,15,3
17,N/A,N/A,N/A,1772,1789,N/A,18,6
4,N/A,N/A,N/A,1768,1772,N/A,21,3
3,N/A,N/A,N/A,1765,1768,N/A,27,3
1,N/A,N/A,N/A,1764,1765,N/A,31,1
2,N/A,N/A,N/A,1762,1764,N/A,37,1
8,N/A,N/A,N/A,1754,1762,N/A,40,4
4,N/A,N/A,N/A,1750,1754,N/A,45,3
2,N/A,N/A,N/A,1748,1750,N/A,49,1
17,N/A,N/A,N/A,1731,1748,N/A,53,5
15,N/A,N/A,N/A,1716,1731,N/A,59,5
11,N/A,N/A,N/A,1705,1716,N/A,64,4
4,N/A,N/A,N/A,1701,1705,N/A,69,3
1,N/A,N/A,N/A,1700,1701,N/A,73,1
10,N/A,N/A,N/A,1690,1700,N/A,76,4
2,N/A,N/A,N/A,1688,1690,N/A,79,1
1,N/A,N/A,N/A,1687,1688,N/A,85,1
18,N/A,N/A,N/A,1669,1687,N/A,90,6
12,N/A,N/A,N/A,1657,1669,N/A,94,4
4,N/A,N/A,N/A,1653,1657,N/A,99,3
1,N/A,N/A,N/A,1652,1653,N/A,103,1
1,N/A,N/A,N/A,1651,1652,N/A,109,1
16,N/A,N/A,N/A,1635,1651,N/A,113,5
2,N/A,N/A,N/A,1633,1635,N/A,117,3
13,N/A,N/A,N/A,1620,1633,N/A,120,6
1,N/A,N/A,N/A,1619,1620,N/A,126,0
11,N/A,N/A,N/A,1608,1619,N/A,132,6
10,N/A,N/A,N/A,1598,1608,N/A,137,5
2,N/A,N/A,N/A,404,406,N/A,5,3
12,N/A,N/A,N/A,392,404,N/A,8,6
12,N/A,N/A,N/A,380,392,N/A,13,5
5,N/A,N/A,N/A,375,380,N/A,18,4
2,N/A,N/A,N/A,373,375,N/A,23,3
3,N/A,N/A,N/A,370,373,N/A,29,3
15,N/A,N/A,N/A,355,370,N/A,32,6
2,N/A,N/A,N/A,353,355,N/A,38,0
7,N/A,N/A,N/A,346,353,N/A,42,4
6,N/A,N/A,N/A,340,346,N/A,48,4
4,N/A,N/A,N/A,336,340,N/A,52,2
14,N/A,N/A,N/A,322,336,N/A,55,5
2,N/A,N/A,N/A,320,322,N/A,58,2
16,N/A,N/A,N/A,304,320,N/A,62,6
14,N/A,N/A,N/A,290,304,N/A,66,4
7,N/A,N/A,N/A,283,290,N/A,72,4
4,N/A,N/A,N/A,279,283,N/A,76,2
2,N/A,N/A,N/A,277,279,N/A,81,1
1,N/A,N/A,N/A,276,277,N/A,87,1
14,N/A,N/A,N/A,262,276,N/A,92,6
4,N/A,N/A,N/A,258,262,N/A,95,3
2,N/A,N/A,N/A,256,258,N/A,99,1
13,N/A,N/A,N/A,243,256,N/A,103,5
2,N/A,N/A,N/A,241,243,N/A,107,3
2,N/A,N/A,N/A,239,241,N/A,113,3
2,N/A,N/A,N/A,237,239,N/A,118,2
20,N/A,N/A,N/A,217,237,N/A,122,6
1,N/A,N/A,N/A,216,217,N/A,128,0
18,N/A,N/A,N/A,198,216,N/A,134,6
4,N/A,N/A,N/A,194,198,N/A,137,3
3,N/A,N/A,N/A,1345,1348,N/A,3,3
1,N/A,N/A,N/A,1344,1345,N/A,7,1
9,N/A,N/A,N/A,1335,1344,N/A,10,4
2,N/A,N/A,N/A,1333,1335,N/A,13,1
14,N/A,N/A,N/A,1319,1333,N/A,18,6
13,N/A,N/A,N/A,1306,1319,N/A,22,4
9,N/A,N/A,N/A,1297,1306,N/A,28,4
2,N/A,N/A,N/A,1295,1297,N/A,33,3
2,N/A,N/A,N/A,1293,1295,N/A,37,1
16,N/A,N/A,N/A,1277,1293,N/A,42,6
10,N/A,N/A,N/A,1267,1277,N/A,47,5
13,N/A,N/A,N/A,1254,1267,N/A,52,4
6,N/A,N/A,N/A,1248,1254,N/A,58,4
1,N/A,N/A,N/A,1247,1248,N/A,61,1
1,N/A,N/A,N/A,1246,1247,N/A,67,1
1,N/A,N/A,N/A,1245,1246,N/A,73,1
14,N/A,N/A,N/A,1231,1245,N/A,77,5
3,N/A,N/A,N/A,1228,1231,N/A,80,2
13,N/A,N/A,N/A,1215,1228,N/A,83,5
9,N/A,N/A,N/A,1206,1215,N/A,88,4
3,N/A,N/A,N/A,1203,1206,N/A,93,3
2,N/A,N/A,N/A,1201,1203,N/A,98,2
2,N/A,N/A,N/A,1199,1201,N/A,104,2
2,N/A,N/A,N/A,1197,1199,N/A,109,1
11,N/A,N/A,N/A,1186,1197,N/A,114,6
10,N/A,N/A,N/A,1176,1186,N/A,118,4
1,N/A,N/A,N/A,1175,1176,N/A,121,1
15,N/A,N/A,N/A,1160,1175,N/A,126,6
7,N/A,N/A,N/A,1153,1160,N/A,130,4
1,N/A,N/A,N/A,1152,1153,N/A,133,1
12,N/A,N/A,N/A,1402,1414,N/A,6,4
4,N/A,N/A,N/A,1398,1402,N/A,10,2
3,N/A,N/A,N/A,1395,1398,N/A,16,2
2,N/A,N/A,N/A,1393,1395,N/A,21,1
14,N/A,N/A,N/A,1379,1393,N/A,25,5
2,N/A,N/A,N/A,1377,1379,N/A,29,3
3,N/A,N/A,N/A,1374,1377,N/A,35,3
2,N/A,N/A,N/A,1372,1374,N/A,40,2
3,N/A,N/A,N/A,1369,1372,N/A,46,2
14,N/A,N/A,N/A,1355,1369,N/A,50,6
18,N/A,N/A,N/A,1337,1355,N/A,55,5
4,N/A,N/A,N/A,1333,1337,N/A,58,2
3,N/A,N/A,N/A,1330,1333,N/A,64,2
12,N/A,N/A,N/A,1318,1330,N/A,68,6
14,N/A,N/A,N/A,1304,1318,N/A,72,4
1,N/A,N/A,N/A,1303,1304,N/A,75,1
17,N/A,N/A,N/A,1286,1303,N/A,79,5
5,N/A,N/A,N/A,1281,1286,N/A,84,4
14,N/A,N/A,N/A,1267,1281,N/A,90,4
4,N/A,N/A,N/A,1263,1267,N/A,95,3
4,N/A,N/A,N/A,1259,1263,N/A,101,3
18,N/A,N/A,N/A,1241,1259,N/A,104,6
9,N/A,N/A,N/A,1232,1241,N/A,108,4
3,N/A,N/A,N/A,1229,1232,N/A,113,3
1,N/A,N/A,N/A,1228,1229,N/A,117,1
13,N/A,N/A,N/A,1215,1228,N/A,121,5
3,N/A,N/A,N/A,1212,1215,N/A,125,3
1,N/A,N/A,N/A,1211,1212,N/A,129,1
7,N/A,N/A,N/A,1204,1211,N/A,132,4
2,N/A,N/A,N/A,1202,1204,N/A,136,2
1,N/A,N/A,N/A,1092,1093,N/A,6,1
16,N/A,N/A,N/A,1076,1092,N/A,10,5
4,N/A,N/A,N/A,1072,1076,N/A,14,3
4,N/A,N/A,N/A,1068,1072,N/A,20,3
2,N/A,N/A,N/A,1066,1068,N/A,24,1
1,N/A,N/A,N/A,1065,1066,N/A,30,1
8,N/A,N/A,N/A,1057,1065,N/A,33,4
11,N/A,N/A,N/A,1046,1057,N/A,39,4
5,N/A,N/A,N/A,1041,1046,N/A,45,4
11,N/A,N/A,N/A,1030,1041,N/A,51,4
3,N/A,N/A,N/A,1027,1030,N/A,56,3
2,N/A,N/A,N/A,1025,1027,N/A,60,1
14,N/A,N/A,N/A,1011,1025,N/A,63,4
2,N/A,N/A,N/A,1009,1011,N/A,66,1
16,N/A,N/A,N/A,993,1009,N/A,70,5
9,N/A,N/A,N/A,984,993,N/A,75,4
3,N/A,N/A,N/A,981,984,N/A,80,3
12,N/A,N/A,N/A,969,981,N/A,83,6
8,N/A,N/A,N/A,961,969,N/A,87,4
9,N/A,N/A,N/A,952,961,N/A,93,4
2,N/A,N/A,N/A,950,952,N/A,96,1
2,N/A,N/A,N/A,948,950,N/A,102,1
10,N/A,N/A,N/A,938,948,N/A,105,4
4,N/A,N/A,N/A,934,938,N/A,110,3
2,N/A,N/A,N/A,932,934,N/A,114,1
1,N/A,N/A,N/A,931,932,N/A,120,1
19,N/A,N/A,N/A,912,931,N/A,125,6
16,N/A,N/A,N/A,896,912,N/A,130,5
4,N/A,N/A,N/A,892,896,N/A,134,3
3,N/A,N/A,N/A,889,892,N/A,140,3
18,N/A,N/A,N/A,1196,1214,N/A,4,6
1,N/A,N/A,N/A,1195,1196,N/A,10,0
3,N/A,N/A,N/A,1192,1195,N/A,13,3
2,N/A,N/A,N/A,1190,1192,N/A,18,2
1,N/A,N/A,N/A,1189,1190,N/A,23,1
8,N/A,N/A,N/A,1181,1189,N/A,26,4
4,N/A,N/A,N/A,1177,1181,N/A,30,2
12,N/A,N/A,N/A,1165,1177,N/A,33,5
9,N/A,N/A,N/A,1156,1165,N/A,38,4
13,N/A,N/A,N/A,1143,1156,N/A,44,4
1,N/A,N/A,N/A,1142,1143,N/A,47,1
19,N/A,N/A,N/A,1123,1142,N/A,51,5
4,N/A,N/A,N/A,1119,1123,N/A,54,2
20,N/A,N/A,N/A,1099,1119,N/A,58,6
17,N/A,N/A,N/A,1082,1099,N/A,63,5
8,N/A,N/A,N/A,1074,1082,N/A,68,4
7,N/A,N/A,N/A,1067,1074,N/A,74,4
3,N/A,N/A,N/A,1064,1067,N/A,79,3
2,N/A,N/A,N/A,1062,1064,N/A,83,1
2,N/A,N/A,N/A,1060,1062,N/A,89,1
1,N/A,N/A,N/A,1059,1060,N/A,95,1
11,N/A,N/A,N/A,1048,1059,N/A,100,6
3,N/A,N/A,N/A,1045,1048,N/A,103,3
4,N/A,N/A,N/A,1041,1045,N/A,108,2
2,N/A,N/A,N/A,1039,1041,N/A,114,2
3,N/A,N/A,N/A,1036,1039,N/A,120,2
1,N/A,N/A,N/A,1035,1036,N/A,125,1
5,N/A,N/A,N/A,1030,1035,N/A,128,4
2,N/A,N/A,N/A,1028,1030,N/A,133,3
4,N/A,N/A,N/A,1024,1028,N/A,138,2
3,N/A,N/A,N/A,1265,1268,N/A,6,2
10,N/A,N/A,N/A,1255,1265,N/A,9,5
18,N/A,N/A,N/A,1237,1255,N/A,15,5
6,N/A,N/A,N/A,1231,1237,N/A,20,4
8,N/A,N/A,N/A,1223,1231,N/A,26,4
2,N/A,N/A,N/A,1221,1223,N/A,30,2
1,N/A,N/A,N/A,1220,1221,N/A,35,1
16,N/A,N/A,N/A,1204,1220,N/A,39,5
2,N/A,N/A,N/A,1202,1204,N/A,42,2
3,N/A,N/A,N/A,1199,1202,N/A,48,2
2,N/A,N/A,N/A,1197,1199,N/A,54,2
3,N/A,N/A,N/A,1194,1197,N/A,60,2
2,N/A,N/A,N/A,1192,1194,N/A,66,2
2,N/A,N/A,N/A,1190,1192,N/A,71,1
2,N/A,N/A,N/A,1188,1190,N/A,77,1
9,N/A,N/A,N/A,1179,1188,N/A,80,4
2,N/A,N/A,N/A,1177,1179,N/A,83,1
11,N/A,N/A,N/A,1166,1177,N/A,87,5
2,N/A,N/A,N/A,1164,1166,N/A,90,2
15,N/A,N/A,N/A,1149,1164,N/A,93,5
19,N/A,N/A,N/A,1130,1149,N/A,99,5
5,N/A,N/A,N/A,1125,1130,N/A,104,4
1,N/A,N/A,N/A,1124,1125,N/A,107,1
12,N/A,N/A,N/A,1112,1124,N/A,110,4
4,N/A,N/A,N/A,1108,1112,N/A,115,3
1,N/A,N/A,N/A,1107,1108,N/A,119,1
14,N/A,N/A,N/A,1093,1107,N/A,122,4
13,N/A,N/A,N/A,1080,1093,N/A,128,4
3,N/A,N/A,N/A,1077,1080,N/A,132,2
3,N/A,N/A,N/A,1074,1077,N/A,138,2
1,N/A,N/A,N/A,1924,1925,N/A,4,1
17,N/A,N/A,N/A,1907,1924,N/A,9,6
2,N/A,N/A,N/A,1905,1907,N/A,15,0
3,N/A,N/A,N/A,1902,1905,N/A,18,3
2,N/A,N/A,N/A,1900,1902,N/A,22,1
7,N/A,N/A,N/A,1893,1900,N/A,25,4
4,N/A,N/A,N/A,1889,1893,N/A,29,2
1,N/A,N/A,N/A,1888,1889,N/A,34,1
11,N/A,N/A,N/A,1877,1888,N/A,38,5
3,N/A,N/A,N/A,1874,1877,N/A,41,2
19,N/A,N/A,N/A,1855,1874,N/A,44,5
4,N/A,N/A,N/A,1851,1855,N/A,48,3
14,N/A,N/A,N/A,1837,1851,N/A,51,6
13,N/A,N/A,N/A,1824,1837,N/A,55,4
6,N/A,N/A,N/A,1818,1824,N/A,61,4
8,N/A,N/A,N/A,1810,1818,N/A,67,4
4,N/A,N/A,N/A,1806,1810,N/A,72,3
3,N/A,N/A,N/A,1803,1806,N/A,77,2
11,N/A,N/A,N/A,1792,1803,N/A,80,5
3,N/A,N/A,N/A,1789,1792,N/A,83,2
14,N/A,N/A,N/A,1775,1789,N/A,87,6
3,N/A,N/A,N/A,1772,1775,N/A,90,3
2,N/A,N/A,N/A,1770,1772,N/A,94,1
2,N/A,N/A,N/A,1768,1770,N/A,100,1
9,N/A,N/A,N/A,1759,1768,N/A,103,4
1,N/A,N/A,N/A,1758,1759,N/A,106,1
13,N/A,N/A,N/A,1745,1758,N/A,111,6
4,N/A,N/A,N/A,1741,1745,N/A,114,3
2,N/A,N/A,N/A,1739,1741,N/A,120,3
1,N/A,N/A,N/A,1738,1739,N/A,124,1
1,N/A,N/A,N/A,420,421,N/A,6,1
12,N/A,N/A,N/A,408,420,N/A,11,6
18,N/A,N/A,N/A,390,408,N/A,16,5
5,N/A,N/A,N/A,385,390,N/A,21,4
4,N/A,N/A,N/A,381,385,N/A,26,3
2,N/A,N/A,N/A,379,381,N/A,32,3
19,N/A,N/A,N/A,360,379,N/A,35,6
17,N/A,N/A,N/A,343,360,N/A,40,5
4,N/A,N/A,N/A,339,343,N/A,44,3
2,N/A,N/A,N/A,337,339,N/A,49,2
17,N/A,N/A,N/A,320,337,N/A,53,6
4,N/A,N/A,N/A,316,320,N/A,56,3
13,N/A,N/A,N/A,303,316,N/A,59,6
8,N/A,N/A,N/A,295,303,N/A,63,4
8,N/A,N/A,N/A,287,295,N/A,69,4
4,N/A,N/A,N/A,283,287,N/A,74,3
1,N/A,N/A,N/A,282,283,N/A,78,1
7,N/A,N/A,N/A,275,282,N/A,81,4
3,N/A,N/A,N/A,272,275,N/A,86,3
2,N/A,N/A,N/A,270,272,N/A,90,1
14,N/A,N/A,N/A,256,270,N/A,93,4
3,N/A,N/A,N/A,253,256,N/A,98,3
2,N/A,N/A,N/A,251,253,N/A,103,2
12,N/A,N/A,N/A,239,251,N/A,106,5
2,N/A,N/A,N/A,237,239,N/A,110,3
2,N/A,N/A,N/A,235,237,N/A,116,3
3,N/A,N/A,N/A,232,235,N/A,122,3
2,N/A,N/A,N/A,230,232,N/A,128,3
2,N/A,N/A,N/A,228,230,N/A,133,2
2,N/A,N/A,N/A,226,228,N/A,139,2
4,N/A,N/A,N/A,1967,1971,N/A,5,3
20,N/A,N/A,N/A,1947,1967,N/A,8,6
2,N/A,N/A,N/A,1945,1947,N/A,14,0
6,N/A,N/A,N/A,1939,1945,N/A,18,4
4,N/A,N/A,N/A,1935,1939,N/A,23,3
1,N/A,N/A,N/A,1934,1935,N/A,27,1
1,N/A,N/A,N/A,1933,1934,N/A,33,1
2,N/A,N/A,N/A,1931,1933,N/A,39,1
5,N/A,N/A,N/A,1926,1931,N/A,42,4
2,N/A,N/A,N/A,1924,1926,N/A,45,1
15,N/A,N/A,N/A,1909,1924,N/A,49,5
3,N/A,N/A,N/A,1906,1909,N/A,52,2
19,N/A,N/A,N/A,1887,1906,N/A,55,5
11,N/A,N/A,N/A,1876,1887,N/A,61,5
3,N/A,N/A,N/A,1873,1876,N/A,65,3
2,N/A,N/A,N/A,1871,1873,N/A,69,1
5,N/A,N/A,N/A,1866,1871,N/A,72,4
1,N/A,N/A,N/A,1865,1866,N/A,75,1
12,N/A,N/A,N/A,1853,1865,N/A,79,5
3,N/A,N/A,N/A,1850,1853,N/A,83,3
3,N/A,N/A,N/A,1847,1850,N/A,88,2
15,N/A,N/A,N/A,1832,1847,N/A,91,5
16,N/A,N/A,N/A,1816,1832,N/A,97,5
15,N/A,N/A,N/A,1801,1816,N/A,103,5
4,N/A,N/A,N/A,1797,1801,N/A,107,3
13,N/A,N/A,N/A,1784,1797,N/A,110,6
2,N/A,N/A,N/A,1782,1784,N/A,113,3
1,N/A,N/A,N/A,1781,1782,N/A,117,1
6,N/A,N/A,N/A,1775,1781,N/A,120,4
4,N/A,N/A,N/A,1771,1775,N/A,124,2
11,N/A,N/A,N/A,1349,1360,N/A,4,4
3,N/A,N/A,N/A,1346,1349,N/A,8,2
2,N/A,N/A,N/A,1344,1346,N/A,13,1
12,N/A,N/A,N/A,1332,1344,N/A,18,6
1,N/A,N/A,N/A,1331,1332,N/A,24,0
13,N/A,N/A,N/A,1318,1331,N/A,29,5
2,N/A,N/A,N/A,1316,1318,N/A,33,3
3,N/A,N/A,N/A,1313,1316,N/A,39,3
2,N/A,N/A,N/A,1311,1313,N/A,45,3
3,N/A,N/A,N/A,1308,1311,N/A,51,3
4,N/A,N/A,N/A,1304,1308,N/A,57,3
2,N/A,N/A,N/A,1302,1304,N/A,62,2
2,N/A,N/A,N/A,1300,1302,N/A,68,2
1,N/A,N/A,N/A,1299,1300,N/A,73,1
2,N/A,N/A,N/A,1297,1299,N/A,79,1
19,N/A,N/A,N/A,1278,1297,N/A,83,5
3,N/A,N/A,N/A,1275,1278,N/A,86,2
2,N/A,N/A,N/A,1273,1275,N/A,91,1
18,N/A,N/A,N/A,1255,1273,N/A,95,5
10,N/A,N/A,N/A,1245,1255,N/A,100,4
4,N/A,N/A,N/A,1241,1245,N/A,105,3
17,N/A,N/A,N/A,1224,1241,N/A,108,6
12,N/A,N/A,N/A,1212,1224,N/A,113,5
12,N/A,N/A,N/A,1200,1212,N/A,119,5
5,N/A,N/A,N/A,1195,1200,N/A,124,4
11,N/A,N/A,N/A,1184,1195,N/A,130,4
4,N/A,N/A,N/A,1180,1184,N/A,134,2
13,N/A,N/A,N/A,1167,1180,N/A,138,6
1,N/A,N/A,N/A,1166,1167,N/A,144,0
12,N/A,N/A,N/A,1154,1166,N/A,150,6
10,N/A,N/A,N/A,1451,1461,N/A,6,4
3,N/A,N/A,N/A,1448,1451,N/A,10,2
17,N/A,N/A,N/A,1431,1448,N/A,13,5
4,N/A,N/A,N/A,1427,1431,N/A,17,3
2,N/A,N/A,N/A,1425,1427,N/A,21,1
11,N/A,N/A,N/A,1414,1425,N/A,25,5
7,N/A,N/A,N/A,1407,1414,N/A,30,4
5,N/A,N/A,N/A,1402,1407,N/A,36,4
3,N/A,N/A,N/A,1399,1402,N/A,40,2
1,N/A,N/A,N/A,1398,1399,N/A,45,1
16,N/A,N/A,N/A,1382,1398,N/A,49,5
3,N/A,N/A,N/A,1379,1382,N/A,52,2
18,N/A,N/A,N/A,1361,1379,N/A,55,5
2,N/A,N/A,N/A,1359,1361,N/A,58,2
14,N/A,N/A,N/A,1345,1359,N/A,62,6
13,N/A,N/A,N/A,1332,1345,N/A,66,4
2,N/A,N/A,N/A,1330,1332,N/A,69,1
1,N/A,N/A,N/A,1329,1330,N/A,75,1
1,N/A,N/A,N/A,1328,1329,N/A,81,1
1,N/A,N/A,N/A,1327,1328,N/A,87,1
2,N/A,N/A,N/A,1325,1327,N/A,93,1
13,N/A,N/A,N/A,1312,1325,N/A,98,6
15,N/A,N/A,N/A,1297,1312,N/A,103,5
4,N/A,N/A,N/A,1293,1297,N/A,106,2
15,N/A,N/A,N/A,1278,1293,N/A,110,6
13,N/A,N/A,N/A,1265,1278,N/A,114,4
8,N/A,N/A,N/A,1257,1265,N/A,120,4
2,N/A,N/A,N/A,1255,1257,N/A,125,3
3,N/A,N/A,N/A,1252,1255,N/A,130,2
2,N/A,N/A,N/A,1250,1252,N/A,135,1
9,N/A,N/A,N/A,1028,1037,N/A,6,4
1,N/A,N/A,N/A,1027,1028,N/A,9,1
1,N/A,N/A,N/A,1026,1027,N/A,15,1
1,N/A,N/A,N/A,1025,1026,N/A,21,1
2,N/A,N/A,N/A,1023,1025,N/A,27,1
8,N/A,N/A,N/A,1015,1023,N/A,30,4
2,N/A,N/A,N/A,1013,1015,N/A,35,3
2,N/A,N/A,N/A,1011,1013,N/A,41,3
11,N/A,N/A,N/A,1000,1011,N/A,44,6
1,N/A,N/A,N/A,999,1000,N/A,50,0
3,N/A,N/A,N/A,996,999,N/A,53,3
2,N/A,N/A,N/A,994,996,N/A,58,2
11,N/A,N/A,N/A,983,994,N/A,62,6
2,N/A,N/A,N/A,981,983,N/A,65,3
3,N/A,N/A,N/A,978,981,N/A,70,2
18,N/A,N/A,N/A,960,978,N/A,73,5
2,N/A,N/A,N/A,958,960,N/A,77,3
15,N/A,N/A,N/A,943,958,N/A,80,6
11,N/A,N/A,N/A,932,943,N/A,85,5
3,N/A,N/A,N/A,929,932,N/A,89,3
4,N/A,N/A,N/A,925,929,N/A,95,3
4,N/A,N/A,N/A,921,925,N/A,100,2
15,N/A,N/A,N/A,906,921,N/A,104,6
2,N/A,N/A,N/A,904,906,N/A,107,3
18,N/A,N/A,N/A,886,904,N/A,110,6
2,N/A,N/A,N/A,884,886,N/A,116,0
17,N/A,N/A,N/A,867,884,N/A,122,6
4,N/A,N/A,N/A,863,867,N/A,125,3
2,N/A,N/A,N/A,861,863,N/A,130,2
3,N/A,N/A,N/A,858,861,N/A,136,2
12,N/A,N/A,N/A,1834,1846,N/A,6,6
2,N/A,N/A,N/A,1832,1834,N/A,9,3
4,N/A,N/A,N/A,1828,1832,N/A,15,3
4,N/A,N/A,N/A,1824,1828,N/A,21,3
14,N/A,N/A,N/A,1810,1824,N/A,24,6
3,N/A,N/A,N/A,1807,1810,N/A,27,3
2,N/A,N/A,N/A,1805,1807,N/A,32,2
16,N/A,N/A,N/A,1789,1805,N/A,36,6
12,N/A,N/A,N/A,1777,1789,N/A,40,4
1,N/A,N/A,N/A,1776,1777,N/A,43,1
20,N/A,N/A,N/A,1756,1776,N/A,48,6
8,N/A,N/A,N/A,1748,1756,N/A,52,4
2,N/A,N/A,N/A,1746,1748,N/A,56,2
19,N/A,N/A,N/A,1727,1746,N/A,60,6
2,N/A,N/A,N/A,1725,1727,N/A,66,0
6,N/A,N/A,N/A,1719,1725,N/A,70,4
8,N/A,N/A,N/A,1711,1719,N/A,76,4
13,N/A,N/A,N/A,1698,1711,N/A,82,4
2,N/A,N/A,N/A,1696,1698,N/A,85,1
16,N/A,N/A,N/A,1680,1696,N/A,90,6
14,N/A,N/A,N/A,1666,1680,N/A,95,5
4,N/A,N/A,N/A,1662,1666,N/A,99,3
2,N/A,N/A,N/A,1660,1662,N/A,105,3
3,N/A,N/A,N/A,1657,1660,N/A,110,2
2,N/A,N/A,N/A,1655,1657,N/A,115,1
1,N/A,N/A,N/A,1654,1655,N/A,121,1
2,N/A,N/A,N/A,1652,1654,N/A,127,1
11,N/A,N/A,N/A,1641,1652,N/A,132,6
1,N/A,N/A,N/A,1640,1641,N/A,138,0
15,N/A,N/A,N/A,1625,1640,N/A,144,6
12,N/A,N/A,N/A,1682,1694,N/A,3,4
3,N/A,N/A,N/A,1679,1682,N/A,7,2
4,N/A,N/A,N/A,1675,1679,N/A,13,2
18,N/A,N/A,N/A,1657,1675,N/A,16,5
3,N/A,N/A,N/A,1654,1657,N/A,20,3
2,N/A,N/A,N/A,1652,1654,N/A,26,3
1,N/A,N/A,N/A,1651,1652,N/A,30,1
1,N/A,N/A,N/A,1650,1651,N/A,36,1
19,N/A,N/A,N/A,1631,1650,N/A,41,6
16,N/A,N/A,N/A,1615,1631,N/A,46,5
16,N/A,N/A,N/A,1599,1615,N/A,52,5
3,N/A,N/A,N/A,1596,1599,N/A,56,3
3,N/A,N/A,N/A,1593,1596,N/A,61,2
16,N/A,N/A,N/A,1577,1593,N/A,65,6
13,N/A,N/A,N/A,1564,1577,N/A,69,4
2,N/A,N/A,N/A,1562,1564,N/A,72,1
2,N/A,N/A,N/A,1560,1562,N/A,78,1
15,N/A,N/A,N/A,1545,1560,N/A,82,5
8,N/A,N/A,N/A,1537,1545,N/A,87,4
1,N/A,N/A,N/A,1536,1537,N/A,90,1
19,N/A,N/A,N/A,1517,1536,N/A,94,5
2,N/A,N/A,N/A,1515,1517,N/A,97,2
4,N/A,N/A,N/A,1511,1515,N/A,103,2
3,N/A,N/A,N/A,1508,1511,N/A,109,2
13,N/A,N/A,N/A,1495,1508,N/A,113,6
4,N/A,N/A,N/A,1491,1495,N/A,116,3
1,N/A,N/A,N/A,1490,1491,N/A,120,1
9,N/A,N/A,N/A,1481,1490,N/A,123,4
3,N/A,N/A,N/A,1478,1481,N/A,127,2
13,N/A,N/A,N/A,1465,1478,N/A,130,5
12,N/A,N/A,N/A,753,765,N/A,4,6
10,N/A,N/A,N/A,743,753,N/A,8,4
4,N/A,N/A,N/A,739,743,N/A,13,3
3,N/A,N/A,N/A,736,739,N/A,19,3
2,N/A,N/A,N/A,734,736,N/A,25,3
4,N/A,N/A,N/A,730,734,N/A,30,2
13,N/A,N/A,N/A,717,730,N/A,34,6
4,N/A,N/A,N/A,713,717,N/A,37,3
2,N/A,N/A,N/A,711,713,N/A,41,1
17,N/A,N/A,N/A,694,711,N/A,45,5
4,N/A,N/A,N/A,690,694,N/A,48,2
18,N/A,N/A,N/A,672,690,N/A,52,6
14,N/A,N/A,N/A,658,672,N/A,57,5
10,N/A,N/A,N/A,648,658,N/A,62,4
4,N/A,N/A,N/A,644,648,N/A,66,2
11,N/A,N/A,N/A,633,644,N/A,69,5
15,N/A,N/A,N/A,618,633,N/A,75,5
3,N/A,N/A,N/A,615,618,N/A,79,3
15,N/A,N/A,N/A,600,615,N/A,82,6
4,N/A,N/A,N/A,596,600,N/A,85,3
2,N/A,N/A,N/A,594,596,N/A,89,1
14,N/A,N/A,N/A,580,594,N/A,93,5
4,N/A,N/A,N/A,576,580,N/A,97,3
12,N/A,N/A,N/A,564,576,N/A,100,6
1,N/A,N/A,N/A,563,564,N/A,106,0
13,N/A,N/A,N/A,550,563,N/A,110,4
3,N/A,N/A,N/A,547,550,N/A,114,2
10,N/A,N/A,N/A,537,547,N/A,117,5
4,N/A,N/A,N/A,533,537,N/A,120,2
4,N/A,N/A,N/A,529,533,N/A,126,2
11,N/A,N/A,N/A,1329,1340,N/A,5,5
18,N/A,N/A,N/A,1311,1329,N/A,11,5
3,N/A,N/A,N/A,1308,1311,N/A,14,2
2,N/A,N/A,N/A,1306,1308,N/A,19,1
2,N/A,N/A,N/A,1304,1306,N/A,25,1
13,N/A,N/A,N/A,1291,1304,N/A,29,5
6,N/A,N/A,N/A,1285,1291,N/A,34,4
10,N/A,N/A,N/A,1275,1285,N/A,40,4
1,N/A,N/A,N/A,1274,1275,N/A,43,1
17,N/A,N/A,N/A,1257,1274,N/A,47,5
4,N/A,N/A,N/A,1253,1257,N/A,51,3
3,N/A,N/A,N/A,1250,1253,N/A,56,2
17,N/A,N/A,N/A,1233,1250,N/A,60,6
2,N/A,N/A,N/A,1231,1233,N/A,63,3
1,N/A,N/A,N/A,1230,1231,N/A,67,1
14,N/A,N/A,N/A,1216,1230,N/A,70,4
4,N/A,N/A,N/A,1212,1216,N/A,75,3
2,N/A,N/A,N/A,1210,1212,N/A,81,3
4,N/A,N/A,N/A,1206,1210,N/A,86,2
3,N/A,N/A,N/A,1203,1206,N/A,92,2
10,N/A,N/A,N/A,1193,1203,N/A,95,5
4,N/A,N/A,N/A,1189,1193,N/A,98,2
2,N/A,N/A,N/A,1187,1189,N/A,103,1
14,N/A,N/A,N/A,1173,1187,N/A,107,5
4,N/A,N/A,N/A,1169,1173,N/A,111,3
16,N/A,N/A,N/A,1153,1169,N/A,114,6
1,N/A,N/A,N/A,1152,1153,N/A,120,0
11,N/A,N/A,N/A,1141,1152,N/A,126,6
4,N/A,N/A,N/A,1137,1141,N/A,129,3
2,N/A,N/A,N/A,1135,1137,N/A,135,3
18,N/A,N/A,N/A,1864,1882,N/A,5,5
15,N/A,N/A,N/A,1849,1864,N/A,11,5
3,N/A,N/A,N/A,1846,1849,N/A,14,2
17,N/A,N/A,N/A,1829,1846,N/A,18,6
2,N/A,N/A,N/A,1827,1829,N/A,24,0
6,N/A,N/A,N/A,1821,1827,N/A,28,4
2,N/A,N/A,N/A,1819,1821,N/A,31,1
15,N/A,N/A,N/A,1804,1819,N/A,36,6
2,N/A,N/A,N/A,1802,1804,N/A,42,0
14,N/A,N/A,N/A,1788,1802,N/A,48,6
14,N/A,N/A,N/A,1774,1788,N/A,53,5
19,N/A,N/A,N/A,1755,1774,N/A,59,5
2,N/A,N/A,N/A,1753,1755,N/A,62,2
15,N/A,N/A,N/A,1738,1753,N/A,66,6
2,N/A,N/A,N/A,1736,1738,N/A,69,3
20,N/A,N/A,N/A,1716,1736,N/A,72,6
2,N/A,N/A,N/A,1714,1716,N/A,78,0
2,N/A,N/A,N/A,1712,1714,N/A,81,3
4,N/A,N/A,N/A,1708,1712,N/A,86,2
17,N/A,N/A,N/A,1691,1708,N/A,90,6
15,N/A,N/A,N/A,1676,1691,N/A,95,5
19,N/A,N/A,N/A,1657,1676,N/A,101,5
4,N/A,N/A,N/A,1653,1657,N/A,104,2
3,N/A,N/A,N/A,1650,1653,N/A,110,2
14,N/A,N/A,N/A,1636,1650,N/A,114,6
4,N/A,N/A,N/A,1632,1636,N/A,117,3
2,N/A,N/A,N/A,1630,1632,N/A,122,2
2,N/A,N/A,N/A,1628,1630,N/A,128,2
10,N/A,N/A,N/A,1618,1628,N/A,131,5
7,N/A,N/A,N/A,1611,1618,N/A,136,4
17,N/A,N/A,N/A,946,963,N/A,6,5
4,N/A,N/A,N/A,942,946,N/A,10,3
19,N/A,N/A,N/A,923,942,N/A,13,6
3,N/A,N/A,N/A,920,923,N/A,16,3
4,N/A,N/A,N/A,916,920,N/A,22,3
3,N/A,N/A,N/A,913,916,N/A,28,3
1,N/A,N/A,N/A,912,913,N/A,32,1
1,N/A,N/A,N/A,911,912,N/A,38,1
12,N/A,N/A,N/A,899,911,N/A,42,5
3,N/A,N/A,N/A,896,899,N/A,46,3
17,N/A,N/A,N/A,879,896,N/A,49,6
2,N/A,N/A,N/A,877,879,N/A,52,3
3,N/A,N/A,N/A,874,877,N/A,58,3
1,N/A,N/A,N/A,873,874,N/A,62,1
8,N/A,N/A,N/A,865,873,N/A,65,4
10,N/A,N/A,N/A,855,865,N/A,71,4
3,N/A,N/A,N/A,852,855,N/A,76,3
4,N/A,N/A,N/A,848,852,N/A,82,3
1,N/A,N/A,N/A,847,848,N/A,86,1
18,N/A,N/A,N/A,829,847,N/A,90,5
7,N/A,N/A,N/A,822,829,N/A,95,4
1,N/A,N/A,N/A,821,822,N/A,98,1
12,N/A,N/A,N/A,809,821,N/A,103,6
6,N/A,N/A,N/A,803,809,N/A,107,4
2,N/A,N/A,N/A,801,803,N/A,110,1
2,N/A,N/A,N/A,799,801,N/A,116,1
7,N/A,N/A,N/A,792,799,N/A,119,4
3,N/A,N/A,N/A,789,792,N/A,123,2
17,N/A,N/A,N/A,772,789,N/A,127,6
10,N/A,N/A,N/A,762,772,N/A,132,5
9,N/A,N/A,N/A,1713,1722,N/A,3,4
2,N/A,N/A,N/A,1711,1713,N/A,6,1
19,N/A,N/A,N/A,1692,1711,N/A,10,5
3,N/A,N/A,N/A,1689,1692,N/A,14,3
2,N/A,N/A,N/A,1687,1689,N/A,20,3
13,N/A,N/A,N/A,1674,1687,N/A,23,6
10,N/A,N/A,N/A,1664,1674,N/A,28,5
14,N/A,N/A,N/A,1650,1664,N/A,34,5
6,N/A,N/A,N/A,1644,1650,N/A,39,4
2,N/A,N/A,N/A,1642,1644,N/A,42,1
1,N/A,N/A,N/A,1641,1642,N/A,48,1
12,N/A,N/A,N/A,1629,1641,N/A,53,6
2,N/A,N/A,N/A,1627,1629,N/A,59,0
11,N/A,N/A,N/A,1616,1627,N/A,65,6
4,N/A,N/A,N/A,1612,1616,N/A,68,3
4,N/A,N/A,N/A,1608,1612,N/A,74,3
2,N/A,N/A,N/A,1606,1608,N/A,79,2
11,N/A,N/A,N/A,1595,1606,N/A,83,6
8,N/A,N/A,N/A,1587,1595,N/A,87,4
4,N/A,N/A,N/A,1583,1587,N/A,91,2
2,N/A,N/A,N/A,1581,1583,N/A,96,1
2,N/A,N/A,N/A,1579,1581,N/A,102,1
1,N/A,N/A,N/A,1578,1579,N/A,108,1
1,N/A,N/A,N/A,1577,1578,N/A,114,1
2,N/A,N/A,N/A,1575,1577,N/A,120,1
8,N/A,N/A,N/A,1567,1575,N/A,123,4
13,N/A,N/A,N/A,1554,1567,N/A,129,4
13,N/A,N/A,N/A,1541,1554,N/A,135,4
2,N/A,N/A,N/A,1539,1541,N/A,140,3
2,N/A,N/A,N/A,1537,1539,N/A,145,2
1,N/A,N/A,N/A,368,369,N/A,4,1
9,N/A,N/A,N/A,359,368,N/A,7,4
1,N/A,N/A,N/A,358,359,N/A,10,1
19,N/A,N/A,N/A,339,358,N/A,15,6
14,N/A,N/A,N/A,325,339,N/A,19,4
13,N/A,N/A,N/A,312,325,N/A,25,4
4,N/A,N/A,N/A,308,312,N/A,30,3
3,N/A,N/A,N/A,305,308,N/A,35,2
4,N/A,N/A,N/A,301,305,N/A,41,2
3,N/A,N/A,N/A,298,301,N/A,47,2
2,N/A,N/A,N/A,296,298,N/A,52,1
11,N/A,N/A,N/A,285,296,N/A,57,6
4,N/A,N/A,N/A,281,285,N/A,60,3
4,N/A,N/A,N/A,277,281,N/A,66,3
3,N/A,N/A,N/A,274,277,N/A,72,3
2,N/A,N/A,N/A,272,274,N/A,76,1
11,N/A,N/A,N/A,261,272,N/A,80,5
3,N/A,N/A,N/A,258,261,N/A,83,2
2,N/A,N/A,N/A,256,258,N/A,88,1
2,N/A,N/A,N/A,254,256,N/A,94,1
16,N/A,N/A,N/A,238,254,N/A,98,5
4,N/A,N/A,N/A,234,238,N/A,102,3
14,N/A,N/A,N/A,220,234,N/A,105,6
6,N/A,N/A,N/A,214,220,N/A,109,4
10,N/A,N/A,N/A,204,214,N/A,115,4
1,N/A,N/A,N/A,203,204,N/A,118,1
18,N/A,N/A,N/A,185,203,N/A,123,6
13,N/A,N/A,N/A,172,185,N/A,128,5
13,N/A,N/A,N/A,159,172,N/A,134,5
8,N/A,N/A,N/A,151,159,N/A,139,4
15,N/A,N/A,N/A,1677,1692,N/A,3,5
10,N/A,N/A,N/A,1667,1677,N/A,9,5
10,N/A,N/A,N/A,1657,1667,N/A,15,5
13,N/A,N/A,N/A,1644,1657,N/A,21,5
4,N/A,N/A,N/A,1640,1644,N/A,25,3
20,N/A,N/A,N/A,1620,1640,N/A,28,6
15,N/A,N/A,N/A,1605,1620,N/A,33,5
4,N/A,N/A,N/A,1601,1605,N/A,36,2
4,N/A,N/A,N/A,1597,1601,N/A,42,2
11,N/A,N/A,N/A,1586,1597,N/A,46,6
11,N/A,N/A,N/A,1575,1586,N/A,51,5
13,N/A,N/A,N/A,1562,1575,N/A,56,4
4,N/A,N/A,N/A,1558,1562,N/A,60,2
12,N/A,N/A,N/A,1546,1558,N/A,64,6
11,N/A,N/A,N/A,1535,1546,N/A,68,4
1,N/A,N/A,N/A,1534,1535,N/A,71,1
10,N/A,N/A,N/A,1524,1534,N/A,75,5
4,N/A,N/A,N/A,1520,1524,N/A,78,2
20,N/A,N/A,N/A,1500,1520,N/A,82,6
2,N/A,N/A,N/A,1498,1500,N/A,85,3
3,N/A,N/A,N/A,1495,1498,N/A,90,2
17,N/A,N/A,N/A,1478,1495,N/A,94,6
12,N/A,N/A,N/A,1466,1478,N/A,98,4
5,N/A,N/A,N/A,1461,1466,N/A,104,4
2,N/A,N/A,N/A,1459,1461,N/A,107,1
2,N/A,N/A,N/A,1457,1459,N/A,113,1
12,N/A,N/A,N/A,1445,1457,N/A,118,6
2,N/A,N/A,N/A,1443,1445,N/A,124,0
2,N/A,N/A,N/A,1441,1443,N/A,127,3
18,N/A,N/A,N/A,1423,1441,N/A,130,6
16,N/A,N/A,N/A,1043,1059,N/A,3,5
10,N/A,N/A,N/A,1033,1043,N/A,8,4
9,N/A,N/A,N/A,1024,1033,N/A,14,4
3,N/A,N/A,N/A,1021,1024,N/A,19,3
3,N/A,N/A,N/A,1018,1021,N/A,24,2
13,N/A,N/A,N/A,1005,1018,N/A,27,5
4,N/A,N/A,N/A,1001,1005,N/A,30,2
16,N/A,N/A,N/A,985,1001,N/A,34,6
3,N/A,N/A,N/A,982,985,N/A,37,3
19,N/A,N/A,N/A,963,982,N/A,40,6
19,N/A,N/A,N/A,944,963,N/A,45,5
2,N/A,N/A,N/A,942,944,N/A,48,2
13,N/A,N/A,N/A,929,942,N/A,52,6
2,N/A,N/A,N/A,927,929,N/A,55,3
2,N/A,N/A,N/A,925,927,N/A,59,1
7,N/A,N/A,N/A,918,925,N/A,62,4
14,N/A,N/A,N/A,904,918,N/A,68,4
3,N/A,N/A,N/A,901,904,N/A,72,2
1,N/A,N/A,N/A,900,901,N/A,77,1
19,N/A,N/A,N/A,881,900,N/A,82,6
15,N/A,N/A,N/A,866,881,N/A,87,5
11,N/A,N/A,N/A,855,866,N/A,92,4
2,N/A,N/A,N/A,853,855,N/A,95,1
16,N/A,N/A,N/A,837,853,N/A,99,5
3,N/A,N/A,N/A,834,837,N/A,102,2
19,N/A,N/A,N/A,815,834,N/A,106,6
1,N/A,N/A,N/A,814,815,N/A,112,0
18,N/A,N/A,N/A,796,814,N/A,118,6
2,N/A,N/A,N/A,794,796,N/A,121,3
2,N/A,N/A,N/A,792,794,N/A,126,2
12,N/A,N/A,N/A,778,790,N/A,6,5
3,N/A,N/A,N/A,775,778,N/A,10,3
1,N/A,N/A,N/A,774,775,N/A,14,1
16,N/A,N/A,N/A,758,774,N/A,19,6
2,N/A,N/A,N/A,756,758,N/A,22,3
2,N/A,N/A,N/A,754,756,N/A,27,2
3,N/A,N/A,N/A,751,754,N/A,33,2
2,N/A,N/A,N/A,749,751,N/A,38,1
16,N/A,N/A,N/A,733,749,N/A,42,5
3,N/A,N/A,N/A,730,733,N/A,45,2
11,N/A,N/A,N/A,719,730,N/A,49,6
11,N/A,N/A,N/A,708,719,N/A,53,4
2,N/A,N/A,N/A,706,708,N/A,57,2
4,N/A,N/A,N/A,702,706,N/A,63,2
1,N/A,N/A,N/A,701,702,N/A,68,1
2,N/A,N/A,N/A,699,701,N/A,74,1
7,N/A,N/A,N/A,692,699,N/A,77,4
4,N/A,N/A,N/A,688,692,N/A,82,3
11,N/A,N/A,N/A,677,688,N/A,85,6
4,N/A,N/A,N/A,673,677,N/A,88,3
16,N/A,N/A,N/A,657,673,N/A,91,6
14,N/A,N/A,N/A,643,657,N/A,95,4
2,N/A,N/A,N/A,641,643,N/A,98,1
17,N/A,N/A,N/A,624,641,N/A,103,6
2,N/A,N/A,N/A,622,624,N/A,109,0
18,N/A,N/A,N/A,604,622,N/A,115,6
6,N/A,N/A,N/A,598,604,N/A,119,4
1,N/A,N/A,N/A,597,598,N/A,122,1
19,N/A,N/A,N/A,578,597,N/A,127,6
1,N/A,N/A,N/A,577,578,N/A,133,0
3,N/A,N/A,N/A,1129,1132,N/A,3,3
13,N/A,N/A,N/A,1116,1129,N/A,6,6
13,N/A,N/A,N/A,1103,1116,N/A,10,4
6,N/A,N/A,N/A,1097,1103,N/A,16,4
2,N/A,N/A,N/A,1095,1097,N/A,19,1
1,N/A,N/A,N/A,1094,1095,N/A,25,1
18,N/A,N/A,N/A,1076,1094,N/A,30,6
7,N/A,N/A,N/A,1069,1076,N/A,34,4
2,N/A,N/A,N/A,1067,1069,N/A,39,3
1,N/A,N/A,N/A,1066,1067,N/A,43,1
18,N/A,N/A,N/A,1048,1066,N/A,48,6
11,N/A,N/A,N/A,1037,1048,N/A,52,4
14,N/A,N/A,N/A,1023,1037,N/A,58,4
1,N/A,N/A,N/A,1022,1023,N/A,61,1
20,N/A,N/A,N/A,1002,1022,N/A,66,6
9,N/A,N/A,N/A,993,1002,N/A,70,4
3,N/A,N/A,N/A,990,993,N/A,75,3
20,N/A,N/A,N/A,970,990,N/A,78,6
3,N/A,N/A,N/A,967,970,N/A,81,3
1,N/A,N/A,N/A,966,967,N/A,85,1
2,N/A,N/A,N/A,964,966,N/A,91,1
12,N/A,N/A,N/A,952,964,N/A,95,5
2,N/A,N/A,N/A,950,952,N/A,98,2
2,N/A,N/A,N/A,948,950,N/A,103,1
14,N/A,N/A,N/A,934,948,N/A,107,5
4,N/A,N/A,N/A,930,934,N/A,111,3
1,N/A,N/A,N/A,929,930,N/A,115,1
10,N/A,N/A,N/A,919,929,N/A,119,5
2,N/A,N/A,N/A,917,919,N/A,122,2
12,N/A,N/A,N/A,905,917,N/A,125,5
15,N/A,N/A,N/A,1574,1589,N/A,4,5
4,N/A,N/A,N/A,1570,1574,N/A,7,2
14,N/A,N/A,N/A,1556,1570,N/A,10,5
3,N/A,N/A,N/A,1553,1556,N/A,14,3
2,N/A,N/A,N/A,1551,1553,N/A,18,1
11,N/A,N/A,N/A,1540,1551,N/A,23,6
12,N/A,N/A,N/A,1528,1540,N/A,27,4
14,N/A,N/A,N/A,1514,1528,N/A,33,4
3,N/A,N/A,N/A,1511,1514,N/A,38,3
3,N/A,N/A,N/A,1508,1511,N/A,44,3
2,N/A,N/A,N/A,1506,1508,N/A,50,3
1,N/A,N/A,N/A,1505,1506,N/A,54,1
2,N/A,N/A,N/A,1503,1505,N/A,60,1
1,N/A,N/A,N/A,1502,1503,N/A,66,1
2,N/A,N/A,N/A,1500,1502,N/A,72,1
14,N/A,N/A,N/A,1486,1500,N/A,77,6
2,N/A,N/A,N/A,1484,1486,N/A,80,3
2,N/A,N/A,N/A,1482,1484,N/A,86,3
18,N/A,N/A,N/A,1464,1482,N/A,89,6
2,N/A,N/A,N/A,1462,1464,N/A,95,0
19,N/A,N/A,N/A,1443,1462,N/A,101,6
10,N/A,N/A,N/A,1433,1443,N/A,106,5
16,N/A,N/A,N/A,1417,1433,N/A,112,5
17,N/A,N/A,N/A,1400,1417,N/A,118,5
4,N/A,N/A,N/A,1396,1400,N/A,121,2
18,N/A,N/A,N/A,1378,1396,N/A,124,5
4,N/A,N/A,N/A,1374,1378,N/A,127,2
13,N/A,N/A,N/A,1361,1374,N/A,130,5
2,N/A,N/A,N/A,1359,1361,N/A,133,2
2,N/A,N/A,N/A,1357,1359,N/A,138,1
3,N/A,N/A,N/A,907,910,N/A,3,2
2,N/A,N/A,N/A,905,907,N/A,8,1
2,N/A,N/A,N/A,903,905,N/A,14,1
2,N/A,N/A,N/A,901,903,N/A,20,1
11,N/A,N/A,N/A,890,901,N/A,23,4
2,N/A,N/A,N/A,888,890,N/A,27,2
3,N/A,N/A,N/A,885,888,N/A,33,2
2,N/A,N/A,N/A,883,885,N/A,38,1
15,N/A,N/A,N/A,868,883,N/A,43,6
6,N/A,N/A,N/A,862,868,N/A,47,4
2,N/A,N/A,N/A,860,862,N/A,51,2
19,N/A,N/A,N/A,841,860,N/A,54,5
5,N/A,N/A,N/A,836,841,N/A,59,4
4,N/A,N/A,N/A,832,836,N/A,64,3
2,N/A,N/A,N/A,830,832,N/A,68,1
17,N/A,N/A,N/A,813,830,N/A,72,5
3,N/A,N/A,N/A,810,813,N/A,75,2
13,N/A,N/A,N/A,797,810,N/A,79,6
4,N/A,N/A,N/A,793,797,N/A,82,3
4,N/A,N/A,N/A,789,793,N/A,87,2
16,N/A,N/A,N/A,773,789,N/A,91,6
11,N/A,N/A,N/A,762,773,N/A,96,5
2,N/A,N/A,N/A,760,762,N/A,100,3
3,N/A,N/A,N/A,757,760,N/A,105,2
1,N/A,N/A,N/A,756,757,N/A,110,1
1,N/A,N/A,N/A,755,756,N/A,116,1
1,N/A,N/A,N/A,754,755,N/A,122,1
2,N/A,N/A,N/A,752,754,N/A,128,1
18,N/A,N/A,N/A,734,752,N/A,133,6
13,N/A,N/A,N/A,721,734,N/A,138,5
3,N/A,N/A,N/A,1882,1885,N/A,6,2
2,N/A,N/A,N/A,1880,1882,N/A,11,1
13,N/A,N/A,N/A,1867,1880,N/A,14,4
2,N/A,N/A,N/A,1865,1867,N/A,18,2
2,N/A,N/A,N/A,1863,1865,N/A,23,1
9,N/A,N/A,N/A,1854,1863,N/A,26,4
2,N/A,N/A,N/A,1852,1854,N/A,29,1
2,N/A,N/A,N/A,1850,1852,N/A,35,1
2,N/A,N/A,N/A,1848,1850,N/A,41,1
6,N/A,N/A,N/A,1842,1848,N/A,44,4
4,N/A,N/A,N/A,1838,1842,N/A,49,3
3,N/A,N/A,N/A,1835,1838,N/A,54,2
18,N/A,N/A,N/A,1817,1835,N/A,57,5
17,N/A,N/A,N/A,1800,1817,N/A,63,5
2,N/A,N/A,N/A,1798,1800,N/A,66,2
15,N/A,N/A,N/A,1783,1798,N/A,70,6
1,N/A,N/A,N/A,1782,1783,N/A,76,0
16,N/A,N/A,N/A,1766,1782,N/A,82,6
1,N/A,N/A,N/A,1765,1766,N/A,88,0
12,N/A,N/A,N/A,1753,1765,N/A,94,6
2,N/A,N/A,N/A,1751,1753,N/A,100,0
19,N/A,N/A,N/A,1732,1751,N/A,105,5
13,N/A,N/A,N/A,1719,1732,N/A,111,5
10,N/A,N/A,N/A,1709,1719,N/A,116,4
4,N/A,N/A,N/A,1705,1709,N/A,121,3
15,N/A,N/A,N/A,1690,1705,N/A,124,6
16,N/A,N/A,N/A,1674,1690,N/A,129,5
13,N/A,N/A,N/A,1661,1674,N/A,135,5
4,N/A,N/A,N/A,1657,1661,N/A,138,2
15,N/A,N/A,N/A,1642,1657,N/A,142,6
1,N/A,N/A,N/A,1466,1467,N/A,5,1
10,N/A,N/A,N/A,1456,1466,N/A,8,4
2,N/A,N/A,N/A,1454,1456,N/A,12,2
10,N/A,N/A,N/A,1444,1454,N/A,15,5
4,N/A,N/A,N/A,1440,1444,N/A,18,2
1,N/A,N/A,N/A,1439,1440,N/A,23,1
1,N/A,N/A,N/A,1438,1439,N/A,29,1
12,N/A,N/A,N/A,1426,1438,N/A,32,4
2,N/A,N/A,N/A,1424,1426,N/A,35,1
11,N/A,N/A,N/A,1413,1424,N/A,38,4
9,N/A,N/A,N/A,1404,1413,N/A,44,4
14,N/A,N/A,N/A,1390,1404,N/A,50,4
3,N/A,N/A,N/A,1387,1390,N/A,54,2
10,N/A,N/A,N/A,1377,1387,N/A,57,5
2,N/A,N/A,N/A,1375,1377,N/A,61,3
1,N/A,N/A,N/A,1374,1375,N/A,65,1
10,N/A,N/A,N/A,1364,1374,N/A,68,4
10,N/A,N/A,N/A,1354,1364,N/A,74,4
2,N/A,N/A,N/A,1352,1354,N/A,79,3
3,N/A,N/A,N/A,1349,1352,N/A,85,3
13,N/A,N/A,N/A,1336,1349,N/A,88,6
1,N/A,N/A,N/A,1335,1336,N/A,94,0
18,N/A,N/A,N/A,1317,1335,N/A,100,6
3,N/A,N/A,N/A,1314,1317,N/A,103,3
3,N/A,N/A,N/A,1311,1314,N/A,109,3
2,N/A,N/A,N/A,1309,1311,N/A,115,3
1,N/A,N/A,N/A,1308,1309,N/A,119,1
18,N/A,N/A,N/A,1290,1308,N/A,124,6
13,N/A,N/A,N/A,1277,1290,N/A,129,5
2,N/A,N/A,N/A,1275,1277,N/A,132,2
4,N/A,N/A,N/A,1516,1520,N/A,4,2
2,N/A,N/A,N/A,1514,1516,N/A,9,1
1,N/A,N/A,N/A,1513,1514,N/A,15,1
7,N/A,N/A,N/A,1506,1513,N/A,18,4
4,N/A,N/A,N/A,1502,1506,N/A,23,3
1,N/A,N/A,N/A,1501,1502,N/A,27,1
12,N/A,N/A,N/A,1489,1501,N/A,30,4
2,N/A,N/A,N/A,1487,1489,N/A,33,1
19,N/A,N/A,N/A,1468,1487,N/A,37,5
6,N/A,N/A,N/A,1462,1468,N/A,42,4
5,N/A,N/A,N/A,1457,1462,N/A,48,4
2,N/A,N/A,N/A,1455,1457,N/A,52,2
3,N/A,N/A,N/A,1452,1455,N/A,58,2
18,N/A,N/A,N/A,1434,1452,N/A,62,6
17,N/A,N/A,N/A,1417,1434,N/A,67,5
3,N/A,N/A,N/A,1414,1417,N/A,71,3
4,N/A,N/A,N/A,1410,1414,N/A,76,2
10,N/A,N/A,N/A,1400,1410,N/A,79,5
4,N/A,N/A,N/A,1396,1400,N/A,83,3
1,N/A,N/A,N/A,1395,1396,N/A,87,1
13,N/A,N/A,N/A,1382,1395,N/A,90,4
2,N/A,N/A,N/A,1380,1382,N/A,94,2
12,N/A,N/A,N/A,1368,1380,N/A,97,5
4,N/A,N/A,N/A,1364,1368,N/A,100,2
18,N/A,N/A,N/A,1346,1364,N/A,104,6
18,N/A,N/A,N/A,1328,1346,N/A,109,5
6,N/A,N/A,N/A,1322,1328,N/A,114,4
2,N/A,N/A,N/A,1320,1322,N/A,117,1
13,N/A,N/A,N/A,1307,1320,N/A,120,4
2,N/A,N/A,N/A,1305,1307,N/A,124,2
4,N/A,N/A,N/A,410,414,N/A,5,2
10,N/A,N/A,N/A,400,410,N/A,8,5
14,N/A,N/A,N/A,386,400,N/A,14,5
2,N/A,N/A,N/A,384,386,N/A,17,2
2,N/A,N/A,N/A,382,384,N/A,22,1
9,N/A,N/A,N/A,373,382,N/A,25,4
4,N/A,N/A,N/A,369,373,N/A,30,3
15,N/A,N/A,N/A,354,369,N/A,33,6
2,N/A,N/A,N/A,352,354,N/A,36,3
15,N/A,N/A,N/A,337,352,N/A,39,6
10,N/A,N/A,N/A,327,337,N/A,44,5
4,N/A,N/A,N/A,323,327,N/A,48,3
20,N/A,N/A,N/A,303,323,N/A,51,6
2,N/A,N/A,N/A,301,303,N/A,54,3
3,N/A,N/A,N/A,298,301,N/A,60,3
3,N/A,N/A,N/A,295,298,N/A,66,3
2,N/A,N/A,N/A,293,295,N/A,72,3
2,N/A,N/A,N/A,291,293,N/A,76,1
12,N/A,N/A,N/A,279,291,N/A,80,5
2,N/A,N/A,N/A,277,279,N/A,83,2
4,N/A,N/A,N/A,273,277,N/A,89,2
1,N/A,N/A,N/A,272,273,N/A,94,1
11,N/A,N/A,N/A,261,272,N/A,98,5
2,N/A,N/A,N/A,259,261,N/A,102,3
4,N/A,N/A,N/A,255,259,N/A,108,3
2,N/A,N/A,N/A,253,255,N/A,112,1
2,N/A,N/A,N/A,251,253,N/A,118,1
12,N/A,N/A,N/A,239,251,N/A,123,6
2,N/A,N/A,N/A,237,239,N/A,126,3
3,N/A,N/A,N/A,234,237,N/A,132,3
2,N/A,N/A,N/A,1510,1512,N/A,4,3
18,N/A,N/A,N/A,1492,1510,N/A,7,6
6,N/A,N/A,N/A,1486,1492,N/A,11,4
2,N/A,N/A,N/A,1484,1486,N/A,14,1
11,N/A,N/A,N/A,1473,1484,N/A,18,5
4,N/A,N/A,N/A,1469,1473,N/A,22,3
20,N/A,N/A,N/A,1449,1469,N/A,25,6
10,N/A,N/A,N/A,1439,1449,N/A,30,5
8,N/A,N/A,N/A,1431,1439,N/A,35,4
5,N/A,N/A,N/A,1426,1431,N/A,41,4
4,N/A,N/A,N/A,1422,1426,N/A,45,2
18,N/A,N/A,N/A,1404,1422,N/A,49,6
2,N/A,N/A,N/A,1402,1404,N/A,55,0
19,N/A,N/A,N/A,1383,1402,N/A,61,6
13,N/A,N/A,N/A,1370,1383,N/A,65,4
2,N/A,N/A,N/A,1368,1370,N/A,69,2
2,N/A,N/A,N/A,1366,1368,N/A,75,2
3,N/A,N/A,N/A,1363,1366,N/A,81,2
16,N/A,N/A,N/A,1347,1363,N/A,84,5
4,N/A,N/A,N/A,1343,1347,N/A,88,3
2,N/A,N/A,N/A,1341,1343,N/A,94,3
11,N/A,N/A,N/A,1330,1341,N/A,97,6
1,N/A,N/A,N/A,1329,1330,N/A,103,0
12,N/A,N/A,N/A,1317,1329,N/A,108,5
3,N/A,N/A,N/A,1314,1317,N/A,112,3
3,N/A,N/A,N/A,1311,1314,N/A,118,3
4,N/A,N/A,N/A,1307,1311,N/A,124,3
16,N/A,N/A,N/A,1291,1307,N/A,127,6
11,N/A,N/A,N/A,1280,1291,N/A,132,5
6,N/A,N/A,N/A,1274,1280,N/A,137,4
13,N/A,N/A,N/A,1395,1408,N/A,3,4
7,N/A,N/A,N/A,1388,1395,N/A,9,4
3,N/A,N/A,N/A,1385,1388,N/A,13,2
3,N/A,N/A,N/A,1382,1385,N/A,19,2
15,N/A,N/A,N/A,1367,1382,N/A,23,6
12,N/A,N/A,N/A,1355,1367,N/A,28,5
4,N/A,N/A,N/A,1351,1355,N/A,31,2
13,N/A,N/A,N/A,1338,1351,N/A,35,6
3,N/A,N/A,N/A,1335,1338,N/A,38,3
13,N/A,N/A,N/A,1322,1335,N/A,41,6
4,N/A,N/A,N/A,1318,1322,N/A,44,3
1,N/A,N/A,N/A,1317,1318,N/A,48,1
2,N/A,N/A,N/A,1315,1317,N/A,54,1
1,N/A,N/A,N/A,1314,1315,N/A,60,1
20,N/A,N/A,N/A,1294,1314,N/A,65,6
3,N/A,N/A,N/A,1291,1294,N/A,68,3
2,N/A,N/A,N/A,1289,1291,N/A,72,1
7,N/A,N/A,N/A,1282,1289,N/A,75,4
1,N/A,N/A,N/A,1281,1282,N/A,78,1
5,N/A,N/A,N/A,1276,1281,N/A,81,4
2,N/A,N/A,N/A,1274,1276,N/A,84,1
2,N/A,N/A,N/A,1272,1274,N/A,90,1
19,N/A,N/A,N/A,1253,1272,N/A,95,6
1,N/A,N/A,N/A,1252,1253,N/A,101,0
12,N/A,N/A,N/A,1240,1252,N/A,105,4
2,N/A,N/A,N/A,1238,1240,N/A,109,2
10,N/A,N/A,N/A,1228,1238,N/A,112,5
2,N/A,N/A,N/A,1226,1228,N/A,115,2
20,N/A,N/A,N/A,1206,1226,N/A,119,6
2,N/A,N/A,N/A,1204,1206,N/A,125,0
11,N/A,N/A,N/A,938,949,N/A,4,4
4,N/A,N/A,N/A,934,938,N/A,9,3
3,N/A,N/A,N/A,931,934,N/A,15,3
2,N/A,N/A,N/A,929,931,N/A,21,3
2,N/A,N/A,N/A,927,929,N/A,26,2
10,N/A,N/A,N/A,917,927,N/A,29,5
16,N/A,N/A,N/A,901,917,N/A,35,5
10,N/A,N/A,N/A,891,901,N/A,41,5
4,N/A,N/A,N/A,887,891,N/A,45,3
2,N/A,N/A,N/A,885,887,N/A,49,1
12,N/A,N/A,N/A,873,885,N/A,52,4
3,N/A,N/A,N/A,870,873,N/A,57,3
1,N/A,N/A,N/A,869,870,N/A,61,1
2,N/A,N/A,N/A,867,869,N/A,67,1
12,N/A,N/A,N/A,855,867,N/A,70,4
3,N/A,N/A,N/A,852,855,N/A,75,3
4,N/A,N/A,N/A,848,852,N/A,80,2
4,N/A,N/A,N/A,844,848,N/A,86,2
11,N/A,N/A,N/A,833,844,N/A,89,5
4,N/A,N/A,N/A,829,833,N/A,92,2
15,N/A,N/A,N/A,814,829,N/A,96,6
2,N/A,N/A,N/A,812,814,N/A,102,0
20,N/A,N/A,N/A,792,812,N/A,108,6
9,N/A,N/A,N/A,783,792,N/A,112,4
4,N/A,N/A,N/A,779,783,N/A,116,2
11,N/A,N/A,N/A,768,779,N/A,119,5
4,N/A,N/A,N/A,764,768,N/A,123,3
4,N/A,N/A,N/A,760,764,N/A,128,2
18,N/A,N/A,N/A,742,760,N/A,131,5
4,N/A,N/A,N/A,738,742,N/A,135,3
15,N/A,N/A,N/A,1052,1067,N/A,4,5
9,N/A,N/A,N/A,1043,1052,N/A,9,4
7,N/A,N/A,N/A,1036,1043,N/A,15,4
8,N/A,N/A,N/A,1028,1036,N/A,21,4
1,N/A,N/A,N/A,1027,1028,N/A,24,1
13,N/A,N/A,N/A,1014,1027,N/A,27,4
6,N/A,N/A,N/A,1008,1014,N/A,33,4
3,N/A,N/A,N/A,1005,1008,N/A,38,3
3,N/A,N/A,N/A,1002,1005,N/A,44,3
2,N/A,N/A,N/A,1000,1002,N/A,48,1
12,N/A,N/A,N/A,988,1000,N/A,53,6
2,N/A,N/A,N/A,986,988,N/A,56,3
1,N/A,N/A,N/A,985,986,N/A,60,1
17,N/A,N/A,N/A,968,985,N/A,64,5
10,N/A,N/A,N/A,958,968,N/A,69,4
3,N/A,N/A,N/A,955,958,N/A,74,3
15,N/A,N/A,N/A,940,955,N/A,77,6
2,N/A,N/A,N/A,938,940,N/A,80,3
17,N/A,N/A,N/A,921,938,N/A,83,6
13,N/A,N/A,N/A,908,921,N/A,87,4
2,N/A,N/A,N/A,906,908,N/A,92,3
18,N/A,N/A,N/A,888,906,N/A,95,6
1,N/A,N/A,N/A,887,888,N/A,101,0
15,N/A,N/A,N/A,872,887,N/A,107,6
12,N/A,N/A,N/A,860,872,N/A,111,4
11,N/A,N/A,N/A,849,860,N/A,117,4
14,N/A,N/A,N/A,835,849,N/A,123,4
14,N/A,N/A,N/A,821,835,N/A,129,4
1,N/A,N/A,N/A,820,821,N/A,132,1
11,N/A,N/A,N/A,809,820,N/A,135,4
1,N/A,N/A,N/A,1347,1348,N/A,4,1
1,N/A,N/A,N/A,1346,1347,N/A,10,1
11,N/A,N/A,N/A,1335,1346,N/A,15,6
2,N/A,N/A,N/A,1333,1335,N/A,21,0
9,N/A,N/A,N/A,1324,1333,N/A,25,4
1,N/A,N/A,N/A,1323,1324,N/A,28,1
11,N/A,N/A,N/A,1312,1323,N/A,31,4
8,N/A,N/A,N/A,1304,1312,N/A,37,4
1,N/A,N/A,N/A,1303,1304,N/A,40,1
1,N/A,N/A,N/A,1302,1303,N/A,46,1
19,N/A,N/A,N/A,1283,1302,N/A,51,6
3,N/A,N/A,N/A,1280,1283,N/A,54,3
3,N/A,N/A,N/A,1277,1280,N/A,60,3
2,N/A,N/A,N/A,1275,1277,N/A,66,3
3,N/A,N/A,N/A,1272,1275,N/A,72,3
13,N/A,N/A,N/A,1259,1272,N/A,75,6
2,N/A,N/A,N/A,1257,1259,N/A,81,0
19,N/A,N/A,N/A,1238,1257,N/A,87,6
2,N/A,N/A,N/A,1236,1238,N/A,93,0
3,N/A,N/A,N/A,1233,1236,N/A,96,3
2,N/A,N/A,N/A,1231,1233,N/A,100,1
14,N/A,N/A,N/A,1217,1231,N/A,105,6
10,N/A,N/A,N/A,1207,1217,N/A,110,5
13,N/A,N/A,N/A,1194,1207,N/A,115,4
4,N/A,N/A,N/A,1190,1194,N/A,119,2
11,N/A,N/A,N/A,1179,1190,N/A,122,5
4,N/A,N/A,N/A,1175,1179,N/A,125,2
11,N/A,N/A,N/A,1164,1175,N/A,129,6
1,N/A,N/A,N/A,1163,1164,N/A,135,0
15,N/A,N/A,N/A,1148,1163,N/A,140,5
2,N/A,N/A,N/A,321,323,N/A,6,2
2,N/A,N/A,N/A,319,321,N/A,11,1
2,N/A,N/A,N/A,317,319,N/A,17,1
15,N/A,N/A,N/A,302,317,N/A,22,6
3,N/A,N/A,N/A,299,302,N/A,25,3
18,N/A,N/A,N/A,281,299,N/A,28,6
15,N/A,N/A,N/A,266,281,N/A,33,5
4,N/A,N/A,N/A,262,266,N/A,36,2
16,N/A,N/A,N/A,246,262,N/A,39,5
4,N/A,N/A,N/A,242,246,N/A,43,3
16,N/A,N/A,N/A,226,242,N/A,46,6
14,N/A,N/A,N/A,212,226,N/A,51,5
16,N/A,N/A,N/A,196,212,N/A,57,5
12,N/A,N/A,N/A,184,196,N/A,63,5
3,N/A,N/A,N/A,181,184,N/A,66,2
10,N/A,N/A,N/A,171,181,N/A,69,5
13,N/A,N/A,N/A,158,171,N/A,74,4
2,N/A,N/A,N/A,156,158,N/A,78,2
3,N/A,N/A,N/A,153,156,N/A,84,2
11,N/A,N/A,N/A,142,153,N/A,87,5
4,N/A,N/A,N/A,138,142,N/A,90,2
12,N/A,N/A,N/A,126,138,N/A,94,6
2,N/A,N/A,N/A,124,126,N/A,97,3
4,N/A,N/A,N/A,120,124,N/A,102,2
4,N/A,N/A,N/A,116,120,N/A,108,2
20,N/A,N/A,N/A,96,116,N/A,112,6
10,N/A,N/A,N/A,86,96,N/A,117,5
17,N/A,N/A,N/A,69,86,N/A,123,5
4,N/A,N/A,N/A,65,69,N/A,126,2
3,N/A,N/A,N/A,62,65,N/A,132,2
2,N/A,N/A,N/A,1224,1226,N/A,4,3
19,N/A,N/A,N/A,1205,1224,N/A,7,6
17,N/A,N/A,N/A,1188,1205,N/A,12,5
4,N/A,N/A,N/A,1184,1188,N/A,16,3
2,N/A,N/A,N/A,1182,1184,N/A,20,1
2,N/A,N/A,N/A,1180,1182,N/A,26,1
1,N/A,N/A,N/A,1179,1180,N/A,32,1
2,N/A,N/A,N/A,1177,1179,N/A,38,1
11,N/A,N/A,N/A,1166,1177,N/A,42,5
4,N/A,N/A,N/A,1162,1166,N/A,46,3
14,N/A,N/A,N/A,1148,1162,N/A,49,6
11,N/A,N/A,N/A,1137,1148,N/A,53,4
9,N/A,N/A,N/A,1128,1137,N/A,59,4
3,N/A,N/A,N/A,1125,1128,N/A,64,3
18,N/A,N/A,N/A,1107,1125,N/A,67,6
3,N/A,N/A,N/A,1104,1107,N/A,70,3
1,N/A,N/A,N/A,1103,1104,N/A,74,1
12,N/A,N/A,N/A,1091,1103,N/A,77,4
7,N/A,N/A,N/A,1084,1091,N/A,83,4
2,N/A,N/A,N/A,1082,1084,N/A,87,2
19,N/A,N/A,N/A,1063,1082,N/A,90,5
12,N/A,N/A,N/A,1051,1063,N/A,95,4
1,N/A,N/A,N/A,1050,1051,N/A,98,1
1,N/A,N/A,N/A,1049,1050,N/A,104,1
19,N/A,N/A,N/A,1030,1049,N/A,109,6
2,N/A,N/A,N/A,1028,1030,N/A,115,0
16,N/A,N/A,N/A,1012,1028,N/A,121,6
4,N/A,N/A,N/A,1008,1012,N/A,124,3
13,N/A,N/A,N/A,995,1008,N/A,127,6
6,N/A,N/A,N/A,989,995,N/A,131,4
1,N/A,N/A,N/A,1549,1550,N/A,5,1
6,N/A,N/A,N/A,1543,1549,N/A,8,4
2,N/A,N/A,N/A,1541,1543,N/A,13,3
2,N/A,N/A,N/A,1539,1541,N/A,18,2
20,N/A,N/A,N/A,1519,1539,N/A,22,6
13,N/A,N/A,N/A,1506,1519,N/A,26,4
4,N/A,N/A,N/A,1502,1506,N/A,31,3
20,N/A,N/A,N/A,1482,1502,N/A,34,6
2,N/A,N/A,N/A,1480,1482,N/A,37,3
4,N/A,N/A,N/A,1476,1480,N/A,42,2
2,N/A,N/A,N/A,1474,1476,N/A,48,2
19,N/A,N/A,N/A,1455,1474,N/A,51,5
6,N/A,N/A,N/A,1449,1455,N/A,56,4
3,N/A,N/A,N/A,1446,1449,N/A,60,2
3,N/A,N/A,N/A,1443,1446,N/A,66,2
2,N/A,N/A,N/A,1441,1443,N/A,72,2
10,N/A,N/A,N/A,1431,1441,N/A,75,5
3,N/A,N/A,N/A,1428,1431,N/A,79,3
1,N/A,N/A,N/A,1427,1428,N/A,83,1
15,N/A,N/A,N/A,1412,1427,N/A,88,6
2,N/A,N/A,N/A,1410,1412,N/A,91,3
2,N/A,N/A,N/A,1408,1410,N/A,95,1
14,N/A,N/A,N/A,1394,1408,N/A,99,5
2,N/A,N/A,N/A,1392,1394,N/A,103,3
4,N/A,N/A,N/A,1388,1392,N/A,108,2
12,N/A,N/A,N/A,1376,1388,N/A,111,5
2,N/A,N/A,N/A,1374,1376,N/A,114,2
16,N/A,N/A,N/A,1358,1374,N/A,118,6
13,N/A,N/A,N/A,1345,1358,N/A,123,5
12,N/A,N/A,N/A,1333,1345,N/A,128,4
11,N/A,N/A,N/A,617,628,N/A,4,6
4,N/A,N/A,N/A,613,617,N/A,7,3
16,N/A,N/A,N/A,597,613,N/A,10,6
18,N/A,N/A,N/A,579,597,N/A,15,5
2,N/A,N/A,N/A,577,579,N/A,19,3
4,N/A,N/A,N/A,573,577,N/A,24,2
17,N/A,N/A,N/A,556,573,N/A,27,5
2,N/A,N/A,N/A,554,556,N/A,30,2
2,N/A,N/A,N/A,552,554,N/A,35,1
5,N/A,N/A,N/A,547,552,N/A,38,4
3,N/A,N/A,N/A,544,547,N/A,43,3
3,N/A,N/A,N/A,541,544,N/A,49,3
19,N/A,N/A,N/A,522,541,N/A,52,6
3,N/A,N/A,N/A,519,522,N/A,55,3
2,N/A,N/A,N/A,517,519,N/A,60,2
2,N/A,N/A,N/A,515,517,N/A,65,1
11,N/A,N/A,N/A,504,515,N/A,69,5
3,N/A,N/A,N/A,501,504,N/A,73,3
2,N/A,N/A,N/A,499,501,N/A,78,2
2,N/A,N/A,N/A,497,499,N/A,84,2
13,N/A,N/A,N/A,484,497,N/A,88,6
1,N/A,N/A,N/A,483,484,N/A,94,0
16,N/A,N/A,N/A,467,483,N/A,99,5
19,N/A,N/A,N/A,448,467,N/A,105,5
9,N/A,N/A,N/A,439,448,N/A,110,4
14,N/A,N/A,N/A,425,439,N/A,116,4
2,N/A,N/A,N/A,423,425,N/A,119,1
11,N/A,N/A,N/A,412,423,N/A,122,4
13,N/A,N/A,N/A,399,412,N/A,128,4
2,N/A,N/A,N/A,397,399,N/A,131,1
1,N/A,N/A,N/A,1657,1658,N/A,5,1
19,N/A,N/A,N/A,1638,1657,N/A,9,5
13,N/A,N/A,N/A,1625,1638,N/A,14,4
13,N/A,N/A,N/A,1612,1625,N/A,20,4
2,N/A,N/A,N/A,1610,1612,N/A,25,3
4,N/A,N/A,N/A,1606,1610,N/A,30,2
2,N/A,N/A,N/A,1604,1606,N/A,35,1
20,N/A,N/A,N/A,1584,1604,N/A,40,6
6,N/A,N/A,N/A,1578,1584,N/A,44,4
2,N/A,N/A,N/A,1576,1578,N/A,49,3
2,N/A,N/A,N/A,1574,1576,N/A,53,1
18,N/A,N/A,N/A,1556,1574,N/A,57,5
8,N/A,N/A,N/A,1548,1556,N/A,62,4
13,N/A,N/A,N/A,1535,1548,N/A,68,4
1,N/A,N/A,N/A,1534,1535,N/A,71,1
17,N/A,N/A,N/A,1517,1534,N/A,75,5
19,N/A,N/A,N/A,1498,1517,N/A,81,5
12,N/A,N/A,N/A,1486,1498,N/A,87,5
7,N/A,N/A,N/A,1479,1486,N/A,92,4
2,N/A,N/A,N/A,1477,1479,N/A,97,3
20,N/A,N/A,N/A,1457,1477,N/A,100,6
11,N/A,N/A,N/A,1446,1457,N/A,104,4
2,N/A,N/A,N/A,1444,1446,N/A,108,2
18,N/A,N/A,N/A,1426,1444,N/A,112,6
11,N/A,N/A,N/A,1415,1426,N/A,117,5
2,N/A,N/A,N/A,1413,1415,N/A,120,2
2,N/A,N/A,N/A,1411,1413,N/A,125,1
19,N/A,N/A,N/A,1392,1411,N/A,129,5
4,N/A,N/A,N/A,1388,1392,N/A,132,2
2,N/A,N/A,N/A,1386,1388,N/A,137,1
2,N/A,N/A,N/A,1180,1182,N/A,6,3
14,N/A,N/A,N/A,1166,1180,N/A,9,6
15,N/A,N/A,N/A,1151,1166,N/A,14,5
4,N/A,N/A,N/A,1147,1151,N/A,17,2
2,N/A,N/A,N/A,1145,1147,N/A,22,1
12,N/A,N/A,N/A,1133,1145,N/A,26,5
4,N/A,N/A,N/A,1129,1133,N/A,30,3
3,N/A,N/A,N/A,1126,1129,N/A,36,3
4,N/A,N/A,N/A,1122,1126,N/A,42,3
3,N/A,N/A,N/A,1119,1122,N/A,48,3
4,N/A,N/A,N/A,1115,1119,N/A,54,3
3,N/A,N/A,N/A,1112,1115,N/A,60,3
18,N/A,N/A,N/A,1094,1112,N/A,63,6
13,N/A,N/A,N/A,1081,1094,N/A,68,5
11,N/A,N/A,N/A,1070,1081,N/A,73,4
7,N/A,N/A,N/A,1063,1070,N/A,79,4
1,N/A,N/A,N/A,1062,1063,N/A,82,1
11,N/A,N/A,N/A,1051,1062,N/A,86,5
12,N/A,N/A,N/A,1039,1051,N/A,92,5
2,N/A,N/A,N/A,1037,1039,N/A,95,2
1,N/A,N/A,N/A,1036,1037,N/A,100,1
18,N/A,N/A,N/A,1018,1036,N/A,105,6
4,N/A,N/A,N/A,1014,1018,N/A,108,3
3,N/A,N/A,N/A,1011,1014,N/A,113,2
13,N/A,N/A,N/A,998,1011,N/A,116,5
15,N/A,N/A,N/A,983,998,N/A,122,5
4,N/A,N/A,N/A,979,983,N/A,126,3
3,N/A,N/A,N/A,976,979,N/A,131,2
3,N/A,N/A,N/A,973,976,N/A,137,2
2,N/A,N/A,N/A,971,973,N/A,142,1
1,N/A,N/A,N/A,1481,1482,N/A,4,1
14,N/A,N/A,N/A,1467,1481,N/A,7,4
2,N/A,N/A,N/A,1465,1467,N/A,10,1
15,N/A,N/A,N/A,1450,1465,N/A,14,5
4,N/A,N/A,N/A,1446,1450,N/A,18,3
3,N/A,N/A,N/A,1443,1446,N/A,23,2
12,N/A,N/A,N/A,1431,1443,N/A,26,5
2,N/A,N/A,N/A,1429,1431,N/A,30,3
3,N/A,N/A,N/A,1426,1429,N/A,36,3
2,N/A,N/A,N/A,1424,1426,N/A,42,3
12,N/A,N/A,N/A,1412,1424,N/A,45,6
17,N/A,N/A,N/A,1395,1412,N/A,50,5
2,N/A,N/A,N/A,1393,1395,N/A,54,3
17,N/A,N/A,N/A,1376,1393,N/A,57,6
10,N/A,N/A,N/A,1366,1376,N/A,61,4
13,N/A,N/A,N/A,1353,1366,N/A,67,4
2,N/A,N/A,N/A,1351,1353,N/A,71,2
4,N/A,N/A,N/A,1347,1351,N/A,77,2
4,N/A,N/A,N/A,1343,1347,N/A,83,2
1,N/A,N/A,N/A,1342,1343,N/A,88,1
2,N/A,N/A,N/A,1340,1342,N/A,94,1
16,N/A,N/A,N/A,1324,1340,N/A,99,6
4,N/A,N/A,N/A,1320,1324,N/A,102,3
2,N/A,N/A,N/A,1318,1320,N/A,108,3
2,N/A,N/A,N/A,1316,1318,N/A,112,1
16,N/A,N/A,N/A,1300,1316,N/A,116,5
2,N/A,N/A,N/A,1298,1300,N/A,120,3
1,N/A,N/A,N/A,1297,1298,N/A,124,1
1,N/A,N/A,N/A,1296,1297,N/A,130,1
10,N/A,N/A,N/A,1286,1296,N/A,134,5
3,N/A,N/A,N/A,915,918,N/A,3,3
3,N/A,N/A,N/A,912,915,N/A,8,2
3,N/A,N/A,N/A,909,912,N/A,14,2
2,N/A,N/A,N/A,907,909,N/A,19,1
1,N/A,N/A,N/A,906,907,N/A,25,1
7,N/A,N/A,N/A,899,906,N/A,28,4
1,N/A,N/A,N/A,898,899,N/A,31,1
13,N/A,N/A,N/A,885,898,N/A,34,4
2,N/A,N/A,N/A,883,885,N/A,39,3
2,N/A,N/A,N/A,881,883,N/A,44,2
12,N/A,N/A,N/A,869,881,N/A,48,6
4,N/A,N/A,N/A,865,869,N/A,51,3
3,N/A,N/A,N/A,862,865,N/A,56,2
18,N/A,N/A,N/A,844,862,N/A,60,6
18,N/A,N/A,N/A,826,844,N/A,65,5
13,N/A,N/A,N/A,813,826,N/A,70,4
1,N/A,N/A,N/A,812,813,N/A,73,1
17,N/A,N/A,N/A,795,812,N/A,77,5
4,N/A,N/A,N/A,791,795,N/A,81,3
2,N/A,N/A,N/A,789,791,N/A,85,1
6,N/A,N/A,N/A,783,789,N/A,88,4
4,N/A,N/A,N/A,779,783,N/A,92,2
15,N/A,N/A,N/A,764,779,N/A,95,5
11,N/A,N/A,N/A,753,764,N/A,100,4
2,N/A,N/A,N/A,751,753,N/A,104,2
1,N/A,N/A,N/A,750,751,N/A,109,1
5,N/A,N/A,N/A,745,750,N/A,112,4
8,N/A,N/A,N/A,737,745,N/A,118,4
2,N/A,N/A,N/A,735,737,N/A,123,3
2,N/A,N/A,N/A,733,735,N/A,128,2
12,N/A,N/A,N/A,866,878,N/A,5,6
3,N/A,N/A,N/A,863,866,N/A,8,3
20,N/A,N/A,N/A,843,863,N/A,11,6
1,N/A,N/A,N/A,842,843,N/A,17,0
8,N/A,N/A,N/A,834,842,N/A,21,4
2,N/A,N/A,N/A,832,834,N/A,25,2
17,N/A,N/A,N/A,815,832,N/A,28,5
3,N/A,N/A,N/A,812,815,N/A,32,3
12,N/A,N/A,N/A,800,812,N/A,35,6
4,N/A,N/A,N/A,796,800,N/A,38,3
14,N/A,N/A,N/A,782,796,N/A,41,6
1,N/A,N/A,N/A,781,782,N/A,47,0
13,N/A,N/A,N/A,768,781,N/A,51,4
6,N/A,N/A,N/A,762,768,N/A,57,4
4,N/A,N/A,N/A,758,762,N/A,61,2
2,N/A,N/A,N/A,756,758,N/A,67,2
12,N/A,N/A,N/A,744,756,N/A,70,5
4,N/A,N/A,N/A,740,744,N/A,74,3
2,N/A,N/A,N/A,738,740,N/A,78,1
11,N/A,N/A,N/A,727,738,N/A,83,6
2,N/A,N/A,N/A,725,727,N/A,86,3
2,N/A,N/A,N/A,723,725,N/A,92,3
4,N/A,N/A,N/A,719,723,N/A,98,3
20,N/A,N/A,N/A,699,719,N/A,101,6
17,N/A,N/A,N/A,682,699,N/A,106,5
10,N/A,N/A,N/A,672,682,N/A,111,4
2,N/A,N/A,N/A,670,672,N/A,114,1
16,N/A,N/A,N/A,654,670,N/A,118,5
4,N/A,N/A,N/A,650,654,N/A,122,3
3,N/A,N/A,N/A,647,650,N/A,128,3
18,N/A,N/A,N/A,1149,1167,N/A,6,5
4,N/A,N/A,N/A,1145,1149,N/A,9,2
18,N/A,N/A,N/A,1127,1145,N/A,12,5
12,N/A,N/A,N/A,1115,1127,N/A,18,5
13,N/A,N/A,N/A,1102,1115,N/A,24,5
3,N/A,N/A,N/A,1099,1102,N/A,28,3
3,N/A,N/A,N/A,1096,1099,N/A,33,2
16,N/A,N/A,N/A,1080,1096,N/A,37,6
4,N/A,N/A,N/A,1076,1080,N/A,40,3
3,N/A,N/A,N/A,1073,1076,N/A,46,3
16,N/A,N/A,N/A,1057,1073,N/A,49,6
18,N/A,N/A,N/A,1039,1057,N/A,54,5
12,N/A,N/A,N/A,1027,1039,N/A,60,5
2,N/A,N/A,N/A,1025,1027,N/A,63,2
16,N/A,N/A,N/A,1009,1025,N/A,67,6
15,N/A,N/A,N/A,994,1009,N/A,72,5
2,N/A,N/A,N/A,992,994,N/A,75,2
11,N/A,N/A,N/A,981,992,N/A,78,5
17,N/A,N/A,N/A,964,981,N/A,84,5
14,N/A,N/A,N/A,950,964,N/A,90,5
6,N/A,N/A,N/A,944,950,N/A,95,4
11,N/A,N/A,N/A,933,944,N/A,101,4
2,N/A,N/A,N/A,931,933,N/A,104,1
11,N/A,N/A,N/A,920,931,N/A,108,5
2,N/A,N/A,N/A,918,920,N/A,112,3
2,N/A,N/A,N/A,916,918,N/A,116,1
11,N/A,N/A,N/A,905,916,N/A,120,5
13,N/A,N/A,N/A,892,905,N/A,125,4
3,N/A,N/A,N/A,889,892,N/A,129,2
1,N/A,N/A,N/A,888,889,N/A,134,1
1,N/A,N/A,N/A,886,887,N/A,3,1
17,N/A,N/A,N/A,869,886,N/A,8,6
19,N/A,N/A,N/A,850,869,N/A,13,5
3,N/A,N/A,N/A,847,850,N/A,17,3
3,N/A,N/A,N/A,844,847,N/A,22,2
12,N/A,N/A,N/A,832,844,N/A,26,6
3,N/A,N/A,N/A,829,832,N/A,29,3
17,N/A,N/A,N/A,812,829,N/A,32,6
17,N/A,N/A,N/A,795,812,N/A,37,5
12,N/A,N/A,N/A,783,795,N/A,42,4
4,N/A,N/A,N/A,779,783,N/A,46,2
4,N/A,N/A,N/A,775,779,N/A,52,2
3,N/A,N/A,N/A,772,775,N/A,58,2
2,N/A,N/A,N/A,770,772,N/A,63,1
12,N/A,N/A,N/A,758,770,N/A,66,4
7,N/A,N/A,N/A,751,758,N/A,72,4
1,N/A,N/A,N/A,750,751,N/A,75,1
12,N/A,N/A,N/A,738,750,N/A,79,5
4,N/A,N/A,N/A,734,738,N/A,83,3
2,N/A,N/A,N/A,732,734,N/A,87,1
20,N/A,N/A,N/A,712,732,N/A,92,6
14,N/A,N/A,N/A,698,712,N/A,97,5
13,N/A,N/A,N/A,685,698,N/A,102,4
3,N/A,N/A,N/A,682,685,N/A,106,2
2,N/A,N/A,N/A,680,682,N/A,111,1
13,N/A,N/A,N/A,667,680,N/A,116,6
3,N/A,N/A,N/A,664,667,N/A,119,3
20,N/A,N/A,N/A,644,664,N/A,122,6
16,N/A,N/A,N/A,628,644,N/A,127,5
4,N/A,N/A,N/A,624,628,N/A,130,2
4,N/A,N/A,N/A,799,803,N/A,6,2
2,N/A,N/A,N/A,797,799,N/A,11,1
2,N/A,N/A,N/A,795,797,N/A,17,1
15,N/A,N/A,N/A,780,795,N/A,21,5
3,N/A,N/A,N/A,777,780,N/A,24,2
13,N/A,N/A,N/A,764,777,N/A,27,5
3,N/A,N/A,N/A,761,764,N/A,31,3
1,N/A,N/A,N/A,760,761,N/A,35,1
11,N/A,N/A,N/A,749,760,N/A,40,6
4,N/A,N/A,N/A,745,749,N/A,43,3
14,N/A,N/A,N/A,731,745,N/A,46,6
8,N/A,N/A,N/A,723,731,N/A,50,4
5,N/A,N/A,N/A,718,723,N/A,56,4
7,N/A,N/A,N/A,711,718,N/A,62,4
4,N/A,N/A,N/A,707,711,N/A,67,3
19,N/A,N/A,N/A,688,707,N/A,70,6
14,N/A,N/A,N/A,674,688,N/A,75,5
3,N/A,N/A,N/A,671,674,N/A,79,3
2,N/A,N/A,N/A,669,671,N/A,83,1
8,N/A,N/A,N/A,661,669,N/A,86,4
2,N/A,N/A,N/A,659,661,N/A,89,1
11,N/A,N/A,N/A,648,659,N/A,94,6
2,N/A,N/A,N/A,646,648,N/A,100,0
12,N/A,N/A,N/A,634,646,N/A,105,5
4,N/A,N/A,N/A,630,634,N/A,109,3
4,N/A,N/A,N/A,626,630,N/A,114,2
4,N/A,N/A,N/A,622,626,N/A,120,2
2,N/A,N/A,N/A,620,622,N/A,126,2
17,N/A,N/A,N/A,603,620,N/A,129,5
11,N/A,N/A,N/A,592,603,N/A,134,4
3,N/A,N/A,N/A,1855,1858,N/A,5,3
2,N/A,N/A,N/A,1853,1855,N/A,11,3
2,N/A,N/A,N/A,1851,1853,N/A,15,1
13,N/A,N/A,N/A,1838,1851,N/A,19,5
11,N/A,N/A,N/A,1827,1838,N/A,24,4
3,N/A,N/A,N/A,1824,1827,N/A,29,3
3,N/A,N/A,N/A,1821,1824,N/A,35,3
2,N/A,N/A,N/A,1819,1821,N/A,41,3
1,N/A,N/A,N/A,1818,1819,N/A,45,1
18,N/A,N/A,N/A,1800,1818,N/A,49,5
4,N/A,N/A,N/A,1796,1800,N/A,53,3
4,N/A,N/A,N/A,1792,1796,N/A,58,2
13,N/A,N/A,N/A,1779,1792,N/A,61,5
10,N/A,N/A,N/A,1769,1779,N/A,66,4
4,N/A,N/A,N/A,1765,1769,N/A,70,2
3,N/A,N/A,N/A,1762,1765,N/A,76,2
2,N/A,N/A,N/A,1760,1762,N/A,81,1
11,N/A,N/A,N/A,1749,1760,N/A,85,5
15,N/A,N/A,N/A,1734,1749,N/A,91,5
4,N/A,N/A,N/A,1730,1734,N/A,94,2
14,N/A,N/A,N/A,1716,1730,N/A,98,6
4,N/A,N/A,N/A,1712,1716,N/A,101,3
11,N/A,N/A,N/A,1701,1712,N/A,104,6
2,N/A,N/A,N/A,1699,1701,N/A,110,0
3,N/A,N/A,N/A,1696,1699,N/A,113,3
14,N/A,N/A,N/A,1682,1696,N/A,116,6
17,N/A,N/A,N/A,1665,1682,N/A,121,5
13,N/A,N/A,N/A,1652,1665,N/A,127,5
3,N/A,N/A,N/A,1649,1652,N/A,131,3
1,N/A,N/A,N/A,1648,1649,N/A,135,1
2,N/A,N/A,N/A,1295,1297,N/A,4,2
1,N/A,N/A,N/A,1294,1295,N/A,9,1
18,N/A,N/A,N/A,1276,1294,N/A,13,5
4,N/A,N/A,N/A,1272,1276,N/A,17,3
4,N/A,N/A,N/A,1268,1272,N/A,23,3
1,N/A,N/A,N/A,1267,1268,N/A,27,1
8,N/A,N/A,N/A,1259,1267,N/A,30,4
10,N/A,N/A,N/A,1249,1259,N/A,36,4
7,N/A,N/A,N/A,1242,1249,N/A,42,4
8,N/A,N/A,N/A,1234,1242,N/A,48,4
4,N/A,N/A,N/A,1230,1234,N/A,53,3
4,N/A,N/A,N/A,1226,1230,N/A,58,2
19,N/A,N/A,N/A,1207,1226,N/A,61,5
2,N/A,N/A,N/A,1205,1207,N/A,65,3
3,N/A,N/A,N/A,1202,1205,N/A,71,3
4,N/A,N/A,N/A,1198,1202,N/A,77,3
2,N/A,N/A,N/A,1196,1198,N/A,81,1
12,N/A,N/A,N/A,1184,1196,N/A,84,4
2,N/A,N/A,N/A,1182,1184,N/A,87,1
11,N/A,N/A,N/A,1171,1182,N/A,91,5
3,N/A,N/A,N/A,1168,1171,N/A,94,2
2,N/A,N/A,N/A,1166,1168,N/A,100,2
17,N/A,N/A,N/A,1149,1166,N/A,103,5
2,N/A,N/A,N/A,1147,1149,N/A,106,2
2,N/A,N/A,N/A,1145,1147,N/A,111,1
15,N/A,N/A,N/A,1130,1145,N/A,115,5
17,N/A,N/A,N/A,1113,1130,N/A,121,5
2,N/A,N/A,N/A,1111,1113,N/A,125,3
1,N/A,N/A,N/A,1110,1111,N/A,129,1
9,N/A,N/A,N/A,1101,1110,N/A,132,4
14,N/A,N/A,N/A,1611,1625,N/A,6,5
3,N/A,N/A,N/A,1608,1611,N/A,9,2
2,N/A,N/A,N/A,1606,1608,N/A,15,2
18,N/A,N/A,N/A,1588,1606,N/A,18,5
3,N/A,N/A,N/A,1585,1588,N/A,21,2
2,N/A,N/A,N/A,1583,1585,N/A,26,1
19,N/A,N/A,N/A,1564,1583,N/A,30,5
11,N/A,N/A,N/A,1553,1564,N/A,36,5
13,N/A,N/A,N/A,1540,1553,N/A,41,4
2,N/A,N/A,N/A,1538,1540,N/A,44,1
1,N/A,N/A,N/A,1537,1538,N/A,50,1
19,N/A,N/A,N/A,1518,1537,N/A,54,5
6,N/A,N/A,N/A,1512,1518,N/A,59,4
11,N/A,N/A,N/A,1501,1512,N/A,65,4
3,N/A,N/A,N/A,1498,1501,N/A,70,3
3,N/A,N/A,N/A,1495,1498,N/A,76,3
4,N/A,N/A,N/A,1491,1495,N/A,82,3
17,N/A,N/A,N/A,1474,1491,N/A,85,6
2,N/A,N/A,N/A,1472,1474,N/A,91,0
12,N/A,N/A,N/A,1460,1472,N/A,97,6
4,N/A,N/A,N/A,1456,1460,N/A,100,3
3,N/A,N/A,N/A,1453,1456,N/A,106,3
15,N/A,N/A,N/A,1438,1453,N/A,109,6
3,N/A,N/A,N/A,1435,1438,N/A,112,3
4,N/A,N/A,N/A,1431,1435,N/A,118,3
2,N/A,N/A,N/A,1429,1431,N/A,122,1
17,N/A,N/A,N/A,1412,1429,N/A,126,5
4,N/A,N/A,N/A,1408,1412,N/A,129,2
19,N/A,N/A,N/A,1389,1408,N/A,133,6
2,N/A,N/A,N/A,1387,1389,N/A,139,0
20,N/A,N/A,N/A,1676,1696,N/A,4,6
6,N/A,N/A,N/A,1670,1676,N/A,8,4
4,N/A,N/A,N/A,1666,1670,N/A,13,3
17,N/A,N/A,N/A,1649,1666,N/A,16,6
4,N/A,N/A,N/A,1645,1649,N/A,19,3
1,N/A,N/A,N/A,1644,1645,N/A,23,1
17,N/A,N/A,N/A,1627,1644,N/A,27,5
2,N/A,N/A,N/A,1625,1627,N/A,30,2
2,N/A,N/A,N/A,1623,1625,N/A,36,2
19,N/A,N/A,N/A,1604,1623,N/A,40,6
10,N/A,N/A,N/A,1594,1604,N/A,44,4
3,N/A,N/A,N/A,1591,1594,N/A,49,3
20,N/A,N/A,N/A,1571,1591,N/A,52,6
1,N/A,N/A,N/A,1570,1571,N/A,58,0
20,N/A,N/A,N/A,1550,1570,N/A,64,6
2,N/A,N/A,N/A,1548,1550,N/A,70,0
18,N/A,N/A,N/A,1530,1548,N/A,75,5
4,N/A,N/A,N/A,1526,1530,N/A,79,3
1,N/A,N/A,N/A,1525,1526,N/A,83,1
11,N/A,N/A,N/A,1514,1525,N/A,87,5
15,N/A,N/A,N/A,1499,1514,N/A,93,5
3,N/A,N/A,N/A,1496,1499,N/A,96,2
1,N/A,N/A,N/A,1495,1496,N/A,101,1
2,N/A,N/A,N/A,1493,1495,N/A,107,1
12,N/A,N/A,N/A,1481,1493,N/A,111,5
2,N/A,N/A,N/A,1479,1481,N/A,114,2
4,N/A,N/A,N/A,1475,1479,N/A,120,2
16,N/A,N/A,N/A,1459,1475,N/A,123,5
9,N/A,N/A,N/A,1450,1459,N/A,128,4
1,N/A,N/A,N/A,1449,1450,N/A,131,1
3,N/A,N/A,N/A,1574,1577,N/A,3,3
4,N/A,N/A,N/A,1570,1574,N/A,8,2
1,N/A,N/A,N/A,1569,1570,N/A,13,1
2,N/A,N/A,N/A,1567,1569,N/A,19,1
14,N/A,N/A,N/A,1553,1567,N/A,24,6
3,N/A,N/A,N/A,1550,1553,N/A,27,3
1,N/A,N/A,N/A,1549,1550,N/A,31,1
15,N/A,N/A,N/A,1534,1549,N/A,35,5
14,N/A,N/A,N/A,1520,1534,N/A,41,5
2,N/A,N/A,N/A,1518,1520,N/A,44,2
18,N/A,N/A,N/A,1500,1518,N/A,47,5
13,N/A,N/A,N/A,1487,1500,N/A,53,5
2,N/A,N/A,N/A,1485,1487,N/A,56,2
2,N/A,N/A,N/A,1483,1485,N/A,61,1
1,N/A,N/A,N/A,1482,1483,N/A,67,1
14,N/A,N/A,N/A,1468,1482,N/A,70,4
2,N/A,N/A,N/A,1466,1468,N/A,74,2
15,N/A,N/A,N/A,1451,1466,N/A,77,5
6,N/A,N/A,N/A,1445,1451,N/A,82,4
8,N/A,N/A,N/A,1437,1445,N/A,88,4
3,N/A,N/A,N/A,1434,1437,N/A,92,2
2,N/A,N/A,N/A,1432,1434,N/A,98,2
13,N/A,N/A,N/A,1419,1432,N/A,102,6
2,N/A,N/A,N/A,1417,1419,N/A,105,3
2,N/A,N/A,N/A,1415,1417,N/A,111,3
2,N/A,N/A,N/A,1413,1415,N/A,116,2
12,N/A,N/A,N/A,1401,1413,N/A,119,5
4,N/A,N/A,N/A,1397,1401,N/A,122,2
2,N/A,N/A,N/A,1395,1397,N/A,127,1
15,N/A,N/A,N/A,1380,1395,N/A,131,5
13,N/A,N/A,N/A,1757,1770,N/A,5,6
3,N/A,N/A,N/A,1754,1757,N/A,8,3
12,N/A,N/A,N/A,1742,1754,N/A,11,6
10,N/A,N/A,N/A,1732,1742,N/A,16,5
4,N/A,N/A,N/A,1728,1732,N/A,19,2
2,N/A,N/A,N/A,1726,1728,N/A,24,1
14,N/A,N/A,N/A,1712,1726,N/A,27,4
4,N/A,N/A,N/A,1708,1712,N/A,32,3
2,N/A,N/A,N/A,1706,1708,N/A,38,3
4,N/A,N/A,N/A,1702,1706,N/A,43,2
15,N/A,N/A,N/A,1687,1702,N/A,47,6
7,N/A,N/A,N/A,1680,1687,N/A,51,4
9,N/A,N/A,N/A,1671,1680,N/A,57,4
10,N/A,N/A,N/A,1661,1671,N/A,63,4
2,N/A,N/A,N/A,1659,1661,N/A,68,3
4,N/A,N/A,N/A,1655,1659,N/A,73,2
3,N/A,N/A,N/A,1652,1655,N/A,79,2
13,N/A,N/A,N/A,1639,1652,N/A,82,5
4,N/A,N/A,N/A,1635,1639,N/A,85,2
3,N/A,N/A,N/A,1632,1635,N/A,91,2
2,N/A,N/A,N/A,1630,1632,N/A,96,1
12,N/A,N/A,N/A,1618,1630,N/A,100,5
3,N/A,N/A,N/A,1615,1618,N/A,104,3
2,N/A,N/A,N/A,1613,1615,N/A,108,1
11,N/A,N/A,N/A,1602,1613,N/A,111,4
2,N/A,N/A,N/A,1600,1602,N/A,114,1
11,N/A,N/A,N/A,1589,1600,N/A,119,6
11,N/A,N/A,N/A,1578,1589,N/A,123,4
2,N/A,N/A,N/A,1576,1578,N/A,126,1
18,N/A,N/A,N/A,1558,1576,N/A,130,5
19,N/A,N/A,N/A,292,311,N/A,6,5
4,N/A,N/A,N/A,288,292,N/A,10,3
11,N/A,N/A,N/A,277,288,N/A,13,6
10,N/A,N/A,N/A,267,277,N/A,17,4
10,N/A,N/A,N/A,257,267,N/A,23,4
13,N/A,N/A,N/A,244,257,N/A,29,4
3,N/A,N/A,N/A,241,244,N/A,33,2
11,N/A,N/A,N/A,230,241,N/A,36,5
6,N/A,N/A,N/A,224,230,N/A,41,4
3,N/A,N/A,N/A,221,224,N/A,46,3
4,N/A,N/A,N/A,217,221,N/A,52,3
4,N/A,N/A,N/A,213,217,N/A,57,2
4,N/A,N/A,N/A,209,213,N/A,63,2
3,N/A,N/A,N/A,206,209,N/A,69,2
18,N/A,N/A,N/A,188,206,N/A,72,5
4,N/A,N/A,N/A,184,188,N/A,75,2
14,N/A,N/A,N/A,170,184,N/A,78,5
4,N/A,N/A,N/A,166,170,N/A,82,3
4,N/A,N/A,N/A,162,166,N/A,88,3
19,N/A,N/A,N/A,143,162,N/A,91,6
1,N/A,N/A,N/A,142,143,N/A,97,0
14,N/A,N/A,N/A,128,142,N/A,101,4
2,N/A,N/A,N/A,126,128,N/A,106,3
19,N/A,N/A,N/A,107,126,N/A,109,6
14,N/A,N/A,N/A,93,107,N/A,113,4
4,N/A,N/A,N/A,89,93,N/A,118,3
3,N/A,N/A,N/A,86,89,N/A,123,2
3,N/A,N/A,N/A,83,86,N/A,129,2
11,N/A,N/A,N/A,72,83,N/A,133,6
2,N/A,N/A,N/A,70,72,N/A,136,3
3,N/A,N/A,N/A,684,687,N/A,6,2
3,N/A,N/A,N/A,681,684,N/A,12,2
11,N/A,N/A,N/A,670,681,N/A,15,5
2,N/A,N/A,N/A,668,670,N/A,18,2
18,N/A,N/A,N/A,650,668,N/A,21,5
5,N/A,N/A,N/A,645,650,N/A,26,4
2,N/A,N/A,N/A,643,645,N/A,29,1
12,N/A,N/A,N/A,631,643,N/A,34,6
1,N/A,N/A,N/A,630,631,N/A,40,0
20,N/A,N/A,N/A,610,630,N/A,46,6
6,N/A,N/A,N/A,604,610,N/A,50,4
3,N/A,N/A,N/A,601,604,N/A,54,2
17,N/A,N/A,N/A,584,601,N/A,58,6
4,N/A,N/A,N/A,580,584,N/A,61,3
4,N/A,N/A,N/A,576,580,N/A,67,3
2,N/A,N/A,N/A,574,576,N/A,72,2
18,N/A,N/A,N/A,556,574,N/A,76,6
4,N/A,N/A,N/A,552,556,N/A,79,3
2,N/A,N/A,N/A,550,552,N/A,84,2
20,N/A,N/A,N/A,530,550,N/A,88,6
1,N/A,N/A,N/A,529,530,N/A,94,0
13,N/A,N/A,N/A,516,529,N/A,99,5
12,N/A,N/A,N/A,504,516,N/A,104,4
2,N/A,N/A,N/A,502,504,N/A,107,1
8,N/A,N/A,N/A,494,502,N/A,110,4
2,N/A,N/A,N/A,492,494,N/A,113,1
13,N/A,N/A,N/A,479,492,N/A,116,4
6,N/A,N/A,N/A,473,479,N/A,122,4
3,N/A,N/A,N/A,470,473,N/A,127,3
4,N/A,N/A,N/A,466,470,N/A,132,2
